Date,Description,Deposits,Withdrawls,Balance
20-Aug-2020,Cheque,"582,827.75",00.00,"609,730.09"
20-Aug-2020,Interest,00.00,"76,216.26","533,513.83"
20-Aug-2020,Cheque,00.00,"177,837.94","355,675.89"
20-Aug-2020,Tax,00.00,"50,810.84","304,865.05"
20-Aug-2020,Debit Card,"260,428.00",00.00,"565,293.05"
20-Aug-2020,Interest,"10,289.95",00.00,"575,583.00"
20-Aug-2020,ATM,00.00,"575,583.00",00.00
20-Aug-2020,Commission,02.00,00.00,02.00
20-Aug-2020,RTGS,"259,250.00",00.00,"259,252.00"
20-Aug-2020,RTGS,"1,587,927.50",00.00,"1,847,179.50"
20-Aug-2020,Reversal,03.00,00.00,"1,847,182.50"
20-Aug-2020,ATM,"739,105.00",00.00,"2,586,287.50"
20-Aug-2020,Tax,00.00,"431,047.92","2,155,239.58"
20-Aug-2020,Purchase,"458,962.50",00.00,"2,614,202.08"
20-Aug-2020,RTGS,"31,544.40",00.00,"2,645,746.48"
20-Aug-2020,Cheque,00.00,"2,645,746.48",00.00
20-Aug-2020,IMPS,21.60,00.00,21.60
20-Aug-2020,Purchase,"133,742.00",00.00,"133,763.60"
20-Aug-2020,NEFT,00.00,"14,862.62","118,900.98"
20-Aug-2020,Tax,02.80,00.00,"118,903.78"
20-Aug-2020,Commission,"155,885.00",00.00,"274,788.78"
20-Aug-2020,Purchase,184.23,00.00,"274,973.01"
20-Aug-2020,Miscellaneous,00.00,"54,994.60","219,978.41"
20-Aug-2020,Debit Card,380.93,00.00,"220,359.34"
21-Aug-2020,Cash,00.00,"31,479.91","188,879.43"
21-Aug-2020,Cash,00.00,"47,219.86","141,659.57"
21-Aug-2020,Reversal,00.00,"47,219.86","94,439.71"
21-Aug-2020,Tax,00.00,"13,491.39","80,948.32"
21-Aug-2020,Transfer,35.89,00.00,"80,984.21"
21-Aug-2020,Bill,47.00,00.00,"81,031.21"
21-Aug-2020,Reversal,00.00,"13,505.20","67,526.01"
21-Aug-2020,IMPS,00.00,"67,526.01",00.00
21-Aug-2020,Bill,"29,903.10",00.00,"29,903.10"
21-Aug-2020,Purchase,"22,292.40",00.00,"52,195.50"
21-Aug-2020,Purchase,"836,681.00",00.00,"888,876.50"
21-Aug-2020,Cheque,"1,262,915.00",00.00,"2,151,791.50"
21-Aug-2020,Reversal,00.00,"215,179.15","1,936,612.35"
21-Aug-2020,Miscellaneous,11.30,00.00,"1,936,623.65"
21-Aug-2020,Interest,"22,367.00",00.00,"1,958,990.65"
21-Aug-2020,Cheque,00.00,"244,873.83","1,714,116.82"
21-Aug-2020,IMPS,00.00,"342,823.36","1,371,293.46"
21-Aug-2020,Tax,01.60,00.00,"1,371,295.06"
21-Aug-2020,NEFT,"63,677.91",00.00,"1,434,972.97"
21-Aug-2020,Cheque,00.00,"204,996.14","1,229,976.83"
21-Aug-2020,NEFT,00.00,"175,710.98","1,054,265.85"
21-Aug-2020,Transfer,"9,002.50",00.00,"1,063,268.35"
21-Aug-2020,Debit Card,00.00,"177,211.39","886,056.96"
21-Aug-2020,Cheque,"298,564.00",00.00,"1,184,620.96"
21-Aug-2020,Transfer,00.00,"197,436.83","987,184.13"
21-Aug-2020,Transfer,00.00,"197,436.83","789,747.30"
21-Aug-2020,Cash,00.00,"789,747.30",00.00
21-Aug-2020,Reversal,"194,534.00",00.00,"194,534.00"
21-Aug-2020,IMPS,00.00,"24,316.75","170,217.25"
21-Aug-2020,IMPS,09.25,00.00,"170,226.50"
21-Aug-2020,Debit Card,00.00,"17,022.65","153,203.85"
21-Aug-2020,IMPS,00.00,"21,886.26","131,317.59"
21-Aug-2020,IMPS,00.00,"65,658.80","65,658.80"
21-Aug-2020,Tax,36.12,00.00,"65,694.92"
21-Aug-2020,RTGS,"93,975.00",00.00,"159,669.92"
21-Aug-2020,ATM,00.00,"19,958.74","139,711.18"
21-Aug-2020,Purchase,"1,070,024.75",00.00,"1,209,735.93"
21-Aug-2020,Miscellaneous,00.00,"151,216.99","1,058,518.94"
21-Aug-2020,Reversal,00.00,"1,058,518.94",00.00
21-Aug-2020,Debit Card,"209,014.00",00.00,"209,014.00"
21-Aug-2020,RTGS,00.00,"20,901.40","188,112.60"
21-Aug-2020,NEFT,"4,258.00",00.00,"192,370.60"
21-Aug-2020,RTGS,00.00,"19,237.06","173,133.54"
21-Aug-2020,Commission,00.00,"86,566.77","86,566.77"
21-Aug-2020,Cash,263.70,00.00,"86,830.47"
21-Aug-2020,Transfer,"149,670.00",00.00,"236,500.47"
21-Aug-2020,Commission,00.00,"78,833.49","157,666.98"
21-Aug-2020,Miscellaneous,00.00,"22,523.85","135,143.13"
21-Aug-2020,Bill,02.83,00.00,"135,145.96"
21-Aug-2020,Bill,53.11,00.00,"135,199.07"
21-Aug-2020,NEFT,"185,008.90",00.00,"320,207.97"
21-Aug-2020,Reversal,139.00,00.00,"320,346.97"
21-Aug-2020,Miscellaneous,04.80,00.00,"320,351.77"
21-Aug-2020,Miscellaneous,00.00,"80,087.94","240,263.83"
21-Aug-2020,Bill,15.12,00.00,"240,278.95"
21-Aug-2020,Cash,00.00,"60,069.74","180,209.21"
21-Aug-2020,NEFT,347.00,00.00,"180,556.21"
21-Aug-2020,Interest,"21,316.46",00.00,"201,872.67"
21-Aug-2020,IMPS,01.70,00.00,"201,874.37"
21-Aug-2020,Interest,00.44,00.00,"201,874.81"
21-Aug-2020,Debit Card,07.00,00.00,"201,881.81"
21-Aug-2020,IMPS,00.00,"100,940.91","100,940.90"
21-Aug-2020,NEFT,06.44,00.00,"100,947.34"
21-Aug-2020,Purchase,00.00,"33,649.11","67,298.23"
21-Aug-2020,ATM,00.00,"9,614.03","57,684.20"
21-Aug-2020,Miscellaneous,02.60,00.00,"57,686.80"
21-Aug-2020,Debit Card,00.00,"14,421.70","43,265.10"
21-Aug-2020,Cheque,00.00,"7,210.85","36,054.25"
21-Aug-2020,Purchase,36.00,00.00,"36,090.25"
21-Aug-2020,ATM,208.61,00.00,"36,298.86"
21-Aug-2020,Miscellaneous,00.00,"18,149.43","18,149.43"
21-Aug-2020,Tax,00.00,"18,149.43",00.00
21-Aug-2020,Cash,"8,487.81",00.00,"8,487.81"
21-Aug-2020,Interest,06.61,00.00,"8,494.42"
21-Aug-2020,Bill,33.00,00.00,"8,527.42"
21-Aug-2020,Purchase,"29,988.00",00.00,"38,515.42"
21-Aug-2020,Tax,21.10,00.00,"38,536.52"
21-Aug-2020,Tax,"23,286.10",00.00,"61,822.62"
21-Aug-2020,Debit Card,00.00,"10,303.77","51,518.85"
21-Aug-2020,Debit Card,347.70,00.00,"51,866.55"
21-Aug-2020,Debit Card,00.00,"7,409.51","44,457.04"
21-Aug-2020,Miscellaneous,00.00,"11,114.26","33,342.78"
21-Aug-2020,Tax,00.00,"6,668.56","26,674.22"
21-Aug-2020,RTGS,00.00,"2,963.80","23,710.42"
21-Aug-2020,Cash,00.00,"2,371.04","21,339.38"
21-Aug-2020,Debit Card,466.00,00.00,"21,805.38"
21-Aug-2020,Purchase,00.00,"2,422.82","19,382.56"
21-Aug-2020,Commission,"655,348.00",00.00,"674,730.56"
21-Aug-2020,Transfer,167.00,00.00,"674,897.56"
21-Aug-2020,Bill,00.00,"112,482.93","562,414.63"
21-Aug-2020,Reversal,00.00,"112,482.93","449,931.70"
21-Aug-2020,Cheque,00.00,"449,931.70",00.00
21-Aug-2020,Transfer,04.60,00.00,04.60
21-Aug-2020,IMPS,456.34,00.00,460.94
21-Aug-2020,Cheque,00.00,57.62,403.32
22-Aug-2020,Purchase,00.00,100.83,302.49
22-Aug-2020,Bill,"1,981,317.80",00.00,"1,981,620.29"
22-Aug-2020,Transfer,453.00,00.00,"1,982,073.29"
22-Aug-2020,Purchase,308.00,00.00,"1,982,381.29"
22-Aug-2020,Transfer,05.00,00.00,"1,982,386.29"
22-Aug-2020,Interest,00.00,"396,477.26","1,585,909.03"
22-Aug-2020,Cheque,05.36,00.00,"1,585,914.39"
22-Aug-2020,Miscellaneous,00.00,"317,182.88","1,268,731.51"
22-Aug-2020,Bill,"15,733.50",00.00,"1,284,465.01"
22-Aug-2020,Debit Card,00.00,"256,893.00","1,027,572.01"
22-Aug-2020,Interest,00.00,"171,262.00","856,310.01"
22-Aug-2020,Tax,00.00,"856,310.01",00.00
22-Aug-2020,Cheque,06.10,00.00,06.10
22-Aug-2020,NEFT,00.00,03.05,03.05
22-Aug-2020,Bill,00.00,01.53,01.52
23-Aug-2020,Bill,00.00,00.38,01.14
23-Aug-2020,RTGS,00.00,00.16,00.98
23-Aug-2020,Tax,52.57,00.00,53.55
23-Aug-2020,RTGS,00.00,07.65,45.90
23-Aug-2020,NEFT,18.00,00.00,63.90
23-Aug-2020,RTGS,59.41,00.00,123.31
23-Aug-2020,Purchase,297.50,00.00,420.81
23-Aug-2020,IMPS,33.95,00.00,454.76
23-Aug-2020,Interest,00.00,454.76,00.00
23-Aug-2020,Miscellaneous,57.00,00.00,57.00
23-Aug-2020,Reversal,"9,486.00",00.00,"9,543.00"
23-Aug-2020,IMPS,"190,201.70",00.00,"199,744.70"
23-Aug-2020,Interest,"378,589.25",00.00,"578,333.95"
23-Aug-2020,Purchase,223.79,00.00,"578,557.74"
23-Aug-2020,Bill,46.69,00.00,"578,604.43"
23-Aug-2020,Miscellaneous,00.00,"72,325.55","506,278.88"
23-Aug-2020,IMPS,00.00,"84,379.81","421,899.07"
23-Aug-2020,Miscellaneous,"24,681.00",00.00,"446,580.07"
23-Aug-2020,RTGS,46.75,00.00,"446,626.82"
23-Aug-2020,Tax,00.00,"74,437.80","372,189.02"
23-Aug-2020,Purchase,00.00,"186,094.51","186,094.51"
23-Aug-2020,Commission,"201,518.00",00.00,"387,612.51"
23-Aug-2020,Reversal,00.00,"38,761.25","348,851.26"
23-Aug-2020,IMPS,171.90,00.00,"349,023.16"
23-Aug-2020,Purchase,419.10,00.00,"349,442.26"
23-Aug-2020,Interest,00.00,"38,826.92","310,615.34"
23-Aug-2020,Cash,00.00,"77,653.84","232,961.50"
23-Aug-2020,Miscellaneous,00.00,"23,296.15","209,665.35"
23-Aug-2020,Purchase,00.00,"104,832.68","104,832.68"
23-Aug-2020,Debit Card,00.00,"20,966.54","83,866.14"
23-Aug-2020,Transfer,"3,351.42",00.00,"87,217.56"
23-Aug-2020,Tax,"1,599,028.00",00.00,"1,686,245.56"
23-Aug-2020,Reversal,21.90,00.00,"1,686,267.46"
23-Aug-2020,Interest,01.30,00.00,"1,686,268.76"
23-Aug-2020,Miscellaneous,"110,661.20",00.00,"1,796,929.96"
23-Aug-2020,Miscellaneous,"10,582.20",00.00,"1,807,512.16"
23-Aug-2020,Commission,07.00,00.00,"1,807,519.16"
23-Aug-2020,Interest,00.00,"200,835.46","1,606,683.70"
23-Aug-2020,Miscellaneous,00.00,"803,341.85","803,341.85"
23-Aug-2020,IMPS,"3,806.27",00.00,"807,148.12"
23-Aug-2020,Miscellaneous,00.00,"100,893.52","706,254.60"
23-Aug-2020,Tax,00.00,"88,281.83","617,972.78"
23-Aug-2020,Interest,00.00,"154,493.20","463,479.58"
23-Aug-2020,Tax,36.45,00.00,"463,516.03"
23-Aug-2020,Tax,00.00,"51,501.78","412,014.25"
23-Aug-2020,Reversal,00.00,"412,014.25",00.00
23-Aug-2020,Tax,20.99,00.00,20.99
23-Aug-2020,Cheque,07.50,00.00,28.49
23-Aug-2020,Commission,"234,063.00",00.00,"234,091.49"
23-Aug-2020,Tax,01.30,00.00,"234,092.79"
23-Aug-2020,IMPS,"3,159.00",00.00,"237,251.79"
23-Aug-2020,Bill,00.00,"23,725.18","213,526.61"
23-Aug-2020,Interest,31.90,00.00,"213,558.51"
23-Aug-2020,Debit Card,00.00,"23,728.72","189,829.79"
23-Aug-2020,Interest,406.80,00.00,"190,236.59"
23-Aug-2020,Interest,00.00,"95,118.30","95,118.30"
23-Aug-2020,Purchase,"30,921.47",00.00,"126,039.77"
23-Aug-2020,Interest,00.00,"12,603.98","113,435.79"
23-Aug-2020,Miscellaneous,00.00,"14,179.47","99,256.32"
23-Aug-2020,Cheque,00.00,"11,028.48","88,227.84"
23-Aug-2020,Commission,00.00,"14,704.64","73,523.20"
23-Aug-2020,RTGS,00.00,"12,253.87","61,269.33"
23-Aug-2020,Tax,00.00,"6,126.93","55,142.40"
23-Aug-2020,Purchase,00.00,"27,571.20","27,571.20"
24-Aug-2020,Tax,"9,075.07",00.00,"36,646.27"
24-Aug-2020,Purchase,"222,086.00",00.00,"258,732.27"
24-Aug-2020,Interest,"779,073.80",00.00,"1,037,806.07"
24-Aug-2020,Transfer,00.00,"518,903.04","518,903.04"
24-Aug-2020,Transfer,00.00,"518,903.04",00.00
24-Aug-2020,Miscellaneous,57.00,00.00,57.00
24-Aug-2020,Cash,00.00,11.40,45.60
24-Aug-2020,Reversal,"224,476.31",00.00,"224,521.91"
24-Aug-2020,Miscellaneous,"138,805.28",00.00,"363,327.19"
24-Aug-2020,Interest,387.00,00.00,"363,714.19"
24-Aug-2020,ATM,00.00,"181,857.10","181,857.10"
24-Aug-2020,Cash,147.90,00.00,"182,005.00"
24-Aug-2020,Purchase,"610,829.25",00.00,"792,834.25"
24-Aug-2020,Reversal,00.00,"158,566.85","634,267.40"
24-Aug-2020,Cheque,00.00,"211,422.47","422,844.93"
24-Aug-2020,Cash,00.00,"105,711.23","317,133.70"
24-Aug-2020,Debit Card,00.00,"52,855.62","264,278.08"
24-Aug-2020,IMPS,00.00,"66,069.52","198,208.56"
24-Aug-2020,Debit Card,418.20,00.00,"198,626.76"
25-Aug-2020,Purchase,59.32,00.00,"198,686.08"
25-Aug-2020,Cheque,"190,294.40",00.00,"388,980.48"
25-Aug-2020,Reversal,"960,797.00",00.00,"1,349,777.48"
25-Aug-2020,Cheque,00.00,"168,722.19","1,181,055.30"
25-Aug-2020,Transfer,00.00,"131,228.37","1,049,826.93"
25-Aug-2020,Tax,00.00,"174,971.16","874,855.77"
25-Aug-2020,Purchase,00.00,"145,809.30","729,046.48"
25-Aug-2020,Bill,00.00,"243,015.49","486,030.99"
25-Aug-2020,Transfer,"176,425.50",00.00,"662,456.49"
25-Aug-2020,IMPS,00.00,"331,228.25","331,228.24"
25-Aug-2020,Reversal,"143,443.00",00.00,"474,671.24"
25-Aug-2020,Transfer,04.00,00.00,"474,675.24"
25-Aug-2020,Transfer,00.00,"237,337.62","237,337.62"
25-Aug-2020,Commission,"3,768.00",00.00,"241,105.62"
26-Aug-2020,Commission,00.00,"120,552.81","120,552.81"
26-Aug-2020,Interest,"2,870.20",00.00,"123,423.01"
26-Aug-2020,Purchase,00.00,"12,342.30","111,080.71"
26-Aug-2020,Purchase,04.40,00.00,"111,085.11"
26-Aug-2020,Reversal,"28,472.10",00.00,"139,557.21"
26-Aug-2020,Interest,00.00,"46,519.07","93,038.14"
26-Aug-2020,Bill,00.49,00.00,"93,038.63"
26-Aug-2020,Cash,00.00,"31,012.88","62,025.75"
26-Aug-2020,Reversal,00.00,"10,337.63","51,688.12"
26-Aug-2020,Debit Card,04.70,00.00,"51,692.82"
26-Aug-2020,ATM,00.00,"25,846.41","25,846.41"
26-Aug-2020,Miscellaneous,"53,876.70",00.00,"79,723.11"
26-Aug-2020,NEFT,00.00,"11,389.02","68,334.09"
26-Aug-2020,RTGS,604.04,00.00,"68,938.13"
26-Aug-2020,Tax,05.08,00.00,"68,943.21"
26-Aug-2020,NEFT,"1,499.83",00.00,"70,443.04"
26-Aug-2020,Interest,00.00,"70,443.04",00.00
26-Aug-2020,Purchase,"161,788.70",00.00,"161,788.70"
26-Aug-2020,NEFT,14.51,00.00,"161,803.21"
26-Aug-2020,Debit Card,05.00,00.00,"161,808.21"
26-Aug-2020,Tax,"969,973.00",00.00,"1,131,781.21"
26-Aug-2020,Bill,"2,164.00",00.00,"1,133,945.21"
26-Aug-2020,Miscellaneous,00.00,"377,981.74","755,963.47"
26-Aug-2020,Tax,00.00,"125,993.91","629,969.56"
26-Aug-2020,Tax,"1,016.40",00.00,"630,985.96"
26-Aug-2020,Transfer,47.48,00.00,"631,033.44"
26-Aug-2020,Cash,"69,776.19",00.00,"700,809.63"
26-Aug-2020,Reversal,00.00,"116,801.61","584,008.02"
26-Aug-2020,Transfer,00.00,"97,334.67","486,673.35"
26-Aug-2020,Tax,00.00,"48,667.34","438,006.01"
26-Aug-2020,Interest,"2,135.62",00.00,"440,141.63"
26-Aug-2020,Cheque,00.00,"440,141.63",00.00
26-Aug-2020,Debit Card,01.30,00.00,01.30
26-Aug-2020,Interest,00.00,00.65,00.65
26-Aug-2020,ATM,"1,955.00",00.00,"1,955.65"
26-Aug-2020,NEFT,00.00,"1,955.65",00.00
26-Aug-2020,NEFT,"19,096.00",00.00,"19,096.00"
26-Aug-2020,Tax,00.00,"6,365.33","12,730.67"
26-Aug-2020,Cash,02.00,00.00,"12,732.67"
26-Aug-2020,Cheque,"143,963.30",00.00,"156,695.97"
26-Aug-2020,Commission,07.00,00.00,"156,702.97"
26-Aug-2020,NEFT,00.00,"39,175.74","117,527.23"
26-Aug-2020,Reversal,00.00,"29,381.81","88,145.42"
26-Aug-2020,Interest,184.00,00.00,"88,329.42"
26-Aug-2020,Commission,938.00,00.00,"89,267.42"
26-Aug-2020,Tax,00.00,"17,853.48","71,413.94"
26-Aug-2020,Bill,"178,381.00",00.00,"249,794.94"
26-Aug-2020,Commission,00.00,"24,979.49","224,815.45"
26-Aug-2020,Tax,00.00,"22,481.55","202,333.90"
26-Aug-2020,IMPS,59.00,00.00,"202,392.90"
26-Aug-2020,Bill,"19,213.10",00.00,"221,606.00"
26-Aug-2020,Interest,00.00,"22,160.60","199,445.40"
26-Aug-2020,IMPS,00.00,"33,240.90","166,204.50"
26-Aug-2020,Cheque,470.15,00.00,"166,674.65"
26-Aug-2020,NEFT,00.00,"166,674.65",00.00
26-Aug-2020,NEFT,"1,810.10",00.00,"1,810.10"
26-Aug-2020,Cheque,"30,822.00",00.00,"32,632.10"
26-Aug-2020,Transfer,"240,016.00",00.00,"272,648.10"
26-Aug-2020,Transfer,99.99,00.00,"272,748.09"
26-Aug-2020,Cheque,00.00,"38,964.01","233,784.08"
26-Aug-2020,Tax,"3,722.01",00.00,"237,506.09"
26-Aug-2020,Purchase,00.00,"79,168.70","158,337.39"
26-Aug-2020,Bill,00.00,"15,833.74","142,503.65"
26-Aug-2020,Cheque,"1,350.30",00.00,"143,853.95"
26-Aug-2020,IMPS,06.20,00.00,"143,860.15"
26-Aug-2020,RTGS,"2,043.30",00.00,"145,903.45"
26-Aug-2020,Commission,25.50,00.00,"145,928.95"
26-Aug-2020,Miscellaneous,00.00,"36,482.24","109,446.71"
26-Aug-2020,Reversal,"203,959.12",00.00,"313,405.83"
26-Aug-2020,Miscellaneous,00.00,"156,702.92","156,702.92"
26-Aug-2020,Miscellaneous,00.00,"39,175.73","117,527.19"
26-Aug-2020,Commission,"9,085.79",00.00,"126,612.98"
26-Aug-2020,NEFT,00.00,"18,087.57","108,525.41"
26-Aug-2020,NEFT,00.00,"54,262.71","54,262.70"
26-Aug-2020,Debit Card,00.00,"7,751.81","46,510.89"
26-Aug-2020,Bill,00.00,"7,751.82","38,759.07"
26-Aug-2020,NEFT,62.00,00.00,"38,821.07"
26-Aug-2020,Cash,00.00,"4,313.45","34,507.62"
26-Aug-2020,Transfer,785.38,00.00,"35,293.00"
27-Aug-2020,RTGS,88.00,00.00,"35,381.00"
27-Aug-2020,Reversal,00.00,"3,538.10","31,842.90"
27-Aug-2020,ATM,"15,816.30",00.00,"47,659.20"
27-Aug-2020,ATM,00.00,"5,957.40","41,701.80"
27-Aug-2020,Bill,00.00,"8,340.36","33,361.44"
27-Aug-2020,Bill,"2,214.00",00.00,"35,575.44"
27-Aug-2020,NEFT,00.00,"5,082.21","30,493.23"
27-Aug-2020,Interest,00.00,"3,049.32","27,443.91"
27-Aug-2020,NEFT,09.54,00.00,"27,453.45"
27-Aug-2020,IMPS,00.00,"6,863.36","20,590.09"
27-Aug-2020,NEFT,272.00,00.00,"20,862.09"
27-Aug-2020,Bill,00.00,"2,980.30","17,881.79"
27-Aug-2020,Commission,27.41,00.00,"17,909.20"
27-Aug-2020,Bill,"25,223.42",00.00,"43,132.62"
27-Aug-2020,NEFT,00.00,"43,132.62",00.00
27-Aug-2020,NEFT,01.85,00.00,01.85
27-Aug-2020,Tax,00.00,00.31,01.54
27-Aug-2020,Debit Card,00.00,00.19,01.35
27-Aug-2020,Tax,00.00,00.27,01.08
27-Aug-2020,Cheque,"131,849.00",00.00,"131,850.08"
27-Aug-2020,NEFT,00.00,"43,950.03","87,900.05"
27-Aug-2020,Cash,00.00,"29,300.02","58,600.03"
27-Aug-2020,NEFT,456.29,00.00,"59,056.32"
27-Aug-2020,Transfer,00.00,"6,561.81","52,494.51"
27-Aug-2020,NEFT,00.00,"26,247.26","26,247.26"
27-Aug-2020,Cheque,00.00,"5,249.45","20,997.81"
27-Aug-2020,Transfer,"3,031.00",00.00,"24,028.81"
27-Aug-2020,Interest,00.00,"2,669.87","21,358.94"
27-Aug-2020,IMPS,00.00,"5,339.74","16,019.20"
27-Aug-2020,Cash,40.87,00.00,"16,060.07"
27-Aug-2020,IMPS,00.00,"5,353.36","10,706.71"
27-Aug-2020,Bill,"30,108.38",00.00,"40,815.09"
27-Aug-2020,Debit Card,"183,150.00",00.00,"223,965.09"
27-Aug-2020,Cheque,"169,834.20",00.00,"393,799.29"
27-Aug-2020,Miscellaneous,00.00,"393,799.29",00.00
27-Aug-2020,Reversal,247.90,00.00,247.90
27-Aug-2020,Purchase,58.00,00.00,305.90
27-Aug-2020,ATM,"3,746.00",00.00,"4,051.90"
27-Aug-2020,Miscellaneous,252.90,00.00,"4,304.80"
27-Aug-2020,Cheque,00.00,478.31,"3,826.49"
27-Aug-2020,Cash,00.00,956.62,"2,869.87"
27-Aug-2020,IMPS,00.00,"1,434.94","1,434.94"
27-Aug-2020,Bill,174.17,00.00,"1,609.11"
27-Aug-2020,Miscellaneous,"77,265.20",00.00,"78,874.31"
27-Aug-2020,Interest,38.00,00.00,"78,912.31"
27-Aug-2020,Bill,07.00,00.00,"78,919.31"
27-Aug-2020,Tax,01.00,00.00,"78,920.31"
27-Aug-2020,RTGS,"25,608.56",00.00,"104,528.87"
27-Aug-2020,Bill,37.00,00.00,"104,565.87"
27-Aug-2020,IMPS,00.00,"10,456.59","94,109.28"
27-Aug-2020,Debit Card,00.00,"10,456.59","83,652.69"
27-Aug-2020,Commission,00.00,"13,942.12","69,710.58"
27-Aug-2020,Transfer,00.00,"13,942.12","55,768.46"
27-Aug-2020,Interest,00.00,"7,966.92","47,801.54"
27-Aug-2020,Cash,00.00,"47,801.54",00.00
27-Aug-2020,NEFT,341.16,00.00,341.16
27-Aug-2020,NEFT,07.36,00.00,348.52
27-Aug-2020,Miscellaneous,00.00,348.52,00.00
27-Aug-2020,Debit Card,474.08,00.00,474.08
27-Aug-2020,RTGS,00.00,59.26,414.82
27-Aug-2020,Bill,00.00,51.85,362.97
27-Aug-2020,Miscellaneous,00.00,36.30,326.67
27-Aug-2020,IMPS,00.00,108.89,217.78
27-Aug-2020,ATM,39.15,00.00,256.93
27-Aug-2020,Purchase,00.00,64.23,192.70
27-Aug-2020,Miscellaneous,"1,851,946.00",00.00,"1,852,138.70"
27-Aug-2020,IMPS,23.53,00.00,"1,852,162.23"
27-Aug-2020,NEFT,00.00,"308,693.71","1,543,468.52"
27-Aug-2020,NEFT,00.00,"1,543,468.52",00.00
27-Aug-2020,Reversal,22.77,00.00,22.77
27-Aug-2020,Commission,00.00,11.39,11.38
27-Aug-2020,Cheque,00.00,03.79,07.59
27-Aug-2020,RTGS,00.00,00.84,06.75
27-Aug-2020,Interest,00.00,02.25,04.50
27-Aug-2020,Interest,00.00,04.50,00.00
27-Aug-2020,Interest,08.00,00.00,08.00
27-Aug-2020,Bill,"257,850.16",00.00,"257,858.16"
27-Aug-2020,IMPS,00.00,"128,929.08","128,929.08"
27-Aug-2020,RTGS,"76,143.84",00.00,"205,072.92"
27-Aug-2020,Cheque,00.00,"51,268.23","153,804.69"
27-Aug-2020,Purchase,00.00,"153,804.69",00.00
27-Aug-2020,Tax,07.00,00.00,07.00
27-Aug-2020,Bill,19.00,00.00,26.00
27-Aug-2020,Tax,00.00,08.67,17.33
27-Aug-2020,Reversal,00.00,02.48,14.85
27-Aug-2020,RTGS,"24,661.00",00.00,"24,675.85"
27-Aug-2020,ATM,"118,041.00",00.00,"142,716.85"
27-Aug-2020,Bill,00.00,"23,786.14","118,930.71"
27-Aug-2020,Purchase,02.68,00.00,"118,933.39"
27-Aug-2020,Bill,11.20,00.00,"118,944.59"
27-Aug-2020,Cash,00.00,"23,788.92","95,155.67"
27-Aug-2020,Cheque,00.00,"9,515.57","85,640.10"
27-Aug-2020,NEFT,23.40,00.00,"85,663.50"
27-Aug-2020,Bill,00.00,"10,707.94","74,955.56"
27-Aug-2020,Debit Card,00.00,"9,369.45","65,586.11"
27-Aug-2020,RTGS,00.00,"65,586.11",00.00
27-Aug-2020,IMPS,48.13,00.00,48.13
27-Aug-2020,Cash,00.00,12.03,36.10
27-Aug-2020,Transfer,00.00,18.05,18.05
27-Aug-2020,NEFT,40.00,00.00,58.05
27-Aug-2020,RTGS,"18,017.00",00.00,"18,075.05"
27-Aug-2020,Cash,41.50,00.00,"18,116.55"
27-Aug-2020,Bill,00.00,"3,623.31","14,493.24"
27-Aug-2020,Cash,01.00,00.00,"14,494.24"
27-Aug-2020,Cheque,00.00,"3,623.56","10,870.68"
27-Aug-2020,IMPS,00.00,"3,623.56","7,247.12"
27-Aug-2020,Cash,00.00,"1,207.85","6,039.27"
27-Aug-2020,Commission,24.00,00.00,"6,063.27"
27-Aug-2020,NEFT,"260,845.00",00.00,"266,908.27"
27-Aug-2020,Bill,477.69,00.00,"267,385.96"
27-Aug-2020,Cash,888.00,00.00,"268,273.96"
27-Aug-2020,Tax,00.00,"38,324.85","229,949.11"
27-Aug-2020,IMPS,"21,147.70",00.00,"251,096.81"
27-Aug-2020,Reversal,00.00,"41,849.47","209,247.34"
27-Aug-2020,Interest,"171,357.22",00.00,"380,604.56"
27-Aug-2020,Cash,"111,626.00",00.00,"492,230.56"
27-Aug-2020,Tax,"186,913.90",00.00,"679,144.46"
27-Aug-2020,RTGS,"783,641.00",00.00,"1,462,785.46"
27-Aug-2020,NEFT,00.00,"162,531.72","1,300,253.74"
27-Aug-2020,Interest,00.00,"650,126.87","650,126.87"
27-Aug-2020,Commission,00.00,"325,063.44","325,063.44"
27-Aug-2020,Commission,"22,113.56",00.00,"347,177.00"
27-Aug-2020,Tax,512.00,00.00,"347,689.00"
27-Aug-2020,NEFT,"483,813.50",00.00,"831,502.50"
27-Aug-2020,Cheque,"253,094.70",00.00,"1,084,597.20"
27-Aug-2020,ATM,"1,353,039.00",00.00,"2,437,636.20"
27-Aug-2020,Cash,00.00,"609,409.05","1,828,227.15"
27-Aug-2020,Debit Card,458.26,00.00,"1,828,685.41"
27-Aug-2020,NEFT,"204,007.00",00.00,"2,032,692.41"
27-Aug-2020,Cheque,00.00,"225,854.71","1,806,837.70"
27-Aug-2020,Reversal,00.00,"602,279.23","1,204,558.47"
27-Aug-2020,Purchase,270.12,00.00,"1,204,828.59"
27-Aug-2020,Transfer,135.20,00.00,"1,204,963.79"
27-Aug-2020,RTGS,00.00,"120,496.38","1,084,467.41"
27-Aug-2020,Debit Card,"25,501.09",00.00,"1,109,968.50"
27-Aug-2020,Miscellaneous,00.00,"369,989.50","739,979.00"
27-Aug-2020,Debit Card,00.00,"105,711.29","634,267.71"
27-Aug-2020,Reversal,"1,899,984.00",00.00,"2,534,251.71"
27-Aug-2020,Cash,00.00,"506,850.34","2,027,401.37"
27-Aug-2020,Commission,00.00,"675,800.46","1,351,600.91"
27-Aug-2020,IMPS,00.00,"337,900.23","1,013,700.68"
27-Aug-2020,ATM,05.20,00.00,"1,013,705.88"
27-Aug-2020,ATM,05.40,00.00,"1,013,711.28"
27-Aug-2020,Debit Card,06.00,00.00,"1,013,717.28"
27-Aug-2020,Interest,00.00,"337,905.76","675,811.52"
27-Aug-2020,Interest,00.00,"96,544.50","579,267.02"
27-Aug-2020,RTGS,41.00,00.00,"579,308.02"
27-Aug-2020,Reversal,"25,207.00",00.00,"604,515.02"
27-Aug-2020,Debit Card,02.38,00.00,"604,517.40"
27-Aug-2020,Cash,00.00,"201,505.80","403,011.60"
28-Aug-2020,Cash,00.00,"40,301.16","362,710.44"
28-Aug-2020,IMPS,"9,574.54",00.00,"372,284.98"
28-Aug-2020,Commission,411.00,00.00,"372,695.98"
28-Aug-2020,IMPS,"8,181.00",00.00,"380,876.98"
28-Aug-2020,Bill,00.00,"95,219.25","285,657.74"
28-Aug-2020,Commission,"891,198.00",00.00,"1,176,855.74"
28-Aug-2020,Tax,"9,979.21",00.00,"1,186,834.95"
28-Aug-2020,Cash,00.00,"237,366.99","949,467.96"
28-Aug-2020,Miscellaneous,"221,719.30",00.00,"1,171,187.26"
28-Aug-2020,Cheque,504.53,00.00,"1,171,691.79"
28-Aug-2020,ATM,"288,208.00",00.00,"1,459,899.79"
28-Aug-2020,Interest,00.00,"729,949.90","729,949.90"
28-Aug-2020,Bill,"11,694.21",00.00,"741,644.11"
28-Aug-2020,Reversal,00.00,"74,164.41","667,479.70"
28-Aug-2020,Bill,00.00,"66,747.97","600,731.73"
28-Aug-2020,Miscellaneous,00.00,"120,146.35","480,585.38"
28-Aug-2020,Debit Card,00.00,"53,398.38","427,187.00"
28-Aug-2020,NEFT,"46,265.80",00.00,"473,452.80"
28-Aug-2020,NEFT,00.00,"94,690.56","378,762.24"
28-Aug-2020,Cheque,00.00,"378,762.24",00.00
28-Aug-2020,Cash,"130,530.00",00.00,"130,530.00"
28-Aug-2020,Purchase,00.00,"26,106.00","104,424.00"
28-Aug-2020,Tax,440.66,00.00,"104,864.66"
28-Aug-2020,Interest,"1,015,571.00",00.00,"1,120,435.66"
28-Aug-2020,Tax,27.37,00.00,"1,120,463.03"
28-Aug-2020,ATM,04.00,00.00,"1,120,467.03"
28-Aug-2020,Cash,00.00,"186,744.51","933,722.52"
28-Aug-2020,Reversal,52.60,00.00,"933,775.12"
28-Aug-2020,IMPS,00.00,"933,775.12",00.00
28-Aug-2020,Interest,03.02,00.00,03.02
28-Aug-2020,Transfer,11.69,00.00,14.71
28-Aug-2020,Transfer,00.00,14.71,00.00
28-Aug-2020,Cash,"977,676.80",00.00,"977,676.80"
28-Aug-2020,ATM,00.00,"122,209.60","855,467.20"
28-Aug-2020,NEFT,487.00,00.00,"855,954.20"
28-Aug-2020,Miscellaneous,05.20,00.00,"855,959.40"
28-Aug-2020,Miscellaneous,175.85,00.00,"856,135.25"
28-Aug-2020,RTGS,01.90,00.00,"856,137.15"
28-Aug-2020,Reversal,00.00,"428,068.58","428,068.58"
28-Aug-2020,Cheque,08.00,00.00,"428,076.58"
29-Aug-2020,Purchase,611.30,00.00,"428,687.88"
29-Aug-2020,Miscellaneous,"10,906.10",00.00,"439,593.98"
29-Aug-2020,Reversal,296.78,00.00,"439,890.76"
29-Aug-2020,Debit Card,60.90,00.00,"439,951.66"
29-Aug-2020,Reversal,00.00,"219,975.83","219,975.83"
29-Aug-2020,Miscellaneous,00.00,"27,496.98","192,478.85"
29-Aug-2020,Miscellaneous,"7,308.20",00.00,"199,787.05"
29-Aug-2020,RTGS,00.00,"49,946.76","149,840.29"
29-Aug-2020,IMPS,"858,393.00",00.00,"1,008,233.29"
29-Aug-2020,IMPS,00.00,"126,029.16","882,204.13"
29-Aug-2020,IMPS,00.00,"147,034.02","735,170.11"
29-Aug-2020,Interest,00.00,"183,792.53","551,377.58"
29-Aug-2020,NEFT,00.00,"91,896.26","459,481.32"
29-Aug-2020,Commission,00.00,"65,640.19","393,841.13"
29-Aug-2020,Miscellaneous,14.00,00.00,"393,855.13"
29-Aug-2020,Debit Card,"11,763.70",00.00,"405,618.83"
29-Aug-2020,Purchase,"6,959.50",00.00,"412,578.33"
29-Aug-2020,Purchase,277.00,00.00,"412,855.33"
29-Aug-2020,Debit Card,161.92,00.00,"413,017.25"
29-Aug-2020,ATM,00.00,"45,890.81","367,126.44"
29-Aug-2020,NEFT,00.00,"61,187.74","305,938.70"
29-Aug-2020,Commission,00.00,"305,938.70",00.00
29-Aug-2020,Transfer,01.00,00.00,01.00
29-Aug-2020,Debit Card,320.00,00.00,321.00
29-Aug-2020,Transfer,00.00,107.00,214.00
30-Aug-2020,Cheque,00.00,107.00,107.00
30-Aug-2020,Transfer,00.00,21.40,85.60
30-Aug-2020,IMPS,00.00,12.23,73.37
30-Aug-2020,RTGS,"161,559.00",00.00,"161,632.37"
30-Aug-2020,Miscellaneous,00.00,"32,326.47","129,305.90"
30-Aug-2020,RTGS,103.00,00.00,"129,408.90"
30-Aug-2020,Reversal,07.00,00.00,"129,415.90"
30-Aug-2020,Reversal,"19,747.70",00.00,"149,163.60"
30-Aug-2020,RTGS,00.00,"16,573.73","132,589.87"
31-Aug-2020,Miscellaneous,00.00,"14,732.21","117,857.66"
31-Aug-2020,Transfer,"262,028.20",00.00,"379,885.86"
31-Aug-2020,Purchase,00.00,"63,314.31","316,571.55"
31-Aug-2020,Bill,00.00,"45,224.51","271,347.04"
31-Aug-2020,Reversal,"31,706.55",00.00,"303,053.59"
31-Aug-2020,Reversal,00.00,"101,017.86","202,035.73"
31-Aug-2020,RTGS,"1,233,713.00",00.00,"1,435,748.73"
31-Aug-2020,Interest,00.00,"179,468.59","1,256,280.14"
31-Aug-2020,Transfer,00.00,"179,468.59","1,076,811.55"
31-Aug-2020,Purchase,00.00,"153,830.22","922,981.33"
31-Aug-2020,Bill,00.00,"307,660.44","615,320.89"
31-Aug-2020,NEFT,00.00,"102,553.48","512,767.41"
31-Aug-2020,Transfer,00.00,"256,383.71","256,383.70"
31-Aug-2020,Transfer,02.00,00.00,"256,385.70"
31-Aug-2020,Purchase,00.00,"32,048.21","224,337.49"
31-Aug-2020,Transfer,00.00,"28,042.19","196,295.30"
31-Aug-2020,Interest,00.00,"65,431.77","130,863.53"
31-Aug-2020,Cash,00.00,"18,694.79","112,168.74"
31-Aug-2020,Miscellaneous,"232,425.22",00.00,"344,593.96"
31-Aug-2020,Interest,00.00,"68,918.79","275,675.17"
31-Aug-2020,Miscellaneous,55.00,00.00,"275,730.17"
31-Aug-2020,RTGS,"176,271.00",00.00,"452,001.17"
31-Aug-2020,Miscellaneous,00.00,"452,001.17",00.00
31-Aug-2020,Interest,"886,954.00",00.00,"886,954.00"
31-Aug-2020,Commission,174.26,00.00,"887,128.26"
31-Aug-2020,NEFT,07.40,00.00,"887,135.66"
31-Aug-2020,Reversal,07.65,00.00,"887,143.31"
31-Aug-2020,Cheque,"24,253.00",00.00,"911,396.31"
31-Aug-2020,Debit Card,00.00,"303,798.77","607,597.54"
31-Aug-2020,Purchase,78.00,00.00,"607,675.54"
31-Aug-2020,Interest,00.00,"151,918.89","455,756.66"
31-Aug-2020,RTGS,"13,488.00",00.00,"469,244.66"
31-Aug-2020,ATM,00.00,"58,655.58","410,589.08"
31-Aug-2020,ATM,00.00,"410,589.08",00.00
31-Aug-2020,IMPS,"293,589.80",00.00,"293,589.80"
31-Aug-2020,Purchase,"66,283.44",00.00,"359,873.24"
31-Aug-2020,Transfer,"1,864,251.20",00.00,"2,224,124.44"
31-Aug-2020,Commission,00.00,"1,112,062.22","1,112,062.22"
31-Aug-2020,IMPS,00.00,"556,031.11","556,031.11"
31-Aug-2020,NEFT,00.00,"55,603.11","500,428.00"
31-Aug-2020,Cheque,00.00,"83,404.67","417,023.33"
31-Aug-2020,IMPS,"22,341.00",00.00,"439,364.33"
31-Aug-2020,IMPS,"810,075.80",00.00,"1,249,440.13"
31-Aug-2020,Interest,00.00,"124,944.01","1,124,496.12"
01-Sep-2020,RTGS,33.00,00.00,"1,124,529.12"
01-Sep-2020,ATM,15.00,00.00,"1,124,544.12"
01-Sep-2020,RTGS,00.00,"124,949.35","999,594.77"
01-Sep-2020,NEFT,"2,885.00",00.00,"1,002,479.77"
01-Sep-2020,Reversal,00.00,"334,159.92","668,319.85"
02-Sep-2020,ATM,00.00,"83,539.98","584,779.87"
02-Sep-2020,Cheque,00.00,"64,975.54","519,804.33"
02-Sep-2020,IMPS,00.00,"51,980.43","467,823.90"
02-Sep-2020,Bill,"4,924.00",00.00,"472,747.90"
02-Sep-2020,Commission,61.00,00.00,"472,808.90"
02-Sep-2020,Miscellaneous,00.00,"94,561.78","378,247.12"
02-Sep-2020,Reversal,00.00,"189,123.56","189,123.56"
02-Sep-2020,IMPS,"99,097.00",00.00,"288,220.56"
02-Sep-2020,Purchase,19.30,00.00,"288,239.86"
02-Sep-2020,Transfer,07.30,00.00,"288,247.16"
02-Sep-2020,Purchase,00.00,"28,824.72","259,422.44"
02-Sep-2020,Bill,218.60,00.00,"259,641.04"
02-Sep-2020,Reversal,00.00,"259,641.04",00.00
02-Sep-2020,Reversal,02.10,00.00,02.10
02-Sep-2020,Interest,"16,551.40",00.00,"16,553.50"
02-Sep-2020,Cash,07.20,00.00,"16,560.70"
02-Sep-2020,IMPS,"232,002.25",00.00,"248,562.95"
02-Sep-2020,Transfer,381.00,00.00,"248,943.95"
02-Sep-2020,Purchase,"1,876.35",00.00,"250,820.30"
02-Sep-2020,ATM,00.00,"31,352.54","219,467.76"
02-Sep-2020,Debit Card,"17,565.00",00.00,"237,032.76"
02-Sep-2020,Tax,05.90,00.00,"237,038.66"
02-Sep-2020,Interest,188.70,00.00,"237,227.36"
02-Sep-2020,ATM,479.00,00.00,"237,706.36"
02-Sep-2020,Commission,08.10,00.00,"237,714.46"
02-Sep-2020,Cheque,00.00,"29,714.31","208,000.15"
02-Sep-2020,Reversal,"18,853.00",00.00,"226,853.15"
02-Sep-2020,ATM,00.00,"22,685.32","204,167.84"
02-Sep-2020,Cash,"3,059.22",00.00,"207,227.06"
02-Sep-2020,Transfer,"1,160.10",00.00,"208,387.16"
02-Sep-2020,Debit Card,00.00,"69,462.39","138,924.77"
02-Sep-2020,IMPS,00.00,"15,436.09","123,488.68"
02-Sep-2020,Cash,482.53,00.00,"123,971.21"
02-Sep-2020,Cash,00.00,"41,323.74","82,647.47"
02-Sep-2020,Cash,258.52,00.00,"82,905.99"
02-Sep-2020,Bill,"1,558,175.20",00.00,"1,641,081.19"
02-Sep-2020,Commission,108.00,00.00,"1,641,189.19"
02-Sep-2020,Interest,00.00,"328,237.84","1,312,951.35"
02-Sep-2020,NEFT,00.00,"437,650.45","875,300.90"
02-Sep-2020,IMPS,00.00,"218,825.23","656,475.68"
02-Sep-2020,Reversal,00.00,"109,412.61","547,063.07"
03-Sep-2020,Purchase,00.00,"60,784.79","486,278.28"
03-Sep-2020,Debit Card,00.00,"60,784.79","425,493.50"
03-Sep-2020,Interest,"710,341.00",00.00,"1,135,834.50"
03-Sep-2020,Bill,00.00,"141,979.31","993,855.19"
03-Sep-2020,Transfer,00.00,"248,463.80","745,391.39"
03-Sep-2020,Reversal,07.40,00.00,"745,398.79"
03-Sep-2020,NEFT,11.43,00.00,"745,410.22"
03-Sep-2020,ATM,"7,267.66",00.00,"752,677.88"
03-Sep-2020,NEFT,01.00,00.00,"752,678.88"
03-Sep-2020,IMPS,"2,040,331.50",00.00,"2,793,010.38"
03-Sep-2020,ATM,134.00,00.00,"2,793,144.38"
03-Sep-2020,Purchase,"10,412.33",00.00,"2,803,556.71"
03-Sep-2020,ATM,00.00,"934,518.90","1,869,037.81"
03-Sep-2020,Commission,00.00,"233,629.73","1,635,408.08"
03-Sep-2020,NEFT,00.00,"272,568.01","1,362,840.07"
03-Sep-2020,Tax,00.00,"170,355.01","1,192,485.06"
03-Sep-2020,Bill,00.20,00.00,"1,192,485.26"
03-Sep-2020,Purchase,00.00,"397,495.09","794,990.17"
03-Sep-2020,Reversal,02.20,00.00,"794,992.37"
03-Sep-2020,Cash,"77,961.00",00.00,"872,953.37"
04-Sep-2020,Miscellaneous,"186,759.84",00.00,"1,059,713.21"
04-Sep-2020,NEFT,"7,565.45",00.00,"1,067,278.66"
04-Sep-2020,Commission,61.00,00.00,"1,067,339.66"
04-Sep-2020,Tax,00.00,"1,067,339.66",00.00
04-Sep-2020,Commission,"3,277.00",00.00,"3,277.00"
04-Sep-2020,Bill,"23,126.87",00.00,"26,403.87"
04-Sep-2020,Interest,00.00,"6,600.97","19,802.90"
04-Sep-2020,NEFT,00.00,"6,600.97","13,201.93"
04-Sep-2020,Debit Card,"1,325,445.00",00.00,"1,338,646.93"
04-Sep-2020,Tax,00.00,"334,661.73","1,003,985.20"
04-Sep-2020,Bill,"29,159.91",00.00,"1,033,145.11"
04-Sep-2020,Transfer,00.00,"344,381.70","688,763.41"
04-Sep-2020,NEFT,"28,884.40",00.00,"717,647.81"
04-Sep-2020,Purchase,00.00,"71,764.78","645,883.03"
04-Sep-2020,ATM,"1,810,525.00",00.00,"2,456,408.03"
04-Sep-2020,Purchase,421.64,00.00,"2,456,829.67"
04-Sep-2020,Miscellaneous,"13,097.34",00.00,"2,469,927.01"
04-Sep-2020,Interest,30.70,00.00,"2,469,957.71"
04-Sep-2020,Bill,146.34,00.00,"2,470,104.05"
04-Sep-2020,Bill,06.60,00.00,"2,470,110.65"
04-Sep-2020,Miscellaneous,00.00,"247,011.07","2,223,099.58"
04-Sep-2020,Tax,"2,241.69",00.00,"2,225,341.27"
05-Sep-2020,Interest,02.00,00.00,"2,225,343.27"
05-Sep-2020,Commission,02.00,00.00,"2,225,345.27"
05-Sep-2020,Tax,00.00,"741,781.76","1,483,563.51"
05-Sep-2020,NEFT,"220,283.81",00.00,"1,703,847.32"
05-Sep-2020,Miscellaneous,00.00,"567,949.11","1,135,898.21"
05-Sep-2020,Interest,"95,863.00",00.00,"1,231,761.21"
05-Sep-2020,Interest,00.00,"1,231,761.21",00.00
05-Sep-2020,RTGS,05.00,00.00,05.00
05-Sep-2020,NEFT,00.00,02.50,02.50
05-Sep-2020,Reversal,"168,260.00",00.00,"168,262.50"
05-Sep-2020,Cheque,07.42,00.00,"168,269.92"
05-Sep-2020,Purchase,00.00,"56,089.97","112,179.95"
05-Sep-2020,Debit Card,00.00,"37,393.32","74,786.63"
05-Sep-2020,Reversal,00.00,"8,309.63","66,477.00"
05-Sep-2020,Reversal,00.00,"33,238.50","33,238.50"
05-Sep-2020,Interest,03.00,00.00,"33,241.50"
05-Sep-2020,Reversal,00.00,"3,693.50","29,548.00"
05-Sep-2020,Miscellaneous,00.00,"4,221.14","25,326.86"
05-Sep-2020,Reversal,00.00,"3,165.86","22,161.00"
05-Sep-2020,Reversal,657.02,00.00,"22,818.02"
05-Sep-2020,Miscellaneous,"3,539.00",00.00,"26,357.02"
05-Sep-2020,Interest,"99,300.00",00.00,"125,657.02"
05-Sep-2020,Miscellaneous,"4,060.00",00.00,"129,717.02"
05-Sep-2020,Bill,830.32,00.00,"130,547.34"
05-Sep-2020,Interest,00.00,"32,636.84","97,910.50"
05-Sep-2020,IMPS,00.00,"97,910.50",00.00
05-Sep-2020,Cash,07.52,00.00,07.52
05-Sep-2020,Cheque,00.00,01.07,06.45
05-Sep-2020,Debit Card,499.70,00.00,506.15
06-Sep-2020,NEFT,"113,619.25",00.00,"114,125.40"
06-Sep-2020,Tax,01.00,00.00,"114,126.40"
06-Sep-2020,NEFT,00.00,"11,412.64","102,713.76"
06-Sep-2020,Bill,"716,955.25",00.00,"819,669.01"
06-Sep-2020,Bill,"3,893.38",00.00,"823,562.39"
06-Sep-2020,Reversal,"186,805.09",00.00,"1,010,367.48"
06-Sep-2020,Reversal,"29,510.80",00.00,"1,039,878.28"
06-Sep-2020,Transfer,00.00,"129,984.79","909,893.50"
06-Sep-2020,Interest,00.00,"129,984.79","779,908.71"
07-Sep-2020,Cheque,00.00,"155,981.74","623,926.97"
07-Sep-2020,IMPS,"16,621.30",00.00,"640,548.27"
07-Sep-2020,ATM,00.00,"128,109.65","512,438.62"
07-Sep-2020,Tax,00.00,"85,406.44","427,032.18"
07-Sep-2020,Transfer,00.00,"61,004.60","366,027.58"
07-Sep-2020,Bill,494.00,00.00,"366,521.58"
07-Sep-2020,Cheque,33.50,00.00,"366,555.08"
07-Sep-2020,Tax,00.00,"36,655.51","329,899.57"
07-Sep-2020,RTGS,14.41,00.00,"329,913.98"
07-Sep-2020,Purchase,00.00,"164,956.99","164,956.99"
07-Sep-2020,Bill,"3,406.70",00.00,"168,363.69"
07-Sep-2020,Bill,00.00,"42,090.92","126,272.77"
07-Sep-2020,Interest,"2,719.00",00.00,"128,991.77"
07-Sep-2020,Bill,00.00,"21,498.63","107,493.14"
07-Sep-2020,Miscellaneous,00.00,"10,749.31","96,743.83"
07-Sep-2020,Interest,"1,164,284.00",00.00,"1,261,027.83"
07-Sep-2020,NEFT,00.00,"126,102.78","1,134,925.05"
07-Sep-2020,Transfer,"1,530.00",00.00,"1,136,455.05"
07-Sep-2020,Debit Card,00.00,"162,350.72","974,104.33"
07-Sep-2020,Commission,00.00,"324,701.44","649,402.89"
07-Sep-2020,Cheque,00.00,"81,175.36","568,227.53"
07-Sep-2020,Purchase,00.00,"113,645.51","454,582.02"
07-Sep-2020,Bill,00.00,"45,458.20","409,123.82"
07-Sep-2020,Reversal,00.00,"45,458.20","363,665.62"
07-Sep-2020,NEFT,858.15,00.00,"364,523.77"
08-Sep-2020,Miscellaneous,00.00,"40,502.64","324,021.13"
08-Sep-2020,RTGS,00.00,"81,005.28","243,015.85"
08-Sep-2020,Commission,"79,059.60",00.00,"322,075.45"
08-Sep-2020,Purchase,15.00,00.00,"322,090.45"
08-Sep-2020,Cash,"604,302.00",00.00,"926,392.45"
08-Sep-2020,ATM,05.70,00.00,"926,398.15"
08-Sep-2020,RTGS,00.00,"185,279.63","741,118.52"
08-Sep-2020,Purchase,24.49,00.00,"741,143.01"
08-Sep-2020,Miscellaneous,"2,643.30",00.00,"743,786.31"
08-Sep-2020,NEFT,"29,277.39",00.00,"773,063.70"
08-Sep-2020,RTGS,"1,494,483.00",00.00,"2,267,546.70"
08-Sep-2020,Tax,"1,503,367.00",00.00,"3,770,913.70"
08-Sep-2020,NEFT,295.30,00.00,"3,771,209.00"
08-Sep-2020,NEFT,00.00,"754,241.80","3,016,967.20"
08-Sep-2020,Commission,"69,756.00",00.00,"3,086,723.20"
08-Sep-2020,NEFT,00.00,"440,960.46","2,645,762.74"
08-Sep-2020,Commission,00.00,"264,576.27","2,381,186.47"
08-Sep-2020,Interest,00.00,"1,190,593.24","1,190,593.24"
08-Sep-2020,Transfer,00.00,"1,190,593.24",00.00
08-Sep-2020,Cash,00.97,00.00,00.97
08-Sep-2020,Purchase,13.00,00.00,13.97
09-Sep-2020,RTGS,"261,880.30",00.00,"261,894.27"
09-Sep-2020,Commission,"2,280.40",00.00,"264,174.67"
10-Sep-2020,Transfer,00.00,"52,834.93","211,339.74"
10-Sep-2020,Purchase,"5,453.00",00.00,"216,792.74"
10-Sep-2020,Debit Card,00.00,"54,198.19","162,594.56"
10-Sep-2020,Tax,"38,903.88",00.00,"201,498.44"
10-Sep-2020,Reversal,00.00,"67,166.15","134,332.29"
10-Sep-2020,Transfer,"8,542.00",00.00,"142,874.29"
10-Sep-2020,Interest,"221,480.20",00.00,"364,354.49"
10-Sep-2020,NEFT,00.00,"52,050.64","312,303.85"
10-Sep-2020,Purchase,360.70,00.00,"312,664.55"
10-Sep-2020,Cash,"33,517.40",00.00,"346,181.95"
10-Sep-2020,Cheque,00.00,"173,090.98","173,090.98"
10-Sep-2020,Cheque,00.00,"173,090.98",00.00
11-Sep-2020,Cash,05.00,00.00,05.00
11-Sep-2020,Purchase,00.00,02.50,02.50
11-Sep-2020,IMPS,"1,996,046.25",00.00,"1,996,048.75"
11-Sep-2020,Bill,"736,832.00",00.00,"2,732,880.75"
12-Sep-2020,Commission,"19,899.68",00.00,"2,752,780.43"
12-Sep-2020,Transfer,399.63,00.00,"2,753,180.06"
12-Sep-2020,Cash,00.00,"1,376,590.03","1,376,590.03"
12-Sep-2020,Cheque,"30,766.67",00.00,"1,407,356.70"
12-Sep-2020,Tax,00.00,"175,919.59","1,231,437.11"
12-Sep-2020,ATM,00.00,"307,859.28","923,577.83"
12-Sep-2020,Bill,"242,287.00",00.00,"1,165,864.83"
12-Sep-2020,Debit Card,00.00,"233,172.97","932,691.86"
12-Sep-2020,Debit Card,00.00,"466,345.93","466,345.93"
12-Sep-2020,ATM,02.84,00.00,"466,348.77"
12-Sep-2020,Cheque,00.00,"93,269.75","373,079.02"
12-Sep-2020,Reversal,00.00,"74,615.80","298,463.22"
12-Sep-2020,Tax,00.00,"49,743.87","248,719.35"
12-Sep-2020,Purchase,"29,028.00",00.00,"277,747.35"
12-Sep-2020,NEFT,00.00,"39,678.19","238,069.16"
12-Sep-2020,Tax,08.54,00.00,"238,077.70"
12-Sep-2020,Miscellaneous,00.00,"79,359.23","158,718.47"
13-Sep-2020,Reversal,"10,858.71",00.00,"169,577.18"
13-Sep-2020,Purchase,00.00,"42,394.30","127,182.88"
13-Sep-2020,Tax,00.00,"25,436.58","101,746.30"
13-Sep-2020,IMPS,00.60,00.00,"101,746.90"
13-Sep-2020,ATM,"1,592,296.50",00.00,"1,694,043.40"
14-Sep-2020,IMPS,"11,768.03",00.00,"1,705,811.43"
14-Sep-2020,ATM,00.00,"189,534.60","1,516,276.83"
14-Sep-2020,Debit Card,00.00,"303,255.37","1,213,021.46"
14-Sep-2020,Cash,00.00,"242,604.29","970,417.17"
14-Sep-2020,NEFT,"75,372.00",00.00,"1,045,789.17"
14-Sep-2020,ATM,00.00,"116,198.80","929,590.37"
14-Sep-2020,ATM,00.00,"154,931.73","774,658.64"
14-Sep-2020,Transfer,178.80,00.00,"774,837.44"
14-Sep-2020,Transfer,"454,054.25",00.00,"1,228,891.69"
14-Sep-2020,Reversal,126.44,00.00,"1,229,018.13"
14-Sep-2020,Bill,00.00,"136,557.57","1,092,460.56"
14-Sep-2020,IMPS,00.00,"156,065.79","936,394.77"
14-Sep-2020,ATM,00.00,"936,394.77",00.00
14-Sep-2020,ATM,"2,011,523.00",00.00,"2,011,523.00"
14-Sep-2020,Reversal,00.00,"287,360.43","1,724,162.57"
14-Sep-2020,NEFT,00.00,"574,720.86","1,149,441.71"
14-Sep-2020,Tax,"147,138.00",00.00,"1,296,579.71"
14-Sep-2020,NEFT,00.00,"432,193.24","864,386.47"
15-Sep-2020,Tax,"153,857.00",00.00,"1,018,243.47"
15-Sep-2020,RTGS,00.00,"339,414.49","678,828.98"
15-Sep-2020,NEFT,00.00,"96,975.57","581,853.41"
15-Sep-2020,Miscellaneous,00.00,"145,463.35","436,390.06"
15-Sep-2020,ATM,00.00,"218,195.03","218,195.03"
15-Sep-2020,NEFT,"11,502.00",00.00,"229,697.03"
16-Sep-2020,Cheque,00.00,"28,712.13","200,984.90"
16-Sep-2020,Cheque,00.00,"200,984.90",00.00
16-Sep-2020,Commission,426.28,00.00,426.28
16-Sep-2020,Reversal,39.58,00.00,465.86
16-Sep-2020,Miscellaneous,00.00,116.47,349.40
16-Sep-2020,Bill,07.00,00.00,356.40
16-Sep-2020,Cash,00.00,178.20,178.20
16-Sep-2020,Commission,00.00,22.28,155.92
16-Sep-2020,Debit Card,00.00,25.99,129.93
16-Sep-2020,NEFT,00.58,00.00,130.51
16-Sep-2020,Commission,"28,787.00",00.00,"28,917.51"
16-Sep-2020,Interest,00.00,"4,819.59","24,097.92"
17-Sep-2020,Interest,318.90,00.00,"24,416.82"
17-Sep-2020,Reversal,"16,168.60",00.00,"40,585.42"
17-Sep-2020,Interest,00.00,"4,509.49","36,075.93"
17-Sep-2020,Tax,00.00,"4,509.49","31,566.44"
17-Sep-2020,Cheque,00.00,"10,522.15","21,044.29"
17-Sep-2020,Debit Card,00.00,"2,338.25","18,706.04"
17-Sep-2020,Interest,"1,160,476.00",00.00,"1,179,182.04"
17-Sep-2020,Tax,00.30,00.00,"1,179,182.34"
17-Sep-2020,RTGS,00.00,"393,060.78","786,121.56"
17-Sep-2020,Bill,00.00,"131,020.26","655,101.30"
17-Sep-2020,Miscellaneous,00.40,00.00,"655,101.70"
17-Sep-2020,Debit Card,00.00,"65,510.17","589,591.53"
17-Sep-2020,IMPS,00.00,"294,795.77","294,795.76"
17-Sep-2020,Cheque,00.00,"58,959.15","235,836.61"
17-Sep-2020,Interest,40.57,00.00,"235,877.18"
17-Sep-2020,RTGS,00.00,"78,625.73","157,251.45"
17-Sep-2020,ATM,"715,719.00",00.00,"872,970.45"
17-Sep-2020,Miscellaneous,00.00,"145,495.08","727,475.38"
17-Sep-2020,Reversal,00.00,"145,495.08","581,980.30"
17-Sep-2020,Purchase,"11,287.04",00.00,"593,267.34"
17-Sep-2020,Tax,00.00,"59,326.73","533,940.61"
17-Sep-2020,Reversal,00.00,00.00,"533,940.61"
17-Sep-2020,IMPS,"3,280.00",00.00,"537,220.61"
17-Sep-2020,Debit Card,49.80,00.00,"537,270.41"
17-Sep-2020,NEFT,145.00,00.00,"537,415.41"
17-Sep-2020,Debit Card,00.00,"179,138.47","358,276.94"
17-Sep-2020,Tax,"14,395.00",00.00,"372,671.94"
17-Sep-2020,Bill,00.00,"37,267.19","335,404.75"
17-Sep-2020,Reversal,"110,750.03",00.00,"446,154.78"
17-Sep-2020,Cash,00.00,"44,615.48","401,539.30"
17-Sep-2020,Cash,"3,084.30",00.00,"404,623.60"
17-Sep-2020,Cheque,"512,883.50",00.00,"917,507.10"
17-Sep-2020,NEFT,"1,856,147.20",00.00,"2,773,654.30"
17-Sep-2020,Miscellaneous,00.00,"346,706.79","2,426,947.51"
17-Sep-2020,Interest,00.00,"606,736.88","1,820,210.63"
17-Sep-2020,ATM,00.00,"1,820,210.63",00.00
17-Sep-2020,IMPS,"26,459.30",00.00,"26,459.30"
17-Sep-2020,Cheque,455.00,00.00,"26,914.30"
17-Sep-2020,Reversal,00.00,"5,382.86","21,531.44"
17-Sep-2020,Tax,"2,738.00",00.00,"24,269.44"
17-Sep-2020,Miscellaneous,00.00,"3,467.06","20,802.38"
17-Sep-2020,Cheque,03.10,00.00,"20,805.48"
17-Sep-2020,Tax,00.00,"2,600.69","18,204.79"
17-Sep-2020,Purchase,00.00,"4,551.20","13,653.59"
17-Sep-2020,IMPS,29.00,00.00,"13,682.59"
17-Sep-2020,ATM,00.00,"1,710.32","11,972.27"
18-Sep-2020,Transfer,00.50,00.00,"11,972.77"
18-Sep-2020,Reversal,"73,315.94",00.00,"85,288.71"
18-Sep-2020,RTGS,178.00,00.00,"85,466.71"
18-Sep-2020,Tax,40.00,00.00,"85,506.71"
18-Sep-2020,IMPS,01.00,00.00,"85,507.71"
19-Sep-2020,Cheque,00.00,"12,215.39","73,292.32"
19-Sep-2020,Interest,"3,908.28",00.00,"77,200.60"
19-Sep-2020,Tax,"26,704.81",00.00,"103,905.41"
19-Sep-2020,IMPS,00.00,"103,905.41",00.00
19-Sep-2020,Bill,286.04,00.00,286.04
19-Sep-2020,Debit Card,00.00,95.35,190.69
19-Sep-2020,Debit Card,00.00,63.56,127.13
19-Sep-2020,Transfer,"2,708.97",00.00,"2,836.10"
19-Sep-2020,IMPS,"104,688.00",00.00,"107,524.10"
19-Sep-2020,IMPS,00.00,"26,881.03","80,643.08"
19-Sep-2020,IMPS,191.00,00.00,"80,834.08"
20-Sep-2020,Bill,"4,951.00",00.00,"85,785.08"
20-Sep-2020,ATM,00.00,"28,595.03","57,190.05"
20-Sep-2020,Purchase,00.00,"6,354.45","50,835.60"
20-Sep-2020,Cheque,00.00,"10,167.12","40,668.48"
20-Sep-2020,Miscellaneous,00.00,"6,778.08","33,890.40"
20-Sep-2020,Cash,494.50,00.00,"34,384.90"
20-Sep-2020,Cash,05.00,00.00,"34,389.90"
20-Sep-2020,Cash,08.64,00.00,"34,398.54"
20-Sep-2020,Commission,00.00,"11,466.18","22,932.36"
20-Sep-2020,ATM,"76,524.00",00.00,"99,456.36"
20-Sep-2020,RTGS,"229,994.00",00.00,"329,450.36"
20-Sep-2020,NEFT,18.15,00.00,"329,468.51"
20-Sep-2020,Interest,00.00,"65,893.70","263,574.81"
20-Sep-2020,IMPS,"31,768.00",00.00,"295,342.81"
20-Sep-2020,Cash,112.86,00.00,"295,455.67"
20-Sep-2020,Purchase,77.00,00.00,"295,532.67"
20-Sep-2020,NEFT,00.00,"42,218.95","253,313.72"
20-Sep-2020,Cash,"3,920.23",00.00,"257,233.95"
20-Sep-2020,Miscellaneous,00.00,"51,446.79","205,787.16"
20-Sep-2020,Reversal,00.00,"41,157.43","164,629.73"
20-Sep-2020,RTGS,00.00,"82,314.87","82,314.87"
20-Sep-2020,Bill,07.30,00.00,"82,322.17"
20-Sep-2020,Transfer,00.00,"10,290.27","72,031.90"
20-Sep-2020,NEFT,98.60,00.00,"72,130.50"
20-Sep-2020,RTGS,00.00,"10,304.36","61,826.14"
20-Sep-2020,Reversal,00.00,"7,728.27","54,097.87"
20-Sep-2020,Cash,00.00,"7,728.27","46,369.60"
20-Sep-2020,NEFT,00.00,"5,796.20","40,573.40"
20-Sep-2020,Cheque,00.00,"5,796.20","34,777.20"
20-Sep-2020,Commission,07.00,00.00,"34,784.20"
20-Sep-2020,ATM,00.00,"17,392.10","17,392.10"
20-Sep-2020,Tax,00.00,"17,392.10",00.00
20-Sep-2020,Debit Card,"113,373.80",00.00,"113,373.80"
20-Sep-2020,Reversal,00.00,"37,791.27","75,582.53"
20-Sep-2020,IMPS,00.00,"37,791.27","37,791.26"
20-Sep-2020,Transfer,"37,558.00",00.00,"75,349.26"
20-Sep-2020,Cheque,219.80,00.00,"75,569.06"
20-Sep-2020,Miscellaneous,"1,275.31",00.00,"76,844.37"
20-Sep-2020,Debit Card,"1,968.00",00.00,"78,812.37"
20-Sep-2020,Transfer,00.00,"19,703.09","59,109.28"
20-Sep-2020,IMPS,"1,657,443.75",00.00,"1,716,553.03"
20-Sep-2020,Miscellaneous,00.00,"245,221.86","1,471,331.17"
20-Sep-2020,Tax,45.88,00.00,"1,471,377.05"
20-Sep-2020,Transfer,00.00,"147,137.71","1,324,239.34"
20-Sep-2020,Transfer,60.88,00.00,"1,324,300.22"
20-Sep-2020,ATM,00.00,"165,537.53","1,158,762.69"
20-Sep-2020,NEFT,00.00,"579,381.35","579,381.34"
20-Sep-2020,Tax,07.06,00.00,"579,388.40"
20-Sep-2020,NEFT,00.00,"579,388.40",00.00
20-Sep-2020,Miscellaneous,283.00,00.00,283.00
20-Sep-2020,IMPS,00.00,94.33,188.67
21-Sep-2020,NEFT,00.00,23.58,165.09
21-Sep-2020,Reversal,00.60,00.00,165.69
21-Sep-2020,Reversal,00.00,16.57,149.12
22-Sep-2020,IMPS,458.70,00.00,607.82
22-Sep-2020,Cash,07.20,00.00,615.02
22-Sep-2020,Purchase,00.00,205.01,410.01
22-Sep-2020,Commission,07.90,00.00,417.91
22-Sep-2020,Interest,51.90,00.00,469.81
22-Sep-2020,NEFT,00.00,117.45,352.36
22-Sep-2020,Tax,55.00,00.00,407.36
22-Sep-2020,Interest,02.00,00.00,409.36
22-Sep-2020,NEFT,"15,939.00",00.00,"16,348.36"
22-Sep-2020,NEFT,00.00,"2,043.55","14,304.82"
22-Sep-2020,Commission,01.70,00.00,"14,306.52"
22-Sep-2020,Reversal,01.20,00.00,"14,307.72"
22-Sep-2020,RTGS,46.90,00.00,"14,354.62"
22-Sep-2020,Bill,"24,230.10",00.00,"38,584.72"
22-Sep-2020,Miscellaneous,41.00,00.00,"38,625.72"
22-Sep-2020,Tax,"212,382.80",00.00,"251,008.52"
22-Sep-2020,NEFT,00.00,"251,008.52",00.00
22-Sep-2020,RTGS,01.82,00.00,01.82
22-Sep-2020,Debit Card,00.00,00.23,01.59
22-Sep-2020,Tax,00.00,00.27,01.33
22-Sep-2020,IMPS,00.00,00.13,01.20
22-Sep-2020,Transfer,00.00,00.40,00.80
22-Sep-2020,ATM,"2,080,047.00",00.00,"2,080,047.80"
22-Sep-2020,Reversal,00.00,"520,011.95","1,560,035.85"
22-Sep-2020,Interest,00.00,"780,017.93","780,017.92"
22-Sep-2020,Cash,"35,064.80",00.00,"815,082.72"
22-Sep-2020,Commission,"31,664.00",00.00,"846,746.72"
22-Sep-2020,Cheque,187.20,00.00,"846,933.92"
22-Sep-2020,IMPS,"22,248.61",00.00,"869,182.53"
22-Sep-2020,Tax,21.96,00.00,"869,204.49"
22-Sep-2020,IMPS,377.00,00.00,"869,581.49"
22-Sep-2020,Tax,00.00,"124,225.93","745,355.56"
22-Sep-2020,Cash,00.00,"372,677.78","372,677.78"
22-Sep-2020,Miscellaneous,345.00,00.00,"373,022.78"
22-Sep-2020,NEFT,00.00,"46,627.85","326,394.93"
22-Sep-2020,Transfer,01.00,00.00,"326,395.93"
22-Sep-2020,Miscellaneous,00.00,"108,798.64","217,597.29"
22-Sep-2020,Transfer,"29,587.00",00.00,"247,184.29"
22-Sep-2020,Bill,"248,391.00",00.00,"495,575.29"
22-Sep-2020,Reversal,"25,655.88",00.00,"521,231.17"
22-Sep-2020,NEFT,"5,693.30",00.00,"526,924.47"
22-Sep-2020,Miscellaneous,00.00,"175,641.49","351,282.98"
22-Sep-2020,IMPS,03.00,00.00,"351,285.98"
22-Sep-2020,Reversal,04.54,00.00,"351,290.52"
23-Sep-2020,Bill,13.00,00.00,"351,303.52"
23-Sep-2020,RTGS,00.00,"35,130.35","316,173.17"
23-Sep-2020,NEFT,"249,104.09",00.00,"565,277.26"
23-Sep-2020,NEFT,14.00,00.00,"565,291.26"
23-Sep-2020,RTGS,15.10,00.00,"565,306.36"
23-Sep-2020,Bill,00.00,"94,217.73","471,088.63"
23-Sep-2020,Transfer,00.00,"47,108.86","423,979.77"
23-Sep-2020,Debit Card,00.00,"60,568.54","363,411.23"
23-Sep-2020,ATM,00.00,"121,137.08","242,274.15"
23-Sep-2020,Cheque,"1,580,179.00",00.00,"1,822,453.15"
23-Sep-2020,Transfer,00.00,"455,613.29","1,366,839.86"
23-Sep-2020,Cheque,"16,221.00",00.00,"1,383,060.86"
23-Sep-2020,RTGS,00.00,"172,882.61","1,210,178.25"
23-Sep-2020,Bill,"2,141.31",00.00,"1,212,319.56"
23-Sep-2020,Purchase,290.00,00.00,"1,212,609.56"
23-Sep-2020,Bill,"1,251,455.50",00.00,"2,464,065.06"
23-Sep-2020,Commission,25.00,00.00,"2,464,090.06"
23-Sep-2020,Commission,"1,845,833.00",00.00,"4,309,923.06"
23-Sep-2020,Tax,07.01,00.00,"4,309,930.07"
23-Sep-2020,Interest,00.00,"861,986.01","3,447,944.06"
24-Sep-2020,Transfer,"11,762.00",00.00,"3,459,706.06"
24-Sep-2020,RTGS,02.20,00.00,"3,459,708.26"
24-Sep-2020,RTGS,00.00,"432,463.53","3,027,244.73"
24-Sep-2020,Cash,57.86,00.00,"3,027,302.59"
25-Sep-2020,Interest,00.00,"302,730.26","2,724,572.33"
25-Sep-2020,Cheque,00.00,"1,362,286.17","1,362,286.16"
25-Sep-2020,RTGS,00.00,"194,612.31","1,167,673.85"
25-Sep-2020,Miscellaneous,00.00,"389,224.62","778,449.23"
25-Sep-2020,Transfer,00.00,"77,844.92","700,604.31"
25-Sep-2020,NEFT,00.00,"233,534.77","467,069.54"
25-Sep-2020,RTGS,150.00,00.00,"467,219.54"
25-Sep-2020,Tax,00.00,"155,739.85","311,479.69"
25-Sep-2020,Purchase,00.00,"77,869.92","233,609.77"
25-Sep-2020,RTGS,256.60,00.00,"233,866.37"
25-Sep-2020,Interest,"28,499.09",00.00,"262,365.46"
25-Sep-2020,RTGS,137.10,00.00,"262,502.56"
25-Sep-2020,Bill,00.00,"37,500.37","225,002.19"
25-Sep-2020,NEFT,"31,904.00",00.00,"256,906.19"
25-Sep-2020,Tax,00.00,"256,906.19",00.00
25-Sep-2020,Cheque,387.00,00.00,387.00
25-Sep-2020,Cheque,"110,390.00",00.00,"110,777.00"
25-Sep-2020,Reversal,00.00,"27,694.25","83,082.75"
25-Sep-2020,Debit Card,00.00,"11,868.96","71,213.79"
25-Sep-2020,Tax,00.00,"71,213.79",00.00
25-Sep-2020,IMPS,"1,771,572.00",00.00,"1,771,572.00"
25-Sep-2020,Reversal,00.00,"221,446.50","1,550,125.50"
25-Sep-2020,NEFT,09.19,00.00,"1,550,134.69"
25-Sep-2020,Cash,00.00,"258,355.78","1,291,778.91"
25-Sep-2020,Cash,81.08,00.00,"1,291,859.99"
25-Sep-2020,IMPS,"311,841.00",00.00,"1,603,700.99"
25-Sep-2020,Bill,02.00,00.00,"1,603,702.99"
25-Sep-2020,Commission,00.00,"400,925.75","1,202,777.24"
25-Sep-2020,Reversal,00.00,"601,388.62","601,388.62"
25-Sep-2020,Commission,00.00,"120,277.72","481,110.90"
25-Sep-2020,Commission,597.00,00.00,"481,707.90"
25-Sep-2020,Bill,23.00,00.00,"481,730.90"
25-Sep-2020,Reversal,06.57,00.00,"481,737.47"
26-Sep-2020,IMPS,48.00,00.00,"481,785.47"
26-Sep-2020,Debit Card,00.00,"53,531.72","428,253.75"
26-Sep-2020,Tax,00.00,"71,375.63","356,878.12"
26-Sep-2020,Debit Card,280.00,00.00,"357,158.12"
26-Sep-2020,Debit Card,00.00,"59,526.35","297,631.77"
26-Sep-2020,Transfer,"187,367.72",00.00,"484,999.49"
26-Sep-2020,Cheque,354.00,00.00,"485,353.49"
26-Sep-2020,Transfer,00.00,"48,535.35","436,818.14"
27-Sep-2020,IMPS,"349,453.00",00.00,"786,271.14"
27-Sep-2020,NEFT,00.00,"87,363.46","698,907.68"
27-Sep-2020,Debit Card,06.00,00.00,"698,913.68"
27-Sep-2020,IMPS,00.00,"698,913.68",00.00
27-Sep-2020,Transfer,316.87,00.00,316.87
27-Sep-2020,Reversal,00.00,39.61,277.26
27-Sep-2020,NEFT,"1,290,266.00",00.00,"1,290,543.26"
27-Sep-2020,Tax,00.00,"430,181.09","860,362.17"
27-Sep-2020,ATM,"184,328.40",00.00,"1,044,690.57"
27-Sep-2020,Purchase,"3,400.73",00.00,"1,048,091.30"
27-Sep-2020,IMPS,00.00,"149,727.33","898,363.97"
27-Sep-2020,Transfer,09.00,00.00,"898,372.97"
27-Sep-2020,Transfer,00.00,"112,296.62","786,076.35"
27-Sep-2020,Interest,00.00,"131,012.73","655,063.62"
27-Sep-2020,Transfer,00.00,"72,784.85","582,278.77"
27-Sep-2020,Miscellaneous,00.00,"72,784.85","509,493.92"
27-Sep-2020,Debit Card,00.00,"56,610.44","452,883.48"
27-Sep-2020,Commission,37.01,00.00,"452,920.49"
27-Sep-2020,Tax,00.00,"452,920.49",00.00
27-Sep-2020,Tax,25.86,00.00,25.86
27-Sep-2020,Interest,00.00,02.59,23.27
27-Sep-2020,Cheque,00.00,03.88,19.39
27-Sep-2020,Cash,00.00,04.85,14.54
27-Sep-2020,Debit Card,00.00,01.82,12.72
27-Sep-2020,RTGS,"2,237.00",00.00,"2,249.72"
27-Sep-2020,IMPS,01.47,00.00,"2,251.19"
27-Sep-2020,Reversal,00.00,750.40,"1,500.79"
27-Sep-2020,RTGS,"3,006.00",00.00,"4,506.79"
27-Sep-2020,NEFT,"25,219.00",00.00,"29,725.79"
27-Sep-2020,Bill,03.10,00.00,"29,728.89"
27-Sep-2020,Tax,"2,806.00",00.00,"32,534.89"
27-Sep-2020,Commission,00.00,"4,647.84","27,887.05"
27-Sep-2020,Interest,00.00,"3,983.86","23,903.19"
27-Sep-2020,Cash,00.00,"2,390.32","21,512.87"
27-Sep-2020,Reversal,00.00,"5,378.22","16,134.65"
27-Sep-2020,RTGS,"1,113.50",00.00,"17,248.15"
27-Sep-2020,Interest,00.00,"1,916.46","15,331.69"
27-Sep-2020,Cash,"1,079.00",00.00,"16,410.69"
27-Sep-2020,Cash,08.00,00.00,"16,418.69"
27-Sep-2020,Interest,"1,550.44",00.00,"17,969.13"
27-Sep-2020,Reversal,"20,280.42",00.00,"38,249.55"
27-Sep-2020,Interest,00.00,"6,374.93","31,874.63"
27-Sep-2020,Commission,360.10,00.00,"32,234.73"
27-Sep-2020,ATM,00.00,"6,446.95","25,787.78"
27-Sep-2020,Interest,00.00,"25,787.78",00.00
27-Sep-2020,Interest,"1,438,178.00",00.00,"1,438,178.00"
27-Sep-2020,IMPS,25.40,00.00,"1,438,203.40"
28-Sep-2020,Debit Card,"27,682.11",00.00,"1,465,885.51"
28-Sep-2020,Reversal,00.00,"162,876.17","1,303,009.34"
28-Sep-2020,Debit Card,"1,341,141.00",00.00,"2,644,150.34"
28-Sep-2020,Transfer,00.00,"661,037.59","1,983,112.76"
28-Sep-2020,NEFT,"25,225.16",00.00,"2,008,337.92"
28-Sep-2020,Miscellaneous,00.00,"334,722.99","1,673,614.93"
28-Sep-2020,Transfer,409.50,00.00,"1,674,024.43"
28-Sep-2020,Bill,"932,894.00",00.00,"2,606,918.43"
28-Sep-2020,ATM,00.00,"651,729.61","1,955,188.82"
28-Sep-2020,NEFT,17.00,00.00,"1,955,205.82"
28-Sep-2020,Commission,00.00,"391,041.16","1,564,164.66"
28-Sep-2020,IMPS,"241,496.50",00.00,"1,805,661.16"
28-Sep-2020,Interest,16.20,00.00,"1,805,677.36"
28-Sep-2020,IMPS,00.00,"225,709.67","1,579,967.69"
28-Sep-2020,Cheque,05.00,00.00,"1,579,972.69"
28-Sep-2020,Cash,54.00,00.00,"1,580,026.69"
28-Sep-2020,Bill,02.76,00.00,"1,580,029.45"
28-Sep-2020,RTGS,00.00,"175,558.83","1,404,470.62"
28-Sep-2020,Cheque,90.00,00.00,"1,404,560.62"
28-Sep-2020,Purchase,55.00,00.00,"1,404,615.62"
28-Sep-2020,Interest,00.00,"140,461.56","1,264,154.06"
28-Sep-2020,Debit Card,00.00,"252,830.81","1,011,323.25"
28-Sep-2020,Transfer,29.35,00.00,"1,011,352.60"
28-Sep-2020,NEFT,00.00,"168,558.77","842,793.83"
28-Sep-2020,Cheque,"2,677.00",00.00,"845,470.83"
28-Sep-2020,RTGS,00.00,"93,941.20","751,529.63"
28-Sep-2020,Bill,00.00,"150,305.93","601,223.70"
28-Sep-2020,Commission,548.26,00.00,"601,771.96"
28-Sep-2020,Interest,00.00,"150,442.99","451,328.97"
29-Sep-2020,Reversal,00.00,"90,265.79","361,063.18"
29-Sep-2020,Miscellaneous,00.00,"180,531.59","180,531.59"
29-Sep-2020,Debit Card,00.00,"20,059.07","160,472.52"
29-Sep-2020,Interest,136.00,00.00,"160,608.52"
29-Sep-2020,IMPS,54.00,00.00,"160,662.52"
29-Sep-2020,IMPS,11.00,00.00,"160,673.52"
29-Sep-2020,Tax,"212,315.31",00.00,"372,988.83"
29-Sep-2020,Cash,00.00,"372,988.83",00.00
29-Sep-2020,ATM,"30,827.81",00.00,"30,827.81"
29-Sep-2020,Cash,00.00,"4,403.97","26,423.84"
29-Sep-2020,Reversal,02.00,00.00,"26,425.84"
29-Sep-2020,Reversal,00.00,"5,285.17","21,140.67"
29-Sep-2020,RTGS,00.00,"3,020.10","18,120.57"
29-Sep-2020,NEFT,03.00,00.00,"18,123.57"
29-Sep-2020,Tax,00.00,"1,812.36","16,311.21"
29-Sep-2020,Interest,54.80,00.00,"16,366.01"
29-Sep-2020,ATM,02.70,00.00,"16,368.71"
29-Sep-2020,ATM,00.00,"2,728.12","13,640.59"
29-Sep-2020,Reversal,"1,275.77",00.00,"14,916.36"
29-Sep-2020,Debit Card,00.00,"2,130.91","12,785.45"
29-Sep-2020,IMPS,00.00,"3,196.36","9,589.09"
29-Sep-2020,Miscellaneous,00.00,"3,196.36","6,392.73"
29-Sep-2020,Commission,"47,878.00",00.00,"54,270.73"
29-Sep-2020,Reversal,"2,059,310.20",00.00,"2,113,580.93"
29-Sep-2020,Transfer,"10,209.50",00.00,"2,123,790.43"
29-Sep-2020,IMPS,06.61,00.00,"2,123,797.04"
29-Sep-2020,Tax,"45,636.20",00.00,"2,169,433.24"
29-Sep-2020,IMPS,50.80,00.00,"2,169,484.04"
29-Sep-2020,Miscellaneous,"2,695.17",00.00,"2,172,179.21"
29-Sep-2020,Reversal,"2,023.00",00.00,"2,174,202.21"
29-Sep-2020,ATM,"17,059.45",00.00,"2,191,261.66"
29-Sep-2020,IMPS,51.00,00.00,"2,191,312.66"
29-Sep-2020,Debit Card,401.00,00.00,"2,191,713.66"
29-Sep-2020,Cheque,"195,970.00",00.00,"2,387,683.66"
29-Sep-2020,Transfer,00.00,"2,387,683.66",00.00
29-Sep-2020,RTGS,"24,190.90",00.00,"24,190.90"
29-Sep-2020,NEFT,"2,200.75",00.00,"26,391.65"
29-Sep-2020,Cheque,00.00,"2,639.17","23,752.48"
29-Sep-2020,NEFT,00.00,"5,938.12","17,814.36"
29-Sep-2020,Interest,60.00,00.00,"17,874.36"
29-Sep-2020,IMPS,00.00,"1,787.44","16,086.92"
29-Sep-2020,Miscellaneous,05.80,00.00,"16,092.72"
29-Sep-2020,Transfer,00.00,"4,023.18","12,069.54"
29-Sep-2020,Miscellaneous,407.60,00.00,"12,477.14"
29-Sep-2020,Commission,00.00,"2,495.43","9,981.71"
29-Sep-2020,Purchase,00.00,"1,425.96","8,555.75"
29-Sep-2020,Interest,00.00,"1,425.96","7,129.79"
29-Sep-2020,Debit Card,00.00,"2,376.60","4,753.19"
29-Sep-2020,Purchase,"36,520.20",00.00,"41,273.39"
29-Sep-2020,Tax,00.00,"8,254.68","33,018.71"
29-Sep-2020,Miscellaneous,53.69,00.00,"33,072.40"
29-Sep-2020,NEFT,00.00,"6,614.48","26,457.92"
29-Sep-2020,Cheque,"29,265.70",00.00,"55,723.62"
29-Sep-2020,Interest,00.00,"6,191.51","49,532.11"
29-Sep-2020,RTGS,304.60,00.00,"49,836.71"
29-Sep-2020,Bill,63.54,00.00,"49,900.25"
29-Sep-2020,Transfer,"28,711.00",00.00,"78,611.25"
29-Sep-2020,NEFT,07.10,00.00,"78,618.35"
29-Sep-2020,NEFT,00.00,"13,103.06","65,515.29"
29-Sep-2020,IMPS,00.00,"10,919.22","54,596.08"
29-Sep-2020,Reversal,66.00,00.00,"54,662.08"
29-Sep-2020,IMPS,00.00,"18,220.69","36,441.39"
29-Sep-2020,Tax,00.00,"3,644.14","32,797.25"
29-Sep-2020,Interest,"112,806.00",00.00,"145,603.25"
29-Sep-2020,NEFT,"3,066.00",00.00,"148,669.25"
29-Sep-2020,Transfer,00.00,"49,556.42","99,112.83"
29-Sep-2020,Reversal,00.00,"14,158.98","84,953.85"
29-Sep-2020,Debit Card,00.00,"84,953.85",00.00
29-Sep-2020,RTGS,05.70,00.00,05.70
29-Sep-2020,Debit Card,341.00,00.00,346.70
29-Sep-2020,Tax,00.00,49.53,297.17
29-Sep-2020,Debit Card,00.00,99.06,198.11
29-Sep-2020,Transfer,114.80,00.00,312.91
29-Sep-2020,Cash,"3,732.80",00.00,"4,045.71"
29-Sep-2020,Interest,00.00,674.29,"3,371.42"
29-Sep-2020,Cheque,00.00,"1,685.71","1,685.71"
29-Sep-2020,Cheque,"913,807.00",00.00,"915,492.71"
29-Sep-2020,IMPS,"185,059.00",00.00,"1,100,551.71"
29-Sep-2020,NEFT,00.00,"157,221.67","943,330.04"
29-Sep-2020,Interest,00.00,"235,832.51","707,497.53"
29-Sep-2020,Debit Card,"250,243.25",00.00,"957,740.78"
29-Sep-2020,NEFT,00.00,"136,820.11","820,920.67"
29-Sep-2020,NEFT,"369,211.50",00.00,"1,190,132.17"
29-Sep-2020,Tax,"911,899.20",00.00,"2,102,031.37"
29-Sep-2020,IMPS,00.00,"525,507.84","1,576,523.53"
29-Sep-2020,NEFT,451.00,00.00,"1,576,974.53"
29-Sep-2020,NEFT,00.00,"394,243.63","1,182,730.90"
29-Sep-2020,Commission,00.00,"147,841.36","1,034,889.54"
29-Sep-2020,Transfer,00.00,"147,841.36","887,048.18"
29-Sep-2020,RTGS,00.00,"221,762.05","665,286.14"
29-Sep-2020,Reversal,00.00,"166,321.54","498,964.60"
29-Sep-2020,Commission,"21,773.00",00.00,"520,737.60"
29-Sep-2020,Debit Card,"23,637.92",00.00,"544,375.52"
29-Sep-2020,Bill,39.48,00.00,"544,415.00"
29-Sep-2020,Miscellaneous,"10,374.20",00.00,"554,789.20"
29-Sep-2020,Interest,00.00,"554,789.20",00.00
29-Sep-2020,Transfer,"26,576.75",00.00,"26,576.75"
29-Sep-2020,RTGS,"86,216.20",00.00,"112,792.95"
29-Sep-2020,Cash,00.00,"28,198.24","84,594.71"
29-Sep-2020,RTGS,00.00,"9,399.41","75,195.30"
29-Sep-2020,Purchase,00.00,"37,597.65","37,597.65"
29-Sep-2020,NEFT,00.00,"18,798.83","18,798.82"
29-Sep-2020,Bill,30.00,00.00,"18,828.82"
29-Sep-2020,ATM,00.00,"2,689.83","16,138.99"
29-Sep-2020,Miscellaneous,"158,255.50",00.00,"174,394.49"
29-Sep-2020,Bill,"240,281.00",00.00,"414,675.49"
29-Sep-2020,Reversal,"185,647.70",00.00,"600,323.19"
29-Sep-2020,Cheque,"460,045.00",00.00,"1,060,368.19"
29-Sep-2020,Transfer,00.00,"265,092.05","795,276.14"
29-Sep-2020,IMPS,03.70,00.00,"795,279.84"
29-Sep-2020,Miscellaneous,"236,055.06",00.00,"1,031,334.90"
29-Sep-2020,NEFT,00.00,"147,333.56","884,001.34"
29-Sep-2020,Interest,"1,116,914.00",00.00,"2,000,915.34"
29-Sep-2020,Tax,07.00,00.00,"2,000,922.34"
29-Sep-2020,Bill,298.00,00.00,"2,001,220.34"
29-Sep-2020,Debit Card,20.36,00.00,"2,001,240.70"
29-Sep-2020,Miscellaneous,"103,555.62",00.00,"2,104,796.32"
29-Sep-2020,NEFT,00.00,"210,479.63","1,894,316.69"
29-Sep-2020,Miscellaneous,"3,887.00",00.00,"1,898,203.69"
29-Sep-2020,Cheque,"159,222.25",00.00,"2,057,425.94"
29-Sep-2020,Tax,00.00,"342,904.32","1,714,521.62"
29-Sep-2020,Commission,00.00,"1,714,521.62",00.00
29-Sep-2020,Debit Card,234.00,00.00,234.00
29-Sep-2020,RTGS,00.00,26.00,208.00
29-Sep-2020,Cash,04.85,00.00,212.85
29-Sep-2020,Bill,00.00,70.95,141.90
29-Sep-2020,Interest,00.00,47.30,94.60
29-Sep-2020,Transfer,00.00,23.65,70.95
29-Sep-2020,Debit Card,37.89,00.00,108.84
29-Sep-2020,Cheque,00.00,12.09,96.75
29-Sep-2020,NEFT,00.00,96.75,00.00
29-Sep-2020,ATM,"2,027,135.00",00.00,"2,027,135.00"
29-Sep-2020,Cash,"2,085.00",00.00,"2,029,220.00"
29-Sep-2020,NEFT,206.60,00.00,"2,029,426.60"
29-Sep-2020,Interest,"19,216.91",00.00,"2,048,643.51"
29-Sep-2020,Reversal,00.00,"2,048,643.51",00.00
29-Sep-2020,Miscellaneous,"26,489.31",00.00,"26,489.31"
29-Sep-2020,Debit Card,00.00,"5,297.86","21,191.45"
29-Sep-2020,Cheque,"952,533.50",00.00,"973,724.95"
29-Sep-2020,Bill,00.00,"121,715.62","852,009.33"
29-Sep-2020,NEFT,457.80,00.00,"852,467.13"
29-Sep-2020,Cash,00.00,"142,077.86","710,389.28"
29-Sep-2020,Bill,00.00,"355,194.64","355,194.64"
29-Sep-2020,Purchase,00.00,"355,194.64",00.00
29-Sep-2020,Cheque,"163,385.25",00.00,"163,385.25"
29-Sep-2020,Interest,00.00,"18,153.92","145,231.33"
29-Sep-2020,Commission,"1,142.46",00.00,"146,373.79"
29-Sep-2020,IMPS,00.00,"16,263.75","130,110.04"
29-Sep-2020,Tax,00.00,"14,456.67","115,653.37"
29-Sep-2020,RTGS,"1,944,408.80",00.00,"2,060,062.17"
29-Sep-2020,NEFT,01.80,00.00,"2,060,063.97"
29-Sep-2020,ATM,00.00,"294,294.85","1,765,769.12"
29-Sep-2020,Interest,00.00,"220,721.14","1,545,047.98"
29-Sep-2020,Reversal,46.00,00.00,"1,545,093.98"
29-Sep-2020,Miscellaneous,34.87,00.00,"1,545,128.85"
29-Sep-2020,Debit Card,"2,082,417.25",00.00,"3,627,546.10"
29-Sep-2020,RTGS,00.00,"604,591.02","3,022,955.08"
29-Sep-2020,Miscellaneous,56.60,00.00,"3,023,011.68"
29-Sep-2020,Miscellaneous,"1,949.10",00.00,"3,024,960.78"
29-Sep-2020,Cash,318.00,00.00,"3,025,278.78"
29-Sep-2020,Cash,00.00,"302,527.88","2,722,750.90"
29-Sep-2020,Interest,00.00,"544,550.18","2,178,200.72"
29-Sep-2020,Cash,"126,482.90",00.00,"2,304,683.62"
29-Sep-2020,Cheque,00.00,"1,152,341.81","1,152,341.81"
29-Sep-2020,Tax,"1,319,137.00",00.00,"2,471,478.81"
29-Sep-2020,Reversal,00.00,"823,826.27","1,647,652.54"
29-Sep-2020,Miscellaneous,00.00,"205,956.57","1,441,695.97"
29-Sep-2020,Interest,"42,458.00",00.00,"1,484,153.97"
29-Sep-2020,Commission,00.00,"247,359.00","1,236,794.98"
29-Sep-2020,Miscellaneous,00.00,"309,198.75","927,596.24"
29-Sep-2020,Debit Card,05.00,00.00,"927,601.24"
29-Sep-2020,Purchase,00.00,"154,600.21","773,001.03"
29-Sep-2020,Interest,00.00,"85,889.00","687,112.03"
29-Sep-2020,NEFT,490.70,00.00,"687,602.73"
29-Sep-2020,Transfer,45.10,00.00,"687,647.83"
29-Sep-2020,ATM,00.00,"171,911.96","515,735.87"
29-Sep-2020,Miscellaneous,500.00,00.00,"516,235.87"
30-Sep-2020,ATM,00.00,"172,078.62","344,157.25"
30-Sep-2020,RTGS,"1,142,340.00",00.00,"1,486,497.25"
30-Sep-2020,Cheque,"1,813,731.00",00.00,"3,300,228.25"
30-Sep-2020,NEFT,20.65,00.00,"3,300,248.90"
30-Sep-2020,Bill,04.00,00.00,"3,300,252.90"
30-Sep-2020,Transfer,00.00,"330,025.29","2,970,227.61"
01-Oct-2020,Transfer,987.60,00.00,"2,971,215.21"
01-Oct-2020,Transfer,00.00,"330,135.02","2,641,080.19"
01-Oct-2020,RTGS,00.40,00.00,"2,641,080.59"
01-Oct-2020,Transfer,"797,401.50",00.00,"3,438,482.09"
01-Oct-2020,Purchase,360.00,00.00,"3,438,842.09"
01-Oct-2020,Transfer,00.00,"1,146,280.70","2,292,561.39"
01-Oct-2020,RTGS,"1,321.11",00.00,"2,293,882.50"
01-Oct-2020,ATM,"1,712,788.50",00.00,"4,006,671.00"
01-Oct-2020,Purchase,00.00,"4,006,671.00",00.00
01-Oct-2020,RTGS,"32,316.22",00.00,"32,316.22"
01-Oct-2020,Debit Card,00.00,"3,231.62","29,084.60"
01-Oct-2020,Cash,00.00,"7,271.15","21,813.45"
02-Oct-2020,Reversal,08.17,00.00,"21,821.62"
02-Oct-2020,ATM,00.00,"7,273.87","14,547.75"
02-Oct-2020,Interest,00.00,"3,636.94","10,910.81"
02-Oct-2020,Reversal,"1,351,914.50",00.00,"1,362,825.31"
02-Oct-2020,Bill,"13,257.80",00.00,"1,376,083.11"
02-Oct-2020,Debit Card,355.00,00.00,"1,376,438.11"
02-Oct-2020,Bill,02.69,00.00,"1,376,440.80"
02-Oct-2020,Commission,"26,622.10",00.00,"1,403,062.90"
02-Oct-2020,Bill,"1,632.90",00.00,"1,404,695.80"
02-Oct-2020,Debit Card,00.00,00.00,"1,404,695.80"
02-Oct-2020,Bill,04.60,00.00,"1,404,700.40"
02-Oct-2020,Commission,"1,060,288.50",00.00,"2,464,988.90"
02-Oct-2020,Cheque,00.00,"821,662.97","1,643,325.93"
02-Oct-2020,Transfer,00.00,"410,831.48","1,232,494.45"
02-Oct-2020,Interest,07.90,00.00,"1,232,502.35"
02-Oct-2020,RTGS,317.00,00.00,"1,232,819.35"
02-Oct-2020,Debit Card,"59,515.25",00.00,"1,292,334.60"
02-Oct-2020,Cash,06.00,00.00,"1,292,340.60"
02-Oct-2020,RTGS,00.00,"323,085.15","969,255.45"
02-Oct-2020,Reversal,00.00,"121,156.93","848,098.52"
02-Oct-2020,Debit Card,00.00,"121,156.93","726,941.59"
02-Oct-2020,ATM,"157,870.00",00.00,"884,811.59"
02-Oct-2020,Cash,"216,275.50",00.00,"1,101,087.09"
02-Oct-2020,Transfer,00.00,"137,635.89","963,451.20"
02-Oct-2020,Cash,06.23,00.00,"963,457.43"
02-Oct-2020,Reversal,00.00,"160,576.24","802,881.19"
03-Oct-2020,Reversal,00.00,"267,627.06","535,254.13"
03-Oct-2020,NEFT,63.90,00.00,"535,318.03"
03-Oct-2020,IMPS,"31,656.60",00.00,"566,974.63"
03-Oct-2020,ATM,200.00,00.00,"567,174.63"
03-Oct-2020,Transfer,25.70,00.00,"567,200.33"
03-Oct-2020,Cheque,20.53,00.00,"567,220.86"
03-Oct-2020,Cash,00.00,"81,031.55","486,189.31"
03-Oct-2020,Tax,01.00,00.00,"486,190.31"
03-Oct-2020,Interest,"5,918.32",00.00,"492,108.63"
03-Oct-2020,IMPS,373.63,00.00,"492,482.26"
03-Oct-2020,NEFT,"1,959,690.25",00.00,"2,452,172.51"
03-Oct-2020,Reversal,00.00,"272,463.61","2,179,708.90"
03-Oct-2020,Transfer,"29,220.97",00.00,"2,208,929.87"
03-Oct-2020,Commission,00.00,"220,892.99","1,988,036.88"
03-Oct-2020,RTGS,00.00,"198,803.69","1,789,233.19"
04-Oct-2020,Debit Card,"3,243.00",00.00,"1,792,476.19"
04-Oct-2020,NEFT,00.00,"1,792,476.19",00.00
04-Oct-2020,Commission,08.90,00.00,08.90
04-Oct-2020,Reversal,25.40,00.00,34.30
04-Oct-2020,Cheque,00.00,06.86,27.44
04-Oct-2020,Debit Card,"2,901.10",00.00,"2,928.54"
05-Oct-2020,Purchase,"8,355.80",00.00,"11,284.34"
05-Oct-2020,ATM,00.00,"5,642.17","5,642.17"
05-Oct-2020,Reversal,"177,263.62",00.00,"182,905.79"
05-Oct-2020,Interest,"94,772.10",00.00,"277,677.89"
05-Oct-2020,Bill,"2,036.00",00.00,"279,713.89"
05-Oct-2020,RTGS,03.91,00.00,"279,717.80"
05-Oct-2020,Cheque,00.00,"31,079.76","248,638.04"
05-Oct-2020,Cash,51.00,00.00,"248,689.04"
05-Oct-2020,Interest,150.00,00.00,"248,839.04"
05-Oct-2020,RTGS,00.00,"24,883.90","223,955.14"
05-Oct-2020,Interest,00.00,"223,955.14",00.00
05-Oct-2020,Reversal,35.64,00.00,35.64
05-Oct-2020,Reversal,"202,089.00",00.00,"202,124.64"
06-Oct-2020,Cash,"2,446.00",00.00,"204,570.64"
06-Oct-2020,IMPS,"1,952,958.00",00.00,"2,157,528.64"
06-Oct-2020,Debit Card,"1,164,217.80",00.00,"3,321,746.44"
06-Oct-2020,ATM,00.00,"1,107,248.81","2,214,497.63"
06-Oct-2020,NEFT,"1,039,583.25",00.00,"3,254,080.88"
06-Oct-2020,Reversal,00.00,"361,564.54","2,892,516.34"
06-Oct-2020,Purchase,00.00,"482,086.06","2,410,430.28"
06-Oct-2020,Cheque,"1,711,514.50",00.00,"4,121,944.78"
06-Oct-2020,Cash,"11,790.50",00.00,"4,133,735.28"
06-Oct-2020,Bill,"230,454.50",00.00,"4,364,189.78"
06-Oct-2020,Commission,"118,920.00",00.00,"4,483,109.78"
06-Oct-2020,Miscellaneous,"1,381,942.00",00.00,"5,865,051.78"
07-Oct-2020,Miscellaneous,"31,604.00",00.00,"5,896,655.78"
07-Oct-2020,Bill,429.30,00.00,"5,897,085.08"
07-Oct-2020,Reversal,00.00,"1,965,695.03","3,931,390.05"
07-Oct-2020,Commission,00.00,"491,423.76","3,439,966.29"
07-Oct-2020,Cash,00.00,"491,423.76","2,948,542.53"
07-Oct-2020,Reversal,00.00,"1,474,271.27","1,474,271.26"
07-Oct-2020,Debit Card,11.81,00.00,"1,474,283.07"
07-Oct-2020,Cash,00.00,"737,141.54","737,141.54"
08-Oct-2020,Cheque,00.00,"81,904.62","655,236.92"
08-Oct-2020,RTGS,00.00,00.00,"655,236.92"
08-Oct-2020,NEFT,00.00,"218,412.31","436,824.61"
08-Oct-2020,Transfer,"29,239.10",00.00,"466,063.71"
08-Oct-2020,Bill,00.00,"66,580.53","399,483.18"
08-Oct-2020,Cash,00.00,"99,870.80","299,612.38"
08-Oct-2020,ATM,00.00,"42,801.77","256,810.61"
08-Oct-2020,Miscellaneous,00.00,"28,534.51","228,276.10"
08-Oct-2020,Purchase,00.20,00.00,"228,276.30"
08-Oct-2020,Cash,00.00,"32,610.90","195,665.40"
08-Oct-2020,IMPS,54.60,00.00,"195,720.00"
08-Oct-2020,Reversal,00.00,"21,746.67","173,973.33"
08-Oct-2020,Purchase,"2,811.70",00.00,"176,785.03"
08-Oct-2020,Bill,00.00,"44,196.26","132,588.77"
08-Oct-2020,ATM,00.00,"66,294.39","66,294.38"
08-Oct-2020,RTGS,00.00,"7,366.04","58,928.34"
08-Oct-2020,NEFT,00.00,"14,732.09","44,196.26"
08-Oct-2020,Purchase,00.00,"8,839.25","35,357.01"
08-Oct-2020,Miscellaneous,"1,711.07",00.00,"37,068.08"
08-Oct-2020,Commission,00.00,"6,178.01","30,890.07"
08-Oct-2020,Commission,00.00,"6,178.01","24,712.06"
08-Oct-2020,ATM,00.00,"4,942.41","19,769.65"
08-Oct-2020,Interest,00.00,"9,884.83","9,884.83"
08-Oct-2020,Miscellaneous,"1,605,005.50",00.00,"1,614,890.33"
08-Oct-2020,Interest,"60,627.70",00.00,"1,675,518.03"
08-Oct-2020,Debit Card,00.00,"167,551.80","1,507,966.23"
08-Oct-2020,IMPS,447.70,00.00,"1,508,413.93"
08-Oct-2020,RTGS,217.39,00.00,"1,508,631.32"
08-Oct-2020,IMPS,00.00,"188,578.92","1,320,052.40"
08-Oct-2020,ATM,00.00,"1,320,052.40",00.00
08-Oct-2020,Purchase,10.60,00.00,10.60
08-Oct-2020,Interest,00.00,03.53,07.07
08-Oct-2020,RTGS,00.00,07.07,00.00
08-Oct-2020,Reversal,"1,866.00",00.00,"1,866.00"
08-Oct-2020,Interest,00.00,266.57,"1,599.43"
08-Oct-2020,Commission,00.00,228.49,"1,370.94"
08-Oct-2020,Cash,"26,790.10",00.00,"28,161.04"
09-Oct-2020,Reversal,00.00,"3,520.13","24,640.91"
09-Oct-2020,Purchase,00.00,"8,213.64","16,427.27"
09-Oct-2020,Cash,00.00,"8,213.64","8,213.64"
09-Oct-2020,NEFT,00.00,"1,173.38","7,040.26"
09-Oct-2020,Bill,00.00,"7,040.26",00.00
09-Oct-2020,Miscellaneous,59.90,00.00,59.90
09-Oct-2020,Miscellaneous,"2,895.82",00.00,"2,955.72"
10-Oct-2020,RTGS,00.00,295.57,"2,660.15"
10-Oct-2020,Tax,00.00,532.03,"2,128.12"
10-Oct-2020,Cheque,00.00,266.02,"1,862.10"
10-Oct-2020,Tax,00.00,186.21,"1,675.89"
10-Oct-2020,NEFT,36.00,00.00,"1,711.89"
10-Oct-2020,Cash,00.00,342.38,"1,369.51"
10-Oct-2020,Interest,00.00,228.25,"1,141.26"
10-Oct-2020,NEFT,"3,305.00",00.00,"4,446.26"
10-Oct-2020,ATM,07.18,00.00,"4,453.44"
10-Oct-2020,IMPS,"11,981.60",00.00,"16,435.04"
10-Oct-2020,Tax,00.00,"1,826.12","14,608.92"
10-Oct-2020,Purchase,"4,070.00",00.00,"18,678.92"
10-Oct-2020,Tax,00.00,"3,735.78","14,943.14"
10-Oct-2020,Tax,02.60,00.00,"14,945.74"
10-Oct-2020,NEFT,00.00,"2,135.11","12,810.63"
10-Oct-2020,Bill,"1,748,768.50",00.00,"1,761,579.13"
10-Oct-2020,RTGS,00.00,"352,315.83","1,409,263.30"
10-Oct-2020,Commission,00.00,"140,926.33","1,268,336.97"
10-Oct-2020,Transfer,00.00,"253,667.39","1,014,669.58"
10-Oct-2020,Cash,"36,091.50",00.00,"1,050,761.08"
10-Oct-2020,ATM,28.80,00.00,"1,050,789.88"
10-Oct-2020,Miscellaneous,00.00,"131,348.74","919,441.14"
10-Oct-2020,Miscellaneous,"909,288.80",00.00,"1,828,729.94"
10-Oct-2020,Tax,00.00,"261,247.13","1,567,482.81"
10-Oct-2020,Bill,00.00,"195,935.35","1,371,547.46"
10-Oct-2020,IMPS,409.60,00.00,"1,371,957.06"
10-Oct-2020,Debit Card,00.00,"342,989.27","1,028,967.80"
10-Oct-2020,Commission,53.80,00.00,"1,029,021.60"
10-Oct-2020,Purchase,"1,511,425.20",00.00,"2,540,446.80"
10-Oct-2020,Cheque,"74,811.00",00.00,"2,615,257.80"
10-Oct-2020,Cash,04.00,00.00,"2,615,261.80"
10-Oct-2020,Commission,00.00,"1,307,630.90","1,307,630.90"
10-Oct-2020,Transfer,15.29,00.00,"1,307,646.19"
10-Oct-2020,Cash,00.00,"145,294.02","1,162,352.17"
10-Oct-2020,Cash,00.00,"129,150.24","1,033,201.93"
10-Oct-2020,RTGS,00.00,"344,400.64","688,801.29"
10-Oct-2020,Reversal,159.00,00.00,"688,960.29"
10-Oct-2020,NEFT,"23,263.80",00.00,"712,224.09"
10-Oct-2020,Purchase,"26,815.82",00.00,"739,039.91"
10-Oct-2020,NEFT,00.00,"369,519.96","369,519.96"
10-Oct-2020,IMPS,260.59,00.00,"369,780.55"
10-Oct-2020,Interest,22.19,00.00,"369,802.74"
10-Oct-2020,ATM,196.80,00.00,"369,999.54"
10-Oct-2020,Purchase,00.00,"369,999.54",00.00
10-Oct-2020,RTGS,"126,521.70",00.00,"126,521.70"
10-Oct-2020,Commission,"2,337.00",00.00,"128,858.70"
11-Oct-2020,RTGS,00.00,"42,952.90","85,905.80"
11-Oct-2020,Reversal,00.00,"9,545.09","76,360.71"
11-Oct-2020,Bill,00.00,"15,272.14","61,088.57"
11-Oct-2020,IMPS,"20,102.80",00.00,"81,191.37"
11-Oct-2020,IMPS,"2,631.30",00.00,"83,822.67"
11-Oct-2020,Debit Card,"818,772.00",00.00,"902,594.67"
11-Oct-2020,Reversal,"195,918.40",00.00,"1,098,513.07"
11-Oct-2020,NEFT,"2,705.40",00.00,"1,101,218.47"
11-Oct-2020,Bill,00.00,"275,304.62","825,913.85"
12-Oct-2020,RTGS,"1,044,686.50",00.00,"1,870,600.35"
12-Oct-2020,Miscellaneous,00.00,"623,533.45","1,247,066.90"
12-Oct-2020,RTGS,"91,701.00",00.00,"1,338,767.90"
12-Oct-2020,Reversal,"18,760.31",00.00,"1,357,528.21"
12-Oct-2020,Transfer,00.00,"1,357,528.21",00.00
12-Oct-2020,Transfer,"1,818,009.20",00.00,"1,818,009.20"
12-Oct-2020,Bill,17.50,00.00,"1,818,026.70"
12-Oct-2020,Purchase,"1,881.00",00.00,"1,819,907.70"
12-Oct-2020,ATM,00.00,"227,488.46","1,592,419.24"
12-Oct-2020,Reversal,103.40,00.00,"1,592,522.64"
12-Oct-2020,Purchase,00.00,"318,504.53","1,274,018.11"
12-Oct-2020,Transfer,"98,051.22",00.00,"1,372,069.33"
12-Oct-2020,Commission,00.00,"343,017.33","1,029,052.00"
12-Oct-2020,Reversal,436.70,00.00,"1,029,488.70"
12-Oct-2020,Commission,00.00,"102,948.87","926,539.83"
12-Oct-2020,ATM,00.00,"154,423.31","772,116.52"
12-Oct-2020,Bill,"130,783.00",00.00,"902,899.52"
12-Oct-2020,Transfer,00.00,"902,899.52",00.00
12-Oct-2020,NEFT,09.80,00.00,09.80
12-Oct-2020,ATM,00.00,01.96,07.84
12-Oct-2020,Bill,"214,130.70",00.00,"214,138.54"
12-Oct-2020,Commission,00.00,"21,413.85","192,724.69"
12-Oct-2020,IMPS,00.00,"38,544.94","154,179.75"
12-Oct-2020,Tax,05.03,00.00,"154,184.78"
12-Oct-2020,Debit Card,00.00,"19,273.10","134,911.68"
12-Oct-2020,IMPS,"18,302.00",00.00,"153,213.68"
12-Oct-2020,Tax,52.00,00.00,"153,265.68"
12-Oct-2020,IMPS,00.00,"21,895.10","131,370.58"
12-Oct-2020,Tax,00.00,"131,370.58",00.00
12-Oct-2020,Cash,06.00,00.00,06.00
12-Oct-2020,Interest,472.42,00.00,478.42
12-Oct-2020,Cash,"15,235.09",00.00,"15,713.51"
13-Oct-2020,Miscellaneous,00.00,"15,713.51",00.00
13-Oct-2020,Debit Card,"2,024,270.20",00.00,"2,024,270.20"
13-Oct-2020,Transfer,00.00,"2,024,270.20",00.00
13-Oct-2020,IMPS,384.00,00.00,384.00
13-Oct-2020,Bill,74.64,00.00,458.64
14-Oct-2020,RTGS,"28,748.80",00.00,"29,207.44"
14-Oct-2020,Reversal,"18,143.70",00.00,"47,351.14"
14-Oct-2020,Cheque,25.62,00.00,"47,376.76"
14-Oct-2020,Transfer,"24,436.00",00.00,"71,812.76"
14-Oct-2020,Interest,00.00,"10,258.97","61,553.79"
14-Oct-2020,Interest,00.00,"6,155.38","55,398.41"
14-Oct-2020,Purchase,00.00,"55,398.41",00.00
14-Oct-2020,ATM,"69,482.94",00.00,"69,482.94"
14-Oct-2020,Cheque,"936,663.25",00.00,"1,006,146.19"
14-Oct-2020,Commission,00.00,"100,614.62","905,531.57"
14-Oct-2020,Cash,00.00,"181,106.31","724,425.26"
14-Oct-2020,Reversal,00.00,"80,491.70","643,933.56"
14-Oct-2020,Miscellaneous,00.00,"321,966.78","321,966.78"
14-Oct-2020,Purchase,273.60,00.00,"322,240.38"
14-Oct-2020,Cash,00.00,"32,224.04","290,016.34"
14-Oct-2020,RTGS,"238,942.00",00.00,"528,958.34"
15-Oct-2020,Purchase,00.00,"75,565.48","453,392.86"
15-Oct-2020,Transfer,"26,871.40",00.00,"480,264.26"
15-Oct-2020,Tax,188.74,00.00,"480,453.00"
16-Oct-2020,Debit Card,03.77,00.00,"480,456.77"
16-Oct-2020,Bill,"1,027,584.00",00.00,"1,508,040.77"
16-Oct-2020,RTGS,133.50,00.00,"1,508,174.27"
16-Oct-2020,Tax,00.00,"754,087.14","754,087.14"
16-Oct-2020,Interest,00.00,"83,787.46","670,299.68"
16-Oct-2020,RTGS,00.00,"335,149.84","335,149.84"
16-Oct-2020,Transfer,00.00,"111,716.61","223,433.23"
16-Oct-2020,NEFT,"824,880.80",00.00,"1,048,314.03"
16-Oct-2020,Interest,00.00,"104,831.40","943,482.63"
16-Oct-2020,Miscellaneous,"23,663.60",00.00,"967,146.23"
16-Oct-2020,Interest,"3,278.00",00.00,"970,424.23"
16-Oct-2020,Cash,00.00,"138,632.03","831,792.20"
16-Oct-2020,RTGS,"2,008,474.00",00.00,"2,840,266.20"
16-Oct-2020,Tax,"131,609.16",00.00,"2,971,875.36"
16-Oct-2020,Tax,00.00,"424,553.62","2,547,321.74"
16-Oct-2020,Interest,00.00,"1,273,660.87","1,273,660.87"
16-Oct-2020,Reversal,00.00,"141,517.87","1,132,143.00"
16-Oct-2020,RTGS,00.00,"377,381.00","754,762.00"
17-Oct-2020,Commission,00.00,"754,762.00",00.00
17-Oct-2020,Commission,"1,180,234.00",00.00,"1,180,234.00"
17-Oct-2020,Bill,00.00,"196,705.67","983,528.33"
17-Oct-2020,ATM,"1,765,999.25",00.00,"2,749,527.58"
18-Oct-2020,Cheque,00.00,"687,381.90","2,062,145.68"
18-Oct-2020,Transfer,00.00,"515,536.42","1,546,609.26"
18-Oct-2020,Reversal,00.00,"1,546,609.26",00.00
18-Oct-2020,Commission,"2,939.60",00.00,"2,939.60"
18-Oct-2020,Cash,15.43,00.00,"2,955.03"
18-Oct-2020,RTGS,00.00,591.01,"2,364.02"
18-Oct-2020,Transfer,00.00,"1,182.01","1,182.01"
18-Oct-2020,IMPS,"1,655.29",00.00,"2,837.30"
18-Oct-2020,Bill,"84,725.90",00.00,"87,563.20"
18-Oct-2020,ATM,00.00,"29,187.73","58,375.47"
18-Oct-2020,Purchase,00.00,"8,339.35","50,036.12"
18-Oct-2020,Transfer,00.00,"50,036.12",00.00
18-Oct-2020,Purchase,"190,919.25",00.00,"190,919.25"
18-Oct-2020,Debit Card,00.00,"21,213.25","169,706.00"
18-Oct-2020,Cheque,00.00,"42,426.50","127,279.50"
18-Oct-2020,Commission,"1,467,707.20",00.00,"1,594,986.70"
18-Oct-2020,Reversal,00.00,"265,831.12","1,329,155.58"
18-Oct-2020,Interest,00.00,"1,329,155.58",00.00
18-Oct-2020,Tax,503.70,00.00,503.70
18-Oct-2020,Debit Card,00.00,167.90,335.80
18-Oct-2020,Cash,01.61,00.00,337.41
18-Oct-2020,Interest,"30,461.43",00.00,"30,798.84"
18-Oct-2020,IMPS,02.10,00.00,"30,800.94"
18-Oct-2020,NEFT,00.00,"6,160.19","24,640.75"
18-Oct-2020,Interest,15.84,00.00,"24,656.59"
18-Oct-2020,NEFT,"12,796.23",00.00,"37,452.82"
18-Oct-2020,Purchase,00.00,"4,681.60","32,771.22"
18-Oct-2020,Interest,"27,516.00",00.00,"60,287.22"
18-Oct-2020,Purchase,00.00,"10,047.87","50,239.35"
18-Oct-2020,Bill,00.00,"6,279.92","43,959.43"
18-Oct-2020,Bill,03.60,00.00,"43,963.03"
18-Oct-2020,Miscellaneous,00.00,"5,495.38","38,467.65"
18-Oct-2020,NEFT,"15,594.00",00.00,"54,061.65"
18-Oct-2020,Tax,00.00,"54,061.65",00.00
18-Oct-2020,RTGS,"2,799.00",00.00,"2,799.00"
18-Oct-2020,Purchase,00.00,559.80,"2,239.20"
18-Oct-2020,Bill,"48,028.00",00.00,"50,267.20"
18-Oct-2020,NEFT,00.00,"6,283.40","43,983.80"
18-Oct-2020,Reversal,888.81,00.00,"44,872.61"
18-Oct-2020,Transfer,00.00,"4,985.85","39,886.76"
18-Oct-2020,Reversal,00.00,"4,985.85","34,900.92"
18-Oct-2020,Transfer,"2,704.40",00.00,"37,605.32"
18-Oct-2020,Debit Card,"3,994.40",00.00,"41,599.72"
18-Oct-2020,IMPS,00.00,"4,622.19","36,977.53"
18-Oct-2020,Bill,00.00,"3,697.75","33,279.78"
19-Oct-2020,Cash,00.00,"4,754.25","28,525.53"
19-Oct-2020,RTGS,00.00,"5,705.11","22,820.42"
19-Oct-2020,Debit Card,02.00,00.00,"22,822.42"
19-Oct-2020,Cheque,00.00,"5,705.61","17,116.81"
19-Oct-2020,Interest,"225,356.09",00.00,"242,472.90"
19-Oct-2020,Purchase,"1,997,358.50",00.00,"2,239,831.40"
19-Oct-2020,RTGS,00.00,"746,610.47","1,493,220.93"
19-Oct-2020,Commission,00.40,00.00,"1,493,221.33"
19-Oct-2020,Debit Card,"113,614.00",00.00,"1,606,835.33"
19-Oct-2020,Miscellaneous,00.00,"178,537.26","1,428,298.07"
19-Oct-2020,Debit Card,"2,434.00",00.00,"1,430,732.07"
19-Oct-2020,Reversal,00.00,"715,366.04","715,366.04"
19-Oct-2020,RTGS,"1,970,982.80",00.00,"2,686,348.84"
19-Oct-2020,Commission,14.00,00.00,"2,686,362.84"
19-Oct-2020,IMPS,00.00,"1,343,181.42","1,343,181.42"
19-Oct-2020,Bill,14.00,00.00,"1,343,195.42"
19-Oct-2020,Tax,00.00,"447,731.81","895,463.61"
19-Oct-2020,Cheque,00.00,"179,092.72","716,370.89"
19-Oct-2020,Cheque,00.31,00.00,"716,371.20"
19-Oct-2020,ATM,"2,971.58",00.00,"719,342.78"
19-Oct-2020,Debit Card,09.40,00.00,"719,352.18"
19-Oct-2020,NEFT,40.60,00.00,"719,392.78"
19-Oct-2020,Tax,00.00,"719,392.78",00.00
19-Oct-2020,Commission,"1,321,076.00",00.00,"1,321,076.00"
20-Oct-2020,RTGS,"2,526.00",00.00,"1,323,602.00"
20-Oct-2020,Reversal,"30,404.00",00.00,"1,354,006.00"
20-Oct-2020,NEFT,00.00,"169,250.75","1,184,755.25"
20-Oct-2020,Purchase,"219,243.88",00.00,"1,403,999.13"
20-Oct-2020,Commission,00.00,"233,999.86","1,169,999.27"
20-Oct-2020,Interest,"78,886.10",00.00,"1,248,885.37"
20-Oct-2020,Cash,"25,639.10",00.00,"1,274,524.47"
20-Oct-2020,Cash,"183,933.20",00.00,"1,458,457.67"
20-Oct-2020,IMPS,87.00,00.00,"1,458,544.67"
20-Oct-2020,Tax,"3,686.52",00.00,"1,462,231.19"
20-Oct-2020,IMPS,"808,043.25",00.00,"2,270,274.44"
20-Oct-2020,Cash,"17,560.30",00.00,"2,287,834.74"
20-Oct-2020,Miscellaneous,00.00,"457,566.95","1,830,267.79"
20-Oct-2020,Transfer,37.00,00.00,"1,830,304.79"
20-Oct-2020,Interest,315.36,00.00,"1,830,620.15"
20-Oct-2020,Bill,418.94,00.00,"1,831,039.09"
20-Oct-2020,IMPS,450.35,00.00,"1,831,489.44"
20-Oct-2020,Transfer,00.00,"457,872.36","1,373,617.08"
20-Oct-2020,Transfer,"2,300.80",00.00,"1,375,917.88"
20-Oct-2020,Interest,00.00,"687,958.94","687,958.94"
20-Oct-2020,Cheque,"2,151.62",00.00,"690,110.56"
20-Oct-2020,IMPS,"126,556.00",00.00,"816,666.56"
20-Oct-2020,Cheque,"3,638.04",00.00,"820,304.60"
20-Oct-2020,Commission,00.00,"102,538.08","717,766.52"
20-Oct-2020,Tax,00.00,"71,776.65","645,989.87"
20-Oct-2020,Tax,300.00,00.00,"646,289.87"
20-Oct-2020,Cash,"88,871.00",00.00,"735,160.87"
20-Oct-2020,Bill,504.00,00.00,"735,664.87"
20-Oct-2020,ATM,00.00,"147,132.97","588,531.90"
20-Oct-2020,Debit Card,00.00,"84,075.99","504,455.91"
20-Oct-2020,Debit Card,02.00,00.00,"504,457.91"
20-Oct-2020,Reversal,00.00,"56,050.88","448,407.03"
20-Oct-2020,Reversal,00.00,"49,823.00","398,584.03"
20-Oct-2020,Interest,"2,826.00",00.00,"401,410.03"
20-Oct-2020,Miscellaneous,"2,052,957.00",00.00,"2,454,367.03"
20-Oct-2020,IMPS,22.17,00.00,"2,454,389.20"
20-Oct-2020,Cash,"14,449.17",00.00,"2,468,838.37"
20-Oct-2020,Transfer,00.00,"617,209.59","1,851,628.78"
20-Oct-2020,Reversal,00.00,"308,604.80","1,543,023.98"
20-Oct-2020,Interest,"185,432.25",00.00,"1,728,456.23"
20-Oct-2020,Tax,"6,228.50",00.00,"1,734,684.73"
20-Oct-2020,Cash,24.40,00.00,"1,734,709.13"
20-Oct-2020,Transfer,00.00,"173,470.91","1,561,238.22"
20-Oct-2020,Purchase,"3,400.96",00.00,"1,564,639.18"
20-Oct-2020,Cheque,00.00,"195,579.90","1,369,059.28"
21-Oct-2020,Reversal,00.00,"228,176.55","1,140,882.73"
21-Oct-2020,Purchase,00.00,"114,088.27","1,026,794.46"
21-Oct-2020,Purchase,"216,760.00",00.00,"1,243,554.46"
21-Oct-2020,Cheque,00.00,00.00,"1,243,554.46"
21-Oct-2020,IMPS,05.40,00.00,"1,243,559.86"
21-Oct-2020,Bill,01.10,00.00,"1,243,560.96"
21-Oct-2020,Debit Card,56.00,00.00,"1,243,616.96"
21-Oct-2020,Commission,07.20,00.00,"1,243,624.16"
21-Oct-2020,Transfer,"32,474.82",00.00,"1,276,098.98"
21-Oct-2020,Purchase,00.00,"141,788.78","1,134,310.20"
21-Oct-2020,Miscellaneous,00.00,"113,431.02","1,020,879.18"
21-Oct-2020,Cash,00.00,"204,175.84","816,703.34"
21-Oct-2020,ATM,"33,473.94",00.00,"850,177.28"
21-Oct-2020,Tax,"925,903.20",00.00,"1,776,080.48"
21-Oct-2020,ATM,475.12,00.00,"1,776,555.60"
22-Oct-2020,Bill,"26,026.40",00.00,"1,802,582.00"
22-Oct-2020,Interest,190.82,00.00,"1,802,772.82"
22-Oct-2020,Purchase,"227,122.28",00.00,"2,029,895.10"
22-Oct-2020,RTGS,00.00,"507,473.78","1,522,421.33"
23-Oct-2020,Debit Card,"21,349.97",00.00,"1,543,771.30"
23-Oct-2020,Debit Card,00.00,"514,590.43","1,029,180.87"
23-Oct-2020,Bill,01.20,00.00,"1,029,182.07"
23-Oct-2020,Transfer,01.62,00.00,"1,029,183.69"
23-Oct-2020,RTGS,00.00,"205,836.74","823,346.95"
23-Oct-2020,Interest,"3,480.94",00.00,"826,827.89"
23-Oct-2020,Bill,456.90,00.00,"827,284.79"
23-Oct-2020,NEFT,05.81,00.00,"827,290.60"
23-Oct-2020,Cheque,00.00,"165,458.12","661,832.48"
23-Oct-2020,RTGS,"1,406,907.50",00.00,"2,068,739.98"
23-Oct-2020,Transfer,06.20,00.00,"2,068,746.18"
23-Oct-2020,NEFT,"4,018.88",00.00,"2,072,765.06"
23-Oct-2020,Miscellaneous,19.13,00.00,"2,072,784.19"
23-Oct-2020,Miscellaneous,49.80,00.00,"2,072,833.99"
23-Oct-2020,Commission,00.00,"2,072,833.99",00.00
23-Oct-2020,RTGS,06.44,00.00,06.44
23-Oct-2020,Debit Card,00.00,01.07,05.37
23-Oct-2020,Bill,"15,513.30",00.00,"15,518.67"
23-Oct-2020,Bill,00.00,"15,518.67",00.00
23-Oct-2020,Commission,10.00,00.00,10.00
23-Oct-2020,RTGS,00.00,01.11,08.89
23-Oct-2020,RTGS,"1,599,244.50",00.00,"1,599,253.39"
23-Oct-2020,Bill,06.15,00.00,"1,599,259.54"
23-Oct-2020,Bill,30.00,00.00,"1,599,289.54"
23-Oct-2020,Tax,00.00,"228,469.93","1,370,819.61"
23-Oct-2020,Cash,54.65,00.00,"1,370,874.26"
23-Oct-2020,Bill,00.00,"1,370,874.26",00.00
23-Oct-2020,Interest,"235,185.00",00.00,"235,185.00"
23-Oct-2020,Cheque,07.00,00.00,"235,192.00"
23-Oct-2020,Commission,337.00,00.00,"235,529.00"
23-Oct-2020,Interest,"1,347,114.00",00.00,"1,582,643.00"
24-Oct-2020,Cash,"236,511.50",00.00,"1,819,154.50"
24-Oct-2020,Debit Card,00.00,"909,577.25","909,577.25"
24-Oct-2020,Transfer,"1,199.50",00.00,"910,776.75"
25-Oct-2020,ATM,00.00,"910,776.75",00.00
25-Oct-2020,Cash,"20,419.61",00.00,"20,419.61"
25-Oct-2020,Reversal,00.00,"4,083.92","16,335.69"
25-Oct-2020,Bill,293.39,00.00,"16,629.08"
26-Oct-2020,ATM,"149,938.00",00.00,"166,567.08"
26-Oct-2020,Commission,00.00,"27,761.18","138,805.90"
26-Oct-2020,IMPS,"24,413.21",00.00,"163,219.11"
26-Oct-2020,Purchase,"2,133.00",00.00,"165,352.11"
26-Oct-2020,Transfer,00.00,"33,070.42","132,281.69"
26-Oct-2020,Cash,00.00,"16,535.21","115,746.48"
26-Oct-2020,ATM,00.00,"11,574.65","104,171.83"
26-Oct-2020,Commission,440.22,00.00,"104,612.05"
26-Oct-2020,Debit Card,05.60,00.00,"104,617.65"
26-Oct-2020,Cheque,"31,329.60",00.00,"135,947.25"
26-Oct-2020,NEFT,"12,203.31",00.00,"148,150.56"
26-Oct-2020,Bill,"2,121.00",00.00,"150,271.56"
26-Oct-2020,Reversal,00.00,"75,135.78","75,135.78"
26-Oct-2020,Purchase,"3,076.00",00.00,"78,211.78"
26-Oct-2020,Interest,00.00,"7,821.18","70,390.60"
26-Oct-2020,Purchase,"32,748.56",00.00,"103,139.16"
26-Oct-2020,Transfer,"1,622.00",00.00,"104,761.16"
26-Oct-2020,Tax,"43,995.80",00.00,"148,756.96"
26-Oct-2020,Debit Card,00.00,"49,585.65","99,171.31"
26-Oct-2020,Cheque,263.50,00.00,"99,434.81"
26-Oct-2020,Reversal,00.00,"99,434.81",00.00
26-Oct-2020,Transfer,"6,682.14",00.00,"6,682.14"
26-Oct-2020,Cash,02.70,00.00,"6,684.84"
26-Oct-2020,ATM,00.00,"2,228.28","4,456.56"
26-Oct-2020,RTGS,00.00,"1,114.14","3,342.42"
26-Oct-2020,IMPS,"650,196.00",00.00,"653,538.42"
26-Oct-2020,Purchase,00.00,"72,615.38","580,923.04"
26-Oct-2020,Reversal,00.00,"58,092.30","522,830.74"
26-Oct-2020,IMPS,00.00,"104,566.15","418,264.59"
26-Oct-2020,Debit Card,07.00,00.00,"418,271.59"
26-Oct-2020,NEFT,00.00,"418,271.59",00.00
26-Oct-2020,RTGS,"8,586.00",00.00,"8,586.00"
26-Oct-2020,Purchase,171.26,00.00,"8,757.26"
26-Oct-2020,Cheque,00.00,973.03,"7,784.23"
26-Oct-2020,ATM,"1,635,429.75",00.00,"1,643,213.98"
26-Oct-2020,Cash,00.00,"234,744.85","1,408,469.13"
26-Oct-2020,Commission,00.00,"156,496.57","1,251,972.56"
26-Oct-2020,Purchase,00.00,"139,108.06","1,112,864.50"
26-Oct-2020,Interest,00.00,"185,477.42","927,387.08"
26-Oct-2020,IMPS,00.00,"154,564.51","772,822.57"
26-Oct-2020,IMPS,"19,488.00",00.00,"792,310.57"
26-Oct-2020,Debit Card,"10,085.00",00.00,"802,395.57"
26-Oct-2020,Debit Card,00.00,"802,395.57",00.00
26-Oct-2020,Debit Card,286.00,00.00,286.00
26-Oct-2020,Debit Card,00.00,286.00,00.00
26-Oct-2020,Cheque,"100,565.40",00.00,"100,565.40"
26-Oct-2020,RTGS,00.00,"33,521.80","67,043.60"
26-Oct-2020,Reversal,00.00,"7,449.29","59,594.31"
26-Oct-2020,Cash,246.40,00.00,"59,840.71"
26-Oct-2020,Reversal,06.00,00.00,"59,846.71"
26-Oct-2020,Bill,60.10,00.00,"59,906.81"
26-Oct-2020,Reversal,"225,474.90",00.00,"285,381.71"
26-Oct-2020,IMPS,00.48,00.00,"285,382.19"
26-Oct-2020,Commission,00.00,"285,382.19",00.00
26-Oct-2020,IMPS,34.00,00.00,34.00
26-Oct-2020,Bill,00.00,03.78,30.22
26-Oct-2020,Cash,00.00,04.32,25.90
26-Oct-2020,Debit Card,02.34,00.00,28.24
26-Oct-2020,Debit Card,"3,210.23",00.00,"3,238.47"
26-Oct-2020,Tax,"2,070.70",00.00,"5,309.17"
26-Oct-2020,Reversal,00.76,00.00,"5,309.93"
26-Oct-2020,Cheque,00.00,884.99,"4,424.94"
26-Oct-2020,Cash,"191,658.75",00.00,"196,083.69"
26-Oct-2020,Cheque,00.00,"28,011.96","168,071.73"
26-Oct-2020,NEFT,00.00,"16,807.17","151,264.56"
26-Oct-2020,Reversal,182.88,00.00,"151,447.44"
26-Oct-2020,RTGS,163.60,00.00,"151,611.04"
26-Oct-2020,Commission,00.00,"16,845.67","134,765.37"
26-Oct-2020,Debit Card,354.40,00.00,"135,119.77"
26-Oct-2020,Purchase,00.60,00.00,"135,120.37"
26-Oct-2020,ATM,320.43,00.00,"135,440.80"
26-Oct-2020,NEFT,00.00,"16,930.10","118,510.70"
26-Oct-2020,ATM,00.00,"19,751.78","98,758.92"
26-Oct-2020,IMPS,"19,976.40",00.00,"118,735.32"
26-Oct-2020,Bill,"16,260.10",00.00,"134,995.42"
26-Oct-2020,Reversal,00.00,"33,748.86","101,246.56"
26-Oct-2020,Cheque,"160,689.00",00.00,"261,935.56"
26-Oct-2020,Cheque,"26,546.00",00.00,"288,481.56"
26-Oct-2020,NEFT,00.00,"96,160.52","192,321.04"
26-Oct-2020,IMPS,00.00,"27,474.43","164,846.61"
26-Oct-2020,Tax,00.00,"20,605.83","144,240.78"
26-Oct-2020,Miscellaneous,"253,841.75",00.00,"398,082.53"
26-Oct-2020,Reversal,00.00,"66,347.09","331,735.44"
26-Oct-2020,Purchase,"20,973.74",00.00,"352,709.18"
26-Oct-2020,Interest,00.00,"39,189.91","313,519.27"
27-Oct-2020,Interest,00.00,"78,379.82","235,139.45"
27-Oct-2020,Purchase,"25,291.90",00.00,"260,431.35"
27-Oct-2020,Interest,00.00,"130,215.68","130,215.68"
27-Oct-2020,Cash,"719,858.00",00.00,"850,073.68"
27-Oct-2020,RTGS,00.00,"121,439.10","728,634.58"
27-Oct-2020,Tax,"1,718,160.00",00.00,"2,446,794.58"
27-Oct-2020,Transfer,131.30,00.00,"2,446,925.88"
27-Oct-2020,RTGS,00.00,"305,865.74","2,141,060.14"
27-Oct-2020,Miscellaneous,"1,763.00",00.00,"2,142,823.14"
27-Oct-2020,Debit Card,"73,880.34",00.00,"2,216,703.48"
27-Oct-2020,Cheque,04.00,00.00,"2,216,707.48"
27-Oct-2020,ATM,00.00,"1,108,353.74","1,108,353.74"
27-Oct-2020,Miscellaneous,00.00,"110,835.37","997,518.37"
27-Oct-2020,Reversal,00.00,"498,759.19","498,759.18"
27-Oct-2020,Purchase,00.00,"49,875.92","448,883.26"
27-Oct-2020,Commission,00.00,"64,126.18","384,757.08"
27-Oct-2020,ATM,00.00,"192,378.54","192,378.54"
27-Oct-2020,Cash,404.52,00.00,"192,783.06"
27-Oct-2020,IMPS,826.00,00.00,"193,609.06"
27-Oct-2020,RTGS,"54,312.00",00.00,"247,921.06"
27-Oct-2020,RTGS,313.00,00.00,"248,234.06"
27-Oct-2020,Cash,00.00,"62,058.52","186,175.54"
27-Oct-2020,Purchase,00.00,"26,596.51","159,579.03"
27-Oct-2020,Purchase,00.00,"26,596.51","132,982.52"
27-Oct-2020,Cash,00.00,"16,622.82","116,359.70"
27-Oct-2020,Transfer,407.99,00.00,"116,767.69"
27-Oct-2020,Bill,00.00,"38,922.56","77,845.13"
27-Oct-2020,Purchase,00.00,"77,845.13",00.00
27-Oct-2020,Tax,"18,845.59",00.00,"18,845.59"
27-Oct-2020,Purchase,00.00,"2,355.70","16,489.89"
27-Oct-2020,Miscellaneous,00.00,"2,355.70","14,134.19"
27-Oct-2020,Commission,00.00,"4,711.40","9,422.79"
27-Oct-2020,Tax,00.00,"1,046.98","8,375.81"
27-Oct-2020,Reversal,"6,564.32",00.00,"14,940.13"
27-Oct-2020,Cash,00.00,"14,940.13",00.00
27-Oct-2020,Cheque,02.00,00.00,02.00
27-Oct-2020,Debit Card,00.00,00.20,01.80
27-Oct-2020,Reversal,43.00,00.00,44.80
27-Oct-2020,Interest,00.00,11.20,33.60
27-Oct-2020,Miscellaneous,01.00,00.00,34.60
27-Oct-2020,Cash,"53,513.00",00.00,"53,547.60"
27-Oct-2020,Cheque,196.30,00.00,"53,743.90"
27-Oct-2020,IMPS,"1,308,568.50",00.00,"1,362,312.40"
27-Oct-2020,Debit Card,00.00,"194,616.06","1,167,696.34"
27-Oct-2020,Miscellaneous,00.00,"389,232.11","778,464.23"
27-Oct-2020,Cheque,00.00,"77,846.42","700,617.81"
27-Oct-2020,NEFT,00.00,"116,769.64","583,848.18"
27-Oct-2020,Cash,"1,262,995.25",00.00,"1,846,843.43"
27-Oct-2020,Debit Card,53.30,00.00,"1,846,896.73"
27-Oct-2020,Transfer,42.90,00.00,"1,846,939.63"
27-Oct-2020,NEFT,112.81,00.00,"1,847,052.44"
27-Oct-2020,Reversal,"109,883.00",00.00,"1,956,935.44"
27-Oct-2020,IMPS,00.00,"1,956,935.44",00.00
27-Oct-2020,ATM,"816,948.00",00.00,"816,948.00"
27-Oct-2020,Transfer,00.00,"408,474.00","408,474.00"
27-Oct-2020,ATM,00.00,"68,079.00","340,395.00"
27-Oct-2020,Interest,00.00,"340,395.00",00.00
27-Oct-2020,Cash,41.00,00.00,41.00
27-Oct-2020,RTGS,"126,488.60",00.00,"126,529.60"
27-Oct-2020,Tax,07.88,00.00,"126,537.48"
27-Oct-2020,Interest,00.00,"31,634.37","94,903.11"
27-Oct-2020,RTGS,02.40,00.00,"94,905.51"
27-Oct-2020,Interest,00.00,"15,817.59","79,087.92"
27-Oct-2020,NEFT,"234,187.91",00.00,"313,275.83"
27-Oct-2020,IMPS,00.00,"78,318.96","234,956.87"
27-Oct-2020,Transfer,00.00,"117,478.44","117,478.44"
27-Oct-2020,IMPS,"8,716.41",00.00,"126,194.85"
27-Oct-2020,IMPS,00.00,"12,619.49","113,575.36"
27-Oct-2020,Reversal,01.50,00.00,"113,576.86"
27-Oct-2020,RTGS,00.00,"113,576.86",00.00
27-Oct-2020,Bill,37.90,00.00,37.90
27-Oct-2020,Miscellaneous,07.60,00.00,45.50
27-Oct-2020,NEFT,00.00,06.50,39.00
27-Oct-2020,Cheque,75.00,00.00,114.00
27-Oct-2020,RTGS,"1,418,224.00",00.00,"1,418,338.00"
27-Oct-2020,Interest,00.00,"472,779.33","945,558.67"
27-Oct-2020,Interest,"3,371.00",00.00,"948,929.67"
27-Oct-2020,Miscellaneous,00.00,"189,785.93","759,143.74"
27-Oct-2020,Commission,"13,535.18",00.00,"772,678.92"
27-Oct-2020,Reversal,02.00,00.00,"772,680.92"
27-Oct-2020,Debit Card,00.00,"85,853.44","686,827.48"
27-Oct-2020,Reversal,370.61,00.00,"687,198.09"
27-Oct-2020,Reversal,"144,198.50",00.00,"831,396.59"
27-Oct-2020,Cheque,"1,890,926.25",00.00,"2,722,322.84"
27-Oct-2020,Bill,05.73,00.00,"2,722,328.57"
27-Oct-2020,Commission,192.00,00.00,"2,722,520.57"
27-Oct-2020,Miscellaneous,00.00,"388,931.51","2,333,589.06"
27-Oct-2020,Commission,"13,593.00",00.00,"2,347,182.06"
27-Oct-2020,Reversal,"1,447.02",00.00,"2,348,629.08"
27-Oct-2020,Debit Card,00.00,"391,438.18","1,957,190.90"
27-Oct-2020,Tax,00.00,"1,957,190.90",00.00
27-Oct-2020,Reversal,"843,988.25",00.00,"843,988.25"
27-Oct-2020,Reversal,60.91,00.00,"844,049.16"
27-Oct-2020,Cash,00.00,"844,049.16",00.00
27-Oct-2020,Interest,44.70,00.00,44.70
27-Oct-2020,Reversal,"19,927.90",00.00,"19,972.60"
27-Oct-2020,RTGS,05.08,00.00,"19,977.68"
28-Oct-2020,Interest,"59,816.59",00.00,"79,794.27"
28-Oct-2020,NEFT,00.00,"15,958.85","63,835.42"
28-Oct-2020,Commission,00.00,"15,958.86","47,876.56"
28-Oct-2020,Cash,500.30,00.00,"48,376.86"
28-Oct-2020,NEFT,00.00,"5,375.21","43,001.65"
28-Oct-2020,NEFT,"2,252.00",00.00,"45,253.65"
28-Oct-2020,IMPS,160.06,00.00,"45,413.71"
28-Oct-2020,NEFT,00.00,"7,568.95","37,844.76"
28-Oct-2020,Commission,"1,310.52",00.00,"39,155.28"
28-Oct-2020,IMPS,28.40,00.00,"39,183.68"
28-Oct-2020,Interest,00.00,"5,597.67","33,586.01"
28-Oct-2020,Transfer,107.60,00.00,"33,693.61"
28-Oct-2020,Debit Card,00.00,"5,615.60","28,078.01"
28-Oct-2020,Reversal,"97,060.40",00.00,"125,138.41"
28-Oct-2020,Reversal,00.00,"41,712.80","83,425.61"
28-Oct-2020,Transfer,00.00,"83,425.61",00.00
28-Oct-2020,Tax,"28,650.09",00.00,"28,650.09"
28-Oct-2020,Commission,02.60,00.00,"28,652.69"
28-Oct-2020,Transfer,00.00,"5,730.54","22,922.15"
28-Oct-2020,Cheque,00.00,"5,730.54","17,191.61"
28-Oct-2020,Transfer,00.00,"17,191.61",00.00
28-Oct-2020,Cheque,62.00,00.00,62.00
28-Oct-2020,ATM,"238,717.20",00.00,"238,779.20"
28-Oct-2020,RTGS,00.00,"47,755.84","191,023.36"
28-Oct-2020,Cheque,00.00,"95,511.68","95,511.68"
28-Oct-2020,Reversal,"23,141.82",00.00,"118,653.50"
28-Oct-2020,Miscellaneous,"7,278.00",00.00,"125,931.50"
28-Oct-2020,Miscellaneous,00.00,"41,977.17","83,954.33"
28-Oct-2020,Cheque,00.00,"11,993.48","71,960.85"
28-Oct-2020,Bill,00.00,"35,980.43","35,980.43"
28-Oct-2020,Cash,00.00,"17,990.22","17,990.22"
28-Oct-2020,Interest,"11,958.00",00.00,"29,948.22"
28-Oct-2020,Commission,00.00,"7,487.06","22,461.16"
28-Oct-2020,Miscellaneous,29.25,00.00,"22,490.41"
29-Oct-2020,NEFT,00.00,"11,245.21","11,245.20"
29-Oct-2020,RTGS,"2,819.60",00.00,"14,064.80"
29-Oct-2020,Transfer,00.00,"2,009.26","12,055.54"
29-Oct-2020,Bill,128.10,00.00,"12,183.64"
29-Oct-2020,Reversal,63.00,00.00,"12,246.64"
29-Oct-2020,NEFT,"2,206.90",00.00,"14,453.54"
29-Oct-2020,Cheque,"21,461.00",00.00,"35,914.54"
29-Oct-2020,Tax,00.00,"5,130.65","30,783.89"
29-Oct-2020,Miscellaneous,00.00,"4,397.70","26,386.19"
29-Oct-2020,Purchase,21.00,00.00,"26,407.19"
29-Oct-2020,RTGS,00.00,"2,934.13","23,473.06"
29-Oct-2020,NEFT,"287,356.00",00.00,"310,829.06"
29-Oct-2020,Debit Card,"1,712.00",00.00,"312,541.06"
29-Oct-2020,RTGS,00.00,"312,541.06",00.00
29-Oct-2020,ATM,"999,784.75",00.00,"999,784.75"
29-Oct-2020,Miscellaneous,00.00,"124,973.09","874,811.66"
29-Oct-2020,NEFT,"1,422,238.00",00.00,"2,297,049.66"
29-Oct-2020,RTGS,00.00,"328,149.95","1,968,899.71"
29-Oct-2020,RTGS,00.00,"984,449.86","984,449.86"
29-Oct-2020,ATM,00.00,"123,056.23","861,393.63"
29-Oct-2020,Transfer,49.30,00.00,"861,442.93"
29-Oct-2020,Cash,00.00,"430,721.47","430,721.46"
29-Oct-2020,Reversal,00.00,"107,680.37","323,041.10"
29-Oct-2020,Transfer,00.00,"107,680.37","215,360.73"
29-Oct-2020,Purchase,00.00,"30,765.82","184,594.91"
29-Oct-2020,Bill,00.00,"20,510.55","164,084.36"
29-Oct-2020,NEFT,"3,392.00",00.00,"167,476.36"
29-Oct-2020,ATM,00.00,"41,869.09","125,607.27"
29-Oct-2020,Bill,98.82,00.00,"125,706.09"
29-Oct-2020,Cheque,00.00,"31,426.52","94,279.57"
29-Oct-2020,Miscellaneous,00.00,"47,139.79","47,139.78"
29-Oct-2020,Debit Card,00.00,"4,713.98","42,425.80"
29-Oct-2020,RTGS,00.00,"42,425.80",00.00
29-Oct-2020,Reversal,"1,106.90",00.00,"1,106.90"
29-Oct-2020,Cash,00.00,368.97,737.93
29-Oct-2020,NEFT,155.61,00.00,893.54
29-Oct-2020,ATM,485.00,00.00,"1,378.54"
29-Oct-2020,Commission,00.00,275.71,"1,102.83"
29-Oct-2020,Bill,00.00,110.28,992.55
29-Oct-2020,ATM,00.00,496.28,496.28
29-Oct-2020,Debit Card,"32,649.25",00.00,"33,145.53"
29-Oct-2020,Cheque,00.00,"11,048.51","22,097.02"
29-Oct-2020,Bill,00.00,"11,048.51","11,048.51"
29-Oct-2020,Tax,03.71,00.00,"11,052.22"
29-Oct-2020,Cash,"2,226.00",00.00,"13,278.22"
29-Oct-2020,IMPS,00.00,"1,896.89","11,381.33"
29-Oct-2020,Debit Card,"247,152.09",00.00,"258,533.42"
29-Oct-2020,Miscellaneous,"71,246.50",00.00,"329,779.92"
29-Oct-2020,Bill,241.80,00.00,"330,021.72"
29-Oct-2020,Purchase,00.00,"82,505.43","247,516.29"
29-Oct-2020,Miscellaneous,03.88,00.00,"247,520.17"
29-Oct-2020,Cheque,"25,138.00",00.00,"272,658.17"
29-Oct-2020,Cheque,00.00,"34,082.27","238,575.90"
29-Oct-2020,IMPS,00.00,"238,575.90",00.00
29-Oct-2020,IMPS,07.00,00.00,07.00
29-Oct-2020,Bill,18.77,00.00,25.77
29-Oct-2020,Cash,462.04,00.00,487.81
29-Oct-2020,Tax,"22,102.50",00.00,"22,590.31"
29-Oct-2020,Tax,220.60,00.00,"22,810.91"
29-Oct-2020,Debit Card,"934,784.00",00.00,"957,594.91"
29-Oct-2020,ATM,"147,607.90",00.00,"1,105,202.81"
29-Oct-2020,Cheque,00.00,"368,400.94","736,801.87"
29-Oct-2020,Miscellaneous,00.00,"147,360.37","589,441.50"
29-Oct-2020,Tax,00.00,"73,680.19","515,761.31"
29-Oct-2020,ATM,"30,270.00",00.00,"546,031.31"
29-Oct-2020,NEFT,"9,162.31",00.00,"555,193.62"
29-Oct-2020,ATM,00.00,"111,038.72","444,154.90"
29-Oct-2020,Transfer,00.00,"44,415.49","399,739.41"
29-Oct-2020,Debit Card,00.00,"133,246.47","266,492.94"
29-Oct-2020,Commission,01.00,00.00,"266,493.94"
29-Oct-2020,Debit Card,"26,485.29",00.00,"292,979.23"
29-Oct-2020,Tax,00.00,"48,829.87","244,149.36"
29-Oct-2020,Transfer,"110,877.00",00.00,"355,026.36"
29-Oct-2020,IMPS,00.00,"50,718.05","304,308.31"
29-Oct-2020,Cash,00.00,"101,436.10","202,872.21"
29-Oct-2020,Miscellaneous,00.00,"202,872.21",00.00
29-Oct-2020,Purchase,22.00,00.00,22.00
29-Oct-2020,ATM,00.00,03.67,18.33
29-Oct-2020,IMPS,00.00,06.11,12.22
29-Oct-2020,Bill,07.97,00.00,20.19
29-Oct-2020,Reversal,04.30,00.00,24.49
29-Oct-2020,Transfer,"10,752.00",00.00,"10,776.49"
29-Oct-2020,NEFT,379.00,00.00,"11,155.49"
29-Oct-2020,Cash,00.00,"1,394.44","9,761.05"
29-Oct-2020,Cheque,"19,123.00",00.00,"28,884.05"
29-Oct-2020,Cheque,"54,635.00",00.00,"83,519.05"
29-Oct-2020,ATM,00.00,"20,879.76","62,639.29"
29-Oct-2020,Bill,06.00,00.00,"62,645.29"
29-Oct-2020,Cash,00.00,"8,949.33","53,695.96"
29-Oct-2020,Reversal,00.00,"13,423.99","40,271.97"
29-Oct-2020,Cheque,669.30,00.00,"40,941.27"
29-Oct-2020,IMPS,"561,367.50",00.00,"602,308.77"
29-Oct-2020,Transfer,00.00,"60,230.88","542,077.89"
29-Oct-2020,Purchase,07.60,00.00,"542,085.49"
29-Oct-2020,RTGS,00.00,"54,208.55","487,876.94"
29-Oct-2020,Debit Card,297.00,00.00,"488,173.94"
29-Oct-2020,ATM,00.00,"97,634.79","390,539.15"
29-Oct-2020,Purchase,00.00,"43,393.24","347,145.91"
29-Oct-2020,ATM,"2,002,231.75",00.00,"2,349,377.66"
29-Oct-2020,Bill,00.00,"2,349,377.66",00.00
29-Oct-2020,RTGS,"3,323.24",00.00,"3,323.24"
29-Oct-2020,Miscellaneous,00.00,"1,661.62","1,661.62"
29-Oct-2020,RTGS,01.01,00.00,"1,662.63"
29-Oct-2020,Commission,00.00,237.52,"1,425.11"
29-Oct-2020,NEFT,"1,431,424.20",00.00,"1,432,849.31"
29-Oct-2020,Cheque,"1,090.44",00.00,"1,433,939.75"
29-Oct-2020,Bill,"26,632.96",00.00,"1,460,572.71"
29-Oct-2020,Tax,00.00,"182,571.59","1,278,001.12"
29-Oct-2020,Debit Card,00.00,"213,000.19","1,065,000.93"
29-Oct-2020,Miscellaneous,00.00,"152,142.99","912,857.94"
29-Oct-2020,RTGS,00.00,"456,428.97","456,428.97"
29-Oct-2020,Bill,00.00,"114,107.24","342,321.73"
29-Oct-2020,Commission,00.00,"48,903.10","293,418.63"
29-Oct-2020,Interest,"60,699.00",00.00,"354,117.63"
29-Oct-2020,Debit Card,00.00,"50,588.23","303,529.40"
29-Oct-2020,Transfer,35.20,00.00,"303,564.60"
29-Oct-2020,Reversal,00.00,"303,564.60",00.00
29-Oct-2020,IMPS,"210,792.40",00.00,"210,792.40"
29-Oct-2020,Debit Card,"1,414,262.80",00.00,"1,625,055.20"
29-Oct-2020,Tax,"63,834.60",00.00,"1,688,889.80"
29-Oct-2020,ATM,00.00,"241,269.97","1,447,619.83"
29-Oct-2020,Reversal,"1,422,158.00",00.00,"2,869,777.83"
29-Oct-2020,ATM,00.00,"358,722.23","2,511,055.60"
29-Oct-2020,Cash,00.00,"418,509.27","2,092,546.33"
29-Oct-2020,Tax,00.00,"697,515.44","1,395,030.89"
29-Oct-2020,NEFT,00.00,"697,515.45","697,515.44"
29-Oct-2020,Cash,00.00,"139,503.09","558,012.35"
29-Oct-2020,Cash,00.00,"279,006.18","279,006.18"
29-Oct-2020,ATM,"590,002.20",00.00,"869,008.38"
29-Oct-2020,Cash,50.00,00.00,"869,058.38"
29-Oct-2020,Debit Card,00.00,"144,843.06","724,215.32"
29-Oct-2020,Reversal,00.00,"362,107.66","362,107.66"
29-Oct-2020,Reversal,00.00,"90,526.92","271,580.74"
29-Oct-2020,Transfer,00.00,"67,895.19","203,685.56"
29-Oct-2020,IMPS,00.00,"29,097.94","174,587.62"
29-Oct-2020,RTGS,00.00,"58,195.87","116,391.75"
29-Oct-2020,Commission,00.00,"19,398.63","96,993.12"
29-Oct-2020,Debit Card,59.97,00.00,"97,053.09"
29-Oct-2020,Reversal,00.00,"13,864.73","83,188.36"
29-Oct-2020,Interest,00.00,"27,729.45","55,458.91"
30-Oct-2020,Cheque,"256,983.40",00.00,"312,442.31"
30-Oct-2020,NEFT,"19,471.58",00.00,"331,913.89"
30-Oct-2020,IMPS,"1,772.89",00.00,"333,686.78"
30-Oct-2020,Commission,"1,843,542.00",00.00,"2,177,228.78"
30-Oct-2020,Cheque,00.00,"435,445.76","1,741,783.02"
30-Oct-2020,IMPS,"27,366.75",00.00,"1,769,149.77"
30-Oct-2020,IMPS,00.00,"1,769,149.77",00.00
30-Oct-2020,Purchase,416.00,00.00,416.00
30-Oct-2020,Cheque,00.00,46.22,369.78
30-Oct-2020,Reversal,01.01,00.00,370.79
30-Oct-2020,Cheque,"16,898.20",00.00,"17,268.99"
30-Oct-2020,Purchase,310.00,00.00,"17,578.99"
30-Oct-2020,Bill,00.00,"2,929.83","14,649.16"
30-Oct-2020,Bill,00.00,"3,662.29","10,986.87"
30-Oct-2020,Commission,"4,764.22",00.00,"15,751.09"
30-Oct-2020,Debit Card,494.22,00.00,"16,245.31"
30-Oct-2020,Transfer,00.00,"1,624.53","14,620.78"
30-Oct-2020,Reversal,"2,002.41",00.00,"16,623.19"
30-Oct-2020,Cash,00.00,"2,374.74","14,248.45"
30-Oct-2020,Debit Card,00.00,"3,562.11","10,686.34"
30-Oct-2020,Transfer,00.00,"2,671.59","8,014.76"
30-Oct-2020,RTGS,06.07,00.00,"8,020.83"
30-Oct-2020,Interest,59.00,00.00,"8,079.83"
30-Oct-2020,Cash,122.40,00.00,"8,202.23"
30-Oct-2020,Debit Card,"1,327,533.00",00.00,"1,335,735.23"
30-Oct-2020,Interest,"1,948.00",00.00,"1,337,683.23"
30-Oct-2020,RTGS,"32,662.00",00.00,"1,370,345.23"
30-Oct-2020,NEFT,00.00,"1,370,345.23",00.00
30-Oct-2020,ATM,358.79,00.00,358.79
30-Oct-2020,Debit Card,00.00,89.70,269.09
30-Oct-2020,Transfer,"15,890.00",00.00,"16,159.09"
30-Oct-2020,Commission,187.00,00.00,"16,346.09"
30-Oct-2020,Transfer,160.10,00.00,"16,506.19"
31-Oct-2020,Miscellaneous,00.00,"8,253.10","8,253.09"
31-Oct-2020,Tax,00.00,"1,031.64","7,221.45"
31-Oct-2020,Commission,00.00,"1,805.36","5,416.09"
31-Oct-2020,RTGS,00.00,601.79,"4,814.30"
31-Oct-2020,Tax,00.00,534.92,"4,279.38"
31-Oct-2020,Purchase,"172,542.47",00.00,"176,821.85"
31-Oct-2020,Reversal,00.00,"44,205.46","132,616.39"
31-Oct-2020,Purchase,"205,743.00",00.00,"338,359.39"
31-Oct-2020,Cash,"24,315.80",00.00,"362,675.19"
31-Oct-2020,Bill,"1,348,774.80",00.00,"1,711,449.99"
31-Oct-2020,Transfer,285.22,00.00,"1,711,735.21"
31-Oct-2020,NEFT,"4,843.90",00.00,"1,716,579.11"
31-Oct-2020,Bill,00.00,"572,193.04","1,144,386.07"
31-Oct-2020,Tax,00.00,"163,483.72","980,902.35"
31-Oct-2020,NEFT,00.00,"245,225.59","735,676.76"
31-Oct-2020,Interest,00.00,"735,676.76",00.00
31-Oct-2020,NEFT,"1,799,337.00",00.00,"1,799,337.00"
31-Oct-2020,ATM,"1,515.96",00.00,"1,800,852.96"
31-Oct-2020,Debit Card,06.00,00.00,"1,800,858.96"
31-Oct-2020,NEFT,"7,239.50",00.00,"1,808,098.46"
31-Oct-2020,Tax,291.37,00.00,"1,808,389.83"
31-Oct-2020,Commission,00.00,"200,932.20","1,607,457.63"
31-Oct-2020,Debit Card,00.00,"160,745.76","1,446,711.87"
31-Oct-2020,Miscellaneous,"1,649.64",00.00,"1,448,361.51"
31-Oct-2020,Commission,00.00,"482,787.17","965,574.34"
31-Oct-2020,Bill,00.00,"965,574.34",00.00
01-Nov-2020,Transfer,06.91,00.00,06.91
01-Nov-2020,IMPS,00.00,00.69,06.22
01-Nov-2020,Reversal,00.00,01.56,04.66
01-Nov-2020,Commission,40.00,00.00,44.66
01-Nov-2020,Interest,00.00,05.58,39.08
01-Nov-2020,Interest,"10,551.70",00.00,"10,590.78"
01-Nov-2020,Interest,00.00,"10,590.78",00.00
01-Nov-2020,Debit Card,87.89,00.00,87.89
01-Nov-2020,Purchase,00.00,21.97,65.92
01-Nov-2020,Commission,00.00,13.18,52.74
01-Nov-2020,Cash,"4,686.00",00.00,"4,738.74"
01-Nov-2020,Bill,00.00,"2,369.37","2,369.37"
01-Nov-2020,Bill,00.00,263.26,"2,106.11"
01-Nov-2020,Miscellaneous,00.00,351.02,"1,755.09"
01-Nov-2020,Commission,26.00,00.00,"1,781.09"
01-Nov-2020,Purchase,00.00,197.90,"1,583.19"
01-Nov-2020,Interest,00.00,175.91,"1,407.28"
01-Nov-2020,Transfer,01.80,00.00,"1,409.08"
01-Nov-2020,Commission,00.00,140.91,"1,268.17"
01-Nov-2020,RTGS,25.10,00.00,"1,293.27"
01-Nov-2020,Bill,"1,643.00",00.00,"2,936.27"
01-Nov-2020,Tax,00.00,"1,468.14","1,468.14"
01-Nov-2020,Debit Card,"31,410.02",00.00,"32,878.16"
01-Nov-2020,Bill,00.00,"10,959.39","21,918.77"
01-Nov-2020,ATM,"299,058.50",00.00,"320,977.27"
01-Nov-2020,Interest,50.18,00.00,"321,027.45"
01-Nov-2020,Tax,"250,202.00",00.00,"571,229.45"
01-Nov-2020,Transfer,644.80,00.00,"571,874.25"
01-Nov-2020,Tax,"3,846.90",00.00,"575,721.15"
01-Nov-2020,Debit Card,00.00,"115,144.23","460,576.92"
01-Nov-2020,Cheque,"1,012,407.00",00.00,"1,472,983.92"
01-Nov-2020,RTGS,"1,072,586.80",00.00,"2,545,570.72"
01-Nov-2020,Purchase,02.87,00.00,"2,545,573.59"
01-Nov-2020,Miscellaneous,00.00,"2,545,573.59",00.00
01-Nov-2020,Debit Card,"1,101,890.00",00.00,"1,101,890.00"
01-Nov-2020,Reversal,00.00,"550,945.00","550,945.00"
01-Nov-2020,Debit Card,00.00,"275,472.50","275,472.50"
01-Nov-2020,Transfer,00.00,"34,434.06","241,038.44"
01-Nov-2020,IMPS,00.00,"241,038.44",00.00
01-Nov-2020,Bill,06.50,00.00,06.50
01-Nov-2020,Bill,55.00,00.00,61.50
01-Nov-2020,Interest,10.70,00.00,72.20
01-Nov-2020,IMPS,00.00,18.05,54.15
01-Nov-2020,Debit Card,25.50,00.00,79.65
01-Nov-2020,Bill,42.00,00.00,121.65
01-Nov-2020,Cheque,00.00,12.17,109.48
01-Nov-2020,Tax,438.20,00.00,547.68
01-Nov-2020,Bill,387.00,00.00,934.68
01-Nov-2020,Bill,"7,665.00",00.00,"8,599.68"
01-Nov-2020,Bill,00.00,"1,433.28","7,166.40"
01-Nov-2020,Commission,00.00,"1,791.60","5,374.80"
01-Nov-2020,Cheque,00.00,"5,374.80",00.00
01-Nov-2020,Commission,07.00,00.00,07.00
01-Nov-2020,RTGS,"3,945.20",00.00,"3,952.20"
01-Nov-2020,Debit Card,"17,713.40",00.00,"21,665.60"
01-Nov-2020,IMPS,11.09,00.00,"21,676.69"
01-Nov-2020,Transfer,23.00,00.00,"21,699.69"
01-Nov-2020,NEFT,00.00,"2,712.46","18,987.23"
01-Nov-2020,NEFT,00.00,"2,712.46","16,274.77"
01-Nov-2020,Debit Card,256.80,00.00,"16,531.57"
01-Nov-2020,Commission,00.00,"16,531.57",00.00
01-Nov-2020,Cash,26.20,00.00,26.20
01-Nov-2020,NEFT,"226,705.88",00.00,"226,732.08"
01-Nov-2020,Miscellaneous,00.00,"113,366.04","113,366.04"
01-Nov-2020,Cash,00.00,"28,341.51","85,024.53"
01-Nov-2020,Tax,"190,223.00",00.00,"275,247.53"
01-Nov-2020,Bill,00.00,"34,405.94","240,841.59"
01-Nov-2020,Debit Card,00.00,"40,140.27","200,701.32"
01-Nov-2020,Reversal,00.00,"40,140.26","160,561.06"
01-Nov-2020,Bill,00.00,"40,140.27","120,420.80"
01-Nov-2020,Purchase,446.20,00.00,"120,867.00"
01-Nov-2020,Commission,61.90,00.00,"120,928.90"
01-Nov-2020,Commission,"127,318.80",00.00,"248,247.70"
02-Nov-2020,Transfer,04.84,00.00,"248,252.54"
02-Nov-2020,ATM,"8,244.00",00.00,"256,496.54"
02-Nov-2020,Cheque,30.00,00.00,"256,526.54"
02-Nov-2020,Bill,00.00,"28,502.95","228,023.59"
02-Nov-2020,Interest,00.00,"28,502.95","199,520.64"
02-Nov-2020,Commission,00.00,"22,168.96","177,351.68"
02-Nov-2020,Bill,00.00,"59,117.23","118,234.45"
02-Nov-2020,NEFT,"1,878.27",00.00,"120,112.72"
02-Nov-2020,Interest,00.00,"15,014.09","105,098.63"
02-Nov-2020,RTGS,"25,392.80",00.00,"130,491.43"
02-Nov-2020,Debit Card,00.00,"43,497.14","86,994.29"
02-Nov-2020,Interest,"2,356.50",00.00,"89,350.79"
02-Nov-2020,Miscellaneous,00.00,"12,764.40","76,586.39"
02-Nov-2020,ATM,"11,600.77",00.00,"88,187.16"
02-Nov-2020,Debit Card,"205,894.60",00.00,"294,081.76"
02-Nov-2020,IMPS,00.00,"294,081.76",00.00
02-Nov-2020,Purchase,"1,775,530.00",00.00,"1,775,530.00"
02-Nov-2020,Debit Card,00.00,"355,106.00","1,420,424.00"
02-Nov-2020,Miscellaneous,"173,817.00",00.00,"1,594,241.00"
02-Nov-2020,IMPS,65.30,00.00,"1,594,306.30"
02-Nov-2020,Purchase,00.00,"797,153.15","797,153.15"
02-Nov-2020,Cheque,00.00,"398,576.58","398,576.58"
02-Nov-2020,Bill,00.00,"56,939.51","341,637.07"
02-Nov-2020,Purchase,00.00,"68,327.41","273,309.66"
02-Nov-2020,Cash,00.00,"34,163.71","239,145.95"
02-Nov-2020,Debit Card,06.00,00.00,"239,151.95"
02-Nov-2020,ATM,00.00,"26,572.44","212,579.51"
02-Nov-2020,Tax,00.00,"70,859.84","141,719.67"
02-Nov-2020,Debit Card,"29,827.00",00.00,"171,546.67"
02-Nov-2020,Cheque,"87,011.60",00.00,"258,558.27"
02-Nov-2020,Cash,14.22,00.00,"258,572.49"
02-Nov-2020,Reversal,00.00,"258,572.49",00.00
02-Nov-2020,RTGS,288.00,00.00,288.00
02-Nov-2020,Interest,00.00,41.14,246.86
02-Nov-2020,Transfer,07.00,00.00,253.86
02-Nov-2020,IMPS,00.00,28.21,225.65
02-Nov-2020,Purchase,00.00,32.24,193.41
02-Nov-2020,Miscellaneous,00.00,96.71,96.70
03-Nov-2020,ATM,00.10,00.00,96.80
03-Nov-2020,Purchase,00.00,32.27,64.53
03-Nov-2020,ATM,00.00,08.07,56.46
03-Nov-2020,RTGS,00.00,05.65,50.81
03-Nov-2020,RTGS,00.00,05.08,45.73
03-Nov-2020,Cheque,00.00,22.87,22.86
03-Nov-2020,Reversal,00.00,05.72,17.14
03-Nov-2020,Miscellaneous,00.00,08.57,08.57
03-Nov-2020,Commission,"1,826,892.75",00.00,"1,826,901.32"
03-Nov-2020,Reversal,00.89,00.00,"1,826,902.21"
03-Nov-2020,IMPS,00.00,"202,989.13","1,623,913.08"
03-Nov-2020,Transfer,00.00,"1,623,913.08",00.00
03-Nov-2020,ATM,"12,843.50",00.00,"12,843.50"
03-Nov-2020,Miscellaneous,"3,193.90",00.00,"16,037.40"
03-Nov-2020,IMPS,00.00,"4,009.35","12,028.05"
03-Nov-2020,NEFT,09.00,00.00,"12,037.05"
04-Nov-2020,IMPS,00.00,"1,337.45","10,699.60"
04-Nov-2020,Bill,"1,337,360.00",00.00,"1,348,059.60"
04-Nov-2020,Commission,00.00,"149,784.40","1,198,275.20"
04-Nov-2020,Cash,"7,475.20",00.00,"1,205,750.40"
04-Nov-2020,Miscellaneous,02.90,00.00,"1,205,753.30"
04-Nov-2020,NEFT,"86,781.44",00.00,"1,292,534.74"
04-Nov-2020,Purchase,00.00,"646,267.37","646,267.37"
04-Nov-2020,Tax,00.00,"323,133.69","323,133.68"
04-Nov-2020,NEFT,"1,335.17",00.00,"324,468.85"
04-Nov-2020,Tax,"438,118.50",00.00,"762,587.35"
04-Nov-2020,Interest,"1,659,278.20",00.00,"2,421,865.55"
04-Nov-2020,Interest,00.00,"1,210,932.78","1,210,932.77"
04-Nov-2020,Interest,45.00,00.00,"1,210,977.77"
04-Nov-2020,Purchase,00.00,"134,553.09","1,076,424.68"
04-Nov-2020,Cash,03.00,00.00,"1,076,427.68"
05-Nov-2020,Miscellaneous,00.00,"215,285.54","861,142.14"
05-Nov-2020,ATM,00.00,"95,682.46","765,459.68"
05-Nov-2020,Debit Card,00.00,"153,091.94","612,367.74"
05-Nov-2020,Interest,00.00,"306,183.87","306,183.87"
05-Nov-2020,Tax,49.81,00.00,"306,233.68"
05-Nov-2020,Interest,"2,865.70",00.00,"309,099.38"
05-Nov-2020,Purchase,03.90,00.00,"309,103.28"
05-Nov-2020,Reversal,00.00,"103,034.43","206,068.85"
05-Nov-2020,Debit Card,43.20,00.00,"206,112.05"
05-Nov-2020,Transfer,12.00,00.00,"206,124.05"
05-Nov-2020,RTGS,00.00,"103,062.03","103,062.02"
05-Nov-2020,IMPS,00.00,"20,612.40","82,449.62"
05-Nov-2020,Commission,"519,724.00",00.00,"602,173.62"
05-Nov-2020,Bill,"919,031.75",00.00,"1,521,205.37"
05-Nov-2020,Cash,00.00,"169,022.82","1,352,182.55"
05-Nov-2020,Cash,00.00,"150,242.51","1,201,940.04"
05-Nov-2020,Tax,00.00,"200,323.34","1,001,616.70"
05-Nov-2020,Reversal,"124,357.30",00.00,"1,125,974.00"
05-Nov-2020,Cash,00.00,"225,194.80","900,779.20"
05-Nov-2020,Bill,00.00,"112,597.40","788,181.80"
05-Nov-2020,Debit Card,"32,366.53",00.00,"820,548.33"
05-Nov-2020,Transfer,00.00,"117,221.19","703,327.14"
05-Nov-2020,IMPS,00.00,"117,221.19","586,105.95"
05-Nov-2020,RTGS,"1,613,795.20",00.00,"2,199,901.15"
05-Nov-2020,Debit Card,04.60,00.00,"2,199,905.75"
05-Nov-2020,Cheque,00.00,"2,199,905.75",00.00
05-Nov-2020,Interest,"1,678,782.50",00.00,"1,678,782.50"
05-Nov-2020,Tax,00.00,"1,678,782.50",00.00
05-Nov-2020,Miscellaneous,05.33,00.00,05.33
05-Nov-2020,Transfer,97.16,00.00,102.49
05-Nov-2020,Miscellaneous,00.00,17.08,85.41
05-Nov-2020,Miscellaneous,395.44,00.00,480.85
05-Nov-2020,Cash,00.00,68.69,412.16
05-Nov-2020,IMPS,00.00,82.43,329.73
05-Nov-2020,Commission,"1,420,692.50",00.00,"1,421,022.23"
05-Nov-2020,Cheque,00.00,"177,627.78","1,243,394.45"
05-Nov-2020,Tax,00.00,"414,464.82","828,929.63"
05-Nov-2020,Commission,03.00,00.00,"828,932.63"
05-Nov-2020,Transfer,"463,087.50",00.00,"1,292,020.13"
05-Nov-2020,Reversal,00.00,"143,557.79","1,148,462.34"
05-Nov-2020,Purchase,00.00,"164,066.05","984,396.29"
05-Nov-2020,Bill,"15,185.95",00.00,"999,582.24"
05-Nov-2020,Commission,00.00,"99,958.22","899,624.02"
05-Nov-2020,Cash,"2,179.00",00.00,"901,803.02"
05-Nov-2020,Cheque,00.00,"112,725.38","789,077.64"
05-Nov-2020,Miscellaneous,00.00,"131,512.94","657,564.70"
05-Nov-2020,RTGS,60.80,00.00,"657,625.50"
05-Nov-2020,Bill,"77,467.00",00.00,"735,092.50"
05-Nov-2020,Miscellaneous,00.70,00.00,"735,093.20"
05-Nov-2020,Reversal,"63,688.30",00.00,"798,781.50"
05-Nov-2020,Bill,"3,356.40",00.00,"802,137.90"
05-Nov-2020,Tax,00.00,"267,379.30","534,758.60"
05-Nov-2020,Debit Card,00.00,"66,844.83","467,913.78"
05-Nov-2020,ATM,00.00,"93,582.76","374,331.02"
05-Nov-2020,Commission,00.00,"74,866.20","299,464.82"
05-Nov-2020,Tax,"19,309.90",00.00,"318,774.72"
05-Nov-2020,ATM,"27,915.00",00.00,"346,689.72"
05-Nov-2020,Bill,00.00,"346,689.72",00.00
05-Nov-2020,Transfer,34.90,00.00,34.90
05-Nov-2020,Transfer,00.00,34.90,00.00
05-Nov-2020,Transfer,07.00,00.00,07.00
05-Nov-2020,Bill,60.60,00.00,67.60
05-Nov-2020,Cash,"26,340.80",00.00,"26,408.40"
05-Nov-2020,Miscellaneous,00.00,"4,401.40","22,007.00"
06-Nov-2020,Debit Card,02.30,00.00,"22,009.30"
06-Nov-2020,Cash,"2,241.00",00.00,"24,250.30"
06-Nov-2020,NEFT,00.00,"3,031.29","21,219.01"
06-Nov-2020,Miscellaneous,21.00,00.00,"21,240.01"
06-Nov-2020,IMPS,05.31,00.00,"21,245.32"
06-Nov-2020,IMPS,00.00,"3,035.05","18,210.27"
06-Nov-2020,Cheque,00.00,"9,105.14","9,105.14"
07-Nov-2020,RTGS,00.00,"9,105.14",00.00
07-Nov-2020,Miscellaneous,"3,778.00",00.00,"3,778.00"
08-Nov-2020,ATM,"123,219.00",00.00,"126,997.00"
08-Nov-2020,Tax,00.00,"31,749.25","95,247.75"
08-Nov-2020,ATM,00.00,"11,905.97","83,341.78"
09-Nov-2020,Tax,00.00,"20,835.45","62,506.34"
09-Nov-2020,Transfer,00.00,"12,501.27","50,005.07"
09-Nov-2020,Miscellaneous,00.00,"5,000.51","45,004.56"
09-Nov-2020,Bill,00.00,"9,000.91","36,003.65"
09-Nov-2020,Reversal,35.80,00.00,"36,039.45"
09-Nov-2020,Debit Card,"3,779.18",00.00,"39,818.63"
10-Nov-2020,Transfer,00.00,"9,954.66","29,863.97"
10-Nov-2020,Bill,00.00,"29,863.97",00.00
10-Nov-2020,Cheque,"1,208.70",00.00,"1,208.70"
11-Nov-2020,NEFT,23.60,00.00,"1,232.30"
11-Nov-2020,ATM,00.00,"1,232.30",00.00
11-Nov-2020,Reversal,171.94,00.00,171.94
12-Nov-2020,Bill,00.00,57.31,114.63
12-Nov-2020,Purchase,01.80,00.00,116.43
12-Nov-2020,ATM,793.22,00.00,909.65
13-Nov-2020,RTGS,"19,661.30",00.00,"20,570.95"
14-Nov-2020,Commission,00.00,"3,428.49","17,142.46"
14-Nov-2020,ATM,02.00,00.00,"17,144.46"
14-Nov-2020,Purchase,02.00,00.00,"17,146.46"
14-Nov-2020,ATM,00.00,"4,286.62","12,859.84"
14-Nov-2020,Miscellaneous,00.00,"4,286.61","8,573.23"
14-Nov-2020,Debit Card,00.00,857.32,"7,715.91"
14-Nov-2020,IMPS,00.00,"1,543.18","6,172.73"
14-Nov-2020,ATM,"163,319.50",00.00,"169,492.23"
14-Nov-2020,IMPS,"3,923.87",00.00,"173,416.10"
14-Nov-2020,Debit Card,00.00,"57,805.37","115,610.73"
14-Nov-2020,Bill,"2,077,599.50",00.00,"2,193,210.23"
14-Nov-2020,Purchase,00.00,"365,535.04","1,827,675.19"
14-Nov-2020,Transfer,09.00,00.00,"1,827,684.19"
14-Nov-2020,Tax,00.00,"182,768.42","1,644,915.77"
14-Nov-2020,Commission,00.00,"164,491.58","1,480,424.19"
14-Nov-2020,RTGS,06.00,00.00,"1,480,430.19"
14-Nov-2020,IMPS,"198,550.50",00.00,"1,678,980.69"
14-Nov-2020,Cash,00.00,"167,898.07","1,511,082.62"
14-Nov-2020,RTGS,"2,497.00",00.00,"1,513,579.62"
14-Nov-2020,NEFT,00.00,"756,789.81","756,789.81"
14-Nov-2020,ATM,00.00,"94,598.73","662,191.08"
14-Nov-2020,RTGS,"8,633.80",00.00,"670,824.88"
14-Nov-2020,Cash,443.00,00.00,"671,267.88"
14-Nov-2020,NEFT,"4,353.03",00.00,"675,620.91"
14-Nov-2020,Commission,"89,861.25",00.00,"765,482.16"
14-Nov-2020,Miscellaneous,00.00,"765,482.16",00.00
14-Nov-2020,RTGS,"1,838,411.50",00.00,"1,838,411.50"
14-Nov-2020,Miscellaneous,"198,997.40",00.00,"2,037,408.90"
14-Nov-2020,Cheque,00.00,"203,740.89","1,833,668.01"
14-Nov-2020,Interest,00.00,"611,222.67","1,222,445.34"
14-Nov-2020,Miscellaneous,00.00,"244,489.07","977,956.27"
14-Nov-2020,Commission,00.00,"195,591.25","782,365.02"
14-Nov-2020,Cheque,195.63,00.00,"782,560.65"
14-Nov-2020,Tax,00.00,"195,640.16","586,920.49"
14-Nov-2020,Debit Card,00.00,"73,365.06","513,555.43"
14-Nov-2020,Cash,00.00,"513,555.43",00.00
14-Nov-2020,Purchase,"551,819.00",00.00,"551,819.00"
14-Nov-2020,ATM,00.00,"110,363.80","441,455.20"
14-Nov-2020,Tax,"972,444.50",00.00,"1,413,899.70"
14-Nov-2020,RTGS,00.00,"353,474.93","1,060,424.77"
14-Nov-2020,RTGS,406.16,00.00,"1,060,830.93"
14-Nov-2020,Reversal,348.00,00.00,"1,061,178.93"
14-Nov-2020,NEFT,00.00,"176,863.16","884,315.77"
14-Nov-2020,Interest,05.37,00.00,"884,321.14"
14-Nov-2020,Bill,00.00,"884,321.14",00.00
14-Nov-2020,Interest,334.92,00.00,334.92
14-Nov-2020,Miscellaneous,"20,491.80",00.00,"20,826.72"
14-Nov-2020,Transfer,"17,260.91",00.00,"38,087.63"
14-Nov-2020,Commission,381.00,00.00,"38,468.63"
14-Nov-2020,Cheque,"208,971.00",00.00,"247,439.63"
14-Nov-2020,Reversal,"20,386.00",00.00,"267,825.63"
14-Nov-2020,ATM,396.80,00.00,"268,222.43"
14-Nov-2020,Tax,"1,104.73",00.00,"269,327.16"
14-Nov-2020,Purchase,"32,395.00",00.00,"301,722.16"
14-Nov-2020,RTGS,00.70,00.00,"301,722.86"
15-Nov-2020,Cash,00.00,"37,715.36","264,007.50"
15-Nov-2020,Cheque,00.00,"37,715.36","226,292.14"
15-Nov-2020,Transfer,567.70,00.00,"226,859.84"
15-Nov-2020,NEFT,00.00,"28,357.48","198,502.36"
15-Nov-2020,RTGS,"159,688.41",00.00,"358,190.77"
15-Nov-2020,Cash,"27,192.70",00.00,"385,383.47"
15-Nov-2020,Reversal,00.00,"42,820.39","342,563.08"
15-Nov-2020,Debit Card,00.00,"114,187.69","228,375.39"
15-Nov-2020,Interest,00.00,"76,125.13","152,250.26"
15-Nov-2020,RTGS,01.50,00.00,"152,251.76"
15-Nov-2020,Tax,00.00,"152,251.76",00.00
15-Nov-2020,Transfer,76.90,00.00,76.90
15-Nov-2020,IMPS,00.00,19.23,57.68
15-Nov-2020,Bill,01.00,00.00,58.68
15-Nov-2020,RTGS,00.00,08.38,50.30
15-Nov-2020,Debit Card,"150,494.56",00.00,"150,544.86"
15-Nov-2020,Bill,00.00,"37,636.22","112,908.64"
15-Nov-2020,RTGS,00.00,"37,636.21","75,272.43"
15-Nov-2020,Cash,"24,771.65",00.00,"100,044.08"
15-Nov-2020,Reversal,00.00,"20,008.82","80,035.26"
15-Nov-2020,Commission,00.00,"16,007.05","64,028.21"
15-Nov-2020,Cash,"138,595.10",00.00,"202,623.31"
15-Nov-2020,Debit Card,00.00,"50,655.83","151,967.48"
15-Nov-2020,Reversal,00.00,"151,967.48",00.00
15-Nov-2020,Bill,05.20,00.00,05.20
15-Nov-2020,Reversal,00.00,05.20,00.00
15-Nov-2020,Bill,348.00,00.00,348.00
15-Nov-2020,Reversal,00.00,43.50,304.50
15-Nov-2020,NEFT,"2,406.66",00.00,"2,711.16"
15-Nov-2020,Cheque,00.00,"2,711.16",00.00
15-Nov-2020,Debit Card,59.40,00.00,59.40
15-Nov-2020,Transfer,"25,321.00",00.00,"25,380.40"
15-Nov-2020,Tax,00.00,"12,690.20","12,690.20"
15-Nov-2020,Purchase,"255,931.00",00.00,"268,621.20"
15-Nov-2020,Debit Card,00.00,"44,770.20","223,851.00"
15-Nov-2020,IMPS,00.00,"37,308.50","186,542.50"
15-Nov-2020,IMPS,05.09,00.00,"186,547.59"
15-Nov-2020,IMPS,00.00,"31,091.27","155,456.33"
16-Nov-2020,Interest,49.00,00.00,"155,505.33"
16-Nov-2020,RTGS,00.00,"155,505.33",00.00
16-Nov-2020,Debit Card,"27,636.00",00.00,"27,636.00"
16-Nov-2020,Commission,"22,735.20",00.00,"50,371.20"
16-Nov-2020,Miscellaneous,00.00,"16,790.40","33,580.80"
16-Nov-2020,Commission,46.70,00.00,"33,627.50"
16-Nov-2020,Interest,"18,528.00",00.00,"52,155.50"
16-Nov-2020,Transfer,00.00,"10,431.10","41,724.40"
16-Nov-2020,Bill,00.00,"8,344.88","33,379.52"
16-Nov-2020,Cash,268.96,00.00,"33,648.48"
16-Nov-2020,NEFT,00.00,"11,216.16","22,432.32"
16-Nov-2020,Debit Card,08.00,00.00,"22,440.32"
16-Nov-2020,IMPS,"1,864.03",00.00,"24,304.35"
16-Nov-2020,Debit Card,"21,454.62",00.00,"45,758.97"
16-Nov-2020,Bill,"10,650.60",00.00,"56,409.57"
16-Nov-2020,Debit Card,02.00,00.00,"56,411.57"
16-Nov-2020,Bill,"1,536,756.80",00.00,"1,593,168.37"
16-Nov-2020,NEFT,"61,346.50",00.00,"1,654,514.87"
16-Nov-2020,Miscellaneous,00.00,"165,451.49","1,489,063.38"
16-Nov-2020,ATM,00.00,"297,812.68","1,191,250.70"
16-Nov-2020,Commission,00.00,"297,812.68","893,438.02"
16-Nov-2020,ATM,00.00,"111,679.75","781,758.27"
16-Nov-2020,ATM,05.00,00.00,"781,763.27"
16-Nov-2020,Debit Card,00.00,"111,680.47","670,082.80"
16-Nov-2020,Transfer,00.00,"83,760.35","586,322.45"
16-Nov-2020,Interest,00.00,"83,760.35","502,562.10"
16-Nov-2020,Miscellaneous,00.00,"62,820.26","439,741.84"
17-Nov-2020,Transfer,00.00,"439,741.84",00.00
17-Nov-2020,Debit Card,475.10,00.00,475.10
18-Nov-2020,RTGS,00.00,59.39,415.71
18-Nov-2020,ATM,00.00,69.29,346.42
18-Nov-2020,Bill,00.00,38.49,307.93
19-Nov-2020,Transfer,00.00,34.21,273.72
19-Nov-2020,Tax,00.00,30.41,243.31
19-Nov-2020,Bill,"2,024,886.25",00.00,"2,025,129.56"
19-Nov-2020,Commission,"21,299.00",00.00,"2,046,428.56"
19-Nov-2020,IMPS,"21,204.31",00.00,"2,067,632.87"
19-Nov-2020,Cash,45.00,00.00,"2,067,677.87"
19-Nov-2020,Cash,"3,576.30",00.00,"2,071,254.17"
19-Nov-2020,Cash,"2,004.30",00.00,"2,073,258.47"
19-Nov-2020,IMPS,00.00,"414,651.69","1,658,606.78"
19-Nov-2020,NEFT,00.00,"1,658,606.78",00.00
19-Nov-2020,NEFT,"223,556.00",00.00,"223,556.00"
19-Nov-2020,Debit Card,00.00,"111,778.00","111,778.00"
19-Nov-2020,Bill,00.00,"13,972.25","97,805.75"
19-Nov-2020,Commission,381.56,00.00,"98,187.31"
19-Nov-2020,Commission,00.00,"16,364.55","81,822.76"
19-Nov-2020,Bill,00.00,"9,091.42","72,731.34"
19-Nov-2020,Miscellaneous,00.00,"10,390.19","62,341.15"
20-Nov-2020,Miscellaneous,"1,121.00",00.00,"63,462.15"
20-Nov-2020,Interest,00.00,"63,462.15",00.00
20-Nov-2020,Bill,336.00,00.00,336.00
20-Nov-2020,RTGS,"2,657.80",00.00,"2,993.80"
20-Nov-2020,Tax,"1,607.00",00.00,"4,600.80"
20-Nov-2020,Interest,51.30,00.00,"4,652.10"
20-Nov-2020,Bill,500.44,00.00,"5,152.54"
20-Nov-2020,Reversal,975.00,00.00,"6,127.54"
20-Nov-2020,Cash,35.00,00.00,"6,162.54"
20-Nov-2020,Reversal,00.00,"1,027.09","5,135.45"
20-Nov-2020,NEFT,00.00,733.64,"4,401.81"
20-Nov-2020,Commission,"2,619.00",00.00,"7,020.81"
20-Nov-2020,Cash,00.00,"1,755.20","5,265.61"
20-Nov-2020,Reversal,901.00,00.00,"6,166.61"
20-Nov-2020,Miscellaneous,00.00,"1,027.77","5,138.84"
20-Nov-2020,Purchase,"2,895.50",00.00,"8,034.34"
20-Nov-2020,Purchase,"492,070.00",00.00,"500,104.34"
20-Nov-2020,Miscellaneous,183.40,00.00,"500,287.74"
20-Nov-2020,NEFT,06.50,00.00,"500,294.24"
20-Nov-2020,RTGS,00.00,"50,029.42","450,264.82"
20-Nov-2020,RTGS,05.00,00.00,"450,269.82"
20-Nov-2020,Transfer,00.00,"75,044.97","375,224.85"
20-Nov-2020,Purchase,00.00,"46,903.11","328,321.74"
20-Nov-2020,Purchase,00.00,"54,720.29","273,601.45"
20-Nov-2020,RTGS,"249,087.56",00.00,"522,689.01"
20-Nov-2020,IMPS,"243,862.53",00.00,"766,551.54"
20-Nov-2020,NEFT,00.00,"766,551.54",00.00
20-Nov-2020,Commission,04.40,00.00,04.40
20-Nov-2020,Tax,266.40,00.00,270.80
20-Nov-2020,Debit Card,00.00,33.85,236.95
20-Nov-2020,Purchase,00.00,78.98,157.97
20-Nov-2020,Commission,"23,133.00",00.00,"23,290.97"
20-Nov-2020,Tax,00.00,"3,881.83","19,409.14"
20-Nov-2020,Commission,56.98,00.00,"19,466.12"
20-Nov-2020,Commission,00.00,"3,893.22","15,572.90"
20-Nov-2020,IMPS,959.40,00.00,"16,532.30"
20-Nov-2020,Transfer,"12,887.71",00.00,"29,420.01"
20-Nov-2020,Bill,00.00,"14,710.01","14,710.00"
20-Nov-2020,ATM,00.00,"1,838.75","12,871.25"
20-Nov-2020,Purchase,01.08,00.00,"12,872.33"
20-Nov-2020,Interest,00.00,"6,436.17","6,436.16"
20-Nov-2020,NEFT,00.00,"3,218.08","3,218.08"
20-Nov-2020,Miscellaneous,"1,094,242.00",00.00,"1,097,460.08"
20-Nov-2020,Interest,00.00,"137,182.51","960,277.57"
20-Nov-2020,Reversal,00.00,"960,277.57",00.00
20-Nov-2020,Cheque,02.20,00.00,02.20
20-Nov-2020,Debit Card,00.00,00.73,01.47
20-Nov-2020,Transfer,"416,048.75",00.00,"416,050.22"
20-Nov-2020,Interest,00.40,00.00,"416,050.62"
20-Nov-2020,Miscellaneous,00.00,"52,006.33","364,044.29"
20-Nov-2020,Miscellaneous,467.40,00.00,"364,511.69"
20-Nov-2020,Debit Card,00.00,"364,511.69",00.00
20-Nov-2020,Interest,"102,931.00",00.00,"102,931.00"
20-Nov-2020,IMPS,00.00,"11,436.78","91,494.22"
20-Nov-2020,NEFT,01.84,00.00,"91,496.06"
20-Nov-2020,Reversal,00.00,"18,299.21","73,196.85"
20-Nov-2020,Tax,00.00,"7,319.69","65,877.17"
20-Nov-2020,ATM,00.00,"21,959.06","43,918.11"
20-Nov-2020,NEFT,00.00,"7,319.69","36,598.43"
20-Nov-2020,Interest,"501,066.00",00.00,"537,664.43"
20-Nov-2020,Cash,00.00,"67,208.05","470,456.38"
20-Nov-2020,Cash,00.00,"52,272.93","418,183.45"
20-Nov-2020,Tax,"162,425.00",00.00,"580,608.45"
20-Nov-2020,Cheque,06.20,00.00,"580,614.65"
20-Nov-2020,Cheque,"2,447.00",00.00,"583,061.65"
20-Nov-2020,Reversal,00.00,"583,061.65",00.00
20-Nov-2020,Bill,"2,280.88",00.00,"2,280.88"
20-Nov-2020,Cheque,454.00,00.00,"2,734.88"
20-Nov-2020,Miscellaneous,264.30,00.00,"2,999.18"
20-Nov-2020,Bill,00.00,499.86,"2,499.32"
20-Nov-2020,Tax,00.00,357.05,"2,142.27"
20-Nov-2020,Tax,00.00,"1,071.14","1,071.14"
20-Nov-2020,Bill,00.00,535.57,535.57
20-Nov-2020,Commission,00.00,178.52,357.05
20-Nov-2020,Miscellaneous,"829,754.00",00.00,"830,111.05"
20-Nov-2020,Reversal,00.00,"118,587.29","711,523.76"
20-Nov-2020,Bill,00.00,"142,304.75","569,219.01"
20-Nov-2020,Bill,"1,071,163.00",00.00,"1,640,382.01"
20-Nov-2020,Miscellaneous,00.00,"164,038.20","1,476,343.81"
20-Nov-2020,Debit Card,19.71,00.00,"1,476,363.52"
20-Nov-2020,Cheque,00.00,"1,476,363.52",00.00
20-Nov-2020,NEFT,61.12,00.00,61.12
21-Nov-2020,Purchase,00.00,07.64,53.48
21-Nov-2020,Debit Card,00.00,10.70,42.78
21-Nov-2020,Transfer,00.00,06.11,36.67
21-Nov-2020,Debit Card,00.00,07.33,29.34
21-Nov-2020,NEFT,00.00,09.78,19.56
21-Nov-2020,Cheque,"233,537.84",00.00,"233,557.40"
21-Nov-2020,Commission,06.00,00.00,"233,563.40"
21-Nov-2020,Tax,00.00,"46,712.68","186,850.72"
21-Nov-2020,Reversal,228.70,00.00,"187,079.42"
21-Nov-2020,ATM,"18,330.00",00.00,"205,409.42"
21-Nov-2020,Reversal,00.00,"102,704.71","102,704.71"
21-Nov-2020,NEFT,"1,754.51",00.00,"104,459.22"
21-Nov-2020,Commission,689.20,00.00,"105,148.42"
21-Nov-2020,Cash,00.00,"17,524.74","87,623.68"
21-Nov-2020,Cheque,00.00,"43,811.84","43,811.84"
21-Nov-2020,Tax,00.00,"8,762.37","35,049.47"
21-Nov-2020,Tax,00.00,"4,381.18","30,668.29"
21-Nov-2020,Purchase,02.86,00.00,"30,671.15"
21-Nov-2020,ATM,261.80,00.00,"30,932.95"
21-Nov-2020,Cash,00.00,"4,418.99","26,513.96"
21-Nov-2020,Reversal,"955,527.00",00.00,"982,040.96"
21-Nov-2020,Debit Card,"337,690.80",00.00,"1,319,731.76"
21-Nov-2020,Bill,228.00,00.00,"1,319,959.76"
21-Nov-2020,IMPS,00.00,"164,994.97","1,154,964.79"
22-Nov-2020,Reversal,"67,602.00",00.00,"1,222,566.79"
22-Nov-2020,Reversal,00.00,"203,761.13","1,018,805.66"
22-Nov-2020,Cash,"131,030.00",00.00,"1,149,835.66"
22-Nov-2020,Debit Card,00.00,"164,262.24","985,573.42"
22-Nov-2020,Cheque,81.83,00.00,"985,655.25"
22-Nov-2020,Commission,500.00,00.00,"986,155.25"
22-Nov-2020,IMPS,57.50,00.00,"986,212.75"
22-Nov-2020,Interest,"1,382,422.20",00.00,"2,368,634.95"
22-Nov-2020,Commission,00.00,"236,863.50","2,131,771.46"
22-Nov-2020,ATM,"278,899.80",00.00,"2,410,671.26"
22-Nov-2020,Transfer,00.00,"2,410,671.26",00.00
22-Nov-2020,Debit Card,14.43,00.00,14.43
22-Nov-2020,NEFT,00.00,02.41,12.02
22-Nov-2020,Miscellaneous,305.40,00.00,317.42
22-Nov-2020,RTGS,"4,708.07",00.00,"5,025.49"
22-Nov-2020,Cash,00.00,"1,005.10","4,020.39"
22-Nov-2020,Reversal,00.00,804.08,"3,216.31"
22-Nov-2020,Reversal,"68,079.22",00.00,"71,295.53"
22-Nov-2020,Interest,00.00,"14,259.11","57,036.42"
23-Nov-2020,Bill,21.00,00.00,"57,057.42"
23-Nov-2020,Bill,00.00,"19,019.14","38,038.28"
23-Nov-2020,Purchase,"1,767,788.80",00.00,"1,805,827.08"
23-Nov-2020,NEFT,00.30,00.00,"1,805,827.38"
23-Nov-2020,Cheque,05.53,00.00,"1,805,832.91"
23-Nov-2020,Commission,00.00,"225,729.11","1,580,103.80"
23-Nov-2020,Cash,25.00,00.00,"1,580,128.80"
23-Nov-2020,Bill,"4,207.80",00.00,"1,584,336.60"
23-Nov-2020,Reversal,00.00,"528,112.20","1,056,224.40"
23-Nov-2020,Cash,00.00,"105,622.44","950,601.96"
23-Nov-2020,Bill,00.00,"118,825.25","831,776.72"
23-Nov-2020,Bill,00.00,"118,825.25","712,951.47"
23-Nov-2020,Purchase,03.10,00.00,"712,954.57"
24-Nov-2020,Bill,"380,650.00",00.00,"1,093,604.57"
25-Nov-2020,Cash,00.00,"364,534.86","729,069.71"
25-Nov-2020,Transfer,00.00,"81,007.75","648,061.96"
25-Nov-2020,Cash,"2,083.70",00.00,"650,145.66"
25-Nov-2020,NEFT,00.00,"81,268.21","568,877.45"
25-Nov-2020,Bill,"25,054.00",00.00,"593,931.45"
25-Nov-2020,NEFT,"13,998.10",00.00,"607,929.55"
25-Nov-2020,Debit Card,"1,329,326.20",00.00,"1,937,255.75"
26-Nov-2020,RTGS,00.00,"387,451.15","1,549,804.60"
26-Nov-2020,Cheque,00.00,"193,725.58","1,356,079.02"
26-Nov-2020,RTGS,00.00,"226,013.17","1,130,065.85"
26-Nov-2020,Debit Card,06.80,00.00,"1,130,072.65"
26-Nov-2020,Cheque,00.00,"113,007.27","1,017,065.38"
26-Nov-2020,ATM,02.71,00.00,"1,017,068.09"
26-Nov-2020,Cash,00.00,"113,007.57","904,060.52"
26-Nov-2020,NEFT,00.00,"100,451.17","803,609.35"
26-Nov-2020,Miscellaneous,00.00,"160,721.87","642,887.48"
26-Nov-2020,Purchase,46.04,00.00,"642,933.52"
26-Nov-2020,Interest,00.00,"128,586.70","514,346.82"
26-Nov-2020,Debit Card,00.00,"171,448.94","342,897.88"
26-Nov-2020,Reversal,00.00,"342,897.88",00.00
26-Nov-2020,NEFT,"704,388.80",00.00,"704,388.80"
26-Nov-2020,Purchase,"3,770.85",00.00,"708,159.65"
26-Nov-2020,Bill,"19,071.90",00.00,"727,231.55"
26-Nov-2020,Interest,00.00,"181,807.89","545,423.66"
26-Nov-2020,Cash,"24,556.00",00.00,"569,979.66"
26-Nov-2020,Reversal,"3,853.20",00.00,"573,832.86"
26-Nov-2020,Bill,00.00,"573,832.86",00.00
26-Nov-2020,Debit Card,"1,822,775.00",00.00,"1,822,775.00"
26-Nov-2020,Reversal,"3,407.65",00.00,"1,826,182.65"
26-Nov-2020,NEFT,05.00,00.00,"1,826,187.65"
26-Nov-2020,ATM,"211,308.00",00.00,"2,037,495.65"
26-Nov-2020,Commission,303.90,00.00,"2,037,799.55"
26-Nov-2020,Cash,26.40,00.00,"2,037,825.95"
27-Nov-2020,ATM,"448,867.50",00.00,"2,486,693.45"
27-Nov-2020,NEFT,"202,592.00",00.00,"2,689,285.45"
27-Nov-2020,IMPS,"953,581.00",00.00,"3,642,866.45"
27-Nov-2020,Cash,09.64,00.00,"3,642,876.09"
27-Nov-2020,Purchase,"1,468.90",00.00,"3,644,344.99"
27-Nov-2020,Debit Card,"1,319,238.00",00.00,"4,963,582.99"
28-Nov-2020,Cash,"1,763,768.00",00.00,"6,727,350.99"
28-Nov-2020,RTGS,990.60,00.00,"6,728,341.59"
28-Nov-2020,ATM,"1,543,674.00",00.00,"8,272,015.59"
28-Nov-2020,Reversal,00.00,"8,272,015.59",00.00
28-Nov-2020,Cash,"24,580.00",00.00,"24,580.00"
28-Nov-2020,Bill,07.00,00.00,"24,587.00"
28-Nov-2020,RTGS,"1,524,148.50",00.00,"1,548,735.50"
28-Nov-2020,Miscellaneous,04.00,00.00,"1,548,739.50"
28-Nov-2020,Miscellaneous,30.00,00.00,"1,548,769.50"
28-Nov-2020,Transfer,"209,717.22",00.00,"1,758,486.72"
29-Nov-2020,Tax,"3,744.53",00.00,"1,762,231.25"
29-Nov-2020,RTGS,"1,615.24",00.00,"1,763,846.49"
29-Nov-2020,Cash,"690,649.00",00.00,"2,454,495.49"
29-Nov-2020,NEFT,"1,682,844.80",00.00,"4,137,340.29"
29-Nov-2020,Purchase,300.00,00.00,"4,137,640.29"
29-Nov-2020,ATM,00.00,"459,737.81","3,677,902.48"
29-Nov-2020,NEFT,00.00,"1,225,967.49","2,451,934.99"
29-Nov-2020,Cash,00.00,"1,225,967.50","1,225,967.50"
29-Nov-2020,Interest,00.00,"408,655.83","817,311.67"
29-Nov-2020,RTGS,"241,407.00",00.00,"1,058,718.67"
29-Nov-2020,Interest,"3,909.03",00.00,"1,062,627.70"
29-Nov-2020,Bill,00.00,"1,062,627.70",00.00
29-Nov-2020,Cash,158.40,00.00,158.40
30-Nov-2020,Transfer,414.00,00.00,572.40
30-Nov-2020,NEFT,00.00,572.40,00.00
30-Nov-2020,RTGS,"27,668.80",00.00,"27,668.80"
30-Nov-2020,Bill,"13,450.93",00.00,"41,119.73"
30-Nov-2020,Cash,13.68,00.00,"41,133.41"
30-Nov-2020,Transfer,00.00,"41,133.41",00.00
30-Nov-2020,Miscellaneous,"29,006.64",00.00,"29,006.64"
30-Nov-2020,Miscellaneous,00.00,"5,801.33","23,205.31"
30-Nov-2020,Purchase,"103,484.00",00.00,"126,689.31"
30-Nov-2020,ATM,00.00,"12,668.93","114,020.38"
30-Nov-2020,ATM,392.90,00.00,"114,413.28"
30-Nov-2020,Reversal,00.00,"22,882.66","91,530.62"
30-Nov-2020,Cheque,00.00,"13,075.80","78,454.82"
30-Nov-2020,Transfer,00.00,"9,806.85","68,647.97"
30-Nov-2020,Miscellaneous,00.00,"6,864.80","61,783.17"
30-Nov-2020,IMPS,00.00,"12,356.63","49,426.54"
30-Nov-2020,Debit Card,00.00,"49,426.54",00.00
30-Nov-2020,Purchase,"31,772.10",00.00,"31,772.10"
30-Nov-2020,Reversal,00.00,"15,886.05","15,886.05"
30-Nov-2020,NEFT,"1,146,472.00",00.00,"1,162,358.05"
30-Nov-2020,Purchase,"11,789.60",00.00,"1,174,147.65"
30-Nov-2020,Reversal,00.00,"130,460.85","1,043,686.80"
30-Nov-2020,RTGS,00.00,"104,368.68","939,318.12"
30-Nov-2020,Cheque,49.77,00.00,"939,367.89"
30-Nov-2020,Bill,02.00,00.00,"939,369.89"
30-Nov-2020,Cheque,00.00,"313,123.30","626,246.59"
30-Nov-2020,Transfer,26.32,00.00,"626,272.91"
30-Nov-2020,Miscellaneous,00.00,"208,757.64","417,515.27"
30-Nov-2020,ATM,"127,538.00",00.00,"545,053.27"
30-Nov-2020,Transfer,00.00,"54,505.33","490,547.94"
30-Nov-2020,Bill,00.00,"245,273.97","245,273.97"
30-Nov-2020,Interest,342.00,00.00,"245,615.97"
30-Nov-2020,Commission,00.00,"122,807.99","122,807.98"
30-Nov-2020,Interest,01.60,00.00,"122,809.58"
30-Nov-2020,Cash,00.00,"40,936.53","81,873.05"
30-Nov-2020,Cheque,11.00,00.00,"81,884.05"
30-Nov-2020,Bill,"152,390.40",00.00,"234,274.45"
30-Nov-2020,Miscellaneous,"5,746.50",00.00,"240,020.95"
30-Nov-2020,Reversal,"23,543.01",00.00,"263,563.96"
30-Nov-2020,NEFT,00.00,"52,712.79","210,851.17"
30-Nov-2020,Transfer,00.00,"30,121.60","180,729.57"
30-Nov-2020,Interest,00.00,"30,121.60","150,607.98"
30-Nov-2020,Miscellaneous,00.00,"21,515.43","129,092.55"
30-Nov-2020,NEFT,00.00,"32,273.14","96,819.41"
30-Nov-2020,RTGS,208.00,00.00,"97,027.41"
30-Nov-2020,Bill,06.30,00.00,"97,033.71"
30-Nov-2020,Reversal,00.00,"32,344.57","64,689.14"
30-Nov-2020,Commission,00.00,"9,241.31","55,447.83"
30-Nov-2020,Tax,00.00,"18,482.61","36,965.22"
30-Nov-2020,Purchase,"18,236.00",00.00,"55,201.22"
30-Nov-2020,Transfer,06.90,00.00,"55,208.12"
30-Nov-2020,IMPS,00.00,"27,604.06","27,604.06"
30-Nov-2020,Transfer,00.00,"2,760.41","24,843.65"
30-Nov-2020,Cheque,"721,289.00",00.00,"746,132.65"
30-Nov-2020,Cash,00.00,"106,590.38","639,542.27"
30-Nov-2020,Commission,00.00,"213,180.76","426,361.51"
30-Nov-2020,Cash,"2,574.90",00.00,"428,936.41"
30-Nov-2020,Miscellaneous,00.00,"428,936.41",00.00
30-Nov-2020,Cheque,"57,228.00",00.00,"57,228.00"
30-Nov-2020,NEFT,00.00,"6,358.67","50,869.33"
30-Nov-2020,Purchase,"17,740.58",00.00,"68,609.91"
30-Nov-2020,Tax,"2,586.90",00.00,"71,196.81"
30-Nov-2020,Tax,00.00,"7,119.68","64,077.13"
30-Nov-2020,Transfer,00.00,"21,359.04","42,718.09"
30-Nov-2020,NEFT,"1,181,480.20",00.00,"1,224,198.29"
30-Nov-2020,Miscellaneous,00.00,"122,419.83","1,101,778.46"
01-Dec-2020,Miscellaneous,00.00,"220,355.69","881,422.77"
01-Dec-2020,IMPS,118.80,00.00,"881,541.57"
01-Dec-2020,Purchase,00.00,"125,934.51","755,607.06"
01-Dec-2020,Cheque,00.00,"107,943.87","647,663.19"
01-Dec-2020,Cheque,00.00,"129,532.64","518,130.55"
01-Dec-2020,ATM,"19,101.00",00.00,"537,231.55"
01-Dec-2020,Cash,00.00,"179,077.18","358,154.37"
01-Dec-2020,Tax,00.00,"119,384.79","238,769.58"
01-Dec-2020,Purchase,00.00,"39,794.93","198,974.65"
01-Dec-2020,ATM,"1,384.00",00.00,"200,358.65"
01-Dec-2020,Reversal,00.00,"20,035.87","180,322.78"
01-Dec-2020,Transfer,00.00,"20,035.86","160,286.92"
01-Dec-2020,ATM,"21,834.50",00.00,"182,121.42"
01-Dec-2020,Bill,18.08,00.00,"182,139.50"
01-Dec-2020,NEFT,"10,030.53",00.00,"192,170.03"
01-Dec-2020,Tax,234.36,00.00,"192,404.39"
01-Dec-2020,Debit Card,45.41,00.00,"192,449.80"
01-Dec-2020,Purchase,00.00,"48,112.45","144,337.35"
01-Dec-2020,Tax,00.00,"20,619.62","123,717.73"
01-Dec-2020,Interest,"18,789.52",00.00,"142,507.25"
01-Dec-2020,Miscellaneous,00.00,"23,751.21","118,756.04"
01-Dec-2020,Bill,00.00,"14,844.51","103,911.53"
01-Dec-2020,Purchase,00.00,"14,844.50","89,067.03"
01-Dec-2020,Tax,04.00,00.00,"89,071.03"
01-Dec-2020,IMPS,"1,404.00",00.00,"90,475.03"
01-Dec-2020,Cash,"208,406.00",00.00,"298,881.03"
01-Dec-2020,ATM,00.00,"33,209.00","265,672.03"
01-Dec-2020,RTGS,00.00,"33,209.00","232,463.03"
01-Dec-2020,Purchase,"225,195.00",00.00,"457,658.03"
01-Dec-2020,Miscellaneous,00.00,"76,276.34","381,381.69"
01-Dec-2020,ATM,"3,338.88",00.00,"384,720.57"
01-Dec-2020,Bill,56.00,00.00,"384,776.57"
01-Dec-2020,Commission,00.00,"192,388.29","192,388.28"
01-Dec-2020,ATM,"93,656.00",00.00,"286,044.28"
01-Dec-2020,Transfer,00.00,"286,044.28",00.00
01-Dec-2020,Miscellaneous,"10,545.20",00.00,"10,545.20"
01-Dec-2020,ATM,00.00,"1,506.46","9,038.74"
01-Dec-2020,Purchase,60.20,00.00,"9,098.94"
01-Dec-2020,Cash,00.00,"1,010.99","8,087.95"
01-Dec-2020,Commission,00.00,808.80,"7,279.16"
01-Dec-2020,Bill,68.30,00.00,"7,347.46"
01-Dec-2020,IMPS,00.30,00.00,"7,347.76"
01-Dec-2020,Transfer,12.00,00.00,"7,359.76"
01-Dec-2020,Miscellaneous,00.00,"1,051.39","6,308.37"
01-Dec-2020,Tax,53.68,00.00,"6,362.05"
01-Dec-2020,RTGS,00.00,636.21,"5,725.84"
01-Dec-2020,Tax,63.20,00.00,"5,789.04"
01-Dec-2020,Bill,00.00,827.01,"4,962.03"
01-Dec-2020,Transfer,00.00,992.41,"3,969.62"
01-Dec-2020,Tax,26.40,00.00,"3,996.02"
01-Dec-2020,ATM,00.00,"1,998.01","1,998.01"
01-Dec-2020,Bill,"9,316.89",00.00,"11,314.90"
01-Dec-2020,Reversal,00.00,"2,262.98","9,051.92"
01-Dec-2020,ATM,00.00,"9,051.92",00.00
01-Dec-2020,Tax,496.90,00.00,496.90
01-Dec-2020,Reversal,"5,474.06",00.00,"5,970.96"
02-Dec-2020,Purchase,273.70,00.00,"6,244.66"
02-Dec-2020,ATM,00.00,693.85,"5,550.81"
02-Dec-2020,Miscellaneous,00.00,"2,775.41","2,775.40"
02-Dec-2020,ATM,00.00,277.54,"2,497.86"
02-Dec-2020,Reversal,04.00,00.00,"2,501.86"
02-Dec-2020,Cash,00.00,625.47,"1,876.40"
02-Dec-2020,IMPS,00.00,268.06,"1,608.34"
02-Dec-2020,Purchase,"221,183.20",00.00,"222,791.54"
02-Dec-2020,Reversal,"3,878.34",00.00,"226,669.88"
02-Dec-2020,NEFT,00.00,"75,556.63","151,113.25"
02-Dec-2020,Commission,"1,561,851.20",00.00,"1,712,964.45"
02-Dec-2020,RTGS,"210,948.60",00.00,"1,923,913.05"
02-Dec-2020,Cheque,00.00,"480,978.26","1,442,934.79"
02-Dec-2020,Transfer,00.00,"360,733.70","1,082,201.09"
02-Dec-2020,Commission,01.00,00.00,"1,082,202.09"
02-Dec-2020,Commission,"798,192.00",00.00,"1,880,394.09"
02-Dec-2020,Cheque,00.00,"940,197.05","940,197.04"
02-Dec-2020,RTGS,00.00,"313,399.01","626,798.03"
02-Dec-2020,Bill,05.90,00.00,"626,803.93"
02-Dec-2020,Debit Card,19.00,00.00,"626,822.93"
02-Dec-2020,Cheque,00.00,"104,470.49","522,352.44"
02-Dec-2020,Debit Card,00.00,"87,058.74","435,293.70"
02-Dec-2020,Tax,00.00,"48,365.97","386,927.73"
02-Dec-2020,ATM,356.15,00.00,"387,283.88"
02-Dec-2020,Cash,00.00,"48,410.49","338,873.40"
02-Dec-2020,RTGS,07.40,00.00,"338,880.80"
02-Dec-2020,Cash,07.60,00.00,"338,888.40"
02-Dec-2020,Cash,00.00,"112,962.80","225,925.60"
02-Dec-2020,Commission,00.00,"22,592.56","203,333.04"
02-Dec-2020,NEFT,00.00,"22,592.56","180,740.48"
02-Dec-2020,Purchase,00.00,"36,148.10","144,592.38"
02-Dec-2020,RTGS,"2,006,364.00",00.00,"2,150,956.38"
02-Dec-2020,IMPS,00.00,"358,492.73","1,792,463.65"
02-Dec-2020,IMPS,"3,547.70",00.00,"1,796,011.35"
02-Dec-2020,Purchase,00.00,"898,005.68","898,005.68"
02-Dec-2020,Bill,00.00,"449,002.84","449,002.84"
02-Dec-2020,RTGS,"1,492,954.75",00.00,"1,941,957.59"
02-Dec-2020,Transfer,"721,560.50",00.00,"2,663,518.09"
02-Dec-2020,IMPS,"26,795.80",00.00,"2,690,313.89"
02-Dec-2020,RTGS,"2,383.41",00.00,"2,692,697.30"
02-Dec-2020,Interest,"155,309.75",00.00,"2,848,007.05"
02-Dec-2020,RTGS,00.00,"356,000.88","2,492,006.17"
02-Dec-2020,Bill,"669,843.00",00.00,"3,161,849.17"
02-Dec-2020,IMPS,"234,368.00",00.00,"3,396,217.17"
02-Dec-2020,IMPS,00.00,"3,396,217.17",00.00
02-Dec-2020,IMPS,"874,478.00",00.00,"874,478.00"
02-Dec-2020,IMPS,00.00,"874,478.00",00.00
02-Dec-2020,Bill,"62,681.00",00.00,"62,681.00"
02-Dec-2020,Purchase,173.64,00.00,"62,854.64"
02-Dec-2020,NEFT,"173,889.00",00.00,"236,743.64"
02-Dec-2020,Cash,"108,663.20",00.00,"345,406.84"
02-Dec-2020,Cash,"2,902.00",00.00,"348,308.84"
02-Dec-2020,Cheque,00.00,"58,051.47","290,257.37"
02-Dec-2020,Cash,00.00,"41,465.34","248,792.03"
02-Dec-2020,Transfer,00.00,"41,465.34","207,326.69"
02-Dec-2020,ATM,00.00,"23,036.30","184,290.39"
02-Dec-2020,Transfer,"1,128,505.75",00.00,"1,312,796.14"
02-Dec-2020,Tax,"2,980.60",00.00,"1,315,776.74"
02-Dec-2020,Transfer,28.10,00.00,"1,315,804.84"
02-Dec-2020,Transfer,01.20,00.00,"1,315,806.04"
02-Dec-2020,Tax,00.00,"1,315,806.04",00.00
02-Dec-2020,Bill,"30,008.41",00.00,"30,008.41"
02-Dec-2020,Miscellaneous,"29,312.54",00.00,"59,320.95"
02-Dec-2020,Cheque,00.00,"9,886.83","49,434.12"
02-Dec-2020,Bill,"31,511.97",00.00,"80,946.09"
02-Dec-2020,Bill,00.00,"16,189.22","64,756.87"
02-Dec-2020,Commission,334.60,00.00,"65,091.47"
02-Dec-2020,Cash,00.00,"65,091.47",00.00
02-Dec-2020,Cheque,05.00,00.00,05.00
02-Dec-2020,Bill,02.42,00.00,07.42
02-Dec-2020,Debit Card,"17,969.00",00.00,"17,976.42"
02-Dec-2020,ATM,06.66,00.00,"17,983.08"
02-Dec-2020,ATM,"25,711.10",00.00,"43,694.18"
02-Dec-2020,Cash,00.00,"7,282.36","36,411.82"
02-Dec-2020,ATM,00.00,"6,068.64","30,343.18"
02-Dec-2020,NEFT,00.00,"7,585.80","22,757.38"
02-Dec-2020,Reversal,00.00,"3,251.05","19,506.33"
02-Dec-2020,IMPS,"5,625.10",00.00,"25,131.43"
03-Dec-2020,Interest,00.00,"12,565.72","12,565.72"
03-Dec-2020,Interest,00.00,"4,188.57","8,377.15"
03-Dec-2020,Commission,00.00,"1,675.43","6,701.72"
04-Dec-2020,Bill,00.00,"6,701.72",00.00
04-Dec-2020,ATM,487.60,00.00,487.60
04-Dec-2020,Cash,00.00,97.52,390.08
04-Dec-2020,Purchase,36.65,00.00,426.73
04-Dec-2020,Miscellaneous,"33,668.00",00.00,"34,094.73"
04-Dec-2020,IMPS,"2,393.90",00.00,"36,488.63"
04-Dec-2020,NEFT,00.00,"4,054.29","32,434.34"
04-Dec-2020,Purchase,"13,349.30",00.00,"45,783.64"
04-Dec-2020,Transfer,00.00,"15,261.21","30,522.43"
04-Dec-2020,Commission,"1,698,039.20",00.00,"1,728,561.63"
04-Dec-2020,Transfer,"1,689,793.00",00.00,"3,418,354.63"
04-Dec-2020,Transfer,00.00,"854,588.66","2,563,765.97"
04-Dec-2020,Miscellaneous,15.00,00.00,"2,563,780.97"
04-Dec-2020,Purchase,00.00,"256,378.10","2,307,402.87"
04-Dec-2020,RTGS,"3,120.00",00.00,"2,310,522.87"
04-Dec-2020,Cheque,00.10,00.00,"2,310,522.97"
04-Dec-2020,Tax,"111,553.70",00.00,"2,422,076.67"
04-Dec-2020,IMPS,00.00,"484,415.33","1,937,661.34"
04-Dec-2020,IMPS,"9,211.86",00.00,"1,946,873.20"
04-Dec-2020,RTGS,"31,488.17",00.00,"1,978,361.37"
05-Dec-2020,Reversal,00.00,"197,836.14","1,780,525.23"
05-Dec-2020,NEFT,01.22,00.00,"1,780,526.45"
05-Dec-2020,IMPS,22.20,00.00,"1,780,548.65"
05-Dec-2020,Cheque,00.40,00.00,"1,780,549.05"
05-Dec-2020,Reversal,00.00,"356,109.81","1,424,439.24"
05-Dec-2020,IMPS,00.00,"474,813.08","949,626.16"
05-Dec-2020,Cheque,00.00,"105,514.02","844,112.14"
05-Dec-2020,NEFT,00.00,"105,514.02","738,598.12"
05-Dec-2020,Interest,00.00,"184,649.53","553,948.59"
05-Dec-2020,Commission,00.00,"138,487.15","415,461.44"
06-Dec-2020,Debit Card,00.00,"103,865.36","311,596.08"
06-Dec-2020,Bill,00.00,"77,899.02","233,697.06"
06-Dec-2020,ATM,00.00,"77,899.02","155,798.04"
06-Dec-2020,Interest,00.00,"77,899.02","77,899.02"
06-Dec-2020,Transfer,00.00,"7,789.90","70,109.12"
06-Dec-2020,Cheque,00.00,"17,527.28","52,581.84"
06-Dec-2020,Bill,44.28,00.00,"52,626.12"
06-Dec-2020,Purchase,00.00,"5,847.35","46,778.77"
06-Dec-2020,NEFT,287.20,00.00,"47,065.97"
07-Dec-2020,Reversal,00.00,"23,532.99","23,532.98"
07-Dec-2020,IMPS,00.00,"11,766.49","11,766.49"
08-Dec-2020,RTGS,00.00,"1,176.65","10,589.84"
08-Dec-2020,NEFT,08.00,00.00,"10,597.84"
08-Dec-2020,Interest,37.00,00.00,"10,634.84"
08-Dec-2020,Transfer,470.70,00.00,"11,105.54"
08-Dec-2020,ATM,00.00,"2,221.11","8,884.43"
08-Dec-2020,RTGS,00.00,"2,961.48","5,922.95"
08-Dec-2020,RTGS,00.00,592.30,"5,330.66"
08-Dec-2020,Cash,"2,102.70",00.00,"7,433.36"
08-Dec-2020,Transfer,74.29,00.00,"7,507.65"
08-Dec-2020,ATM,00.00,938.46,"6,569.19"
08-Dec-2020,Cash,00.00,"1,313.84","5,255.35"
08-Dec-2020,Bill,60.00,00.00,"5,315.35"
08-Dec-2020,Tax,06.60,00.00,"5,321.95"
08-Dec-2020,Commission,"28,589.00",00.00,"33,910.95"
08-Dec-2020,Cheque,240.90,00.00,"34,151.85"
09-Dec-2020,Tax,"265,595.50",00.00,"299,747.35"
09-Dec-2020,Commission,00.00,"149,873.68","149,873.67"
09-Dec-2020,Cash,02.40,00.00,"149,876.07"
09-Dec-2020,RTGS,"10,257.64",00.00,"160,133.71"
09-Dec-2020,ATM,41.00,00.00,"160,174.71"
09-Dec-2020,ATM,00.00,"53,391.57","106,783.14"
09-Dec-2020,Cash,517.25,00.00,"107,300.39"
09-Dec-2020,Interest,37.81,00.00,"107,338.20"
09-Dec-2020,Interest,07.70,00.00,"107,345.90"
09-Dec-2020,Interest,"2,542.30",00.00,"109,888.20"
09-Dec-2020,Commission,07.90,00.00,"109,896.10"
09-Dec-2020,Purchase,"1,557,295.00",00.00,"1,667,191.10"
09-Dec-2020,Debit Card,00.00,"1,667,191.10",00.00
09-Dec-2020,NEFT,433.00,00.00,433.00
09-Dec-2020,Commission,00.00,61.86,371.14
09-Dec-2020,Interest,34.00,00.00,405.14
09-Dec-2020,NEFT,00.00,135.05,270.09
09-Dec-2020,Reversal,00.00,33.76,236.33
09-Dec-2020,RTGS,00.00,59.08,177.25
09-Dec-2020,Purchase,00.00,29.54,147.71
09-Dec-2020,Tax,00.00,36.93,110.78
09-Dec-2020,Purchase,00.00,11.08,99.70
09-Dec-2020,Commission,"3,552.40",00.00,"3,652.10"
09-Dec-2020,Purchase,00.00,456.51,"3,195.59"
09-Dec-2020,RTGS,00.00,639.12,"2,556.47"
09-Dec-2020,RTGS,00.00,365.21,"2,191.26"
09-Dec-2020,Tax,00.00,"2,191.26",00.00
09-Dec-2020,Bill,06.84,00.00,06.84
09-Dec-2020,Purchase,"992,248.50",00.00,"992,255.34"
09-Dec-2020,Transfer,00.00,"110,250.59","882,004.75"
09-Dec-2020,ATM,00.00,"441,002.38","441,002.38"
09-Dec-2020,Miscellaneous,"247,906.00",00.00,"688,908.38"
09-Dec-2020,Purchase,02.87,00.00,"688,911.25"
09-Dec-2020,NEFT,00.00,"76,545.69","612,365.56"
09-Dec-2020,Debit Card,00.00,"153,091.39","459,274.17"
09-Dec-2020,Cheque,00.00,"45,927.42","413,346.75"
09-Dec-2020,Bill,00.00,"45,927.42","367,419.33"
09-Dec-2020,Commission,"23,228.80",00.00,"390,648.13"
09-Dec-2020,Cash,"367,144.00",00.00,"757,792.13"
09-Dec-2020,Miscellaneous,00.00,"757,792.13",00.00
09-Dec-2020,Transfer,"1,865,578.00",00.00,"1,865,578.00"
09-Dec-2020,Miscellaneous,00.00,"621,859.33","1,243,718.67"
09-Dec-2020,Tax,"10,826.30",00.00,"1,254,544.97"
09-Dec-2020,Tax,"100,073.00",00.00,"1,354,617.97"
09-Dec-2020,Debit Card,00.00,"1,354,617.97",00.00
10-Dec-2020,IMPS,27.23,00.00,27.23
10-Dec-2020,Commission,"1,732,766.00",00.00,"1,732,793.23"
10-Dec-2020,Interest,150.79,00.00,"1,732,944.02"
10-Dec-2020,Tax,"618,111.50",00.00,"2,351,055.52"
10-Dec-2020,Bill,375.48,00.00,"2,351,431.00"
10-Dec-2020,IMPS,"1,384,521.00",00.00,"3,735,952.00"
10-Dec-2020,ATM,09.16,00.00,"3,735,961.16"
10-Dec-2020,Purchase,"9,455.00",00.00,"3,745,416.16"
10-Dec-2020,RTGS,00.00,"749,083.23","2,996,332.93"
10-Dec-2020,Debit Card,18.00,00.00,"2,996,350.93"
10-Dec-2020,Transfer,00.00,"1,498,175.47","1,498,175.46"
10-Dec-2020,Bill,"14,466.70",00.00,"1,512,642.16"
10-Dec-2020,Bill,00.00,"252,107.03","1,260,535.13"
10-Dec-2020,Bill,"25,743.88",00.00,"1,286,279.01"
10-Dec-2020,Commission,"30,081.29",00.00,"1,316,360.30"
10-Dec-2020,Cash,"1,667,152.50",00.00,"2,983,512.80"
10-Dec-2020,Transfer,00.00,"298,351.28","2,685,161.52"
10-Dec-2020,Cash,00.00,"268,516.15","2,416,645.37"
10-Dec-2020,Cash,"5,760.60",00.00,"2,422,405.97"
10-Dec-2020,Debit Card,"29,536.70",00.00,"2,451,942.67"
10-Dec-2020,RTGS,00.00,"612,985.67","1,838,957.00"
10-Dec-2020,Miscellaneous,00.00,"262,708.14","1,576,248.86"
10-Dec-2020,Miscellaneous,26.00,00.00,"1,576,274.86"
10-Dec-2020,Tax,"189,684.80",00.00,"1,765,959.66"
10-Dec-2020,ATM,00.00,"353,191.93","1,412,767.73"
10-Dec-2020,Commission,"17,516.00",00.00,"1,430,283.73"
10-Dec-2020,Reversal,00.00,"286,056.75","1,144,226.98"
10-Dec-2020,Interest,"1,706,689.50",00.00,"2,850,916.48"
10-Dec-2020,Debit Card,00.00,"356,364.56","2,494,551.92"
10-Dec-2020,NEFT,369.00,00.00,"2,494,920.92"
10-Dec-2020,ATM,"119,646.80",00.00,"2,614,567.72"
10-Dec-2020,Purchase,00.00,"522,913.54","2,091,654.18"
10-Dec-2020,Purchase,00.00,"418,330.84","1,673,323.34"
10-Dec-2020,Reversal,468.72,00.00,"1,673,792.06"
10-Dec-2020,Commission,"48,054.00",00.00,"1,721,846.06"
10-Dec-2020,ATM,"48,087.50",00.00,"1,769,933.56"
10-Dec-2020,Purchase,00.00,"196,659.28","1,573,274.28"
10-Dec-2020,Interest,00.00,"196,659.29","1,376,615.00"
10-Dec-2020,Cash,"1,456,293.00",00.00,"2,832,908.00"
10-Dec-2020,Cash,00.00,"354,113.50","2,478,794.50"
10-Dec-2020,Bill,40.00,00.00,"2,478,834.50"
10-Dec-2020,NEFT,17.52,00.00,"2,478,852.02"
11-Dec-2020,Tax,48.90,00.00,"2,478,900.92"
11-Dec-2020,Tax,00.00,"2,478,900.92",00.00
11-Dec-2020,Cheque,"210,223.66",00.00,"210,223.66"
11-Dec-2020,Bill,"2,219.17",00.00,"212,442.83"
11-Dec-2020,Commission,00.00,"53,110.71","159,332.12"
11-Dec-2020,Miscellaneous,00.00,"17,703.57","141,628.55"
11-Dec-2020,RTGS,"3,349.30",00.00,"144,977.85"
11-Dec-2020,Cheque,00.00,"144,977.85",00.00
11-Dec-2020,ATM,"29,845.00",00.00,"29,845.00"
11-Dec-2020,IMPS,"16,486.00",00.00,"46,331.00"
11-Dec-2020,NEFT,00.00,"15,443.67","30,887.33"
11-Dec-2020,Bill,678.00,00.00,"31,565.33"
11-Dec-2020,Interest,"124,758.10",00.00,"156,323.43"
11-Dec-2020,Debit Card,00.00,"15,632.34","140,691.09"
11-Dec-2020,NEFT,00.00,"70,345.55","70,345.54"
11-Dec-2020,Cash,54.03,00.00,"70,399.57"
11-Dec-2020,Cash,"18,803.06",00.00,"89,202.63"
11-Dec-2020,Interest,00.00,"17,840.53","71,362.10"
11-Dec-2020,Transfer,00.00,"7,929.12","63,432.98"
11-Dec-2020,RTGS,"29,657.00",00.00,"93,089.98"
11-Dec-2020,Commission,00.00,"15,515.00","77,574.98"
11-Dec-2020,Transfer,"27,991.30",00.00,"105,566.28"
11-Dec-2020,RTGS,00.58,00.00,"105,566.86"
11-Dec-2020,Commission,00.00,"15,080.98","90,485.88"
11-Dec-2020,Bill,487.40,00.00,"90,973.28"
11-Dec-2020,Interest,11.88,00.00,"90,985.16"
11-Dec-2020,IMPS,44.00,00.00,"91,029.16"
12-Dec-2020,IMPS,155.50,00.00,"91,184.66"
12-Dec-2020,Transfer,00.00,"22,796.17","68,388.50"
12-Dec-2020,Cheque,"69,765.31",00.00,"138,153.81"
12-Dec-2020,Interest,"5,198.79",00.00,"143,352.60"
12-Dec-2020,Transfer,00.00,"23,892.10","119,460.50"
12-Dec-2020,NEFT,00.00,"23,892.10","95,568.40"
12-Dec-2020,NEFT,"2,795.10",00.00,"98,363.50"
12-Dec-2020,Bill,63.96,00.00,"98,427.46"
12-Dec-2020,Bill,00.00,"49,213.73","49,213.73"
12-Dec-2020,IMPS,00.23,00.00,"49,213.96"
12-Dec-2020,Transfer,02.69,00.00,"49,216.65"
12-Dec-2020,Debit Card,20.30,00.00,"49,236.95"
12-Dec-2020,Transfer,00.00,"24,618.48","24,618.48"
12-Dec-2020,Debit Card,"3,689.20",00.00,"28,307.68"
13-Dec-2020,Commission,00.00,"2,830.77","25,476.91"
13-Dec-2020,IMPS,149.11,00.00,"25,626.02"
13-Dec-2020,Commission,00.00,"5,125.20","20,500.82"
13-Dec-2020,ATM,457.80,00.00,"20,958.62"
13-Dec-2020,Tax,00.00,"4,191.72","16,766.90"
13-Dec-2020,Tax,"22,372.00",00.00,"39,138.90"
14-Dec-2020,Miscellaneous,00.00,"4,348.77","34,790.13"
14-Dec-2020,NEFT,08.00,00.00,"34,798.13"
14-Dec-2020,Tax,"171,310.00",00.00,"206,108.13"
14-Dec-2020,Cash,"1,345.00",00.00,"207,453.13"
14-Dec-2020,Reversal,00.00,"29,636.16","177,816.97"
14-Dec-2020,Cash,00.00,"29,636.16","148,180.81"
14-Dec-2020,NEFT,00.00,"74,090.41","74,090.40"
14-Dec-2020,Transfer,"21,101.57",00.00,"95,191.97"
14-Dec-2020,Cash,388.00,00.00,"95,579.97"
14-Dec-2020,Reversal,"11,488.00",00.00,"107,067.97"
14-Dec-2020,Reversal,00.00,"17,844.66","89,223.31"
14-Dec-2020,Reversal,00.00,"44,611.66","44,611.66"
14-Dec-2020,Reversal,"3,199.30",00.00,"47,810.96"
14-Dec-2020,Bill,"188,314.59",00.00,"236,125.55"
14-Dec-2020,NEFT,00.00,"78,708.52","157,417.03"
14-Dec-2020,Tax,00.00,"17,490.78","139,926.25"
14-Dec-2020,Cheque,502.30,00.00,"140,428.55"
14-Dec-2020,Purchase,00.00,"140,428.55",00.00
14-Dec-2020,NEFT,"1,096.46",00.00,"1,096.46"
14-Dec-2020,Transfer,"245,398.00",00.00,"246,494.46"
14-Dec-2020,ATM,00.00,"35,213.49","211,280.97"
14-Dec-2020,Cheque,00.00,"35,213.50","176,067.48"
14-Dec-2020,ATM,"1,813.38",00.00,"177,880.86"
14-Dec-2020,Tax,607.84,00.00,"178,488.70"
14-Dec-2020,Reversal,00.00,"17,848.87","160,639.83"
14-Dec-2020,Miscellaneous,00.00,"17,848.87","142,790.96"
14-Dec-2020,NEFT,"3,626.10",00.00,"146,417.06"
14-Dec-2020,RTGS,"9,173.00",00.00,"155,590.06"
14-Dec-2020,Cash,00.00,"31,118.01","124,472.05"
14-Dec-2020,ATM,"1,683.40",00.00,"126,155.45"
14-Dec-2020,Debit Card,"195,925.80",00.00,"322,081.25"
14-Dec-2020,NEFT,00.00,"40,260.16","281,821.09"
14-Dec-2020,ATM,"1,286.80",00.00,"283,107.89"
14-Dec-2020,Debit Card,00.00,"31,456.43","251,651.46"
14-Dec-2020,Cash,04.41,00.00,"251,655.87"
14-Dec-2020,Transfer,"1,921,145.20",00.00,"2,172,801.07"
14-Dec-2020,IMPS,"21,479.80",00.00,"2,194,280.87"
14-Dec-2020,Purchase,00.00,"274,285.11","1,919,995.76"
15-Dec-2020,Debit Card,08.00,00.00,"1,920,003.76"
15-Dec-2020,Commission,00.00,"192,000.38","1,728,003.38"
15-Dec-2020,IMPS,00.00,"1,728,003.38",00.00
15-Dec-2020,Cash,528.00,00.00,528.00
15-Dec-2020,Cash,00.00,58.67,469.33
15-Dec-2020,Interest,00.00,52.15,417.18
15-Dec-2020,ATM,00.00,46.35,370.83
15-Dec-2020,Cheque,00.00,61.81,309.02
15-Dec-2020,Tax,00.00,44.15,264.87
15-Dec-2020,Cheque,"107,676.00",00.00,"107,940.87"
15-Dec-2020,Debit Card,12.63,00.00,"107,953.50"
15-Dec-2020,ATM,00.00,"53,976.75","53,976.75"
15-Dec-2020,Cash,00.00,"7,710.96","46,265.79"
15-Dec-2020,Transfer,23.17,00.00,"46,288.96"
15-Dec-2020,ATM,"3,629.94",00.00,"49,918.90"
15-Dec-2020,Reversal,50.13,00.00,"49,969.03"
15-Dec-2020,Cash,"3,033.00",00.00,"53,002.03"
15-Dec-2020,Transfer,00.50,00.00,"53,002.53"
15-Dec-2020,Purchase,00.00,"17,667.51","35,335.02"
15-Dec-2020,IMPS,41.29,00.00,"35,376.31"
15-Dec-2020,Bill,00.00,"17,688.16","17,688.16"
16-Dec-2020,IMPS,00.00,"1,768.82","15,919.34"
16-Dec-2020,Cheque,47.00,00.00,"15,966.34"
16-Dec-2020,IMPS,06.20,00.00,"15,972.54"
16-Dec-2020,ATM,00.00,"1,996.57","13,975.97"
16-Dec-2020,Interest,00.00,"13,975.97",00.00
16-Dec-2020,Commission,"31,929.50",00.00,"31,929.50"
16-Dec-2020,Commission,00.00,"5,321.58","26,607.92"
16-Dec-2020,Bill,"15,776.52",00.00,"42,384.44"
16-Dec-2020,Bill,23.50,00.00,"42,407.94"
16-Dec-2020,Bill,00.00,"5,300.99","37,106.95"
16-Dec-2020,Debit Card,"31,352.00",00.00,"68,458.95"
16-Dec-2020,IMPS,00.00,"34,229.48","34,229.48"
16-Dec-2020,Interest,00.00,"4,889.93","29,339.55"
16-Dec-2020,Cash,10.00,00.00,"29,349.55"
16-Dec-2020,Reversal,00.00,"29,349.55",00.00
16-Dec-2020,Debit Card,"25,604.87",00.00,"25,604.87"
16-Dec-2020,Commission,00.00,"3,657.84","21,947.03"
16-Dec-2020,Miscellaneous,"796,545.00",00.00,"818,492.03"
16-Dec-2020,Debit Card,"166,944.60",00.00,"985,436.63"
16-Dec-2020,Debit Card,00.00,"98,543.66","886,892.97"
17-Dec-2020,Interest,00.00,"126,699.00","760,193.97"
17-Dec-2020,Cheque,08.00,00.00,"760,201.97"
18-Dec-2020,Cheque,00.00,"126,700.33","633,501.64"
18-Dec-2020,IMPS,00.00,"105,583.61","527,918.03"
18-Dec-2020,IMPS,01.75,00.00,"527,919.78"
18-Dec-2020,Cash,00.00,"87,986.63","439,933.15"
18-Dec-2020,RTGS,00.00,"87,986.63","351,946.52"
18-Dec-2020,NEFT,579.00,00.00,"352,525.52"
18-Dec-2020,Interest,00.00,"39,169.50","313,356.02"
18-Dec-2020,Interest,07.30,00.00,"313,363.32"
18-Dec-2020,Debit Card,461.00,00.00,"313,824.32"
18-Dec-2020,Cash,"16,572.00",00.00,"330,396.32"
18-Dec-2020,Interest,19.30,00.00,"330,415.62"
18-Dec-2020,Bill,581.21,00.00,"330,996.83"
18-Dec-2020,RTGS,"24,268.00",00.00,"355,264.83"
18-Dec-2020,Interest,01.00,00.00,"355,265.83"
18-Dec-2020,Commission,02.73,00.00,"355,268.56"
18-Dec-2020,Tax,"153,319.00",00.00,"508,587.56"
18-Dec-2020,Cheque,00.00,"50,858.76","457,728.80"
18-Dec-2020,Transfer,00.00,"65,389.83","392,338.97"
18-Dec-2020,Reversal,00.00,"78,467.79","313,871.18"
18-Dec-2020,Cash,"2,383.00",00.00,"316,254.18"
18-Dec-2020,Reversal,00.00,"105,418.06","210,836.12"
18-Dec-2020,Bill,00.00,"42,167.22","168,668.90"
18-Dec-2020,RTGS,00.00,"24,095.56","144,573.34"
18-Dec-2020,IMPS,00.00,"14,457.33","130,116.01"
18-Dec-2020,Debit Card,"216,421.00",00.00,"346,537.01"
18-Dec-2020,Commission,00.00,"173,268.51","173,268.50"
18-Dec-2020,Commission,00.00,"57,756.17","115,512.33"
18-Dec-2020,Reversal,188.46,00.00,"115,700.79"
18-Dec-2020,Purchase,00.00,"16,528.68","99,172.11"
18-Dec-2020,IMPS,00.00,"99,172.11",00.00
18-Dec-2020,Cash,"1,003.00",00.00,"1,003.00"
18-Dec-2020,Purchase,00.00,501.50,501.50
18-Dec-2020,Reversal,00.00,501.50,00.00
18-Dec-2020,Reversal,"20,000.59",00.00,"20,000.59"
18-Dec-2020,Commission,"2,792.73",00.00,"22,793.32"
18-Dec-2020,RTGS,00.00,"7,597.77","15,195.55"
18-Dec-2020,Purchase,11.69,00.00,"15,207.24"
18-Dec-2020,Bill,00.00,"15,207.24",00.00
18-Dec-2020,Bill,09.10,00.00,09.10
18-Dec-2020,Debit Card,00.00,01.52,07.58
18-Dec-2020,Transfer,"1,675.40",00.00,"1,682.98"
18-Dec-2020,Purchase,335.50,00.00,"2,018.48"
18-Dec-2020,RTGS,19.60,00.00,"2,038.08"
18-Dec-2020,Tax,"105,416.62",00.00,"107,454.70"
18-Dec-2020,IMPS,00.00,"107,454.70",00.00
18-Dec-2020,IMPS,"170,678.81",00.00,"170,678.81"
18-Dec-2020,NEFT,"14,253.50",00.00,"184,932.31"
18-Dec-2020,RTGS,00.00,"20,548.03","164,384.28"
18-Dec-2020,Bill,"190,471.47",00.00,"354,855.75"
18-Dec-2020,Cash,00.00,"118,285.25","236,570.50"
18-Dec-2020,Tax,"226,600.16",00.00,"463,170.66"
18-Dec-2020,Cash,00.00,"46,317.07","416,853.59"
18-Dec-2020,Purchase,"227,454.00",00.00,"644,307.59"
18-Dec-2020,Tax,00.00,"92,043.94","552,263.65"
18-Dec-2020,Interest,"133,816.53",00.00,"686,080.18"
18-Dec-2020,Miscellaneous,"24,208.80",00.00,"710,288.98"
18-Dec-2020,Reversal,00.00,"236,762.99","473,525.99"
18-Dec-2020,Debit Card,"25,167.60",00.00,"498,693.59"
18-Dec-2020,Cash,00.00,"124,673.40","374,020.19"
18-Dec-2020,Commission,00.00,"62,336.70","311,683.49"
18-Dec-2020,Transfer,"117,927.00",00.00,"429,610.49"
18-Dec-2020,Cheque,00.00,"53,701.31","375,909.18"
18-Dec-2020,Reversal,00.00,"375,909.18",00.00
18-Dec-2020,NEFT,"1,220.00",00.00,"1,220.00"
18-Dec-2020,IMPS,00.00,244.00,976.00
18-Dec-2020,Commission,"143,343.70",00.00,"144,319.70"
18-Dec-2020,Cheque,00.00,"144,319.70",00.00
18-Dec-2020,ATM,00.10,00.00,00.10
18-Dec-2020,Reversal,"1,833,210.75",00.00,"1,833,210.85"
18-Dec-2020,Debit Card,00.00,"1,833,210.85",00.00
18-Dec-2020,RTGS,413.00,00.00,413.00
18-Dec-2020,Purchase,476.06,00.00,889.06
18-Dec-2020,Interest,00.00,88.91,800.15
18-Dec-2020,Interest,00.00,200.04,600.11
18-Dec-2020,ATM,00.00,100.02,500.09
18-Dec-2020,Debit Card,"70,467.62",00.00,"70,967.71"
18-Dec-2020,Bill,238.00,00.00,"71,205.71"
18-Dec-2020,Commission,378.00,00.00,"71,583.71"
18-Dec-2020,Reversal,"12,926.80",00.00,"84,510.51"
18-Dec-2020,Reversal,00.00,"12,072.93","72,437.58"
19-Dec-2020,ATM,"192,490.47",00.00,"264,928.05"
19-Dec-2020,RTGS,00.00,"88,309.35","176,618.70"
19-Dec-2020,Tax,00.00,"35,323.74","141,294.96"
19-Dec-2020,Purchase,350.10,00.00,"141,645.06"
19-Dec-2020,Commission,50.90,00.00,"141,695.96"
19-Dec-2020,IMPS,00.00,"35,423.99","106,271.97"
19-Dec-2020,Cash,00.00,"53,135.99","53,135.98"
19-Dec-2020,Reversal,00.00,"13,284.00","39,851.98"
19-Dec-2020,Commission,02.67,00.00,"39,854.65"
19-Dec-2020,Reversal,00.00,"13,284.88","26,569.77"
19-Dec-2020,RTGS,"26,450.00",00.00,"53,019.77"
20-Dec-2020,RTGS,00.00,"6,627.47","46,392.30"
20-Dec-2020,NEFT,44.00,00.00,"46,436.30"
20-Dec-2020,Transfer,"2,605.11",00.00,"49,041.41"
20-Dec-2020,Commission,"173,288.30",00.00,"222,329.71"
21-Dec-2020,Debit Card,00.00,"55,582.43","166,747.28"
21-Dec-2020,ATM,02.40,00.00,"166,749.68"
21-Dec-2020,Commission,00.00,"83,374.84","83,374.84"
21-Dec-2020,Transfer,08.00,00.00,"83,382.84"
21-Dec-2020,NEFT,00.00,"20,845.71","62,537.13"
21-Dec-2020,NEFT,"475,411.00",00.00,"537,948.13"
21-Dec-2020,Bill,00.00,"268,974.07","268,974.06"
21-Dec-2020,Cheque,"18,115.00",00.00,"287,089.06"
21-Dec-2020,Tax,00.00,"31,898.78","255,190.28"
21-Dec-2020,Debit Card,98.56,00.00,"255,288.84"
21-Dec-2020,Interest,00.00,"63,822.21","191,466.63"
21-Dec-2020,Interest,"98,281.40",00.00,"289,748.03"
21-Dec-2020,Tax,251.87,00.00,"289,999.90"
22-Dec-2020,Debit Card,00.00,"36,249.99","253,749.91"
22-Dec-2020,Transfer,00.00,"126,874.96","126,874.96"
22-Dec-2020,IMPS,60.00,00.00,"126,934.96"
22-Dec-2020,Commission,"1,294,784.00",00.00,"1,421,718.96"
22-Dec-2020,Bill,00.00,"203,102.71","1,218,616.25"
22-Dec-2020,Debit Card,52.34,00.00,"1,218,668.59"
22-Dec-2020,Tax,00.00,"135,407.62","1,083,260.97"
22-Dec-2020,Cash,00.00,"216,652.19","866,608.78"
22-Dec-2020,RTGS,00.00,"108,326.10","758,282.68"
22-Dec-2020,IMPS,00.00,"189,570.67","568,712.01"
22-Dec-2020,Cheque,00.00,"284,356.01","284,356.00"
22-Dec-2020,Miscellaneous,38.00,00.00,"284,394.00"
22-Dec-2020,Commission,07.80,00.00,"284,401.80"
22-Dec-2020,Interest,00.00,"56,880.36","227,521.44"
22-Dec-2020,Tax,00.00,"75,840.48","151,680.96"
22-Dec-2020,Purchase,"2,955.00",00.00,"154,635.96"
22-Dec-2020,ATM,"330,084.80",00.00,"484,720.76"
22-Dec-2020,Transfer,"2,410.29",00.00,"487,131.05"
23-Dec-2020,Transfer,07.70,00.00,"487,138.75"
23-Dec-2020,Interest,00.00,"48,713.88","438,424.88"
23-Dec-2020,NEFT,"2,036.48",00.00,"440,461.36"
23-Dec-2020,Tax,00.30,00.00,"440,461.66"
23-Dec-2020,ATM,00.00,"440,461.66",00.00
23-Dec-2020,Bill,"45,219.00",00.00,"45,219.00"
23-Dec-2020,Cash,00.00,"4,521.90","40,697.10"
23-Dec-2020,Commission,00.00,"4,069.71","36,627.39"
24-Dec-2020,Transfer,00.00,"18,313.70","18,313.70"
24-Dec-2020,IMPS,00.00,"1,831.37","16,482.33"
24-Dec-2020,Reversal,00.00,"1,648.23","14,834.10"
24-Dec-2020,NEFT,00.00,"2,966.82","11,867.28"
24-Dec-2020,Reversal,00.00,"1,695.33","10,171.95"
24-Dec-2020,Transfer,00.00,"1,130.22","9,041.73"
24-Dec-2020,Bill,00.00,"1,506.96","7,534.78"
24-Dec-2020,Purchase,00.00,"1,076.40","6,458.38"
24-Dec-2020,Cash,00.00,717.60,"5,740.78"
24-Dec-2020,Reversal,00.00,956.80,"4,783.98"
24-Dec-2020,Purchase,00.00,"1,196.00","3,587.98"
24-Dec-2020,Miscellaneous,06.00,00.00,"3,593.98"
24-Dec-2020,IMPS,54.00,00.00,"3,647.98"
24-Dec-2020,Interest,07.69,00.00,"3,655.67"
24-Dec-2020,NEFT,00.00,609.28,"3,046.39"
24-Dec-2020,IMPS,00.00,507.73,"2,538.66"
24-Dec-2020,Purchase,00.00,507.73,"2,030.93"
25-Dec-2020,Commission,00.00,406.19,"1,624.74"
25-Dec-2020,RTGS,"1,630,089.75",00.00,"1,631,714.49"
25-Dec-2020,Bill,08.50,00.00,"1,631,722.99"
25-Dec-2020,Commission,"1,244,079.20",00.00,"2,875,802.19"
25-Dec-2020,Reversal,09.00,00.00,"2,875,811.19"
25-Dec-2020,Cash,"2,443.74",00.00,"2,878,254.93"
25-Dec-2020,Commission,"669,418.00",00.00,"3,547,672.93"
25-Dec-2020,ATM,338.00,00.00,"3,548,010.93"
25-Dec-2020,Miscellaneous,00.00,"394,223.44","3,153,787.49"
25-Dec-2020,NEFT,00.00,"394,223.44","2,759,564.05"
25-Dec-2020,ATM,00.00,"2,759,564.05",00.00
25-Dec-2020,Purchase,01.54,00.00,01.54
25-Dec-2020,Interest,00.00,00.77,00.77
25-Dec-2020,Cheque,00.00,00.08,00.69
25-Dec-2020,Cash,01.10,00.00,01.79
25-Dec-2020,ATM,18.92,00.00,20.71
25-Dec-2020,ATM,00.00,10.36,10.36
25-Dec-2020,Interest,00.00,01.04,09.32
25-Dec-2020,Cheque,02.79,00.00,12.11
25-Dec-2020,ATM,77.00,00.00,89.11
25-Dec-2020,Transfer,00.00,00.00,89.11
25-Dec-2020,Interest,00.00,11.14,77.97
25-Dec-2020,ATM,00.00,19.49,58.48
25-Dec-2020,Reversal,00.00,09.75,48.73
25-Dec-2020,Reversal,09.00,00.00,57.73
25-Dec-2020,Interest,"863,388.00",00.00,"863,445.73"
25-Dec-2020,Interest,57.30,00.00,"863,503.03"
25-Dec-2020,Purchase,935.80,00.00,"864,438.83"
25-Dec-2020,Cash,00.00,"864,438.83",00.00
25-Dec-2020,Transfer,408.00,00.00,408.00
25-Dec-2020,NEFT,34.00,00.00,442.00
25-Dec-2020,Bill,00.00,55.25,386.75
25-Dec-2020,Cash,"2,584.00",00.00,"2,970.75"
25-Dec-2020,Tax,880.32,00.00,"3,851.07"
25-Dec-2020,Cheque,"2,005,320.00",00.00,"2,009,171.07"
25-Dec-2020,Bill,00.00,"401,834.21","1,607,336.86"
25-Dec-2020,ATM,"204,754.00",00.00,"1,812,090.86"
25-Dec-2020,Tax,"1,592,725.00",00.00,"3,404,815.86"
25-Dec-2020,Cheque,00.00,"567,469.31","2,837,346.55"
25-Dec-2020,Debit Card,257.00,00.00,"2,837,603.55"
25-Dec-2020,RTGS,00.00,"315,289.28","2,522,314.27"
25-Dec-2020,Transfer,07.00,00.00,"2,522,321.27"
25-Dec-2020,Transfer,"27,869.50",00.00,"2,550,190.77"
25-Dec-2020,Interest,22.10,00.00,"2,550,212.87"
25-Dec-2020,Bill,00.00,"2,550,212.87",00.00
25-Dec-2020,Transfer,"3,076.68",00.00,"3,076.68"
25-Dec-2020,NEFT,296.51,00.00,"3,373.19"
25-Dec-2020,IMPS,00.00,421.65,"2,951.54"
25-Dec-2020,Debit Card,"31,114.20",00.00,"34,065.74"
25-Dec-2020,RTGS,"61,486.00",00.00,"95,551.74"
25-Dec-2020,Miscellaneous,00.00,"11,943.97","83,607.77"
25-Dec-2020,Bill,"1,159,699.25",00.00,"1,243,307.02"
25-Dec-2020,NEFT,00.00,"155,413.38","1,087,893.64"
25-Dec-2020,IMPS,00.00,"1,087,893.64",00.00
25-Dec-2020,Interest,"29,173.73",00.00,"29,173.73"
25-Dec-2020,RTGS,00.00,"3,646.72","25,527.01"
25-Dec-2020,Bill,13.00,00.00,"25,540.01"
25-Dec-2020,Cheque,"180,598.50",00.00,"206,138.51"
25-Dec-2020,IMPS,"9,406.00",00.00,"215,544.51"
25-Dec-2020,Miscellaneous,"191,399.16",00.00,"406,943.67"
25-Dec-2020,Debit Card,00.00,"81,388.73","325,554.94"
25-Dec-2020,IMPS,"1,516.00",00.00,"327,070.94"
25-Dec-2020,Interest,00.00,"163,535.47","163,535.47"
25-Dec-2020,Transfer,05.20,00.00,"163,540.67"
26-Dec-2020,IMPS,00.00,"16,354.07","147,186.60"
26-Dec-2020,Cheque,00.00,"147,186.60",00.00
26-Dec-2020,Transfer,366.00,00.00,366.00
26-Dec-2020,Commission,"153,692.00",00.00,"154,058.00"
26-Dec-2020,ATM,03.00,00.00,"154,061.00"
26-Dec-2020,Commission,00.00,"38,515.25","115,545.75"
26-Dec-2020,Bill,00.00,"57,772.88","57,772.88"
26-Dec-2020,Bill,980.82,00.00,"58,753.70"
26-Dec-2020,Cheque,00.00,"8,393.39","50,360.31"
26-Dec-2020,Cheque,"16,681.00",00.00,"67,041.31"
26-Dec-2020,Miscellaneous,35.80,00.00,"67,077.11"
26-Dec-2020,Purchase,"1,570.00",00.00,"68,647.11"
26-Dec-2020,Reversal,292.70,00.00,"68,939.81"
26-Dec-2020,Transfer,"520,562.80",00.00,"589,502.61"
26-Dec-2020,Transfer,00.00,"58,950.26","530,552.35"
26-Dec-2020,ATM,02.96,00.00,"530,555.31"
26-Dec-2020,Interest,"18,765.00",00.00,"549,320.31"
26-Dec-2020,Interest,00.00,"61,035.59","488,284.72"
27-Dec-2020,Bill,283.50,00.00,"488,568.22"
27-Dec-2020,Interest,40.48,00.00,"488,608.70"
27-Dec-2020,Tax,60.70,00.00,"488,669.40"
27-Dec-2020,ATM,00.00,"162,889.80","325,779.60"
27-Dec-2020,Miscellaneous,"25,720.81",00.00,"351,500.41"
27-Dec-2020,Transfer,01.40,00.00,"351,501.81"
27-Dec-2020,Interest,00.00,"70,300.36","281,201.45"
27-Dec-2020,Debit Card,00.00,"28,120.15","253,081.31"
27-Dec-2020,IMPS,05.41,00.00,"253,086.72"
27-Dec-2020,NEFT,00.00,"253,086.72",00.00
27-Dec-2020,Bill,"27,290.00",00.00,"27,290.00"
27-Dec-2020,Cheque,00.00,"2,729.00","24,561.00"
27-Dec-2020,RTGS,"90,524.50",00.00,"115,085.50"
27-Dec-2020,RTGS,"1,653.30",00.00,"116,738.80"
27-Dec-2020,IMPS,926.80,00.00,"117,665.60"
27-Dec-2020,Purchase,00.00,"11,766.56","105,899.04"
27-Dec-2020,Cheque,00.00,"52,949.52","52,949.52"
27-Dec-2020,Debit Card,"1,647,223.20",00.00,"1,700,172.72"
27-Dec-2020,Tax,00.00,"212,521.59","1,487,651.13"
27-Dec-2020,Purchase,02.00,00.00,"1,487,653.13"
27-Dec-2020,Debit Card,43.61,00.00,"1,487,696.74"
27-Dec-2020,NEFT,00.00,"212,528.11","1,275,168.63"
27-Dec-2020,Cash,"7,569.50",00.00,"1,282,738.13"
27-Dec-2020,IMPS,00.00,"256,547.63","1,026,190.50"
27-Dec-2020,Commission,00.00,"205,238.10","820,952.40"
27-Dec-2020,Tax,61.60,00.00,"821,014.00"
27-Dec-2020,ATM,"1,137,783.00",00.00,"1,958,797.00"
27-Dec-2020,Interest,00.00,"979,398.50","979,398.50"
27-Dec-2020,RTGS,00.00,"489,699.25","489,699.25"
27-Dec-2020,RTGS,06.00,00.00,"489,705.25"
27-Dec-2020,Miscellaneous,00.00,"163,235.08","326,470.17"
28-Dec-2020,RTGS,"29,259.70",00.00,"355,729.87"
28-Dec-2020,Commission,00.00,"88,932.47","266,797.40"
28-Dec-2020,RTGS,00.00,"133,398.70","133,398.70"
28-Dec-2020,Miscellaneous,00.00,"44,466.23","88,932.47"
28-Dec-2020,Transfer,00.00,"88,932.47",00.00
28-Dec-2020,Purchase,363.00,00.00,363.00
28-Dec-2020,Cheque,"1,396,614.00",00.00,"1,396,977.00"
28-Dec-2020,Transfer,00.00,"199,568.14","1,197,408.86"
28-Dec-2020,Commission,00.00,"133,045.43","1,064,363.43"
29-Dec-2020,Bill,415.89,00.00,"1,064,779.32"
29-Dec-2020,IMPS,00.60,00.00,"1,064,779.92"
29-Dec-2020,Bill,00.00,"1,064,779.92",00.00
29-Dec-2020,Transfer,"12,258.36",00.00,"12,258.36"
29-Dec-2020,IMPS,00.00,"12,258.36",00.00
29-Dec-2020,Interest,42.25,00.00,42.25
29-Dec-2020,NEFT,00.00,21.13,21.12
29-Dec-2020,Tax,"26,447.70",00.00,"26,468.82"
29-Dec-2020,Cheque,02.26,00.00,"26,471.08"
30-Dec-2020,Cash,403.00,00.00,"26,874.08"
30-Dec-2020,IMPS,00.00,"3,839.15","23,034.93"
30-Dec-2020,Bill,00.00,"23,034.93",00.00
30-Dec-2020,RTGS,"53,322.50",00.00,"53,322.50"
30-Dec-2020,Transfer,25.71,00.00,"53,348.21"
30-Dec-2020,IMPS,00.00,"6,668.53","46,679.68"
30-Dec-2020,Bill,00.00,"7,779.95","38,899.73"
30-Dec-2020,ATM,"1,090,277.50",00.00,"1,129,177.23"
30-Dec-2020,Miscellaneous,00.00,"188,196.21","940,981.02"
30-Dec-2020,Purchase,00.00,"134,425.86","806,555.16"
30-Dec-2020,Transfer,02.00,00.00,"806,557.16"
30-Dec-2020,Cash,00.00,"100,819.65","705,737.52"
30-Dec-2020,Reversal,00.00,"88,217.19","617,520.33"
30-Dec-2020,NEFT,"4,891.20",00.00,"622,411.53"
30-Dec-2020,NEFT,00.00,"88,915.93","533,495.60"
30-Dec-2020,NEFT,"261,215.40",00.00,"794,711.00"
30-Dec-2020,RTGS,00.00,"88,301.22","706,409.78"
30-Dec-2020,Interest,00.00,"176,602.45","529,807.34"
30-Dec-2020,RTGS,54.37,00.00,"529,861.71"
30-Dec-2020,NEFT,00.00,"105,972.34","423,889.37"
30-Dec-2020,Bill,00.00,"42,388.94","381,500.43"
30-Dec-2020,NEFT,"1,232,592.00",00.00,"1,614,092.43"
31-Dec-2020,Interest,00.00,"807,046.22","807,046.22"
31-Dec-2020,Reversal,00.00,"161,409.24","645,636.98"
31-Dec-2020,Miscellaneous,"13,784.00",00.00,"659,420.98"
31-Dec-2020,Reversal,"3,277.00",00.00,"662,697.98"
31-Dec-2020,Commission,00.00,"165,674.50","497,023.48"
31-Dec-2020,Cheque,00.00,"49,702.35","447,321.13"
31-Dec-2020,Purchase,933.30,00.00,"448,254.43"
31-Dec-2020,Commission,190.70,00.00,"448,445.13"
31-Dec-2020,IMPS,00.00,"149,481.71","298,963.42"
31-Dec-2020,Interest,00.00,"298,963.42",00.00
31-Dec-2020,IMPS,"711,079.25",00.00,"711,079.25"
31-Dec-2020,Transfer,00.00,"101,582.75","609,496.50"
31-Dec-2020,Interest,41.00,00.00,"609,537.50"
31-Dec-2020,NEFT,"29,418.50",00.00,"638,956.00"
31-Dec-2020,RTGS,02.60,00.00,"638,958.60"
31-Dec-2020,Bill,00.00,"106,493.10","532,465.50"
31-Dec-2020,RTGS,"791,432.00",00.00,"1,323,897.50"
31-Dec-2020,Miscellaneous,00.00,"264,779.50","1,059,118.00"
31-Dec-2020,Transfer,00.00,"117,679.78","941,438.22"
31-Dec-2020,RTGS,00.00,"117,679.78","823,758.44"
31-Dec-2020,RTGS,00.00,"274,586.15","549,172.29"
31-Dec-2020,Purchase,00.00,"91,528.72","457,643.58"
31-Dec-2020,NEFT,431.41,00.00,"458,074.99"
31-Dec-2020,Tax,00.00,"76,345.83","381,729.16"
31-Dec-2020,Miscellaneous,109.00,00.00,"381,838.16"
31-Dec-2020,Commission,00.00,"190,919.08","190,919.08"
31-Dec-2020,Purchase,03.50,00.00,"190,922.58"
31-Dec-2020,Miscellaneous,00.00,"190,922.58",00.00
31-Dec-2020,RTGS,"10,048.01",00.00,"10,048.01"
31-Dec-2020,Reversal,00.00,"5,024.01","5,024.00"
31-Dec-2020,ATM,00.00,628.00,"4,396.00"
31-Dec-2020,ATM,00.00,439.60,"3,956.40"
31-Dec-2020,Interest,"2,956.00",00.00,"6,912.40"
31-Dec-2020,Commission,"683,241.50",00.00,"690,153.90"
31-Dec-2020,Interest,56.30,00.00,"690,210.20"
31-Dec-2020,ATM,"1,781,779.00",00.00,"2,471,989.20"
31-Dec-2020,ATM,00.00,"411,998.20","2,059,991.00"
31-Dec-2020,IMPS,"11,978.60",00.00,"2,071,969.60"
31-Dec-2020,Interest,04.03,00.00,"2,071,973.63"
31-Dec-2020,Interest,397.90,00.00,"2,072,371.53"
31-Dec-2020,ATM,"26,563.20",00.00,"2,098,934.73"
31-Dec-2020,Commission,"24,703.94",00.00,"2,123,638.67"
31-Dec-2020,Tax,793.00,00.00,"2,124,431.67"
31-Dec-2020,Cash,00.00,"265,553.96","1,858,877.71"
31-Dec-2020,Tax,"177,794.00",00.00,"2,036,671.71"
31-Dec-2020,IMPS,00.00,"2,036,671.71",00.00
31-Dec-2020,RTGS,09.34,00.00,09.34
31-Dec-2020,Miscellaneous,654.00,00.00,663.34
31-Dec-2020,Interest,00.00,73.70,589.64
31-Dec-2020,Commission,496.00,00.00,"1,085.64"
31-Dec-2020,Tax,00.00,155.09,930.55
31-Dec-2020,Commission,"1,921.00",00.00,"2,851.55"
31-Dec-2020,Transfer,"1,778,130.80",00.00,"1,780,982.35"
31-Dec-2020,Bill,00.00,"593,660.78","1,187,321.57"
31-Dec-2020,Cash,00.00,"197,886.93","989,434.64"
31-Dec-2020,Commission,32.99,00.00,"989,467.63"
31-Dec-2020,ATM,"136,756.72",00.00,"1,126,224.35"
31-Dec-2020,Debit Card,"2,774.80",00.00,"1,128,999.15"
31-Dec-2020,IMPS,"1,506,315.00",00.00,"2,635,314.15"
31-Dec-2020,ATM,00.00,"1,317,657.08","1,317,657.08"
31-Dec-2020,Bill,00.00,"329,414.27","988,242.81"
31-Dec-2020,Cheque,00.00,"197,648.56","790,594.25"
31-Dec-2020,Interest,"1,575,246.20",00.00,"2,365,840.45"
31-Dec-2020,Bill,00.00,"394,306.74","1,971,533.71"
31-Dec-2020,Purchase,00.00,"657,177.90","1,314,355.81"
31-Dec-2020,NEFT,"426,050.00",00.00,"1,740,405.81"
31-Dec-2020,RTGS,00.00,"580,135.27","1,160,270.54"
31-Dec-2020,NEFT,00.00,"116,027.05","1,044,243.49"
31-Dec-2020,Cheque,00.00,"130,530.44","913,713.05"
31-Dec-2020,Reversal,01.20,00.00,"913,714.25"
01-Jan-2021,Miscellaneous,00.00,"304,571.42","609,142.83"
01-Jan-2021,Interest,00.60,00.00,"609,143.43"
01-Jan-2021,Cheque,00.00,"609,143.43",00.00
01-Jan-2021,Cheque,"1,626,456.00",00.00,"1,626,456.00"
01-Jan-2021,Debit Card,00.00,"1,626,456.00",00.00
01-Jan-2021,ATM,"1,078,689.00",00.00,"1,078,689.00"
01-Jan-2021,NEFT,"3,821.10",00.00,"1,082,510.10"
01-Jan-2021,RTGS,00.00,"360,836.70","721,673.40"
01-Jan-2021,Tax,"20,034.40",00.00,"741,707.80"
01-Jan-2021,Cheque,00.00,"185,426.95","556,280.85"
01-Jan-2021,NEFT,00.00,"92,713.48","463,567.38"
01-Jan-2021,Purchase,448.00,00.00,"464,015.38"
01-Jan-2021,Interest,00.00,"66,287.91","397,727.47"
01-Jan-2021,IMPS,00.00,"56,818.21","340,909.26"
01-Jan-2021,IMPS,"236,093.00",00.00,"577,002.26"
01-Jan-2021,Cash,"25,768.63",00.00,"602,770.89"
01-Jan-2021,Miscellaneous,00.00,"75,346.36","527,424.53"
02-Jan-2021,Cash,400.80,00.00,"527,825.33"
02-Jan-2021,Reversal,00.00,"131,956.33","395,869.00"
02-Jan-2021,Transfer,00.00,"131,956.33","263,912.67"
02-Jan-2021,Interest,00.00,"52,782.53","211,130.14"
02-Jan-2021,NEFT,00.00,"70,376.71","140,753.43"
02-Jan-2021,Interest,"7,216.80",00.00,"147,970.23"
02-Jan-2021,Interest,00.00,"73,985.12","73,985.12"
02-Jan-2021,Reversal,53.00,00.00,"74,038.12"
02-Jan-2021,Debit Card,00.00,"74,038.12",00.00
02-Jan-2021,Miscellaneous,03.10,00.00,03.10
02-Jan-2021,Miscellaneous,00.00,00.34,02.76
02-Jan-2021,Transfer,00.00,01.38,01.38
02-Jan-2021,Reversal,00.00,00.15,01.23
03-Jan-2021,Transfer,"213,791.00",00.00,"213,792.23"
03-Jan-2021,Purchase,18.00,00.00,"213,810.23"
03-Jan-2021,Miscellaneous,"46,922.00",00.00,"260,732.23"
04-Jan-2021,Tax,00.00,"26,073.22","234,659.01"
04-Jan-2021,Tax,00.00,"23,465.90","211,193.11"
04-Jan-2021,NEFT,57.05,00.00,"211,250.16"
04-Jan-2021,Bill,00.00,"23,472.24","187,777.92"
04-Jan-2021,NEFT,06.20,00.00,"187,784.12"
04-Jan-2021,Debit Card,10.00,00.00,"187,794.12"
04-Jan-2021,NEFT,11.80,00.00,"187,805.92"
04-Jan-2021,Miscellaneous,00.00,"37,561.18","150,244.74"
04-Jan-2021,Interest,"28,595.06",00.00,"178,839.80"
04-Jan-2021,Tax,00.00,"44,709.95","134,129.85"
04-Jan-2021,Reversal,00.00,"13,412.99","120,716.86"
04-Jan-2021,Reversal,00.00,"17,245.27","103,471.59"
04-Jan-2021,Interest,00.00,"10,347.16","93,124.43"
04-Jan-2021,ATM,00.00,"46,562.22","46,562.22"
04-Jan-2021,Tax,05.90,00.00,"46,568.12"
04-Jan-2021,Tax,00.00,"7,761.35","38,806.77"
04-Jan-2021,NEFT,00.00,"38,806.77",00.00
04-Jan-2021,Bill,03.00,00.00,03.00
04-Jan-2021,Debit Card,"2,444.18",00.00,"2,447.18"
04-Jan-2021,IMPS,02.57,00.00,"2,449.75"
04-Jan-2021,Transfer,"1,342.20",00.00,"3,791.95"
04-Jan-2021,Purchase,"32,761.00",00.00,"36,552.95"
04-Jan-2021,RTGS,"135,638.00",00.00,"172,190.95"
04-Jan-2021,Cash,00.00,"24,598.71","147,592.24"
04-Jan-2021,Bill,00.00,"49,197.41","98,394.83"
04-Jan-2021,Bill,00.00,"98,394.83",00.00
04-Jan-2021,Tax,"248,798.20",00.00,"248,798.20"
04-Jan-2021,Miscellaneous,00.00,"49,759.64","199,038.56"
04-Jan-2021,Commission,00.00,"66,346.19","132,692.37"
04-Jan-2021,Reversal,"820,494.75",00.00,"953,187.12"
04-Jan-2021,Transfer,387.00,00.00,"953,574.12"
04-Jan-2021,Purchase,00.00,"953,574.12",00.00
04-Jan-2021,ATM,"10,395.00",00.00,"10,395.00"
04-Jan-2021,Commission,00.00,"2,598.75","7,796.25"
04-Jan-2021,Cheque,00.00,"3,898.13","3,898.12"
04-Jan-2021,Tax,"141,319.25",00.00,"145,217.37"
04-Jan-2021,NEFT,00.00,"48,405.79","96,811.58"
04-Jan-2021,Cheque,"3,705.00",00.00,"100,516.58"
04-Jan-2021,Tax,05.00,00.00,"100,521.58"
04-Jan-2021,Reversal,"15,687.20",00.00,"116,208.78"
04-Jan-2021,Interest,00.00,"23,241.76","92,967.02"
04-Jan-2021,Interest,00.00,"9,296.70","83,670.32"
04-Jan-2021,Bill,00.00,"9,296.70","74,373.62"
04-Jan-2021,Commission,00.00,"14,874.72","59,498.90"
04-Jan-2021,Commission,00.00,"29,749.45","29,749.45"
04-Jan-2021,NEFT,15.30,00.00,"29,764.75"
04-Jan-2021,Cheque,07.00,00.00,"29,771.75"
04-Jan-2021,IMPS,"1,567,024.00",00.00,"1,596,795.75"
04-Jan-2021,Debit Card,00.00,"798,397.88","798,397.88"
04-Jan-2021,NEFT,00.00,"159,679.58","638,718.30"
04-Jan-2021,Cash,00.00,"106,453.05","532,265.25"
05-Jan-2021,Cheque,00.00,"266,132.63","266,132.62"
05-Jan-2021,Transfer,00.00,"26,613.26","239,519.36"
05-Jan-2021,Reversal,00.00,"239,519.36",00.00
05-Jan-2021,Debit Card,"3,464.10",00.00,"3,464.10"
05-Jan-2021,Transfer,00.00,"3,464.10",00.00
05-Jan-2021,Commission,07.21,00.00,07.21
05-Jan-2021,NEFT,"1,746,036.00",00.00,"1,746,043.21"
05-Jan-2021,Cheque,20.30,00.00,"1,746,063.51"
05-Jan-2021,Debit Card,00.00,"194,007.06","1,552,056.45"
05-Jan-2021,Tax,00.00,"155,205.65","1,396,850.80"
05-Jan-2021,Cash,"66,340.80",00.00,"1,463,191.60"
05-Jan-2021,Cheque,00.00,"1,463,191.60",00.00
05-Jan-2021,RTGS,05.00,00.00,05.00
06-Jan-2021,Cheque,"1,620,350.00",00.00,"1,620,355.00"
06-Jan-2021,Debit Card,00.00,"540,118.33","1,080,236.67"
06-Jan-2021,IMPS,218.60,00.00,"1,080,455.27"
06-Jan-2021,Debit Card,00.00,"154,350.75","926,104.52"
06-Jan-2021,Transfer,00.00,"115,763.07","810,341.46"
06-Jan-2021,Reversal,"17,649.70",00.00,"827,991.16"
06-Jan-2021,IMPS,00.00,"165,598.23","662,392.93"
06-Jan-2021,Cash,00.00,"165,598.23","496,794.70"
07-Jan-2021,Interest,453.90,00.00,"497,248.60"
07-Jan-2021,NEFT,00.00,"248,624.30","248,624.30"
07-Jan-2021,Cash,"1,347.00",00.00,"249,971.30"
07-Jan-2021,Cash,367.00,00.00,"250,338.30"
07-Jan-2021,NEFT,00.00,"250,338.30",00.00
07-Jan-2021,Cash,00.20,00.00,00.20
07-Jan-2021,RTGS,00.00,00.20,00.00
07-Jan-2021,Tax,"4,055.90",00.00,"4,055.90"
07-Jan-2021,Commission,00.00,579.41,"3,476.49"
07-Jan-2021,RTGS,00.00,869.12,"2,607.37"
07-Jan-2021,Cash,"197,729.40",00.00,"200,336.77"
07-Jan-2021,Purchase,00.00,"28,619.54","171,717.23"
07-Jan-2021,Debit Card,00.00,"17,171.72","154,545.51"
07-Jan-2021,IMPS,157.00,00.00,"154,702.51"
07-Jan-2021,RTGS,00.00,"51,567.50","103,135.01"
07-Jan-2021,Purchase,"21,359.00",00.00,"124,494.01"
07-Jan-2021,Cash,"3,133.94",00.00,"127,627.95"
07-Jan-2021,Commission,00.00,"21,271.33","106,356.62"
07-Jan-2021,Miscellaneous,00.00,"15,193.80","91,162.82"
07-Jan-2021,NEFT,"4,478.30",00.00,"95,641.12"
07-Jan-2021,Cash,"198,313.40",00.00,"293,954.52"
07-Jan-2021,IMPS,"39,591.80",00.00,"333,546.32"
07-Jan-2021,RTGS,00.00,"41,693.29","291,853.03"
07-Jan-2021,RTGS,00.00,"36,481.63","255,371.40"
07-Jan-2021,Debit Card,00.00,"127,685.70","127,685.70"
07-Jan-2021,RTGS,15.03,00.00,"127,700.73"
08-Jan-2021,Commission,00.00,"31,925.18","95,775.55"
08-Jan-2021,Commission,00.00,"31,925.18","63,850.37"
08-Jan-2021,ATM,"253,088.10",00.00,"316,938.47"
08-Jan-2021,NEFT,"393,860.80",00.00,"710,799.27"
08-Jan-2021,Miscellaneous,116.00,00.00,"710,915.27"
08-Jan-2021,Debit Card,00.00,"71,091.53","639,823.74"
08-Jan-2021,Bill,"28,877.00",00.00,"668,700.74"
08-Jan-2021,Transfer,"22,392.37",00.00,"691,093.11"
08-Jan-2021,Transfer,"7,353.20",00.00,"698,446.31"
08-Jan-2021,IMPS,00.00,"232,815.44","465,630.87"
08-Jan-2021,Reversal,"102,758.90",00.00,"568,389.77"
08-Jan-2021,IMPS,114.10,00.00,"568,503.87"
08-Jan-2021,Purchase,07.26,00.00,"568,511.13"
08-Jan-2021,RTGS,00.00,"568,511.13",00.00
08-Jan-2021,Reversal,04.00,00.00,04.00
08-Jan-2021,Debit Card,00.00,00.57,03.43
08-Jan-2021,Miscellaneous,00.00,03.43,00.00
08-Jan-2021,Purchase,04.00,00.00,04.00
08-Jan-2021,Cheque,40.00,00.00,44.00
08-Jan-2021,Commission,297.29,00.00,341.29
08-Jan-2021,Debit Card,00.00,170.65,170.64
08-Jan-2021,Interest,00.00,42.66,127.98
08-Jan-2021,ATM,"1,213,624.00",00.00,"1,213,751.98"
08-Jan-2021,Reversal,02.70,00.00,"1,213,754.68"
08-Jan-2021,Cheque,"1,669,369.50",00.00,"2,883,124.18"
08-Jan-2021,Debit Card,"1,013.00",00.00,"2,884,137.18"
08-Jan-2021,Bill,164.00,00.00,"2,884,301.18"
08-Jan-2021,Cash,"1,751,383.00",00.00,"4,635,684.18"
09-Jan-2021,Miscellaneous,236.79,00.00,"4,635,920.97"
09-Jan-2021,NEFT,00.20,00.00,"4,635,921.17"
09-Jan-2021,Transfer,396.00,00.00,"4,636,317.17"
09-Jan-2021,Purchase,00.00,"2,318,158.59","2,318,158.58"
09-Jan-2021,Debit Card,44.84,00.00,"2,318,203.42"
09-Jan-2021,IMPS,336.00,00.00,"2,318,539.42"
09-Jan-2021,Bill,00.00,"331,219.92","1,987,319.50"
09-Jan-2021,Transfer,00.00,"220,813.28","1,766,506.22"
09-Jan-2021,IMPS,51.00,00.00,"1,766,557.22"
09-Jan-2021,Reversal,446.00,00.00,"1,767,003.22"
09-Jan-2021,Transfer,00.00,"589,001.07","1,178,002.15"
09-Jan-2021,Bill,00.00,"392,667.38","785,334.77"
09-Jan-2021,NEFT,124.00,00.00,"785,458.77"
09-Jan-2021,IMPS,00.00,"112,208.40","673,250.37"
10-Jan-2021,Cash,00.00,"74,805.60","598,444.77"
10-Jan-2021,Interest,298.00,00.00,"598,742.77"
10-Jan-2021,Cheque,00.00,"199,580.92","399,161.85"
10-Jan-2021,RTGS,371.31,00.00,"399,533.16"
10-Jan-2021,NEFT,159.00,00.00,"399,692.16"
10-Jan-2021,Commission,916.10,00.00,"400,608.26"
10-Jan-2021,Commission,77.00,00.00,"400,685.26"
10-Jan-2021,Commission,00.00,"57,240.75","343,444.51"
10-Jan-2021,Tax,22.00,00.00,"343,466.51"
10-Jan-2021,Miscellaneous,03.80,00.00,"343,470.31"
10-Jan-2021,Miscellaneous,00.00,"171,735.16","171,735.16"
10-Jan-2021,NEFT,"1,520,862.20",00.00,"1,692,597.36"
10-Jan-2021,Miscellaneous,06.00,00.00,"1,692,603.36"
10-Jan-2021,NEFT,479.10,00.00,"1,693,082.46"
10-Jan-2021,Debit Card,"13,297.27",00.00,"1,706,379.73"
10-Jan-2021,Purchase,00.00,"568,793.24","1,137,586.49"
10-Jan-2021,Debit Card,00.00,"227,517.30","910,069.19"
10-Jan-2021,IMPS,00.00,"910,069.19",00.00
10-Jan-2021,ATM,"12,193.56",00.00,"12,193.56"
10-Jan-2021,Tax,00.00,"4,064.52","8,129.04"
10-Jan-2021,Purchase,03.72,00.00,"8,132.76"
10-Jan-2021,Cheque,"19,575.03",00.00,"27,707.79"
10-Jan-2021,Debit Card,00.00,"9,235.93","18,471.86"
10-Jan-2021,Purchase,40.00,00.00,"18,511.86"
10-Jan-2021,Transfer,00.00,"3,085.31","15,426.55"
10-Jan-2021,Commission,10.00,00.00,"15,436.55"
10-Jan-2021,NEFT,00.00,"1,715.17","13,721.38"
10-Jan-2021,Cash,08.00,00.00,"13,729.38"
10-Jan-2021,Interest,"2,442.00",00.00,"16,171.38"
10-Jan-2021,Reversal,"21,553.10",00.00,"37,724.48"
10-Jan-2021,Miscellaneous,67.30,00.00,"37,791.78"
10-Jan-2021,ATM,59.00,00.00,"37,850.78"
10-Jan-2021,Bill,150.00,00.00,"38,000.78"
10-Jan-2021,Cash,00.00,"4,222.31","33,778.47"
11-Jan-2021,Commission,48.85,00.00,"33,827.32"
11-Jan-2021,Cash,367.20,00.00,"34,194.52"
11-Jan-2021,Bill,00.00,"3,419.45","30,775.07"
11-Jan-2021,Cash,00.00,"3,419.45","27,355.62"
11-Jan-2021,Tax,00.00,"3,039.51","24,316.11"
11-Jan-2021,Debit Card,"22,068.80",00.00,"46,384.91"
12-Jan-2021,Purchase,00.00,"6,626.42","39,758.49"
12-Jan-2021,Bill,236.05,00.00,"39,994.54"
12-Jan-2021,Tax,00.00,"39,994.54",00.00
12-Jan-2021,Miscellaneous,"1,400,182.00",00.00,"1,400,182.00"
12-Jan-2021,IMPS,"118,376.00",00.00,"1,518,558.00"
12-Jan-2021,Tax,00.00,"1,518,558.00",00.00
12-Jan-2021,Miscellaneous,"1,075.83",00.00,"1,075.83"
12-Jan-2021,Cheque,00.00,153.69,922.14
12-Jan-2021,Tax,00.00,102.46,819.68
12-Jan-2021,Miscellaneous,00.00,136.61,683.07
12-Jan-2021,Cheque,"7,253.60",00.00,"7,936.67"
12-Jan-2021,IMPS,00.00,"3,968.34","3,968.34"
12-Jan-2021,Cash,00.00,396.83,"3,571.51"
12-Jan-2021,Reversal,"124,123.00",00.00,"127,694.51"
12-Jan-2021,Bill,"186,839.94",00.00,"314,534.45"
12-Jan-2021,ATM,00.00,"34,948.27","279,586.18"
12-Jan-2021,Cheque,30.97,00.00,"279,617.15"
12-Jan-2021,Cash,00.00,"27,961.72","251,655.44"
12-Jan-2021,RTGS,02.20,00.00,"251,657.64"
12-Jan-2021,Cash,00.00,"25,165.76","226,491.88"
12-Jan-2021,Purchase,"26,759.30",00.00,"253,251.18"
12-Jan-2021,Bill,"2,543.69",00.00,"255,794.87"
12-Jan-2021,Bill,"21,073.30",00.00,"276,868.17"
12-Jan-2021,Tax,"1,312,293.20",00.00,"1,589,161.37"
12-Jan-2021,ATM,00.00,"397,290.34","1,191,871.03"
12-Jan-2021,Debit Card,00.00,"148,983.88","1,042,887.15"
12-Jan-2021,RTGS,00.00,"347,629.05","695,258.10"
12-Jan-2021,Cheque,"3,245.00",00.00,"698,503.10"
12-Jan-2021,Interest,00.00,00.00,"698,503.10"
12-Jan-2021,Bill,00.00,"349,251.55","349,251.55"
12-Jan-2021,IMPS,00.00,"43,656.44","305,595.11"
12-Jan-2021,NEFT,"98,073.41",00.00,"403,668.52"
12-Jan-2021,Purchase,"2,205.70",00.00,"405,874.22"
12-Jan-2021,Cash,02.40,00.00,"405,876.62"
12-Jan-2021,Transfer,282.00,00.00,"406,158.62"
12-Jan-2021,RTGS,00.00,"45,128.74","361,029.88"
12-Jan-2021,ATM,00.00,"120,343.29","240,686.59"
12-Jan-2021,Reversal,"104,427.75",00.00,"345,114.34"
12-Jan-2021,NEFT,00.00,"172,557.17","172,557.17"
12-Jan-2021,Tax,00.00,"19,173.02","153,384.15"
12-Jan-2021,Transfer,02.00,00.00,"153,386.15"
12-Jan-2021,Miscellaneous,53.35,00.00,"153,439.50"
12-Jan-2021,NEFT,00.00,"19,179.94","134,259.56"
12-Jan-2021,Debit Card,00.00,"22,376.59","111,882.97"
12-Jan-2021,Cash,02.90,00.00,"111,885.87"
13-Jan-2021,Tax,00.00,"22,377.17","89,508.70"
13-Jan-2021,ATM,"3,566.00",00.00,"93,074.70"
13-Jan-2021,Miscellaneous,13.60,00.00,"93,088.30"
13-Jan-2021,Tax,00.00,"46,544.15","46,544.15"
13-Jan-2021,Bill,683.60,00.00,"47,227.75"
13-Jan-2021,Tax,"22,248.29",00.00,"69,476.04"
13-Jan-2021,Tax,00.00,"11,579.34","57,896.70"
13-Jan-2021,Debit Card,"1,283,756.00",00.00,"1,341,652.70"
14-Jan-2021,Purchase,"29,545.90",00.00,"1,371,198.60"
14-Jan-2021,ATM,"138,102.00",00.00,"1,509,300.60"
14-Jan-2021,Purchase,00.00,"251,550.10","1,257,750.50"
14-Jan-2021,Miscellaneous,00.00,"139,750.06","1,118,000.44"
14-Jan-2021,Bill,"258,730.75",00.00,"1,376,731.19"
14-Jan-2021,Reversal,"1,010,920.50",00.00,"2,387,651.69"
14-Jan-2021,Debit Card,00.00,"298,456.46","2,089,195.23"
14-Jan-2021,IMPS,00.00,"522,298.81","1,566,896.42"
14-Jan-2021,ATM,00.00,"1,566,896.42",00.00
14-Jan-2021,Purchase,"3,341.00",00.00,"3,341.00"
14-Jan-2021,Reversal,00.00,556.83,"2,784.17"
14-Jan-2021,IMPS,37.00,00.00,"2,821.17"
14-Jan-2021,ATM,"1,543,409.00",00.00,"1,546,230.17"
14-Jan-2021,Interest,00.00,"257,705.03","1,288,525.14"
14-Jan-2021,Tax,467.30,00.00,"1,288,992.44"
15-Jan-2021,ATM,00.00,"322,248.11","966,744.33"
15-Jan-2021,Tax,00.00,"120,843.04","845,901.29"
15-Jan-2021,Commission,45.90,00.00,"845,947.19"
15-Jan-2021,Miscellaneous,00.00,"105,743.40","740,203.79"
15-Jan-2021,Commission,00.00,"123,367.30","616,836.49"
15-Jan-2021,Cheque,222.00,00.00,"617,058.49"
16-Jan-2021,Purchase,00.00,"154,264.62","462,793.87"
16-Jan-2021,Tax,00.00,"154,264.62","308,529.25"
17-Jan-2021,NEFT,00.00,"77,132.31","231,396.94"
17-Jan-2021,ATM,00.00,"57,849.24","173,547.70"
17-Jan-2021,Interest,30.00,00.00,"173,577.70"
18-Jan-2021,Tax,00.00,"43,394.43","130,183.28"
18-Jan-2021,RTGS,"496,697.00",00.00,"626,880.28"
18-Jan-2021,ATM,19.56,00.00,"626,899.84"
18-Jan-2021,Bill,00.00,"69,655.54","557,244.30"
18-Jan-2021,Miscellaneous,"156,734.28",00.00,"713,978.58"
18-Jan-2021,NEFT,05.86,00.00,"713,984.44"
18-Jan-2021,IMPS,00.00,"237,994.81","475,989.63"
18-Jan-2021,Cash,00.00,"79,331.61","396,658.02"
18-Jan-2021,RTGS,"16,901.30",00.00,"413,559.32"
18-Jan-2021,Purchase,275.80,00.00,"413,835.12"
18-Jan-2021,Bill,320.67,00.00,"414,155.79"
18-Jan-2021,Tax,10.57,00.00,"414,166.36"
18-Jan-2021,Cash,00.00,"207,083.18","207,083.18"
18-Jan-2021,Debit Card,00.00,"25,885.40","181,197.78"
18-Jan-2021,Reversal,00.00,"90,598.89","90,598.89"
18-Jan-2021,Cheque,00.00,"12,942.70","77,656.19"
18-Jan-2021,Commission,51.56,00.00,"77,707.75"
18-Jan-2021,Interest,00.00,"15,541.55","62,166.20"
18-Jan-2021,Tax,00.00,"10,361.03","51,805.17"
18-Jan-2021,Bill,"19,858.40",00.00,"71,663.57"
18-Jan-2021,ATM,00.00,"35,831.79","35,831.79"
19-Jan-2021,ATM,00.00,"17,915.90","17,915.90"
19-Jan-2021,Interest,07.50,00.00,"17,923.40"
19-Jan-2021,IMPS,417.60,00.00,"18,341.00"
19-Jan-2021,Tax,61.82,00.00,"18,402.82"
19-Jan-2021,Miscellaneous,"1,208.00",00.00,"19,610.82"
19-Jan-2021,Debit Card,00.00,"6,536.94","13,073.88"
19-Jan-2021,Bill,00.00,"1,634.24","11,439.64"
19-Jan-2021,Commission,49.00,00.00,"11,488.64"
19-Jan-2021,Commission,00.00,"1,276.52","10,212.12"
19-Jan-2021,ATM,00.00,"1,134.68","9,077.44"
19-Jan-2021,Miscellaneous,"503,495.50",00.00,"512,572.94"
19-Jan-2021,Transfer,00.00,"512,572.94",00.00
19-Jan-2021,ATM,299.75,00.00,299.75
19-Jan-2021,Commission,"1,634,069.00",00.00,"1,634,368.75"
19-Jan-2021,Debit Card,"150,744.00",00.00,"1,785,112.75"
19-Jan-2021,Transfer,00.00,"223,139.09","1,561,973.66"
19-Jan-2021,Interest,00.00,"156,197.37","1,405,776.29"
19-Jan-2021,Reversal,00.00,"281,155.26","1,124,621.03"
19-Jan-2021,Miscellaneous,"13,449.50",00.00,"1,138,070.53"
19-Jan-2021,ATM,100.00,00.00,"1,138,170.53"
19-Jan-2021,Reversal,00.00,"569,085.27","569,085.26"
19-Jan-2021,Reversal,00.00,"569,085.26",00.00
19-Jan-2021,Interest,"134,552.50",00.00,"134,552.50"
19-Jan-2021,Bill,63.00,00.00,"134,615.50"
19-Jan-2021,Transfer,463.60,00.00,"135,079.10"
19-Jan-2021,Cash,00.00,"45,026.37","90,052.73"
19-Jan-2021,Tax,234.23,00.00,"90,286.96"
19-Jan-2021,Commission,00.00,"90,286.96",00.00
19-Jan-2021,Purchase,489.44,00.00,489.44
19-Jan-2021,Tax,"850,208.75",00.00,"850,698.19"
19-Jan-2021,Cash,00.00,"121,528.31","729,169.88"
19-Jan-2021,Reversal,00.00,"104,167.13","625,002.75"
19-Jan-2021,Commission,00.00,"125,000.55","500,002.20"
19-Jan-2021,Reversal,00.00,"166,667.40","333,334.80"
19-Jan-2021,Bill,00.00,"166,667.40","166,667.40"
19-Jan-2021,Tax,00.00,"55,555.80","111,111.60"
19-Jan-2021,Cheque,23.80,00.00,"111,135.40"
19-Jan-2021,Commission,"1,837.00",00.00,"112,972.40"
19-Jan-2021,NEFT,00.00,"12,552.49","100,419.91"
19-Jan-2021,NEFT,"1,200.94",00.00,"101,620.85"
19-Jan-2021,Tax,"97,799.80",00.00,"199,420.65"
19-Jan-2021,RTGS,00.00,"24,927.58","174,493.07"
19-Jan-2021,Purchase,487.00,00.00,"174,980.07"
19-Jan-2021,Commission,"32,241.49",00.00,"207,221.56"
19-Jan-2021,Tax,00.00,"20,722.16","186,499.40"
19-Jan-2021,NEFT,08.00,00.00,"186,507.40"
19-Jan-2021,Reversal,00.00,"31,084.57","155,422.83"
19-Jan-2021,Purchase,00.00,"17,269.20","138,153.63"
19-Jan-2021,NEFT,00.00,"13,815.36","124,338.27"
19-Jan-2021,Commission,"38,776.00",00.00,"163,114.27"
19-Jan-2021,Bill,00.00,"16,311.43","146,802.84"
19-Jan-2021,Bill,"95,120.70",00.00,"241,923.54"
19-Jan-2021,Purchase,00.00,"60,480.89","181,442.66"
20-Jan-2021,Debit Card,00.00,"90,721.33","90,721.33"
20-Jan-2021,Tax,07.40,00.00,"90,728.73"
20-Jan-2021,RTGS,"3,778.30",00.00,"94,507.03"
20-Jan-2021,Bill,"2,304.30",00.00,"96,811.33"
20-Jan-2021,Purchase,00.00,"48,405.67","48,405.66"
20-Jan-2021,Transfer,00.00,"6,050.71","42,354.95"
20-Jan-2021,Purchase,"30,940.68",00.00,"73,295.63"
20-Jan-2021,Cash,00.00,"8,143.96","65,151.67"
20-Jan-2021,Commission,"4,524.89",00.00,"69,676.56"
20-Jan-2021,Commission,17.60,00.00,"69,694.16"
20-Jan-2021,RTGS,"14,337.70",00.00,"84,031.86"
20-Jan-2021,Miscellaneous,00.00,"9,336.87","74,694.99"
20-Jan-2021,Commission,00.00,"12,449.17","62,245.82"
20-Jan-2021,IMPS,257.50,00.00,"62,503.32"
20-Jan-2021,Bill,00.00,"12,500.66","50,002.66"
20-Jan-2021,Transfer,"1,033,227.00",00.00,"1,083,229.66"
20-Jan-2021,Reversal,41.00,00.00,"1,083,270.66"
20-Jan-2021,NEFT,00.00,"361,090.22","722,180.44"
20-Jan-2021,Commission,06.10,00.00,"722,186.54"
20-Jan-2021,Tax,00.00,"80,242.95","641,943.59"
20-Jan-2021,Interest,"210,314.20",00.00,"852,257.79"
20-Jan-2021,IMPS,22.30,00.00,"852,280.09"
20-Jan-2021,Interest,00.00,"852,280.09",00.00
21-Jan-2021,Purchase,"2,048,961.00",00.00,"2,048,961.00"
21-Jan-2021,IMPS,221.20,00.00,"2,049,182.20"
22-Jan-2021,Bill,00.00,"341,530.37","1,707,651.83"
22-Jan-2021,NEFT,"1,144,762.25",00.00,"2,852,414.08"
22-Jan-2021,Bill,"2,237.02",00.00,"2,854,651.10"
22-Jan-2021,Reversal,101.43,00.00,"2,854,752.53"
22-Jan-2021,Cheque,"1,640,718.00",00.00,"4,495,470.53"
22-Jan-2021,NEFT,"1,615,389.20",00.00,"6,110,859.73"
22-Jan-2021,Cash,"1,767.86",00.00,"6,112,627.59"
22-Jan-2021,ATM,00.00,"873,232.51","5,239,395.08"
22-Jan-2021,Cash,00.00,"873,232.51","4,366,162.57"
22-Jan-2021,Commission,"2,713.60",00.00,"4,368,876.17"
22-Jan-2021,Tax,00.00,"873,775.23","3,495,100.94"
22-Jan-2021,Cheque,00.00,"699,020.19","2,796,080.75"
22-Jan-2021,Reversal,00.00,"466,013.46","2,330,067.29"
23-Jan-2021,Reversal,00.00,"776,689.10","1,553,378.19"
23-Jan-2021,Cheque,"200,917.62",00.00,"1,754,295.81"
23-Jan-2021,Miscellaneous,"1,923.00",00.00,"1,756,218.81"
23-Jan-2021,Bill,00.00,"439,054.70","1,317,164.11"
23-Jan-2021,Tax,00.00,"439,054.70","878,109.41"
23-Jan-2021,ATM,02.00,00.00,"878,111.41"
23-Jan-2021,NEFT,"2,361.70",00.00,"880,473.11"
23-Jan-2021,NEFT,00.00,"146,745.52","733,727.59"
23-Jan-2021,NEFT,00.00,"244,575.86","489,151.73"
23-Jan-2021,RTGS,00.00,"97,830.35","391,321.38"
23-Jan-2021,Debit Card,"1,276,439.00",00.00,"1,667,760.38"
23-Jan-2021,IMPS,00.00,"238,251.48","1,429,508.90"
23-Jan-2021,Debit Card,"2,884.71",00.00,"1,432,393.61"
23-Jan-2021,Purchase,00.00,"143,239.36","1,289,154.25"
23-Jan-2021,Tax,00.00,"161,144.28","1,128,009.97"
23-Jan-2021,Cheque,11.43,00.00,"1,128,021.40"
23-Jan-2021,Purchase,"1,762,191.20",00.00,"2,890,212.60"
23-Jan-2021,Interest,"2,130.00",00.00,"2,892,342.60"
23-Jan-2021,Tax,00.00,"321,371.40","2,570,971.20"
23-Jan-2021,Cheque,"1,562.90",00.00,"2,572,534.10"
23-Jan-2021,Cheque,05.20,00.00,"2,572,539.30"
23-Jan-2021,RTGS,"122,588.50",00.00,"2,695,127.80"
23-Jan-2021,Miscellaneous,00.00,"673,781.95","2,021,345.85"
23-Jan-2021,ATM,00.00,"252,668.23","1,768,677.62"
23-Jan-2021,Debit Card,10.69,00.00,"1,768,688.31"
23-Jan-2021,Debit Card,"29,391.00",00.00,"1,798,079.31"
23-Jan-2021,Commission,00.00,"599,359.77","1,198,719.54"
23-Jan-2021,Purchase,00.00,"199,786.59","998,932.95"
23-Jan-2021,IMPS,63.10,00.00,"998,996.05"
23-Jan-2021,Cheque,00.00,"199,799.21","799,196.84"
23-Jan-2021,Interest,00.00,"799,196.84",00.00
23-Jan-2021,Cheque,"243,835.50",00.00,"243,835.50"
23-Jan-2021,RTGS,404.40,00.00,"244,239.90"
23-Jan-2021,IMPS,00.00,"40,706.65","203,533.25"
23-Jan-2021,Interest,00.00,"101,766.63","101,766.62"
23-Jan-2021,RTGS,00.00,"16,961.10","84,805.52"
23-Jan-2021,ATM,"1,759,646.20",00.00,"1,844,451.72"
23-Jan-2021,Cash,00.00,"368,890.34","1,475,561.38"
23-Jan-2021,Transfer,00.00,"1,475,561.38",00.00
23-Jan-2021,ATM,11.43,00.00,11.43
23-Jan-2021,Cash,00.00,02.29,09.14
23-Jan-2021,ATM,443.48,00.00,452.62
23-Jan-2021,NEFT,483.00,00.00,935.62
23-Jan-2021,ATM,00.00,93.56,842.06
23-Jan-2021,Cheque,00.00,120.29,721.77
23-Jan-2021,Transfer,"776,390.00",00.00,"777,111.77"
23-Jan-2021,ATM,"509,569.75",00.00,"1,286,681.52"
23-Jan-2021,Cash,00.00,"643,340.76","643,340.76"
23-Jan-2021,Cheque,"463,655.20",00.00,"1,106,995.96"
23-Jan-2021,Commission,02.00,00.00,"1,106,997.96"
23-Jan-2021,Debit Card,"256,750.59",00.00,"1,363,748.55"
23-Jan-2021,Debit Card,00.00,"170,468.57","1,193,279.98"
23-Jan-2021,Bill,"237,341.28",00.00,"1,430,621.26"
23-Jan-2021,Tax,"15,214.90",00.00,"1,445,836.16"
23-Jan-2021,Tax,00.00,"481,945.39","963,890.77"
24-Jan-2021,Tax,"168,440.00",00.00,"1,132,330.77"
24-Jan-2021,Interest,"79,401.70",00.00,"1,211,732.47"
24-Jan-2021,Purchase,"1,381,799.00",00.00,"2,593,531.47"
24-Jan-2021,Bill,"26,476.92",00.00,"2,620,008.39"
24-Jan-2021,Reversal,52.00,00.00,"2,620,060.39"
24-Jan-2021,Reversal,00.00,"374,294.34","2,245,766.05"
25-Jan-2021,Cash,00.00,"1,122,883.03","1,122,883.02"
25-Jan-2021,ATM,00.00,"140,360.38","982,522.64"
25-Jan-2021,IMPS,02.00,00.00,"982,524.64"
25-Jan-2021,Cheque,00.00,"327,508.21","655,016.43"
25-Jan-2021,Miscellaneous,11.00,00.00,"655,027.43"
25-Jan-2021,Transfer,"30,406.00",00.00,"685,433.43"
25-Jan-2021,IMPS,346.77,00.00,"685,780.20"
25-Jan-2021,Miscellaneous,00.00,"68,578.02","617,202.18"
25-Jan-2021,NEFT,499.32,00.00,"617,701.50"
25-Jan-2021,Reversal,"1,329,555.80",00.00,"1,947,257.30"
25-Jan-2021,Miscellaneous,00.00,"1,947,257.30",00.00
26-Jan-2021,Commission,"198,563.16",00.00,"198,563.16"
26-Jan-2021,Miscellaneous,00.00,"28,366.17","170,196.99"
27-Jan-2021,Transfer,00.00,"17,019.70","153,177.29"
27-Jan-2021,Tax,00.00,"17,019.70","136,157.59"
28-Jan-2021,NEFT,00.00,"45,385.86","90,771.73"
28-Jan-2021,Reversal,62.59,00.00,"90,834.32"
28-Jan-2021,Reversal,81.00,00.00,"90,915.32"
28-Jan-2021,ATM,00.00,"45,457.66","45,457.66"
28-Jan-2021,Transfer,00.00,"4,545.77","40,911.89"
29-Jan-2021,Tax,00.00,"40,911.89",00.00
29-Jan-2021,RTGS,301.35,00.00,301.35
29-Jan-2021,Cash,00.00,75.34,226.01
29-Jan-2021,Tax,00.00,226.01,00.00
29-Jan-2021,Miscellaneous,"600,212.00",00.00,"600,212.00"
29-Jan-2021,Commission,00.00,"75,026.50","525,185.50"
29-Jan-2021,NEFT,00.00,"262,592.75","262,592.75"
29-Jan-2021,Transfer,00.00,"26,259.28","236,333.48"
29-Jan-2021,IMPS,46.00,00.00,"236,379.48"
29-Jan-2021,RTGS,00.00,"236,379.48",00.00
30-Jan-2021,Debit Card,03.00,00.00,03.00
30-Jan-2021,Transfer,194.90,00.00,197.90
30-Jan-2021,RTGS,02.50,00.00,200.40
30-Jan-2021,IMPS,00.00,100.20,100.20
30-Jan-2021,IMPS,"23,052.70",00.00,"23,152.90"
30-Jan-2021,RTGS,03.00,00.00,"23,155.90"
30-Jan-2021,Tax,00.00,"2,894.49","20,261.41"
30-Jan-2021,Purchase,"2,274.00",00.00,"22,535.41"
30-Jan-2021,Interest,"1,849.00",00.00,"24,384.41"
30-Jan-2021,Purchase,03.00,00.00,"24,387.41"
30-Jan-2021,Bill,"3,035.00",00.00,"27,422.41"
30-Jan-2021,RTGS,"52,757.47",00.00,"80,179.88"
30-Jan-2021,Cheque,00.00,"8,908.88","71,271.00"
30-Jan-2021,Debit Card,"3,721.35",00.00,"74,992.35"
30-Jan-2021,Purchase,00.00,"14,998.47","59,993.88"
30-Jan-2021,ATM,00.00,"7,499.24","52,494.64"
30-Jan-2021,RTGS,540.24,00.00,"53,034.88"
30-Jan-2021,Bill,"557,364.25",00.00,"610,399.13"
30-Jan-2021,Reversal,00.00,"122,079.83","488,319.30"
30-Jan-2021,Bill,02.00,00.00,"488,321.30"
31-Jan-2021,Debit Card,00.00,"61,040.16","427,281.14"
31-Jan-2021,Cheque,326.65,00.00,"427,607.79"
31-Jan-2021,Miscellaneous,00.00,"71,267.97","356,339.82"
31-Jan-2021,IMPS,27.00,00.00,"356,366.82"
31-Jan-2021,Interest,"247,194.31",00.00,"603,561.13"
31-Jan-2021,Transfer,54.00,00.00,"603,615.13"
31-Jan-2021,Transfer,350.00,00.00,"603,965.13"
31-Jan-2021,Cheque,"18,765.00",00.00,"622,730.13"
31-Jan-2021,Tax,63.00,00.00,"622,793.13"
31-Jan-2021,Tax,06.00,00.00,"622,799.13"
31-Jan-2021,NEFT,00.00,"62,279.91","560,519.22"
31-Jan-2021,Debit Card,00.00,"80,074.17","480,445.05"
31-Jan-2021,Debit Card,00.00,"48,044.51","432,400.54"
31-Jan-2021,Bill,00.00,"43,240.05","389,160.49"
31-Jan-2021,Transfer,"3,229.44",00.00,"392,389.93"
31-Jan-2021,Commission,36.00,00.00,"392,425.93"
31-Jan-2021,Miscellaneous,00.00,"130,808.64","261,617.29"
31-Jan-2021,Cash,00.00,"29,068.59","232,548.70"
31-Jan-2021,ATM,00.00,"33,221.24","199,327.46"
31-Jan-2021,Transfer,00.00,"24,915.93","174,411.53"
31-Jan-2021,Bill,00.00,"24,915.93","149,495.60"
31-Jan-2021,Interest,00.00,"18,686.95","130,808.65"
31-Jan-2021,Debit Card,00.00,"26,161.73","104,646.92"
31-Jan-2021,Tax,00.00,"20,929.38","83,717.54"
31-Jan-2021,RTGS,00.00,"16,743.51","66,974.03"
31-Jan-2021,ATM,00.00,"9,567.72","57,406.31"
31-Jan-2021,Bill,197.00,00.00,"57,603.31"
31-Jan-2021,RTGS,"1,485.00",00.00,"59,088.31"
31-Jan-2021,IMPS,00.00,"11,817.66","47,270.65"
31-Jan-2021,Interest,"17,551.19",00.00,"64,821.84"
31-Jan-2021,Interest,"2,485.00",00.00,"67,306.84"
31-Jan-2021,Transfer,"268,746.00",00.00,"336,052.84"
31-Jan-2021,Cheque,00.00,"37,339.20","298,713.64"
31-Jan-2021,Cheque,89.00,00.00,"298,802.64"
31-Jan-2021,Cash,"1,061,625.00",00.00,"1,360,427.64"
31-Jan-2021,Purchase,14.60,00.00,"1,360,442.24"
31-Jan-2021,Commission,02.83,00.00,"1,360,445.07"
31-Jan-2021,NEFT,00.00,"1,360,445.07",00.00
31-Jan-2021,Tax,"13,289.10",00.00,"13,289.10"
01-Feb-2021,IMPS,"1,883.00",00.00,"15,172.10"
01-Feb-2021,Interest,"2,041,286.00",00.00,"2,056,458.10"
01-Feb-2021,IMPS,41.00,00.00,"2,056,499.10"
01-Feb-2021,Debit Card,"31,404.73",00.00,"2,087,903.83"
01-Feb-2021,NEFT,"1,845.80",00.00,"2,089,749.63"
01-Feb-2021,Purchase,204.80,00.00,"2,089,954.43"
01-Feb-2021,Cash,442.00,00.00,"2,090,396.43"
01-Feb-2021,Reversal,00.00,"696,798.81","1,393,597.62"
01-Feb-2021,Cash,"40,618.72",00.00,"1,434,216.34"
01-Feb-2021,Commission,"138,683.40",00.00,"1,572,899.74"
01-Feb-2021,Bill,00.00,"224,699.96","1,348,199.78"
01-Feb-2021,Cash,00.00,"269,639.96","1,078,559.82"
01-Feb-2021,Debit Card,00.00,"269,639.96","808,919.86"
01-Feb-2021,Bill,00.00,"80,891.99","728,027.87"
01-Feb-2021,IMPS,00.00,"80,891.99","647,135.88"
01-Feb-2021,Purchase,00.00,"71,903.99","575,231.89"
02-Feb-2021,Debit Card,667.00,00.00,"575,898.89"
02-Feb-2021,Commission,04.00,00.00,"575,902.89"
02-Feb-2021,Interest,00.00,"63,989.21","511,913.68"
02-Feb-2021,Miscellaneous,00.00,"255,956.84","255,956.84"
02-Feb-2021,Tax,"1,083,022.75",00.00,"1,338,979.59"
02-Feb-2021,Cheque,00.00,"191,282.80","1,147,696.79"
02-Feb-2021,Cash,"1,601,124.00",00.00,"2,748,820.79"
02-Feb-2021,ATM,08.20,00.00,"2,748,828.99"
02-Feb-2021,Miscellaneous,"2,797.44",00.00,"2,751,626.43"
02-Feb-2021,Bill,00.00,"1,375,813.22","1,375,813.22"
02-Feb-2021,Interest,"1,072.80",00.00,"1,376,886.02"
02-Feb-2021,Reversal,00.00,"172,110.75","1,204,775.27"
02-Feb-2021,Reversal,"198,650.59",00.00,"1,403,425.86"
02-Feb-2021,IMPS,150.00,00.00,"1,403,575.86"
02-Feb-2021,IMPS,"777,034.25",00.00,"2,180,610.11"
02-Feb-2021,Bill,00.00,"726,870.04","1,453,740.07"
02-Feb-2021,NEFT,00.00,"726,870.04","726,870.04"
02-Feb-2021,Debit Card,00.00,"80,763.34","646,106.70"
02-Feb-2021,Reversal,00.00,"215,368.90","430,737.80"
02-Feb-2021,Tax,00.00,"47,859.76","382,878.04"
02-Feb-2021,Interest,09.80,00.00,"382,887.84"
02-Feb-2021,ATM,00.00,"382,887.84",00.00
02-Feb-2021,ATM,"19,530.75",00.00,"19,530.75"
02-Feb-2021,Tax,33.00,00.00,"19,563.75"
02-Feb-2021,Reversal,"10,026.00",00.00,"29,589.75"
02-Feb-2021,Interest,00.00,"5,917.95","23,671.80"
02-Feb-2021,Reversal,"518,227.25",00.00,"541,899.05"
02-Feb-2021,Reversal,00.00,"67,737.38","474,161.67"
03-Feb-2021,Interest,116.90,00.00,"474,278.57"
03-Feb-2021,RTGS,00.00,"237,139.29","237,139.28"
03-Feb-2021,Cheque,00.00,"39,523.21","197,616.07"
03-Feb-2021,Tax,"1,550,472.00",00.00,"1,748,088.07"
03-Feb-2021,Interest,"15,038.47",00.00,"1,763,126.54"
03-Feb-2021,Miscellaneous,"3,343.90",00.00,"1,766,470.44"
04-Feb-2021,RTGS,03.00,00.00,"1,766,473.44"
04-Feb-2021,NEFT,00.00,"294,412.24","1,472,061.20"
04-Feb-2021,Purchase,"250,709.00",00.00,"1,722,770.20"
04-Feb-2021,NEFT,00.00,"344,554.04","1,378,216.16"
04-Feb-2021,Cash,00.00,"196,888.02","1,181,328.14"
04-Feb-2021,Cheque,"206,047.75",00.00,"1,387,375.89"
04-Feb-2021,Debit Card,"20,239.90",00.00,"1,407,615.79"
04-Feb-2021,Purchase,"1,183.00",00.00,"1,408,798.79"
04-Feb-2021,Interest,"2,669.00",00.00,"1,411,467.79"
04-Feb-2021,Cheque,07.00,00.00,"1,411,474.79"
04-Feb-2021,Miscellaneous,"1,596,909.00",00.00,"3,008,383.79"
04-Feb-2021,ATM,00.00,"501,397.30","2,506,986.49"
04-Feb-2021,Miscellaneous,04.80,00.00,"2,506,991.29"
04-Feb-2021,Bill,"1,731,572.00",00.00,"4,238,563.29"
04-Feb-2021,Bill,00.00,"847,712.66","3,390,850.63"
04-Feb-2021,Bill,156.00,00.00,"3,391,006.63"
04-Feb-2021,Cheque,00.00,"847,751.66","2,543,254.97"
04-Feb-2021,Bill,32.00,00.00,"2,543,286.97"
04-Feb-2021,ATM,00.00,"423,881.16","2,119,405.81"
04-Feb-2021,Interest,"161,686.00",00.00,"2,281,091.81"
04-Feb-2021,Bill,01.34,00.00,"2,281,093.15"
04-Feb-2021,NEFT,"579,434.00",00.00,"2,860,527.15"
04-Feb-2021,Miscellaneous,00.00,"953,509.05","1,907,018.10"
04-Feb-2021,Cash,00.00,"317,836.35","1,589,181.75"
04-Feb-2021,Miscellaneous,00.00,"264,863.63","1,324,318.12"
04-Feb-2021,Cash,"14,950.00",00.00,"1,339,268.12"
04-Feb-2021,Bill,00.00,"223,211.35","1,116,056.77"
04-Feb-2021,Miscellaneous,334.00,00.00,"1,116,390.77"
04-Feb-2021,Tax,274.32,00.00,"1,116,665.09"
04-Feb-2021,NEFT,00.00,"124,073.90","992,591.19"
04-Feb-2021,Cheque,"29,300.20",00.00,"1,021,891.39"
04-Feb-2021,Purchase,00.00,"510,945.70","510,945.70"
04-Feb-2021,ATM,00.00,"255,472.85","255,472.85"
04-Feb-2021,RTGS,00.00,"255,472.85",00.00
04-Feb-2021,Commission,03.50,00.00,03.50
04-Feb-2021,Reversal,33.00,00.00,36.50
04-Feb-2021,RTGS,00.00,36.50,00.00
04-Feb-2021,Cheque,02.70,00.00,02.70
04-Feb-2021,NEFT,00.00,00.39,02.31
04-Feb-2021,Tax,00.00,01.16,01.16
04-Feb-2021,Transfer,00.70,00.00,01.86
04-Feb-2021,Interest,06.00,00.00,07.86
04-Feb-2021,Tax,506.00,00.00,513.86
04-Feb-2021,Cheque,00.00,64.23,449.63
04-Feb-2021,Interest,30.50,00.00,480.13
04-Feb-2021,Cash,00.00,480.13,00.00
04-Feb-2021,Debit Card,104.00,00.00,104.00
04-Feb-2021,Transfer,78.24,00.00,182.24
04-Feb-2021,Purchase,"2,633.40",00.00,"2,815.64"
04-Feb-2021,Tax,"2,164.40",00.00,"4,980.04"
04-Feb-2021,Cash,"9,615.00",00.00,"14,595.04"
04-Feb-2021,Cheque,"242,209.00",00.00,"256,804.04"
04-Feb-2021,RTGS,00.00,"42,800.67","214,003.37"
04-Feb-2021,IMPS,00.00,"71,334.46","142,668.91"
05-Feb-2021,IMPS,318.79,00.00,"142,987.70"
05-Feb-2021,Tax,00.00,"15,887.52","127,100.18"
05-Feb-2021,Purchase,20.00,00.00,"127,120.18"
05-Feb-2021,Reversal,00.00,"42,373.39","84,746.79"
05-Feb-2021,IMPS,00.00,"12,106.68","72,640.11"
05-Feb-2021,Commission,"780,894.50",00.00,"853,534.61"
05-Feb-2021,Reversal,00.00,"142,255.77","711,278.84"
05-Feb-2021,Transfer,00.00,"79,030.98","632,247.86"
05-Feb-2021,Miscellaneous,"1,734.00",00.00,"633,981.86"
05-Feb-2021,IMPS,00.00,"211,327.29","422,654.57"
05-Feb-2021,Tax,00.00,"46,961.62","375,692.95"
05-Feb-2021,Debit Card,00.00,"93,923.24","281,769.71"
05-Feb-2021,Debit Card,355.68,00.00,"282,125.39"
05-Feb-2021,Purchase,361.00,00.00,"282,486.39"
05-Feb-2021,IMPS,"2,847.09",00.00,"285,333.48"
05-Feb-2021,Reversal,"135,318.00",00.00,"420,651.48"
05-Feb-2021,ATM,"2,567.00",00.00,"423,218.48"
05-Feb-2021,Interest,240.00,00.00,"423,458.48"
05-Feb-2021,Debit Card,00.00,"105,864.62","317,593.86"
06-Feb-2021,Bill,00.00,"158,796.93","158,796.93"
06-Feb-2021,Interest,00.00,"79,398.47","79,398.46"
07-Feb-2021,Tax,"1,632,394.50",00.00,"1,711,792.96"
07-Feb-2021,Bill,382.60,00.00,"1,712,175.56"
07-Feb-2021,Commission,"143,284.50",00.00,"1,855,460.06"
07-Feb-2021,Bill,00.00,"265,065.72","1,590,394.34"
07-Feb-2021,Miscellaneous,08.00,00.00,"1,590,402.34"
07-Feb-2021,Debit Card,00.00,"159,040.23","1,431,362.11"
07-Feb-2021,Tax,00.00,"178,920.26","1,252,441.85"
07-Feb-2021,Debit Card,00.00,"417,480.62","834,961.23"
07-Feb-2021,Commission,00.00,"119,280.18","715,681.05"
07-Feb-2021,Bill,"146,383.03",00.00,"862,064.08"
07-Feb-2021,Bill,00.00,"215,516.02","646,548.06"
07-Feb-2021,Reversal,"75,575.00",00.00,"722,123.06"
07-Feb-2021,ATM,00.00,"80,235.90","641,887.16"
07-Feb-2021,Cash,"63,587.00",00.00,"705,474.16"
07-Feb-2021,Reversal,60.00,00.00,"705,534.16"
07-Feb-2021,Reversal,00.00,"352,767.08","352,767.08"
07-Feb-2021,Reversal,00.00,"39,196.34","313,570.74"
07-Feb-2021,RTGS,00.00,"104,523.58","209,047.16"
07-Feb-2021,Tax,00.00,"34,841.19","174,205.97"
07-Feb-2021,Debit Card,00.00,"43,551.49","130,654.48"
07-Feb-2021,Debit Card,00.00,"16,331.81","114,322.67"
07-Feb-2021,Bill,00.00,"11,432.27","102,890.40"
07-Feb-2021,Cheque,60.41,00.00,"102,950.81"
07-Feb-2021,RTGS,00.00,"20,590.16","82,360.65"
07-Feb-2021,Cheque,00.00,"10,295.08","72,065.57"
07-Feb-2021,Commission,02.04,00.00,"72,067.61"
07-Feb-2021,IMPS,"23,025.00",00.00,"95,092.61"
07-Feb-2021,Purchase,"52,712.22",00.00,"147,804.83"
07-Feb-2021,RTGS,00.00,"14,780.48","133,024.35"
07-Feb-2021,Miscellaneous,00.00,"66,512.18","66,512.18"
07-Feb-2021,RTGS,06.60,00.00,"66,518.78"
07-Feb-2021,Reversal,"239,668.80",00.00,"306,187.58"
07-Feb-2021,Commission,00.00,"76,546.90","229,640.68"
07-Feb-2021,ATM,01.00,00.00,"229,641.68"
07-Feb-2021,RTGS,00.00,"114,820.84","114,820.84"
08-Feb-2021,Interest,00.00,"57,410.42","57,410.42"
08-Feb-2021,NEFT,61.80,00.00,"57,472.22"
08-Feb-2021,Bill,"7,693.20",00.00,"65,165.42"
08-Feb-2021,NEFT,"27,410.00",00.00,"92,575.42"
08-Feb-2021,Debit Card,00.00,"92,575.42",00.00
08-Feb-2021,Interest,05.49,00.00,05.49
08-Feb-2021,Bill,"3,598.53",00.00,"3,604.02"
08-Feb-2021,Miscellaneous,00.00,"1,802.01","1,802.01"
08-Feb-2021,IMPS,"251,353.72",00.00,"253,155.73"
08-Feb-2021,Commission,00.00,"42,192.62","210,963.11"
08-Feb-2021,NEFT,00.00,"210,963.11",00.00
08-Feb-2021,ATM,"53,924.00",00.00,"53,924.00"
08-Feb-2021,Commission,"23,177.00",00.00,"77,101.00"
08-Feb-2021,Interest,00.00,"38,550.50","38,550.50"
08-Feb-2021,NEFT,00.00,"6,425.08","32,125.42"
08-Feb-2021,Transfer,00.00,"4,015.68","28,109.74"
08-Feb-2021,Cash,00.00,"4,684.96","23,424.78"
08-Feb-2021,Tax,00.00,"3,904.13","19,520.65"
08-Feb-2021,Interest,00.00,"9,760.33","9,760.33"
08-Feb-2021,Cheque,114.00,00.00,"9,874.33"
08-Feb-2021,Cash,00.00,"1,645.72","8,228.61"
08-Feb-2021,Debit Card,00.00,"2,057.15","6,171.46"
08-Feb-2021,Purchase,04.18,00.00,"6,175.64"
08-Feb-2021,ATM,"26,121.50",00.00,"32,297.14"
08-Feb-2021,ATM,636.18,00.00,"32,933.32"
08-Feb-2021,Bill,00.00,"8,233.33","24,699.99"
08-Feb-2021,Debit Card,00.00,"8,233.33","16,466.66"
08-Feb-2021,Transfer,"14,056.14",00.00,"30,522.80"
08-Feb-2021,Commission,"16,793.20",00.00,"47,316.00"
08-Feb-2021,Debit Card,"337,210.50",00.00,"384,526.50"
08-Feb-2021,NEFT,03.80,00.00,"384,530.30"
08-Feb-2021,ATM,36.40,00.00,"384,566.70"
08-Feb-2021,NEFT,00.00,"192,283.35","192,283.35"
08-Feb-2021,Tax,00.00,"38,456.67","153,826.68"
08-Feb-2021,Tax,00.00,"25,637.78","128,188.90"
08-Feb-2021,IMPS,"1,297,983.00",00.00,"1,426,171.90"
08-Feb-2021,ATM,00.00,"237,695.32","1,188,476.58"
08-Feb-2021,Bill,"1,342,992.50",00.00,"2,531,469.08"
08-Feb-2021,NEFT,00.00,"843,823.03","1,687,646.05"
08-Feb-2021,Transfer,03.50,00.00,"1,687,649.55"
08-Feb-2021,IMPS,00.00,"421,912.39","1,265,737.16"
08-Feb-2021,ATM,00.00,"253,147.43","1,012,589.73"
08-Feb-2021,Transfer,"1,307,211.00",00.00,"2,319,800.73"
08-Feb-2021,Tax,00.00,"257,755.64","2,062,045.09"
08-Feb-2021,Miscellaneous,00.00,"1,031,022.55","1,031,022.54"
08-Feb-2021,IMPS,"345,446.50",00.00,"1,376,469.04"
08-Feb-2021,Reversal,00.00,"1,376,469.04",00.00
08-Feb-2021,Commission,00.59,00.00,00.59
08-Feb-2021,Cash,00.00,00.08,00.51
08-Feb-2021,Tax,"798,849.50",00.00,"798,850.01"
08-Feb-2021,Reversal,118.00,00.00,"798,968.01"
08-Feb-2021,Reversal,00.00,"199,742.00","599,226.01"
08-Feb-2021,Interest,44.70,00.00,"599,270.71"
08-Feb-2021,RTGS,00.00,"149,817.68","449,453.03"
08-Feb-2021,Cash,15.90,00.00,"449,468.93"
08-Feb-2021,Debit Card,00.00,"112,367.23","337,101.70"
08-Feb-2021,Commission,00.00,"112,367.23","224,734.47"
08-Feb-2021,Miscellaneous,00.00,"44,946.89","179,787.58"
08-Feb-2021,RTGS,00.00,"44,946.90","134,840.68"
08-Feb-2021,Transfer,"201,276.12",00.00,"336,116.80"
08-Feb-2021,IMPS,550.20,00.00,"336,667.00"
08-Feb-2021,Purchase,00.20,00.00,"336,667.20"
08-Feb-2021,Bill,00.00,"67,333.44","269,333.76"
08-Feb-2021,Interest,00.00,"44,888.96","224,444.80"
08-Feb-2021,Transfer,00.00,"37,407.47","187,037.33"
08-Feb-2021,Transfer,00.00,"62,345.78","124,691.55"
08-Feb-2021,Cheque,00.00,"31,172.89","93,518.66"
08-Feb-2021,RTGS,00.00,"10,390.96","83,127.70"
08-Feb-2021,Transfer,"132,741.30",00.00,"215,869.00"
08-Feb-2021,ATM,00.00,"53,967.25","161,901.75"
08-Feb-2021,RTGS,"135,752.03",00.00,"297,653.78"
09-Feb-2021,Purchase,00.00,"297,653.78",00.00
09-Feb-2021,Interest,"659,710.00",00.00,"659,710.00"
09-Feb-2021,Debit Card,"110,056.00",00.00,"769,766.00"
09-Feb-2021,ATM,00.00,"128,294.33","641,471.67"
09-Feb-2021,Miscellaneous,292.00,00.00,"641,763.67"
09-Feb-2021,Cheque,00.00,"320,881.84","320,881.84"
09-Feb-2021,NEFT,"1,192,894.50",00.00,"1,513,776.34"
09-Feb-2021,Debit Card,"20,928.60",00.00,"1,534,704.94"
09-Feb-2021,Commission,200.00,00.00,"1,534,904.94"
09-Feb-2021,Transfer,00.00,"306,980.99","1,227,923.95"
09-Feb-2021,Miscellaneous,00.00,"122,792.40","1,105,131.56"
09-Feb-2021,Interest,58.20,00.00,"1,105,189.76"
09-Feb-2021,Debit Card,20.00,00.00,"1,105,209.76"
09-Feb-2021,ATM,309.70,00.00,"1,105,519.46"
09-Feb-2021,Miscellaneous,"836,500.50",00.00,"1,942,019.96"
09-Feb-2021,Cheque,00.00,"971,009.98","971,009.98"
09-Feb-2021,Transfer,40.30,00.00,"971,050.28"
09-Feb-2021,Debit Card,00.00,"323,683.43","647,366.85"
09-Feb-2021,Debit Card,00.00,"647,366.85",00.00
09-Feb-2021,Interest,166.92,00.00,166.92
09-Feb-2021,ATM,00.00,27.82,139.10
09-Feb-2021,ATM,"2,989.00",00.00,"3,128.10"
09-Feb-2021,Interest,00.00,446.87,"2,681.23"
09-Feb-2021,Miscellaneous,402.72,00.00,"3,083.95"
09-Feb-2021,Reversal,57.00,00.00,"3,140.95"
09-Feb-2021,Tax,"257,506.00",00.00,"260,646.95"
09-Feb-2021,Reversal,00.00,"86,882.32","173,764.63"
09-Feb-2021,Purchase,365.40,00.00,"174,130.03"
09-Feb-2021,Bill,00.00,"87,065.02","87,065.02"
09-Feb-2021,IMPS,38.00,00.00,"87,103.02"
09-Feb-2021,ATM,"1,831.40",00.00,"88,934.42"
09-Feb-2021,Commission,00.00,"22,233.61","66,700.82"
09-Feb-2021,IMPS,00.00,"11,116.80","55,584.02"
09-Feb-2021,ATM,00.00,"11,116.80","44,467.22"
09-Feb-2021,IMPS,00.00,"14,822.41","29,644.81"
09-Feb-2021,Interest,00.00,"3,705.60","25,939.21"
09-Feb-2021,Commission,"42,772.62",00.00,"68,711.83"
09-Feb-2021,Reversal,00.00,"11,451.97","57,259.86"
09-Feb-2021,IMPS,00.00,"28,629.93","28,629.93"
09-Feb-2021,Interest,"3,976.00",00.00,"32,605.93"
09-Feb-2021,Interest,00.00,"6,521.19","26,084.74"
09-Feb-2021,Miscellaneous,00.00,"3,260.59","22,824.15"
09-Feb-2021,Debit Card,"258,534.19",00.00,"281,358.34"
09-Feb-2021,Cheque,61.00,00.00,"281,419.34"
09-Feb-2021,Interest,"3,270.93",00.00,"284,690.27"
09-Feb-2021,Purchase,00.00,"284,690.27",00.00
09-Feb-2021,NEFT,19.00,00.00,19.00
09-Feb-2021,NEFT,04.80,00.00,23.80
09-Feb-2021,RTGS,"1,029.40",00.00,"1,053.20"
09-Feb-2021,Transfer,"26,126.50",00.00,"27,179.70"
09-Feb-2021,Cheque,00.00,"3,397.46","23,782.24"
09-Feb-2021,Tax,"27,129.11",00.00,"50,911.35"
09-Feb-2021,Cash,00.00,"7,273.05","43,638.30"
09-Feb-2021,ATM,03.00,00.00,"43,641.30"
09-Feb-2021,Cash,06.60,00.00,"43,647.90"
09-Feb-2021,Cheque,00.00,"14,549.30","29,098.60"
09-Feb-2021,NEFT,00.00,"9,699.53","19,399.07"
09-Feb-2021,Transfer,00.00,"6,466.36","12,932.71"
09-Feb-2021,Debit Card,236.00,00.00,"13,168.71"
09-Feb-2021,Miscellaneous,"2,442.20",00.00,"15,610.91"
09-Feb-2021,IMPS,00.00,"3,122.18","12,488.73"
09-Feb-2021,Miscellaneous,00.00,"2,081.46","10,407.28"
09-Feb-2021,RTGS,"1,676,056.50",00.00,"1,686,463.78"
09-Feb-2021,Cheque,00.00,"337,292.76","1,349,171.02"
09-Feb-2021,Debit Card,60.30,00.00,"1,349,231.32"
09-Feb-2021,Bill,"22,605.00",00.00,"1,371,836.32"
09-Feb-2021,Bill,"148,798.40",00.00,"1,520,634.72"
09-Feb-2021,NEFT,00.00,"190,079.34","1,330,555.38"
09-Feb-2021,Transfer,02.90,00.00,"1,330,558.28"
09-Feb-2021,ATM,00.00,"133,055.83","1,197,502.45"
09-Feb-2021,NEFT,00.00,"199,583.74","997,918.71"
09-Feb-2021,Purchase,"215,850.80",00.00,"1,213,769.51"
09-Feb-2021,IMPS,"1,838,920.00",00.00,"3,052,689.51"
09-Feb-2021,Reversal,00.00,"1,526,344.76","1,526,344.76"
09-Feb-2021,Debit Card,146.00,00.00,"1,526,490.76"
09-Feb-2021,Bill,07.00,00.00,"1,526,497.76"
09-Feb-2021,IMPS,"1,213,363.00",00.00,"2,739,860.76"
09-Feb-2021,Purchase,"25,453.61",00.00,"2,765,314.37"
09-Feb-2021,Debit Card,00.00,"345,664.30","2,419,650.07"
09-Feb-2021,Commission,00.00,"345,664.30","2,073,985.77"
09-Feb-2021,NEFT,"2,999.75",00.00,"2,076,985.52"
09-Feb-2021,Cheque,06.20,00.00,"2,076,991.72"
09-Feb-2021,Cash,"14,374.50",00.00,"2,091,366.22"
09-Feb-2021,Cheque,00.00,"298,766.60","1,792,599.62"
09-Feb-2021,IMPS,"1,411,433.00",00.00,"3,204,032.62"
09-Feb-2021,Miscellaneous,00.00,"356,003.62","2,848,029.00"
09-Feb-2021,IMPS,00.00,"949,343.00","1,898,686.00"
09-Feb-2021,Tax,05.40,00.00,"1,898,691.40"
09-Feb-2021,Interest,00.00,"316,448.57","1,582,242.83"
09-Feb-2021,Interest,00.00,"1,582,242.83",00.00
09-Feb-2021,RTGS,"133,862.69",00.00,"133,862.69"
09-Feb-2021,Reversal,00.00,"22,310.45","111,552.24"
09-Feb-2021,RTGS,00.00,"22,310.45","89,241.79"
09-Feb-2021,Purchase,00.00,"29,747.26","59,494.53"
09-Feb-2021,Bill,479.72,00.00,"59,974.25"
09-Feb-2021,Cheque,00.00,"7,496.78","52,477.47"
09-Feb-2021,Tax,00.00,"5,830.83","46,646.64"
09-Feb-2021,Bill,00.00,"6,663.81","39,982.83"
09-Feb-2021,Tax,"7,565.00",00.00,"47,547.83"
10-Feb-2021,Bill,"2,072.00",00.00,"49,619.83"
10-Feb-2021,IMPS,00.00,"4,961.98","44,657.85"
10-Feb-2021,Tax,00.00,"14,885.95","29,771.90"
10-Feb-2021,Reversal,00.00,"3,721.49","26,050.41"
10-Feb-2021,Debit Card,"3,876.97",00.00,"29,927.38"
10-Feb-2021,Cash,"142,852.00",00.00,"172,779.38"
10-Feb-2021,Tax,00.00,"28,796.56","143,982.82"
10-Feb-2021,Purchase,"151,996.20",00.00,"295,979.02"
10-Feb-2021,Debit Card,"280,017.25",00.00,"575,996.27"
10-Feb-2021,Tax,00.00,"115,199.25","460,797.02"
10-Feb-2021,Miscellaneous,"2,219.70",00.00,"463,016.72"
10-Feb-2021,IMPS,05.00,00.00,"463,021.72"
10-Feb-2021,Cash,"192,010.53",00.00,"655,032.25"
10-Feb-2021,NEFT,00.00,"93,576.04","561,456.21"
11-Feb-2021,Debit Card,"229,306.20",00.00,"790,762.41"
11-Feb-2021,Reversal,00.00,"98,845.30","691,917.11"
11-Feb-2021,Purchase,"15,958.00",00.00,"707,875.11"
11-Feb-2021,Interest,28.01,00.00,"707,903.12"
11-Feb-2021,IMPS,"1,799,364.80",00.00,"2,507,267.92"
11-Feb-2021,NEFT,"1,546,482.00",00.00,"4,053,749.92"
11-Feb-2021,Purchase,46.01,00.00,"4,053,795.93"
11-Feb-2021,Cheque,00.00,"1,013,448.98","3,040,346.95"
11-Feb-2021,Tax,84.50,00.00,"3,040,431.45"
11-Feb-2021,Tax,"704,142.00",00.00,"3,744,573.45"
11-Feb-2021,Debit Card,"217,076.00",00.00,"3,961,649.45"
11-Feb-2021,Commission,00.00,"440,183.27","3,521,466.18"
11-Feb-2021,Miscellaneous,00.00,"1,173,822.06","2,347,644.12"
11-Feb-2021,Purchase,77.20,00.00,"2,347,721.32"
11-Feb-2021,RTGS,06.00,00.00,"2,347,727.32"
11-Feb-2021,Interest,"3,790.50",00.00,"2,351,517.82"
11-Feb-2021,Miscellaneous,00.70,00.00,"2,351,518.52"
11-Feb-2021,NEFT,00.00,"235,151.85","2,116,366.67"
11-Feb-2021,RTGS,00.00,"302,338.10","1,814,028.57"
11-Feb-2021,RTGS,00.00,"302,338.10","1,511,690.48"
11-Feb-2021,Debit Card,00.00,"755,845.24","755,845.24"
11-Feb-2021,Reversal,894.60,00.00,"756,739.84"
11-Feb-2021,Cash,00.72,00.00,"756,740.56"
11-Feb-2021,Bill,00.00,"378,370.28","378,370.28"
11-Feb-2021,Miscellaneous,00.00,"63,061.71","315,308.57"
11-Feb-2021,ATM,00.00,"45,044.08","270,264.49"
11-Feb-2021,Cash,06.16,00.00,"270,270.65"
11-Feb-2021,Bill,00.00,"270,270.65",00.00
11-Feb-2021,Purchase,47.70,00.00,47.70
12-Feb-2021,Bill,00.00,07.95,39.75
12-Feb-2021,Reversal,00.00,03.98,35.78
12-Feb-2021,Cheque,00.00,03.58,32.20
12-Feb-2021,Transfer,00.00,03.58,28.62
13-Feb-2021,NEFT,"18,737.20",00.00,"18,765.82"
13-Feb-2021,Transfer,"37,794.00",00.00,"56,559.82"
13-Feb-2021,IMPS,"22,404.40",00.00,"78,964.22"
13-Feb-2021,Cheque,00.00,"8,773.80","70,190.42"
13-Feb-2021,Transfer,"4,045.65",00.00,"74,236.07"
13-Feb-2021,Cash,10.00,00.00,"74,246.07"
14-Feb-2021,Reversal,00.00,"14,849.21","59,396.86"
14-Feb-2021,Purchase,185.00,00.00,"59,581.86"
14-Feb-2021,RTGS,00.00,"19,860.62","39,721.24"
14-Feb-2021,Purchase,"1,732.80",00.00,"41,454.04"
14-Feb-2021,Transfer,00.00,"10,363.51","31,090.53"
14-Feb-2021,Commission,00.00,"5,181.76","25,908.78"
14-Feb-2021,Reversal,00.00,"3,701.25","22,207.53"
14-Feb-2021,Cheque,"116,327.03",00.00,"138,534.56"
14-Feb-2021,Transfer,"1,999.00",00.00,"140,533.56"
14-Feb-2021,Cash,00.00,"17,566.70","122,966.86"
14-Feb-2021,ATM,31.10,00.00,"122,997.96"
14-Feb-2021,Tax,00.00,"122,997.96",00.00
14-Feb-2021,ATM,06.19,00.00,06.19
14-Feb-2021,NEFT,"1,812.45",00.00,"1,818.64"
14-Feb-2021,Transfer,00.00,202.07,"1,616.57"
14-Feb-2021,Cheque,00.00,"1,616.57",00.00
14-Feb-2021,Interest,30.80,00.00,30.80
14-Feb-2021,Purchase,00.00,30.80,00.00
14-Feb-2021,Reversal,"42,386.00",00.00,"42,386.00"
14-Feb-2021,Debit Card,00.00,"5,298.25","37,087.75"
14-Feb-2021,Commission,93.33,00.00,"37,181.08"
14-Feb-2021,Miscellaneous,01.40,00.00,"37,182.48"
14-Feb-2021,Tax,"81,065.56",00.00,"118,248.04"
14-Feb-2021,Commission,00.00,"39,416.01","78,832.03"
14-Feb-2021,Purchase,00.00,"11,261.72","67,570.31"
14-Feb-2021,NEFT,30.19,00.00,"67,600.50"
14-Feb-2021,IMPS,"17,703.00",00.00,"85,303.50"
14-Feb-2021,Cheque,00.00,"21,325.88","63,977.62"
14-Feb-2021,Reversal,00.00,"31,988.81","31,988.81"
14-Feb-2021,Reversal,"18,403.82",00.00,"50,392.63"
14-Feb-2021,NEFT,00.00,"6,299.08","44,093.55"
14-Feb-2021,Cheque,"192,589.30",00.00,"236,682.85"
14-Feb-2021,Cheque,00.00,"33,811.84","202,871.01"
14-Feb-2021,Cheque,00.00,"50,717.75","152,153.26"
14-Feb-2021,Tax,"26,792.00",00.00,"178,945.26"
14-Feb-2021,Commission,00.00,"178,945.26",00.00
14-Feb-2021,Commission,423.20,00.00,423.20
14-Feb-2021,Transfer,338.00,00.00,761.20
14-Feb-2021,Cash,00.00,190.30,570.90
14-Feb-2021,Tax,03.42,00.00,574.32
14-Feb-2021,IMPS,07.70,00.00,582.02
14-Feb-2021,Interest,32.00,00.00,614.02
14-Feb-2021,Debit Card,296.00,00.00,910.02
14-Feb-2021,Reversal,00.00,303.34,606.68
14-Feb-2021,NEFT,14.16,00.00,620.84
14-Feb-2021,Reversal,00.00,77.61,543.24
14-Feb-2021,Transfer,00.00,108.65,434.59
14-Feb-2021,Reversal,224.73,00.00,659.32
14-Feb-2021,Bill,00.00,219.77,439.55
14-Feb-2021,ATM,00.00,54.94,384.61
14-Feb-2021,NEFT,"31,072.00",00.00,"31,456.61"
14-Feb-2021,Cheque,00.00,"3,495.18","27,961.43"
14-Feb-2021,Transfer,326.70,00.00,"28,288.13"
14-Feb-2021,Cheque,00.00,"4,714.69","23,573.44"
14-Feb-2021,IMPS,"1,392,036.50",00.00,"1,415,609.94"
14-Feb-2021,Debit Card,632.10,00.00,"1,416,242.04"
14-Feb-2021,IMPS,00.00,"283,248.41","1,132,993.63"
14-Feb-2021,Commission,00.00,"226,598.73","906,394.90"
14-Feb-2021,Reversal,00.00,"181,278.98","725,115.92"
14-Feb-2021,Purchase,"3,538.12",00.00,"728,654.04"
14-Feb-2021,Debit Card,00.00,"104,093.43","624,560.61"
14-Feb-2021,RTGS,383.44,00.00,"624,944.05"
14-Feb-2021,Interest,00.00,"69,438.23","555,505.82"
14-Feb-2021,Debit Card,"55,264.00",00.00,"610,769.82"
14-Feb-2021,NEFT,00.00,"87,252.83","523,516.99"
14-Feb-2021,Cheque,"31,270.50",00.00,"554,787.49"
14-Feb-2021,Miscellaneous,04.00,00.00,"554,791.49"
14-Feb-2021,Bill,30.10,00.00,"554,821.59"
14-Feb-2021,Cheque,00.00,"55,482.16","499,339.43"
14-Feb-2021,ATM,00.00,"99,867.89","399,471.54"
14-Feb-2021,Reversal,00.00,"399,471.54",00.00
14-Feb-2021,Reversal,"16,226.00",00.00,"16,226.00"
14-Feb-2021,IMPS,23.70,00.00,"16,249.70"
15-Feb-2021,Tax,"2,020,517.75",00.00,"2,036,767.45"
15-Feb-2021,Reversal,07.80,00.00,"2,036,775.25"
15-Feb-2021,Commission,111.00,00.00,"2,036,886.25"
15-Feb-2021,Cash,"23,007.00",00.00,"2,059,893.25"
15-Feb-2021,Tax,00.00,"2,059,893.25",00.00
15-Feb-2021,Tax,354.00,00.00,354.00
15-Feb-2021,Purchase,73.80,00.00,427.80
15-Feb-2021,Reversal,"57,456.00",00.00,"57,883.80"
15-Feb-2021,Tax,"926,252.00",00.00,"984,135.80"
15-Feb-2021,Debit Card,"23,981.00",00.00,"1,008,116.80"
15-Feb-2021,Transfer,00.00,"112,012.98","896,103.82"
15-Feb-2021,Transfer,09.00,00.00,"896,112.82"
15-Feb-2021,Purchase,00.00,"89,611.28","806,501.54"
15-Feb-2021,IMPS,23.00,00.00,"806,524.54"
15-Feb-2021,Purchase,34.83,00.00,"806,559.37"
16-Feb-2021,NEFT,65.25,00.00,"806,624.62"
16-Feb-2021,IMPS,"19,272.78",00.00,"825,897.40"
17-Feb-2021,RTGS,126.17,00.00,"826,023.57"
17-Feb-2021,ATM,"1,746.00",00.00,"827,769.57"
17-Feb-2021,Reversal,"3,320.31",00.00,"831,089.88"
17-Feb-2021,Tax,82.00,00.00,"831,171.88"
17-Feb-2021,ATM,00.00,"83,117.19","748,054.69"
17-Feb-2021,Purchase,00.00,"187,013.67","561,041.02"
18-Feb-2021,NEFT,16.80,00.00,"561,057.82"
18-Feb-2021,ATM,06.82,00.00,"561,064.64"
18-Feb-2021,Cheque,00.00,"140,266.16","420,798.48"
18-Feb-2021,Commission,00.00,"210,399.24","210,399.24"
18-Feb-2021,Purchase,00.00,"35,066.54","175,332.70"
18-Feb-2021,ATM,00.00,"25,047.53","150,285.17"
18-Feb-2021,Cheque,00.00,"30,057.03","120,228.14"
18-Feb-2021,Bill,25.30,00.00,"120,253.44"
18-Feb-2021,Reversal,"92,258.00",00.00,"212,511.44"
18-Feb-2021,Miscellaneous,00.00,"21,251.14","191,260.30"
18-Feb-2021,Debit Card,00.00,"38,252.06","153,008.24"
18-Feb-2021,IMPS,"19,211.00",00.00,"172,219.24"
18-Feb-2021,Cash,00.00,"57,406.41","114,812.83"
18-Feb-2021,RTGS,00.00,"12,756.98","102,055.85"
18-Feb-2021,Interest,"10,521.98",00.00,"112,577.83"
18-Feb-2021,Commission,00.00,"12,508.65","100,069.18"
19-Feb-2021,IMPS,00.00,"50,034.59","50,034.59"
19-Feb-2021,Tax,00.00,"6,254.32","43,780.27"
19-Feb-2021,ATM,134.41,00.00,"43,914.68"
19-Feb-2021,Tax,235.00,00.00,"44,149.68"
19-Feb-2021,Purchase,"904,899.00",00.00,"949,048.68"
19-Feb-2021,ATM,"5,232.00",00.00,"954,280.68"
19-Feb-2021,Cash,"4,761.30",00.00,"959,041.98"
19-Feb-2021,Interest,"4,661.19",00.00,"963,703.17"
19-Feb-2021,Cheque,04.00,00.00,"963,707.17"
19-Feb-2021,Bill,00.00,"160,617.86","803,089.31"
19-Feb-2021,Cheque,"13,877.94",00.00,"816,967.25"
19-Feb-2021,Commission,"207,213.90",00.00,"1,024,181.15"
19-Feb-2021,Reversal,00.00,"204,836.23","819,344.92"
20-Feb-2021,ATM,278.70,00.00,"819,623.62"
20-Feb-2021,RTGS,06.00,00.00,"819,629.62"
20-Feb-2021,Miscellaneous,"1,781,810.00",00.00,"2,601,439.62"
20-Feb-2021,Reversal,"49,400.00",00.00,"2,650,839.62"
20-Feb-2021,NEFT,"26,783.00",00.00,"2,677,622.62"
20-Feb-2021,Commission,"613,189.50",00.00,"3,290,812.12"
20-Feb-2021,Cheque,54.06,00.00,"3,290,866.18"
20-Feb-2021,Commission,00.00,"1,096,955.39","2,193,910.79"
20-Feb-2021,Tax,00.00,"2,193,910.79",00.00
20-Feb-2021,Tax,"80,432.06",00.00,"80,432.06"
21-Feb-2021,RTGS,"28,790.40",00.00,"109,222.46"
21-Feb-2021,Tax,00.00,"13,652.81","95,569.65"
21-Feb-2021,Cash,"41,178.70",00.00,"136,748.35"
21-Feb-2021,Interest,46.00,00.00,"136,794.35"
21-Feb-2021,Debit Card,01.06,00.00,"136,795.41"
21-Feb-2021,Transfer,375.46,00.00,"137,170.87"
21-Feb-2021,Miscellaneous,"2,015,560.75",00.00,"2,152,731.62"
21-Feb-2021,Reversal,06.73,00.00,"2,152,738.35"
21-Feb-2021,RTGS,00.00,"538,184.59","1,614,553.76"
21-Feb-2021,Interest,00.00,"201,819.22","1,412,734.54"
21-Feb-2021,Transfer,00.00,"235,455.76","1,177,278.78"
21-Feb-2021,NEFT,"9,512.00",00.00,"1,186,790.78"
21-Feb-2021,Interest,00.00,"237,358.16","949,432.62"
21-Feb-2021,IMPS,00.00,"316,477.54","632,955.08"
21-Feb-2021,Interest,07.13,00.00,"632,962.21"
21-Feb-2021,NEFT,00.00,"79,120.28","553,841.93"
21-Feb-2021,RTGS,"1,464,292.25",00.00,"2,018,134.18"
21-Feb-2021,Purchase,"393,638.00",00.00,"2,411,772.18"
21-Feb-2021,Cash,114.80,00.00,"2,411,886.98"
21-Feb-2021,IMPS,"544,520.00",00.00,"2,956,406.98"
21-Feb-2021,Transfer,00.00,"369,550.87","2,586,856.11"
21-Feb-2021,Commission,00.00,"646,714.03","1,940,142.08"
21-Feb-2021,Commission,05.20,00.00,"1,940,147.28"
21-Feb-2021,NEFT,00.00,"970,073.64","970,073.64"
21-Feb-2021,Cheque,"2,098.00",00.00,"972,171.64"
21-Feb-2021,Interest,01.50,00.00,"972,173.14"
21-Feb-2021,Transfer,00.00,"162,028.86","810,144.28"
21-Feb-2021,Miscellaneous,01.00,00.00,"810,145.28"
21-Feb-2021,ATM,"557,357.25",00.00,"1,367,502.53"
21-Feb-2021,Commission,449.00,00.00,"1,367,951.53"
21-Feb-2021,Cash,162.80,00.00,"1,368,114.33"
21-Feb-2021,Purchase,"808,408.00",00.00,"2,176,522.33"
21-Feb-2021,NEFT,00.00,"310,931.76","1,865,590.57"
21-Feb-2021,RTGS,11.00,00.00,"1,865,601.57"
21-Feb-2021,Tax,00.00,"466,400.39","1,399,201.18"
21-Feb-2021,IMPS,04.33,00.00,"1,399,205.51"
21-Feb-2021,Transfer,"2,480.90",00.00,"1,401,686.41"
21-Feb-2021,Miscellaneous,06.30,00.00,"1,401,692.71"
21-Feb-2021,Miscellaneous,00.00,"467,230.90","934,461.81"
21-Feb-2021,Miscellaneous,00.00,"116,807.73","817,654.08"
21-Feb-2021,NEFT,"12,536.00",00.00,"830,190.08"
21-Feb-2021,Commission,00.00,"92,243.34","737,946.74"
21-Feb-2021,Cash,00.00,"122,991.12","614,955.62"
21-Feb-2021,Cheque,04.52,00.00,"614,960.14"
21-Feb-2021,Cheque,"127,903.16",00.00,"742,863.30"
21-Feb-2021,Debit Card,00.00,"148,572.66","594,290.64"
22-Feb-2021,Reversal,07.30,00.00,"594,297.94"
22-Feb-2021,Interest,63.00,00.00,"594,360.94"
22-Feb-2021,Purchase,"31,529.90",00.00,"625,890.84"
22-Feb-2021,IMPS,"12,944.00",00.00,"638,834.84"
22-Feb-2021,Cash,00.00,"212,944.95","425,889.89"
22-Feb-2021,Transfer,00.00,"85,177.98","340,711.91"
22-Feb-2021,Tax,00.00,"34,071.19","306,640.72"
22-Feb-2021,Cash,00.00,"102,213.57","204,427.15"
22-Feb-2021,NEFT,00.00,"68,142.38","136,284.77"
22-Feb-2021,IMPS,"218,667.00",00.00,"354,951.77"
22-Feb-2021,Interest,00.00,"354,951.77",00.00
22-Feb-2021,Interest,485.80,00.00,485.80
22-Feb-2021,ATM,"31,128.00",00.00,"31,613.80"
22-Feb-2021,Debit Card,271.10,00.00,"31,884.90"
22-Feb-2021,Miscellaneous,721.00,00.00,"32,605.90"
22-Feb-2021,Debit Card,762.00,00.00,"33,367.90"
22-Feb-2021,ATM,00.00,"11,122.63","22,245.27"
22-Feb-2021,IMPS,220.14,00.00,"22,465.41"
22-Feb-2021,Commission,"1,245,896.20",00.00,"1,268,361.61"
22-Feb-2021,Miscellaneous,00.00,"634,180.81","634,180.81"
22-Feb-2021,Purchase,00.00,"158,545.20","475,635.61"
22-Feb-2021,Interest,"2,791.00",00.00,"478,426.61"
22-Feb-2021,Bill,00.00,"59,803.33","418,623.28"
22-Feb-2021,Transfer,00.00,"209,311.64","209,311.64"
22-Feb-2021,Cheque,00.00,"52,327.91","156,983.73"
22-Feb-2021,Tax,00.00,"78,491.87","78,491.87"
23-Feb-2021,Transfer,42.86,00.00,"78,534.73"
23-Feb-2021,IMPS,00.77,00.00,"78,535.50"
23-Feb-2021,Purchase,00.00,"15,707.10","62,828.40"
23-Feb-2021,Cash,00.00,"6,980.93","55,847.47"
23-Feb-2021,Cash,03.40,00.00,"55,850.87"
23-Feb-2021,Interest,00.00,"9,308.48","46,542.39"
23-Feb-2021,RTGS,"3,948.10",00.00,"50,490.49"
23-Feb-2021,Purchase,00.00,"8,415.08","42,075.41"
23-Feb-2021,Tax,"2,802.54",00.00,"44,877.95"
23-Feb-2021,NEFT,00.00,"5,609.74","39,268.21"
23-Feb-2021,IMPS,00.00,"9,817.05","29,451.16"
23-Feb-2021,Reversal,00.00,"9,817.05","19,634.11"
23-Feb-2021,RTGS,"6,344.90",00.00,"25,979.01"
23-Feb-2021,Purchase,00.00,"2,886.56","23,092.45"
23-Feb-2021,IMPS,"83,332.75",00.00,"106,425.20"
23-Feb-2021,Cash,34.09,00.00,"106,459.29"
23-Feb-2021,Tax,00.00,"35,486.43","70,972.86"
23-Feb-2021,RTGS,212.90,00.00,"71,185.76"
23-Feb-2021,Purchase,00.00,"10,169.39","61,016.37"
23-Feb-2021,ATM,"1,356.70",00.00,"62,373.07"
23-Feb-2021,Cheque,00.00,"15,593.27","46,779.80"
23-Feb-2021,Tax,"3,747.10",00.00,"50,526.90"
23-Feb-2021,Interest,04.90,00.00,"50,531.80"
23-Feb-2021,Commission,00.00,"25,265.90","25,265.90"
23-Feb-2021,Commission,21.00,00.00,"25,286.90"
23-Feb-2021,Transfer,"11,983.00",00.00,"37,269.90"
23-Feb-2021,Commission,00.00,"4,141.10","33,128.80"
23-Feb-2021,Tax,00.00,"3,680.98","29,447.82"
23-Feb-2021,Interest,00.00,"7,361.96","22,085.86"
23-Feb-2021,Reversal,"184,413.62",00.00,"206,499.48"
23-Feb-2021,Debit Card,00.00,"206,499.48",00.00
23-Feb-2021,Interest,56.00,00.00,56.00
24-Feb-2021,NEFT,"256,233.00",00.00,"256,289.00"
24-Feb-2021,Transfer,02.50,00.00,"256,291.50"
25-Feb-2021,NEFT,00.00,"256,291.50",00.00
25-Feb-2021,Reversal,"224,383.00",00.00,"224,383.00"
25-Feb-2021,RTGS,00.00,"22,438.30","201,944.70"
25-Feb-2021,Reversal,00.00,"33,657.45","168,287.25"
25-Feb-2021,ATM,"1,686,614.75",00.00,"1,854,902.00"
25-Feb-2021,Cash,"51,958.56",00.00,"1,906,860.56"
25-Feb-2021,Tax,00.00,"272,408.65","1,634,451.91"
25-Feb-2021,Cheque,00.00,"817,225.96","817,225.96"
25-Feb-2021,Cheque,00.00,"163,445.19","653,780.77"
25-Feb-2021,Bill,"1,021,711.50",00.00,"1,675,492.27"
25-Feb-2021,Debit Card,02.00,00.00,"1,675,494.27"
25-Feb-2021,Reversal,00.00,"167,549.43","1,507,944.84"
25-Feb-2021,Tax,"3,353.80",00.00,"1,511,298.64"
25-Feb-2021,ATM,00.10,00.00,"1,511,298.74"
25-Feb-2021,Purchase,00.00,"167,922.08","1,343,376.66"
25-Feb-2021,Commission,00.00,"671,688.33","671,688.33"
25-Feb-2021,Commission,"1,442.09",00.00,"673,130.42"
25-Feb-2021,Reversal,16.00,00.00,"673,146.42"
25-Feb-2021,ATM,00.00,"134,629.28","538,517.14"
25-Feb-2021,Debit Card,00.00,"59,835.24","478,681.90"
25-Feb-2021,Commission,526.69,00.00,"479,208.59"
25-Feb-2021,Interest,27.00,00.00,"479,235.59"
25-Feb-2021,Miscellaneous,328.50,00.00,"479,564.09"
25-Feb-2021,NEFT,00.00,"68,509.16","411,054.93"
25-Feb-2021,ATM,308.70,00.00,"411,363.63"
25-Feb-2021,Miscellaneous,07.00,00.00,"411,370.63"
25-Feb-2021,ATM,00.00,"411,370.63",00.00
25-Feb-2021,IMPS,37.00,00.00,37.00
25-Feb-2021,Transfer,236.80,00.00,273.80
25-Feb-2021,Transfer,"3,171.10",00.00,"3,444.90"
25-Feb-2021,Transfer,00.45,00.00,"3,445.35"
25-Feb-2021,Tax,"61,970.00",00.00,"65,415.35"
25-Feb-2021,NEFT,06.66,00.00,"65,422.01"
25-Feb-2021,Cash,00.00,"16,355.50","49,066.51"
25-Feb-2021,Miscellaneous,00.00,"5,451.83","43,614.68"
25-Feb-2021,NEFT,242.00,00.00,"43,856.68"
25-Feb-2021,Commission,11.60,00.00,"43,868.28"
25-Feb-2021,Debit Card,44.10,00.00,"43,912.38"
25-Feb-2021,ATM,"16,457.00",00.00,"60,369.38"
25-Feb-2021,RTGS,00.00,"6,036.94","54,332.44"
26-Feb-2021,NEFT,00.40,00.00,"54,332.84"
26-Feb-2021,Transfer,00.00,"5,433.28","48,899.56"
26-Feb-2021,Purchase,00.00,"5,433.28","43,466.28"
26-Feb-2021,Debit Card,00.00,"10,866.57","32,599.71"
26-Feb-2021,Debit Card,"84,279.00",00.00,"116,878.71"
26-Feb-2021,Purchase,00.10,00.00,"116,878.81"
26-Feb-2021,ATM,39.60,00.00,"116,918.41"
26-Feb-2021,Cash,483.00,00.00,"117,401.41"
26-Feb-2021,Interest,00.00,"11,740.14","105,661.27"
26-Feb-2021,Reversal,00.00,"105,661.27",00.00
26-Feb-2021,NEFT,"89,842.00",00.00,"89,842.00"
26-Feb-2021,ATM,00.00,"12,834.57","77,007.43"
26-Feb-2021,ATM,"18,165.92",00.00,"95,173.35"
26-Feb-2021,Reversal,55.00,00.00,"95,228.35"
26-Feb-2021,Transfer,00.00,"31,742.78","63,485.57"
26-Feb-2021,Purchase,00.00,"9,069.37","54,416.20"
26-Feb-2021,RTGS,03.00,00.00,"54,419.20"
26-Feb-2021,ATM,"15,016.30",00.00,"69,435.50"
27-Feb-2021,Tax,00.00,"8,679.44","60,756.06"
27-Feb-2021,Debit Card,00.00,"60,756.06",00.00
27-Feb-2021,NEFT,01.60,00.00,01.60
27-Feb-2021,Debit Card,00.00,00.27,01.33
27-Feb-2021,Commission,"1,372,278.25",00.00,"1,372,279.58"
27-Feb-2021,Miscellaneous,04.85,00.00,"1,372,284.43"
27-Feb-2021,IMPS,22.00,00.00,"1,372,306.43"
27-Feb-2021,Bill,553.30,00.00,"1,372,859.73"
27-Feb-2021,Tax,07.30,00.00,"1,372,867.03"
27-Feb-2021,Interest,00.00,"152,540.78","1,220,326.25"
27-Feb-2021,Cheque,00.00,"135,591.81","1,084,734.44"
27-Feb-2021,Cash,00.00,"135,591.81","949,142.64"
27-Feb-2021,Transfer,402.00,00.00,"949,544.64"
27-Feb-2021,NEFT,00.00,"105,504.96","844,039.68"
27-Feb-2021,Interest,00.00,"844,039.68",00.00
27-Feb-2021,Reversal,"10,215.00",00.00,"10,215.00"
27-Feb-2021,IMPS,52.00,00.00,"10,267.00"
27-Feb-2021,Debit Card,00.00,"1,466.71","8,800.29"
27-Feb-2021,Cash,"9,759.00",00.00,"18,559.29"
27-Feb-2021,Debit Card,00.00,"6,186.43","12,372.86"
27-Feb-2021,Cash,16.50,00.00,"12,389.36"
27-Feb-2021,Debit Card,00.00,"2,064.89","10,324.47"
27-Feb-2021,Debit Card,12.00,00.00,"10,336.47"
27-Feb-2021,Transfer,"15,357.30",00.00,"25,693.77"
27-Feb-2021,Reversal,45.45,00.00,"25,739.22"
27-Feb-2021,Tax,00.00,"12,869.61","12,869.61"
27-Feb-2021,Purchase,00.00,"1,838.52","11,031.09"
27-Feb-2021,Miscellaneous,00.00,"3,677.03","7,354.06"
28-Feb-2021,Commission,00.17,00.00,"7,354.23"
28-Feb-2021,Purchase,59.00,00.00,"7,413.23"
28-Feb-2021,IMPS,06.84,00.00,"7,420.07"
28-Feb-2021,IMPS,"705,387.50",00.00,"712,807.57"
28-Feb-2021,Miscellaneous,502.00,00.00,"713,309.57"
28-Feb-2021,Transfer,"1,563.20",00.00,"714,872.77"
28-Feb-2021,Interest,00.00,"357,436.39","357,436.38"
28-Feb-2021,Reversal,"7,516.81",00.00,"364,953.19"
28-Feb-2021,Purchase,"1,097,998.25",00.00,"1,462,951.44"
28-Feb-2021,Interest,725.12,00.00,"1,463,676.56"
28-Feb-2021,ATM,"2,173.46",00.00,"1,465,850.02"
28-Feb-2021,IMPS,00.00,"162,872.22","1,302,977.80"
28-Feb-2021,Cash,00.00,"144,775.31","1,158,202.49"
28-Feb-2021,Miscellaneous,00.00,"144,775.31","1,013,427.18"
28-Feb-2021,Interest,34.70,00.00,"1,013,461.88"
28-Feb-2021,Transfer,00.00,"506,730.94","506,730.94"
28-Feb-2021,Miscellaneous,00.00,"253,365.47","253,365.47"
28-Feb-2021,ATM,"22,059.00",00.00,"275,424.47"
28-Feb-2021,ATM,00.00,"91,808.16","183,616.31"
28-Feb-2021,Reversal,00.00,"45,904.08","137,712.23"
28-Feb-2021,NEFT,00.00,"17,214.03","120,498.20"
28-Feb-2021,Bill,43.00,00.00,"120,541.20"
28-Feb-2021,NEFT,"130,493.00",00.00,"251,034.20"
28-Feb-2021,Interest,"19,988.29",00.00,"271,022.49"
01-Mar-2021,Commission,00.00,"45,170.42","225,852.08"
01-Mar-2021,Bill,"202,293.50",00.00,"428,145.58"
01-Mar-2021,Interest,00.00,"85,629.12","342,516.46"
01-Mar-2021,Transfer,"67,797.69",00.00,"410,314.15"
01-Mar-2021,Reversal,20.00,00.00,"410,334.15"
01-Mar-2021,IMPS,01.20,00.00,"410,335.35"
01-Mar-2021,Tax,00.00,"205,167.68","205,167.68"
01-Mar-2021,Interest,00.00,"51,291.92","153,875.76"
01-Mar-2021,Transfer,00.00,"25,645.96","128,229.80"
01-Mar-2021,Cheque,00.00,"14,247.76","113,982.04"
01-Mar-2021,Purchase,442.00,00.00,"114,424.04"
01-Mar-2021,Miscellaneous,00.00,"38,141.35","76,282.69"
01-Mar-2021,Commission,"237,548.40",00.00,"313,831.09"
01-Mar-2021,Interest,00.00,"34,870.12","278,960.97"
02-Mar-2021,ATM,00.00,"34,870.12","244,090.85"
02-Mar-2021,Transfer,00.00,"27,121.21","216,969.64"
02-Mar-2021,Reversal,"866,726.00",00.00,"1,083,695.64"
02-Mar-2021,Tax,00.00,"154,813.66","928,881.98"
03-Mar-2021,Tax,"106,816.00",00.00,"1,035,697.98"
03-Mar-2021,NEFT,25.80,00.00,"1,035,723.78"
03-Mar-2021,Commission,03.00,00.00,"1,035,726.78"
03-Mar-2021,Tax,"11,894.05",00.00,"1,047,620.83"
03-Mar-2021,Purchase,110.40,00.00,"1,047,731.23"
03-Mar-2021,Tax,00.00,"130,966.40","916,764.83"
03-Mar-2021,Tax,00.00,"183,352.97","733,411.86"
03-Mar-2021,Miscellaneous,"232,846.00",00.00,"966,257.86"
03-Mar-2021,Cash,02.30,00.00,"966,260.16"
03-Mar-2021,Commission,07.00,00.00,"966,267.16"
03-Mar-2021,Debit Card,00.00,"161,044.53","805,222.63"
03-Mar-2021,NEFT,12.10,00.00,"805,234.73"
03-Mar-2021,Purchase,00.00,"115,033.53","690,201.20"
03-Mar-2021,Cheque,00.00,"86,275.15","603,926.05"
03-Mar-2021,ATM,00.00,"201,308.68","402,617.37"
03-Mar-2021,Tax,"1,223.00",00.00,"403,840.37"
03-Mar-2021,ATM,00.00,"40,384.04","363,456.33"
03-Mar-2021,Bill,00.00,"181,728.17","181,728.16"
03-Mar-2021,Miscellaneous,"3,738.17",00.00,"185,466.33"
03-Mar-2021,Reversal,00.00,"185,466.33",00.00
03-Mar-2021,IMPS,"3,271.00",00.00,"3,271.00"
03-Mar-2021,Transfer,00.00,327.10,"2,943.90"
03-Mar-2021,RTGS,"1,536,600.25",00.00,"1,539,544.15"
03-Mar-2021,Commission,"2,779.00",00.00,"1,542,323.15"
04-Mar-2021,Reversal,00.00,"771,161.58","771,161.58"
04-Mar-2021,Reversal,00.00,"771,161.58",00.00
04-Mar-2021,Reversal,"3,549.49",00.00,"3,549.49"
04-Mar-2021,Cheque,"243,237.00",00.00,"246,786.49"
04-Mar-2021,IMPS,46.90,00.00,"246,833.39"
04-Mar-2021,NEFT,00.00,"27,425.93","219,407.46"
04-Mar-2021,Purchase,"19,272.00",00.00,"238,679.46"
04-Mar-2021,Purchase,470.25,00.00,"239,149.71"
04-Mar-2021,Cash,00.00,"29,893.71","209,256.00"
04-Mar-2021,ATM,00.00,"41,851.20","167,404.80"
04-Mar-2021,Interest,782.00,00.00,"168,186.80"
04-Mar-2021,Interest,"144,747.38",00.00,"312,934.18"
04-Mar-2021,ATM,00.00,"312,934.18",00.00
04-Mar-2021,Debit Card,03.70,00.00,03.70
04-Mar-2021,Transfer,40.60,00.00,44.30
04-Mar-2021,Cash,"3,836.20",00.00,"3,880.50"
04-Mar-2021,Cheque,"3,946.57",00.00,"7,827.07"
04-Mar-2021,Cash,"146,232.94",00.00,"154,060.01"
04-Mar-2021,Bill,"3,675.89",00.00,"157,735.90"
04-Mar-2021,Miscellaneous,60.40,00.00,"157,796.30"
04-Mar-2021,Commission,00.00,"26,299.38","131,496.92"
04-Mar-2021,Miscellaneous,"83,512.30",00.00,"215,009.22"
04-Mar-2021,Cash,00.00,"215,009.22",00.00
04-Mar-2021,Cheque,"1,889,116.00",00.00,"1,889,116.00"
04-Mar-2021,IMPS,00.00,"629,705.33","1,259,410.67"
04-Mar-2021,Purchase,00.00,"125,941.07","1,133,469.60"
04-Mar-2021,Reversal,00.00,"377,823.20","755,646.40"
04-Mar-2021,Cheque,"2,789.10",00.00,"758,435.50"
04-Mar-2021,NEFT,00.00,"189,608.88","568,826.62"
04-Mar-2021,Cash,00.00,"71,103.33","497,723.29"
04-Mar-2021,Commission,00.00,"165,907.76","331,815.53"
04-Mar-2021,Purchase,00.00,"110,605.18","221,210.35"
04-Mar-2021,Cheque,00.00,"55,302.59","165,907.76"
04-Mar-2021,Reversal,168.00,00.00,"166,075.76"
04-Mar-2021,Transfer,00.00,"20,759.47","145,316.29"
04-Mar-2021,Interest,00.00,"145,316.29",00.00
04-Mar-2021,Miscellaneous,"202,628.10",00.00,"202,628.10"
04-Mar-2021,RTGS,00.00,"22,514.23","180,113.87"
04-Mar-2021,Cash,00.00,"60,037.96","120,075.91"
04-Mar-2021,Cheque,00.00,"20,012.65","100,063.26"
04-Mar-2021,ATM,"499,764.00",00.00,"599,827.26"
04-Mar-2021,Reversal,"1,380,361.50",00.00,"1,980,188.76"
05-Mar-2021,Reversal,00.00,"990,094.38","990,094.38"
05-Mar-2021,Commission,00.00,"990,094.38",00.00
05-Mar-2021,Purchase,02.84,00.00,02.84
05-Mar-2021,ATM,09.00,00.00,11.84
05-Mar-2021,Bill,00.00,01.97,09.87
05-Mar-2021,Debit Card,"1,887,038.00",00.00,"1,887,047.87"
05-Mar-2021,Miscellaneous,00.00,"1,887,047.87",00.00
05-Mar-2021,RTGS,11.00,00.00,11.00
05-Mar-2021,Purchase,00.00,01.83,09.17
05-Mar-2021,NEFT,"178,397.12",00.00,"178,406.29"
05-Mar-2021,Miscellaneous,00.00,"17,840.63","160,565.66"
05-Mar-2021,Cheque,"56,451.00",00.00,"217,016.66"
05-Mar-2021,Cheque,"25,369.00",00.00,"242,385.66"
05-Mar-2021,RTGS,"10,753.00",00.00,"253,138.66"
05-Mar-2021,Miscellaneous,"46,040.00",00.00,"299,178.66"
05-Mar-2021,Bill,"756,917.50",00.00,"1,056,096.16"
05-Mar-2021,Cash,04.60,00.00,"1,056,100.76"
05-Mar-2021,Tax,00.00,"132,012.60","924,088.16"
05-Mar-2021,ATM,"157,374.34",00.00,"1,081,462.50"
05-Mar-2021,Commission,36.00,00.00,"1,081,498.50"
05-Mar-2021,Reversal,49.70,00.00,"1,081,548.20"
05-Mar-2021,Cheque,"76,661.00",00.00,"1,158,209.20"
05-Mar-2021,Reversal,"13,703.09",00.00,"1,171,912.29"
05-Mar-2021,Bill,60.00,00.00,"1,171,972.29"
05-Mar-2021,Miscellaneous,"1,301.08",00.00,"1,173,273.37"
05-Mar-2021,RTGS,00.00,"391,091.12","782,182.25"
05-Mar-2021,Interest,00.00,"111,740.32","670,441.93"
05-Mar-2021,NEFT,"98,953.00",00.00,"769,394.93"
05-Mar-2021,Debit Card,00.00,"96,174.37","673,220.56"
05-Mar-2021,Cheque,00.00,"134,644.11","538,576.45"
05-Mar-2021,Interest,06.00,00.00,"538,582.45"
05-Mar-2021,Transfer,"3,713.70",00.00,"542,296.15"
05-Mar-2021,Transfer,"57,169.25",00.00,"599,465.40"
05-Mar-2021,Bill,00.00,"99,910.90","499,554.50"
05-Mar-2021,NEFT,00.00,"71,364.93","428,189.57"
05-Mar-2021,Bill,"602,652.50",00.00,"1,030,842.07"
05-Mar-2021,NEFT,"31,079.30",00.00,"1,061,921.37"
05-Mar-2021,Cheque,06.00,00.00,"1,061,927.37"
05-Mar-2021,Reversal,01.60,00.00,"1,061,928.97"
05-Mar-2021,Tax,00.00,"212,385.79","849,543.18"
05-Mar-2021,Tax,108.94,00.00,"849,652.12"
05-Mar-2021,Debit Card,00.00,"424,826.06","424,826.06"
05-Mar-2021,Bill,00.00,"70,804.34","354,021.72"
05-Mar-2021,NEFT,00.00,"177,010.86","177,010.86"
05-Mar-2021,Cheque,"4,651.00",00.00,"181,661.86"
05-Mar-2021,Interest,"1,354.52",00.00,"183,016.38"
05-Mar-2021,Interest,"1,564.92",00.00,"184,581.30"
05-Mar-2021,Purchase,00.00,"92,290.65","92,290.65"
05-Mar-2021,NEFT,00.00,"46,145.33","46,145.32"
06-Mar-2021,Cash,00.00,"5,127.26","41,018.06"
06-Mar-2021,Miscellaneous,00.00,"13,672.69","27,345.37"
06-Mar-2021,Reversal,00.00,"27,345.37",00.00
06-Mar-2021,Cash,"362,016.00",00.00,"362,016.00"
06-Mar-2021,Cheque,05.00,00.00,"362,021.00"
06-Mar-2021,Cheque,07.60,00.00,"362,028.60"
06-Mar-2021,Miscellaneous,"2,541.00",00.00,"364,569.60"
06-Mar-2021,IMPS,"1,263.00",00.00,"365,832.60"
06-Mar-2021,Cheque,00.00,"52,261.80","313,570.80"
06-Mar-2021,Purchase,00.00,"156,785.40","156,785.40"
06-Mar-2021,RTGS,"729,758.00",00.00,"886,543.40"
06-Mar-2021,RTGS,00.00,"443,271.70","443,271.70"
06-Mar-2021,NEFT,"1,155.20",00.00,"444,426.90"
06-Mar-2021,Reversal,00.00,"49,380.77","395,046.13"
06-Mar-2021,Cash,00.00,"39,504.61","355,541.52"
06-Mar-2021,Commission,"2,014.00",00.00,"357,555.52"
06-Mar-2021,Miscellaneous,00.00,"39,728.39","317,827.13"
06-Mar-2021,Debit Card,00.00,"35,314.13","282,513.00"
07-Mar-2021,Cheque,00.00,"40,359.00","242,154.00"
07-Mar-2021,Commission,00.00,"40,359.00","201,795.00"
07-Mar-2021,Commission,"62,749.80",00.00,"264,544.80"
07-Mar-2021,Purchase,00.00,"88,181.60","176,363.20"
07-Mar-2021,Interest,13.76,00.00,"176,376.96"
07-Mar-2021,Tax,"1,463,951.00",00.00,"1,640,327.96"
07-Mar-2021,ATM,"204,441.00",00.00,"1,844,768.96"
07-Mar-2021,Tax,06.50,00.00,"1,844,775.46"
07-Mar-2021,ATM,"27,651.00",00.00,"1,872,426.46"
07-Mar-2021,Transfer,00.00,"187,242.65","1,685,183.81"
07-Mar-2021,Purchase,337.00,00.00,"1,685,520.81"
07-Mar-2021,Cash,00.00,"240,788.69","1,444,732.12"
07-Mar-2021,Transfer,00.00,"1,444,732.12",00.00
07-Mar-2021,ATM,12.10,00.00,12.10
07-Mar-2021,Cheque,00.00,12.10,00.00
07-Mar-2021,Debit Card,"1,529.00",00.00,"1,529.00"
07-Mar-2021,RTGS,00.00,152.90,"1,376.10"
07-Mar-2021,Cheque,00.00,688.05,688.05
07-Mar-2021,NEFT,"3,921.00",00.00,"4,609.05"
07-Mar-2021,IMPS,00.00,576.13,"4,032.92"
07-Mar-2021,Purchase,00.00,"2,016.46","2,016.46"
07-Mar-2021,Cheque,00.00,403.29,"1,613.17"
07-Mar-2021,NEFT,"3,530.80",00.00,"5,143.97"
07-Mar-2021,Transfer,"2,067,048.80",00.00,"2,072,192.77"
07-Mar-2021,Commission,"1,932.50",00.00,"2,074,125.27"
07-Mar-2021,ATM,215.00,00.00,"2,074,340.27"
07-Mar-2021,IMPS,411.46,00.00,"2,074,751.73"
07-Mar-2021,IMPS,"14,005.90",00.00,"2,088,757.63"
07-Mar-2021,Interest,"1,617.00",00.00,"2,090,374.63"
07-Mar-2021,Cheque,20.52,00.00,"2,090,395.15"
07-Mar-2021,Bill,"24,523.00",00.00,"2,114,918.15"
07-Mar-2021,Miscellaneous,00.00,"422,983.63","1,691,934.52"
07-Mar-2021,IMPS,00.00,"187,992.72","1,503,941.80"
07-Mar-2021,Reversal,"24,800.53",00.00,"1,528,742.33"
08-Mar-2021,ATM,"3,791.09",00.00,"1,532,533.42"
08-Mar-2021,Bill,"31,142.03",00.00,"1,563,675.45"
08-Mar-2021,Purchase,00.00,"781,837.73","781,837.72"
08-Mar-2021,IMPS,"192,709.00",00.00,"974,546.72"
08-Mar-2021,ATM,02.00,00.00,"974,548.72"
08-Mar-2021,Interest,00.00,"243,637.18","730,911.54"
08-Mar-2021,Bill,"158,498.00",00.00,"889,409.54"
09-Mar-2021,Tax,07.00,00.00,"889,416.54"
09-Mar-2021,Bill,00.00,"889,416.54",00.00
09-Mar-2021,Interest,"195,841.00",00.00,"195,841.00"
09-Mar-2021,Reversal,06.49,00.00,"195,847.49"
09-Mar-2021,Cheque,00.00,"19,584.75","176,262.74"
09-Mar-2021,Cash,01.95,00.00,"176,264.69"
09-Mar-2021,Tax,00.00,"22,033.09","154,231.60"
09-Mar-2021,ATM,00.00,"77,115.80","77,115.80"
09-Mar-2021,Tax,00.00,"15,423.16","61,692.64"
09-Mar-2021,Purchase,04.00,00.00,"61,696.64"
09-Mar-2021,RTGS,"2,116.53",00.00,"63,813.17"
09-Mar-2021,Debit Card,00.00,"31,906.59","31,906.58"
09-Mar-2021,Reversal,00.00,"5,317.76","26,588.82"
09-Mar-2021,Commission,44.10,00.00,"26,632.92"
09-Mar-2021,Miscellaneous,00.00,"2,663.29","23,969.63"
09-Mar-2021,Transfer,"1,046,350.50",00.00,"1,070,320.13"
09-Mar-2021,Cheque,00.00,"535,160.07","535,160.06"
09-Mar-2021,Debit Card,00.00,"66,895.01","468,265.05"
09-Mar-2021,Commission,00.00,"156,088.35","312,176.70"
09-Mar-2021,Commission,550.70,00.00,"312,727.40"
10-Mar-2021,Bill,"552,985.00",00.00,"865,712.40"
10-Mar-2021,NEFT,464.54,00.00,"866,176.94"
10-Mar-2021,IMPS,00.00,"173,235.39","692,941.55"
10-Mar-2021,ATM,352.20,00.00,"693,293.75"
10-Mar-2021,ATM,03.00,00.00,"693,296.75"
10-Mar-2021,Transfer,66.40,00.00,"693,363.15"
10-Mar-2021,Transfer,11.00,00.00,"693,374.15"
10-Mar-2021,Interest,00.00,"69,337.42","624,036.74"
10-Mar-2021,Cash,00.00,"624,036.74",00.00
10-Mar-2021,Miscellaneous,"923,209.00",00.00,"923,209.00"
10-Mar-2021,Interest,00.00,"461,604.50","461,604.50"
10-Mar-2021,NEFT,00.00,"76,934.08","384,670.42"
10-Mar-2021,Miscellaneous,04.90,00.00,"384,675.32"
10-Mar-2021,Commission,00.00,"128,225.11","256,450.21"
10-Mar-2021,Purchase,00.00,"51,290.04","205,160.17"
10-Mar-2021,Reversal,106.00,00.00,"205,266.17"
10-Mar-2021,RTGS,00.00,"68,422.06","136,844.11"
10-Mar-2021,Cheque,00.65,00.00,"136,844.76"
10-Mar-2021,ATM,563.00,00.00,"137,407.76"
10-Mar-2021,Reversal,152.39,00.00,"137,560.15"
10-Mar-2021,Transfer,07.00,00.00,"137,567.15"
10-Mar-2021,Purchase,"22,044.16",00.00,"159,611.31"
10-Mar-2021,NEFT,"124,453.75",00.00,"284,065.06"
10-Mar-2021,Bill,00.00,"47,344.18","236,720.88"
10-Mar-2021,Cash,00.00,"59,180.22","177,540.66"
10-Mar-2021,Cash,"3,579.00",00.00,"181,119.66"
10-Mar-2021,Debit Card,00.00,"22,639.96","158,479.70"
10-Mar-2021,Reversal,00.00,"79,239.85","79,239.85"
10-Mar-2021,Commission,00.00,"26,413.28","52,826.57"
10-Mar-2021,Cash,485.06,00.00,"53,311.63"
10-Mar-2021,Debit Card,00.00,"5,331.16","47,980.47"
10-Mar-2021,Cash,00.00,"5,331.16","42,649.31"
10-Mar-2021,Debit Card,36.40,00.00,"42,685.71"
10-Mar-2021,Interest,00.00,"21,342.86","21,342.86"
10-Mar-2021,ATM,03.00,00.00,"21,345.86"
10-Mar-2021,Cash,00.00,"2,371.76","18,974.10"
11-Mar-2021,Tax,"2,384.80",00.00,"21,358.90"
11-Mar-2021,Reversal,00.00,"21,358.90",00.00
11-Mar-2021,IMPS,114.23,00.00,114.23
11-Mar-2021,Cheque,04.27,00.00,118.50
11-Mar-2021,Bill,"121,770.90",00.00,"121,889.40"
11-Mar-2021,Debit Card,00.00,"30,472.35","91,417.05"
11-Mar-2021,NEFT,00.00,"45,708.53","45,708.52"
12-Mar-2021,Transfer,00.00,"22,854.26","22,854.26"
12-Mar-2021,IMPS,00.50,00.00,"22,854.76"
12-Mar-2021,Commission,380.21,00.00,"23,234.97"
12-Mar-2021,Purchase,"800,311.75",00.00,"823,546.72"
12-Mar-2021,Interest,00.00,"82,354.67","741,192.05"
12-Mar-2021,ATM,00.00,"92,649.01","648,543.04"
12-Mar-2021,Miscellaneous,00.00,"162,135.76","486,407.28"
12-Mar-2021,RTGS,"242,381.34",00.00,"728,788.62"
12-Mar-2021,NEFT,00.00,"364,394.31","364,394.31"
12-Mar-2021,Commission,00.00,"364,394.31",00.00
12-Mar-2021,Transfer,"18,008.00",00.00,"18,008.00"
12-Mar-2021,Cash,00.00,"9,004.00","9,004.00"
12-Mar-2021,Bill,"241,136.44",00.00,"250,140.44"
12-Mar-2021,Purchase,00.00,"41,690.07","208,450.37"
12-Mar-2021,Reversal,01.30,00.00,"208,451.67"
12-Mar-2021,ATM,00.00,"208,451.67",00.00
12-Mar-2021,Cheque,02.00,00.00,02.00
12-Mar-2021,ATM,00.00,00.67,01.33
13-Mar-2021,Commission,00.56,00.00,01.89
13-Mar-2021,Miscellaneous,"11,403.00",00.00,"11,404.89"
13-Mar-2021,ATM,00.00,"2,851.22","8,553.67"
13-Mar-2021,IMPS,252.00,00.00,"8,805.67"
13-Mar-2021,Tax,438.13,00.00,"9,243.80"
13-Mar-2021,Debit Card,00.00,"3,081.27","6,162.53"
13-Mar-2021,Tax,01.00,00.00,"6,163.53"
13-Mar-2021,Miscellaneous,00.00,616.35,"5,547.18"
13-Mar-2021,Tax,"149,642.00",00.00,"155,189.18"
13-Mar-2021,RTGS,"1,246.39",00.00,"156,435.57"
13-Mar-2021,Cash,260.40,00.00,"156,695.97"
13-Mar-2021,Interest,00.00,"22,385.14","134,310.83"
13-Mar-2021,Purchase,"2,903.00",00.00,"137,213.83"
14-Mar-2021,Debit Card,00.00,"68,606.92","68,606.91"
14-Mar-2021,RTGS,00.00,"13,721.38","54,885.53"
14-Mar-2021,Commission,00.00,"5,488.55","49,396.98"
14-Mar-2021,IMPS,113.33,00.00,"49,510.31"
14-Mar-2021,Cash,03.40,00.00,"49,513.71"
14-Mar-2021,Debit Card,55.13,00.00,"49,568.84"
14-Mar-2021,Cheque,150.10,00.00,"49,718.94"
14-Mar-2021,Interest,00.00,"6,214.87","43,504.07"
14-Mar-2021,NEFT,00.00,"4,833.79","38,670.28"
14-Mar-2021,Cheque,00.00,"7,734.06","30,936.22"
14-Mar-2021,Interest,00.00,"3,437.36","27,498.86"
14-Mar-2021,Interest,"920,762.00",00.00,"948,260.86"
14-Mar-2021,Tax,00.00,"189,652.17","758,608.69"
14-Mar-2021,Reversal,"37,659.40",00.00,"796,268.09"
14-Mar-2021,Miscellaneous,467.50,00.00,"796,735.59"
14-Mar-2021,Miscellaneous,"10,195.58",00.00,"806,931.17"
14-Mar-2021,Transfer,"1,712,841.00",00.00,"2,519,772.17"
14-Mar-2021,RTGS,32.02,00.00,"2,519,804.19"
14-Mar-2021,Miscellaneous,00.00,"2,519,804.19",00.00
14-Mar-2021,Debit Card,"3,653.30",00.00,"3,653.30"
14-Mar-2021,Cheque,00.00,"1,217.77","2,435.53"
14-Mar-2021,Transfer,172.00,00.00,"2,607.53"
14-Mar-2021,Cheque,142.60,00.00,"2,750.13"
14-Mar-2021,Miscellaneous,331.63,00.00,"3,081.76"
14-Mar-2021,Transfer,00.00,513.63,"2,568.13"
14-Mar-2021,Commission,00.00,"1,284.07","1,284.06"
15-Mar-2021,Commission,56.50,00.00,"1,340.56"
15-Mar-2021,Cheque,04.00,00.00,"1,344.56"
15-Mar-2021,Cheque,00.00,"1,344.56",00.00
15-Mar-2021,IMPS,"21,906.00",00.00,"21,906.00"
15-Mar-2021,Purchase,205.28,00.00,"22,111.28"
15-Mar-2021,Reversal,"82,618.00",00.00,"104,729.28"
15-Mar-2021,Cheque,00.00,"13,091.16","91,638.12"
15-Mar-2021,RTGS,"9,362.04",00.00,"101,000.16"
15-Mar-2021,Cheque,00.00,"10,100.02","90,900.14"
15-Mar-2021,Debit Card,00.00,"18,180.03","72,720.11"
15-Mar-2021,Transfer,00.00,"24,240.04","48,480.07"
15-Mar-2021,Miscellaneous,00.00,"6,925.72","41,554.35"
15-Mar-2021,Commission,00.00,"6,925.73","34,628.62"
15-Mar-2021,Debit Card,00.00,"17,314.31","17,314.31"
15-Mar-2021,Cash,00.00,"2,164.29","15,150.02"
15-Mar-2021,Debit Card,63.70,00.00,"15,213.72"
15-Mar-2021,Tax,00.00,"15,213.72",00.00
15-Mar-2021,RTGS,47.00,00.00,47.00
15-Mar-2021,Interest,00.00,05.88,41.12
15-Mar-2021,Debit Card,00.00,04.11,37.01
15-Mar-2021,IMPS,13.70,00.00,50.71
15-Mar-2021,IMPS,00.00,50.71,00.00
15-Mar-2021,IMPS,"21,172.00",00.00,"21,172.00"
15-Mar-2021,Interest,328.00,00.00,"21,500.00"
15-Mar-2021,Commission,00.00,"4,300.00","17,200.00"
15-Mar-2021,ATM,674.00,00.00,"17,874.00"
15-Mar-2021,NEFT,131.60,00.00,"18,005.60"
15-Mar-2021,RTGS,00.00,"3,000.93","15,004.67"
15-Mar-2021,Miscellaneous,00.00,"7,502.34","7,502.34"
15-Mar-2021,ATM,"15,807.80",00.00,"23,310.14"
15-Mar-2021,Purchase,00.00,"11,655.07","11,655.07"
15-Mar-2021,RTGS,00.00,"1,295.01","10,360.06"
15-Mar-2021,Miscellaneous,"124,543.53",00.00,"134,903.59"
15-Mar-2021,Commission,04.50,00.00,"134,908.09"
15-Mar-2021,Reversal,"27,871.22",00.00,"162,779.31"
15-Mar-2021,Interest,"24,999.50",00.00,"187,778.81"
15-Mar-2021,Commission,04.00,00.00,"187,782.81"
15-Mar-2021,Transfer,00.00,"18,778.28","169,004.53"
15-Mar-2021,Reversal,61.26,00.00,"169,065.79"
15-Mar-2021,Tax,00.00,"33,813.16","135,252.63"
15-Mar-2021,Commission,00.00,"16,906.58","118,346.05"
15-Mar-2021,Cheque,"14,875.80",00.00,"133,221.85"
15-Mar-2021,Transfer,365.00,00.00,"133,586.85"
15-Mar-2021,Reversal,00.00,"133,586.85",00.00
15-Mar-2021,Debit Card,"1,150.10",00.00,"1,150.10"
15-Mar-2021,Transfer,00.00,575.05,575.05
15-Mar-2021,RTGS,129.42,00.00,704.47
15-Mar-2021,Debit Card,00.00,140.89,563.58
15-Mar-2021,NEFT,00.00,187.86,375.72
15-Mar-2021,Miscellaneous,"8,394.00",00.00,"8,769.72"
15-Mar-2021,RTGS,"204,112.72",00.00,"212,882.44"
15-Mar-2021,NEFT,01.30,00.00,"212,883.74"
15-Mar-2021,Purchase,"403,179.25",00.00,"616,062.99"
15-Mar-2021,Commission,00.00,"308,031.50","308,031.50"
15-Mar-2021,Commission,00.00,"77,007.88","231,023.62"
15-Mar-2021,Tax,222.44,00.00,"231,246.06"
15-Mar-2021,Bill,00.00,"231,246.06",00.00
15-Mar-2021,Tax,"20,881.50",00.00,"20,881.50"
15-Mar-2021,NEFT,00.00,"6,960.50","13,921.00"
15-Mar-2021,RTGS,403.90,00.00,"14,324.90"
15-Mar-2021,Reversal,60.00,00.00,"14,384.90"
16-Mar-2021,NEFT,00.00,"3,596.23","10,788.68"
16-Mar-2021,Cash,47.70,00.00,"10,836.38"
16-Mar-2021,RTGS,00.00,"1,204.04","9,632.34"
16-Mar-2021,ATM,00.00,"1,605.39","8,026.95"
16-Mar-2021,Tax,"1,080,534.00",00.00,"1,088,560.95"
16-Mar-2021,Tax,00.00,"272,140.24","816,420.71"
16-Mar-2021,NEFT,04.00,00.00,"816,424.71"
16-Mar-2021,Debit Card,"2,229.86",00.00,"818,654.57"
16-Mar-2021,Purchase,14.00,00.00,"818,668.57"
16-Mar-2021,ATM,00.00,"204,667.14","614,001.43"
16-Mar-2021,Miscellaneous,"1,175,858.50",00.00,"1,789,859.93"
16-Mar-2021,Interest,00.00,"447,464.98","1,342,394.95"
16-Mar-2021,Commission,00.00,"1,342,394.95",00.00
16-Mar-2021,ATM,"963,223.80",00.00,"963,223.80"
16-Mar-2021,Tax,"199,129.70",00.00,"1,162,353.50"
16-Mar-2021,Commission,00.00,"387,451.17","774,902.33"
16-Mar-2021,Miscellaneous,00.00,"129,150.39","645,751.94"
16-Mar-2021,IMPS,00.00,"322,875.97","322,875.97"
16-Mar-2021,Commission,45.22,00.00,"322,921.19"
16-Mar-2021,NEFT,00.00,"80,730.30","242,190.89"
16-Mar-2021,Miscellaneous,350.08,00.00,"242,540.97"
16-Mar-2021,Purchase,00.00,"60,635.24","181,905.73"
16-Mar-2021,Miscellaneous,00.00,"90,952.87","90,952.86"
16-Mar-2021,NEFT,04.80,00.00,"90,957.66"
16-Mar-2021,Debit Card,200.00,00.00,"91,157.66"
16-Mar-2021,ATM,00.00,"13,022.52","78,135.14"
16-Mar-2021,Miscellaneous,"165,547.81",00.00,"243,682.95"
16-Mar-2021,Miscellaneous,00.00,"34,811.85","208,871.10"
16-Mar-2021,NEFT,00.00,"208,871.10",00.00
16-Mar-2021,Commission,"3,831.57",00.00,"3,831.57"
16-Mar-2021,Tax,"24,934.00",00.00,"28,765.57"
16-Mar-2021,RTGS,00.00,"7,191.39","21,574.18"
16-Mar-2021,Reversal,00.00,"21,574.18",00.00
16-Mar-2021,RTGS,"42,939.00",00.00,"42,939.00"
16-Mar-2021,Purchase,00.00,"4,293.90","38,645.10"
16-Mar-2021,ATM,06.30,00.00,"38,651.40"
16-Mar-2021,RTGS,06.75,00.00,"38,658.15"
16-Mar-2021,ATM,27.40,00.00,"38,685.55"
16-Mar-2021,Interest,00.00,"4,835.69","33,849.86"
16-Mar-2021,RTGS,227.21,00.00,"34,077.07"
16-Mar-2021,IMPS,00.00,"34,077.07",00.00
16-Mar-2021,Miscellaneous,"2,858.60",00.00,"2,858.60"
16-Mar-2021,Transfer,251.00,00.00,"3,109.60"
16-Mar-2021,Interest,02.00,00.00,"3,111.60"
16-Mar-2021,Cheque,00.00,311.16,"2,800.44"
16-Mar-2021,NEFT,"8,919.00",00.00,"11,719.44"
16-Mar-2021,Transfer,"20,856.60",00.00,"32,576.04"
16-Mar-2021,Purchase,00.00,"10,858.68","21,717.36"
16-Mar-2021,Reversal,00.00,"10,858.68","10,858.68"
16-Mar-2021,Interest,"1,135.00",00.00,"11,993.68"
16-Mar-2021,Miscellaneous,03.09,00.00,"11,996.77"
16-Mar-2021,Purchase,00.00,"1,199.68","10,797.09"
16-Mar-2021,Debit Card,00.00,"5,398.55","5,398.54"
16-Mar-2021,Commission,00.00,"2,699.27","2,699.27"
16-Mar-2021,Reversal,00.00,"1,349.64","1,349.64"
16-Mar-2021,NEFT,00.00,674.82,674.82
16-Mar-2021,Transfer,"15,185.10",00.00,"15,859.92"
17-Mar-2021,Cash,02.00,00.00,"15,861.92"
18-Mar-2021,Cash,00.00,"1,586.19","14,275.73"
18-Mar-2021,Interest,00.80,00.00,"14,276.53"
18-Mar-2021,Reversal,"384,528.00",00.00,"398,804.53"
18-Mar-2021,Tax,259.00,00.00,"399,063.53"
18-Mar-2021,Miscellaneous,00.00,"133,021.18","266,042.35"
18-Mar-2021,Purchase,"134,977.00",00.00,"401,019.35"
18-Mar-2021,Interest,00.00,"133,673.12","267,346.23"
18-Mar-2021,Cash,07.60,00.00,"267,353.83"
18-Mar-2021,Cash,56.60,00.00,"267,410.43"
18-Mar-2021,Commission,00.00,"26,741.04","240,669.39"
18-Mar-2021,Commission,"2,730.00",00.00,"243,399.39"
18-Mar-2021,NEFT,"41,544.00",00.00,"284,943.39"
18-Mar-2021,Reversal,01.20,00.00,"284,944.59"
18-Mar-2021,Cash,458.20,00.00,"285,402.79"
18-Mar-2021,Cheque,00.00,"285,402.79",00.00
18-Mar-2021,Tax,"1,633,076.75",00.00,"1,633,076.75"
18-Mar-2021,Purchase,"1,990,114.50",00.00,"3,623,191.25"
18-Mar-2021,RTGS,00.00,"905,797.81","2,717,393.44"
18-Mar-2021,Tax,07.94,00.00,"2,717,401.38"
18-Mar-2021,Cheque,"1,892,551.75",00.00,"4,609,953.13"
19-Mar-2021,Interest,"101,039.70",00.00,"4,710,992.83"
19-Mar-2021,Debit Card,"244,258.00",00.00,"4,955,250.83"
20-Mar-2021,Cash,"1,408,871.00",00.00,"6,364,121.83"
20-Mar-2021,Cash,"9,212.00",00.00,"6,373,333.83"
20-Mar-2021,NEFT,00.00,"2,124,444.61","4,248,889.22"
20-Mar-2021,Tax,"249,346.00",00.00,"4,498,235.22"
20-Mar-2021,IMPS,00.00,"1,124,558.81","3,373,676.42"
20-Mar-2021,Reversal,"4,072.90",00.00,"3,377,749.32"
20-Mar-2021,Reversal,335.97,00.00,"3,378,085.29"
20-Mar-2021,IMPS,00.00,"482,583.61","2,895,501.68"
20-Mar-2021,NEFT,00.00,"1,447,750.84","1,447,750.84"
20-Mar-2021,Transfer,00.00,"144,775.08","1,302,975.76"
20-Mar-2021,Tax,00.00,"434,325.25","868,650.51"
20-Mar-2021,Bill,00.00,"868,650.51",00.00
20-Mar-2021,Debit Card,"3,099.00",00.00,"3,099.00"
20-Mar-2021,Bill,00.00,774.75,"2,324.25"
20-Mar-2021,Reversal,00.00,232.43,"2,091.82"
20-Mar-2021,Reversal,471.80,00.00,"2,563.62"
20-Mar-2021,Bill,00.00,320.45,"2,243.17"
20-Mar-2021,Transfer,22.98,00.00,"2,266.15"
20-Mar-2021,Reversal,00.00,453.23,"1,812.92"
20-Mar-2021,Interest,59.10,00.00,"1,872.02"
20-Mar-2021,Purchase,01.60,00.00,"1,873.62"
20-Mar-2021,Purchase,00.00,624.54,"1,249.08"
20-Mar-2021,Cash,249.00,00.00,"1,498.08"
20-Mar-2021,Interest,41.00,00.00,"1,539.08"
20-Mar-2021,Purchase,35.00,00.00,"1,574.08"
20-Mar-2021,IMPS,00.00,393.52,"1,180.56"
20-Mar-2021,NEFT,351.01,00.00,"1,531.57"
20-Mar-2021,Interest,"1,190.60",00.00,"2,722.17"
20-Mar-2021,NEFT,06.57,00.00,"2,728.74"
20-Mar-2021,NEFT,00.00,"1,364.37","1,364.37"
20-Mar-2021,Purchase,06.10,00.00,"1,370.47"
20-Mar-2021,IMPS,00.00,685.24,685.24
20-Mar-2021,IMPS,00.00,76.14,609.10
20-Mar-2021,Debit Card,484.00,00.00,"1,093.10"
20-Mar-2021,Bill,00.00,546.55,546.55
20-Mar-2021,Purchase,"2,773.00",00.00,"3,319.55"
20-Mar-2021,IMPS,00.00,"3,319.55",00.00
20-Mar-2021,Purchase,36.87,00.00,36.87
20-Mar-2021,Tax,00.00,07.37,29.50
20-Mar-2021,ATM,00.00,03.28,26.22
20-Mar-2021,Bill,91.00,00.00,117.22
20-Mar-2021,Commission,00.00,19.54,97.68
20-Mar-2021,Tax,"299,110.50",00.00,"299,208.18"
20-Mar-2021,Cash,00.00,"99,736.06","199,472.12"
20-Mar-2021,Reversal,00.00,"33,245.35","166,226.77"
20-Mar-2021,NEFT,05.00,00.00,"166,231.77"
20-Mar-2021,NEFT,00.00,"23,747.40","142,484.37"
20-Mar-2021,Debit Card,00.00,"20,354.91","122,129.46"
20-Mar-2021,NEFT,00.00,"30,532.37","91,597.10"
20-Mar-2021,Miscellaneous,00.00,"13,085.30","78,511.80"
20-Mar-2021,Tax,150.00,00.00,"78,661.80"
20-Mar-2021,Interest,00.00,"19,665.45","58,996.35"
21-Mar-2021,Cash,13.00,00.00,"59,009.35"
21-Mar-2021,Commission,32.60,00.00,"59,041.95"
21-Mar-2021,Debit Card,00.00,"9,840.33","49,201.62"
21-Mar-2021,NEFT,00.00,"9,840.32","39,361.30"
21-Mar-2021,RTGS,06.50,00.00,"39,367.80"
21-Mar-2021,Purchase,07.00,00.00,"39,374.80"
21-Mar-2021,Debit Card,00.00,"7,874.96","31,499.84"
21-Mar-2021,NEFT,463.12,00.00,"31,962.96"
21-Mar-2021,Interest,14.50,00.00,"31,977.46"
21-Mar-2021,Tax,"20,155.90",00.00,"52,133.36"
21-Mar-2021,NEFT,32.00,00.00,"52,165.36"
21-Mar-2021,Reversal,04.50,00.00,"52,169.86"
21-Mar-2021,Cash,"1,918.00",00.00,"54,087.86"
21-Mar-2021,Bill,01.40,00.00,"54,089.26"
21-Mar-2021,Bill,367.84,00.00,"54,457.10"
21-Mar-2021,Reversal,"29,589.00",00.00,"84,046.10"
21-Mar-2021,Commission,86.00,00.00,"84,132.10"
21-Mar-2021,Bill,05.30,00.00,"84,137.40"
21-Mar-2021,Transfer,24.21,00.00,"84,161.61"
21-Mar-2021,Bill,"1,013,987.25",00.00,"1,098,148.86"
21-Mar-2021,Commission,163.99,00.00,"1,098,312.85"
21-Mar-2021,Purchase,00.00,"156,901.84","941,411.01"
21-Mar-2021,Transfer,"949,950.00",00.00,"1,891,361.01"
21-Mar-2021,Commission,"14,348.60",00.00,"1,905,709.61"
21-Mar-2021,Interest,02.00,00.00,"1,905,711.61"
21-Mar-2021,Purchase,00.00,"272,244.52","1,633,467.09"
21-Mar-2021,Miscellaneous,07.68,00.00,"1,633,474.77"
21-Mar-2021,Debit Card,00.00,"163,347.48","1,470,127.29"
21-Mar-2021,RTGS,00.00,"210,018.18","1,260,109.11"
21-Mar-2021,Cheque,00.00,"180,015.59","1,080,093.52"
21-Mar-2021,Purchase,00.00,"360,031.17","720,062.35"
21-Mar-2021,Purchase,07.17,00.00,"720,069.52"
21-Mar-2021,ATM,"221,025.75",00.00,"941,095.27"
21-Mar-2021,Reversal,"2,578.77",00.00,"943,674.04"
21-Mar-2021,Interest,"250,429.94",00.00,"1,194,103.98"
21-Mar-2021,Interest,"1,927.00",00.00,"1,196,030.98"
21-Mar-2021,Bill,00.00,"1,196,030.98",00.00
21-Mar-2021,Cheque,442.00,00.00,442.00
21-Mar-2021,Tax,08.00,00.00,450.00
21-Mar-2021,Interest,00.00,45.00,405.00
21-Mar-2021,Interest,00.00,40.50,364.50
21-Mar-2021,Transfer,00.00,182.25,182.25
21-Mar-2021,Purchase,"764,806.00",00.00,"764,988.25"
21-Mar-2021,Purchase,00.00,"76,498.83","688,489.42"
21-Mar-2021,Cash,00.00,"229,496.47","458,992.95"
21-Mar-2021,Purchase,02.00,00.00,"458,994.95"
21-Mar-2021,Transfer,06.10,00.00,"459,001.05"
21-Mar-2021,Cash,00.00,"114,750.26","344,250.79"
21-Mar-2021,RTGS,00.00,"344,250.79",00.00
21-Mar-2021,Interest,"8,470.00",00.00,"8,470.00"
21-Mar-2021,Tax,"20,595.40",00.00,"29,065.40"
21-Mar-2021,NEFT,00.00,"9,688.47","19,376.93"
21-Mar-2021,Bill,163.23,00.00,"19,540.16"
21-Mar-2021,Cheque,109.22,00.00,"19,649.38"
21-Mar-2021,RTGS,00.00,"1,964.94","17,684.44"
21-Mar-2021,Bill,27.30,00.00,"17,711.74"
21-Mar-2021,Bill,00.00,"2,530.25","15,181.49"
21-Mar-2021,Cheque,00.00,"1,518.15","13,663.34"
21-Mar-2021,Purchase,00.00,"13,663.34",00.00
21-Mar-2021,Tax,"1,422,753.00",00.00,"1,422,753.00"
21-Mar-2021,Transfer,36.00,00.00,"1,422,789.00"
21-Mar-2021,Debit Card,02.39,00.00,"1,422,791.39"
21-Mar-2021,NEFT,00.00,"1,422,791.39",00.00
21-Mar-2021,Miscellaneous,"14,553.00",00.00,"14,553.00"
21-Mar-2021,Purchase,00.00,"1,617.00","12,936.00"
21-Mar-2021,IMPS,00.00,"3,234.00","9,702.00"
21-Mar-2021,Cheque,"19,389.10",00.00,"29,091.10"
21-Mar-2021,Commission,"56,872.90",00.00,"85,964.00"
21-Mar-2021,Tax,00.00,"17,192.80","68,771.20"
21-Mar-2021,Tax,173.00,00.00,"68,944.20"
21-Mar-2021,Interest,00.00,"68,944.20",00.00
21-Mar-2021,Transfer,"2,252.16",00.00,"2,252.16"
21-Mar-2021,Cheque,00.00,281.52,"1,970.64"
21-Mar-2021,Transfer,00.00,328.44,"1,642.20"
21-Mar-2021,ATM,06.52,00.00,"1,648.72"
21-Mar-2021,Cheque,"4,893.70",00.00,"6,542.42"
21-Mar-2021,Cheque,"30,811.00",00.00,"37,353.42"
21-Mar-2021,Commission,"1,671.70",00.00,"39,025.12"
21-Mar-2021,Tax,00.00,"39,025.12",00.00
21-Mar-2021,Commission,"48,974.03",00.00,"48,974.03"
21-Mar-2021,ATM,00.00,"6,121.75","42,852.28"
21-Mar-2021,Interest,00.00,"10,713.07","32,139.21"
21-Mar-2021,IMPS,02.70,00.00,"32,141.91"
21-Mar-2021,Miscellaneous,00.00,"3,214.19","28,927.72"
21-Mar-2021,Interest,59.00,00.00,"28,986.72"
21-Mar-2021,Transfer,00.00,"3,220.75","25,765.97"
21-Mar-2021,Reversal,"74,350.00",00.00,"100,115.97"
21-Mar-2021,Purchase,"3,830.20",00.00,"103,946.17"
21-Mar-2021,Cheque,"144,713.00",00.00,"248,659.17"
21-Mar-2021,Interest,00.00,"41,443.20","207,215.98"
21-Mar-2021,Reversal,"591,241.50",00.00,"798,457.48"
21-Mar-2021,IMPS,"16,140.90",00.00,"814,598.38"
21-Mar-2021,RTGS,47.00,00.00,"814,645.38"
22-Mar-2021,Commission,00.00,"407,322.69","407,322.69"
22-Mar-2021,Purchase,00.00,"81,464.54","325,858.15"
22-Mar-2021,Bill,00.00,"40,732.27","285,125.88"
22-Mar-2021,NEFT,00.00,"285,125.88",00.00
22-Mar-2021,Cheque,"2,088.00",00.00,"2,088.00"
22-Mar-2021,Commission,00.00,"1,044.00","1,044.00"
22-Mar-2021,IMPS,"22,179.00",00.00,"23,223.00"
22-Mar-2021,Purchase,"245,901.10",00.00,"269,124.10"
22-Mar-2021,Cheque,00.00,"89,708.03","179,416.07"
22-Mar-2021,Debit Card,00.00,"35,883.21","143,532.86"
22-Mar-2021,Commission,00.00,"71,766.43","71,766.43"
22-Mar-2021,RTGS,"102,838.50",00.00,"174,604.93"
22-Mar-2021,Cash,"18,497.00",00.00,"193,101.93"
22-Mar-2021,Miscellaneous,00.00,"38,620.39","154,481.54"
22-Mar-2021,Debit Card,51.00,00.00,"154,532.54"
22-Mar-2021,Debit Card,156.00,00.00,"154,688.54"
22-Mar-2021,Cheque,00.00,"51,562.85","103,125.69"
22-Mar-2021,NEFT,00.00,"34,375.23","68,750.46"
22-Mar-2021,Miscellaneous,40.00,00.00,"68,790.46"
22-Mar-2021,Bill,16.60,00.00,"68,807.06"
22-Mar-2021,Cash,00.00,"13,761.41","55,045.65"
22-Mar-2021,Commission,07.26,00.00,"55,052.91"
22-Mar-2021,RTGS,00.00,"13,763.23","41,289.68"
22-Mar-2021,Miscellaneous,"3,626.00",00.00,"44,915.68"
22-Mar-2021,Debit Card,00.00,"14,971.89","29,943.79"
22-Mar-2021,Reversal,"637,382.50",00.00,"667,326.29"
22-Mar-2021,IMPS,"187,294.00",00.00,"854,620.29"
22-Mar-2021,Transfer,00.00,"122,088.61","732,531.68"
22-Mar-2021,Debit Card,62.00,00.00,"732,593.68"
23-Mar-2021,Interest,00.00,"146,518.74","586,074.94"
23-Mar-2021,Cheque,10.90,00.00,"586,085.84"
23-Mar-2021,Commission,62.20,00.00,"586,148.04"
23-Mar-2021,Reversal,"219,775.00",00.00,"805,923.04"
23-Mar-2021,Debit Card,13.00,00.00,"805,936.04"
23-Mar-2021,Cash,00.00,"161,187.21","644,748.83"
23-Mar-2021,Debit Card,00.00,"644,748.83",00.00
23-Mar-2021,Commission,"3,152.41",00.00,"3,152.41"
23-Mar-2021,Tax,00.00,630.48,"2,521.93"
23-Mar-2021,Transfer,96.50,00.00,"2,618.43"
23-Mar-2021,Commission,"3,569.00",00.00,"6,187.43"
23-Mar-2021,Debit Card,"15,071.10",00.00,"21,258.53"
23-Mar-2021,RTGS,"3,250.00",00.00,"24,508.53"
23-Mar-2021,Commission,"3,338.11",00.00,"27,846.64"
23-Mar-2021,Tax,"1,254,028.00",00.00,"1,281,874.64"
23-Mar-2021,Transfer,00.00,"142,430.52","1,139,444.12"
23-Mar-2021,Bill,00.00,"569,722.06","569,722.06"
23-Mar-2021,Bill,"2,841.00",00.00,"572,563.06"
23-Mar-2021,IMPS,00.00,"572,563.06",00.00
23-Mar-2021,Debit Card,"14,366.00",00.00,"14,366.00"
23-Mar-2021,Purchase,"384,712.50",00.00,"399,078.50"
23-Mar-2021,Purchase,00.00,"44,342.06","354,736.44"
23-Mar-2021,Bill,"1,177,602.00",00.00,"1,532,338.44"
23-Mar-2021,Cash,29.50,00.00,"1,532,367.94"
23-Mar-2021,Commission,274.98,00.00,"1,532,642.92"
23-Mar-2021,RTGS,13.00,00.00,"1,532,655.92"
23-Mar-2021,Miscellaneous,00.00,"153,265.59","1,379,390.33"
23-Mar-2021,ATM,00.00,"344,847.58","1,034,542.75"
23-Mar-2021,NEFT,00.00,"129,317.84","905,224.91"
24-Mar-2021,Interest,00.00,"150,870.82","754,354.09"
24-Mar-2021,Debit Card,"2,666.00",00.00,"757,020.09"
25-Mar-2021,Cheque,22.10,00.00,"757,042.19"
25-Mar-2021,Commission,"14,161.00",00.00,"771,203.19"
25-Mar-2021,RTGS,00.00,"154,240.64","616,962.55"
25-Mar-2021,Bill,"2,089,571.00",00.00,"2,706,533.55"
25-Mar-2021,Cheque,06.00,00.00,"2,706,539.55"
25-Mar-2021,Commission,02.00,00.00,"2,706,541.55"
25-Mar-2021,Miscellaneous,00.00,"676,635.39","2,029,906.16"
25-Mar-2021,Reversal,00.00,"253,738.27","1,776,167.89"
25-Mar-2021,NEFT,"3,725.00",00.00,"1,779,892.89"
25-Mar-2021,RTGS,00.00,"889,946.45","889,946.44"
25-Mar-2021,Purchase,00.00,"148,324.41","741,622.03"
25-Mar-2021,NEFT,00.00,"92,702.75","648,919.28"
25-Mar-2021,RTGS,00.00,"92,702.75","556,216.53"
25-Mar-2021,Bill,00.00,"55,621.65","500,594.88"
25-Mar-2021,Commission,00.00,"50,059.49","450,535.39"
25-Mar-2021,Cash,"270,180.00",00.00,"720,715.39"
25-Mar-2021,Purchase,00.00,"240,238.46","480,476.93"
25-Mar-2021,Commission,23.60,00.00,"480,500.53"
25-Mar-2021,Debit Card,00.00,"80,083.42","400,417.11"
26-Mar-2021,Cash,00.00,"400,417.11",00.00
26-Mar-2021,Tax,"215,028.00",00.00,"215,028.00"
26-Mar-2021,NEFT,00.00,"35,838.00","179,190.00"
26-Mar-2021,NEFT,451.10,00.00,"179,641.10"
26-Mar-2021,Commission,"3,387.40",00.00,"183,028.50"
26-Mar-2021,Purchase,00.00,"18,302.85","164,725.65"
26-Mar-2021,Cheque,00.00,"16,472.57","148,253.08"
26-Mar-2021,Commission,00.00,"74,126.54","74,126.54"
26-Mar-2021,Bill,"1,839,877.00",00.00,"1,914,003.54"
26-Mar-2021,Cheque,00.00,"239,250.44","1,674,753.10"
26-Mar-2021,Commission,00.00,"418,688.28","1,256,064.83"
26-Mar-2021,Bill,43.40,00.00,"1,256,108.23"
26-Mar-2021,ATM,"12,307.20",00.00,"1,268,415.43"
26-Mar-2021,IMPS,00.00,"1,268,415.43",00.00
27-Mar-2021,Reversal,"3,596.00",00.00,"3,596.00"
27-Mar-2021,IMPS,00.00,"1,798.00","1,798.00"
27-Mar-2021,Tax,00.00,299.67,"1,498.33"
27-Mar-2021,Debit Card,00.45,00.00,"1,498.78"
27-Mar-2021,NEFT,00.00,187.35,"1,311.43"
27-Mar-2021,Debit Card,"56,848.53",00.00,"58,159.96"
27-Mar-2021,ATM,"226,344.80",00.00,"284,504.76"
27-Mar-2021,NEFT,00.00,"40,643.54","243,861.22"
27-Mar-2021,Miscellaneous,00.00,"24,386.12","219,475.10"
27-Mar-2021,Commission,00.00,"54,868.78","164,606.33"
27-Mar-2021,Interest,"2,642.00",00.00,"167,248.33"
27-Mar-2021,Miscellaneous,"998,388.80",00.00,"1,165,637.13"
27-Mar-2021,ATM,"1,331,362.50",00.00,"2,496,999.63"
28-Mar-2021,Bill,00.00,"1,248,499.82","1,248,499.82"
28-Mar-2021,RTGS,00.00,"156,062.48","1,092,437.34"
28-Mar-2021,Interest,"1,516.77",00.00,"1,093,954.11"
28-Mar-2021,Cash,"3,160.00",00.00,"1,097,114.11"
28-Mar-2021,Purchase,00.00,"548,557.06","548,557.06"
28-Mar-2021,ATM,00.00,"54,855.71","493,701.35"
28-Mar-2021,Purchase,463.90,00.00,"494,165.25"
28-Mar-2021,ATM,"55,279.00",00.00,"549,444.25"
28-Mar-2021,Transfer,00.00,"68,680.53","480,763.72"
28-Mar-2021,Transfer,00.00,"96,152.74","384,610.98"
28-Mar-2021,Purchase,06.28,00.00,"384,617.26"
28-Mar-2021,RTGS,00.00,"38,461.73","346,155.53"
28-Mar-2021,Debit Card,475.23,00.00,"346,630.76"
28-Mar-2021,Bill,00.00,"69,326.15","277,304.61"
28-Mar-2021,IMPS,00.00,"92,434.87","184,869.74"
28-Mar-2021,ATM,"25,715.20",00.00,"210,584.94"
28-Mar-2021,Purchase,00.00,"105,292.47","105,292.47"
28-Mar-2021,Transfer,35.20,00.00,"105,327.67"
28-Mar-2021,Tax,00.00,"11,703.07","93,624.60"
28-Mar-2021,Tax,"2,337.46",00.00,"95,962.06"
28-Mar-2021,Cash,00.00,"10,662.45","85,299.61"
28-Mar-2021,Commission,"13,976.30",00.00,"99,275.91"
28-Mar-2021,Miscellaneous,00.00,"16,545.99","82,729.92"
28-Mar-2021,Cash,00.00,"8,272.99","74,456.93"
28-Mar-2021,Bill,"1,688,348.00",00.00,"1,762,804.93"
28-Mar-2021,Miscellaneous,"168,990.00",00.00,"1,931,794.93"
28-Mar-2021,Cash,"217,219.00",00.00,"2,149,013.93"
28-Mar-2021,Reversal,00.00,"268,626.74","1,880,387.19"
28-Mar-2021,RTGS,00.00,"313,397.87","1,566,989.32"
28-Mar-2021,Miscellaneous,00.00,"261,164.89","1,305,824.43"
28-Mar-2021,ATM,"1,718,796.80",00.00,"3,024,621.23"
28-Mar-2021,Debit Card,00.00,"504,103.54","2,520,517.69"
28-Mar-2021,Reversal,00.00,"840,172.56","1,680,345.13"
29-Mar-2021,Bill,"5,444.30",00.00,"1,685,789.43"
29-Mar-2021,IMPS,00.00,"842,894.72","842,894.72"
29-Mar-2021,Cheque,"31,218.69",00.00,"874,113.41"
29-Mar-2021,Purchase,00.00,"218,528.35","655,585.06"
29-Mar-2021,IMPS,"14,816.00",00.00,"670,401.06"
29-Mar-2021,Cash,00.00,"670,401.06",00.00
29-Mar-2021,Debit Card,408.74,00.00,408.74
29-Mar-2021,Cash,"994,152.20",00.00,"994,560.94"
29-Mar-2021,Miscellaneous,00.00,"331,520.31","663,040.63"
29-Mar-2021,Debit Card,03.20,00.00,"663,043.83"
29-Mar-2021,Bill,00.00,"221,014.61","442,029.22"
29-Mar-2021,NEFT,"1,499,659.00",00.00,"1,941,688.22"
29-Mar-2021,Tax,00.00,"647,229.41","1,294,458.81"
29-Mar-2021,Commission,00.00,"184,922.69","1,109,536.12"
29-Mar-2021,NEFT,00.00,"110,953.61","998,582.51"
29-Mar-2021,IMPS,"1,126,222.20",00.00,"2,124,804.71"
29-Mar-2021,Debit Card,00.00,"212,480.47","1,912,324.24"
29-Mar-2021,Commission,43.04,00.00,"1,912,367.28"
29-Mar-2021,Miscellaneous,"1,067.13",00.00,"1,913,434.41"
29-Mar-2021,Purchase,33.74,00.00,"1,913,468.15"
29-Mar-2021,Tax,21.00,00.00,"1,913,489.15"
29-Mar-2021,Cheque,00.00,"956,744.58","956,744.58"
29-Mar-2021,Commission,"2,308.49",00.00,"959,053.07"
29-Mar-2021,Debit Card,436.00,00.00,"959,489.07"
29-Mar-2021,Commission,"6,075.80",00.00,"965,564.87"
29-Mar-2021,Bill,00.00,"482,782.44","482,782.44"
29-Mar-2021,Miscellaneous,"599,896.00",00.00,"1,082,678.44"
29-Mar-2021,NEFT,385.40,00.00,"1,083,063.84"
29-Mar-2021,Bill,00.00,"541,531.92","541,531.92"
29-Mar-2021,Cheque,24.80,00.00,"541,556.72"
29-Mar-2021,Transfer,00.00,"90,259.45","451,297.27"
29-Mar-2021,Cash,27.41,00.00,"451,324.68"
29-Mar-2021,Purchase,00.00,"225,662.34","225,662.34"
29-Mar-2021,Debit Card,00.00,"112,831.17","112,831.17"
29-Mar-2021,Bill,00.00,"12,536.80","100,294.37"
29-Mar-2021,Reversal,334.56,00.00,"100,628.93"
29-Mar-2021,Tax,00.00,"20,125.79","80,503.14"
29-Mar-2021,Transfer,00.00,"16,100.63","64,402.51"
29-Mar-2021,Tax,00.81,00.00,"64,403.32"
30-Mar-2021,NEFT,00.00,"64,403.32",00.00
30-Mar-2021,IMPS,"1,250.00",00.00,"1,250.00"
30-Mar-2021,Cheque,00.00,208.33,"1,041.67"
30-Mar-2021,NEFT,00.00,148.81,892.86
30-Mar-2021,Miscellaneous,00.00,111.61,781.25
30-Mar-2021,Purchase,00.00,260.42,520.83
30-Mar-2021,ATM,00.00,74.40,446.43
30-Mar-2021,Interest,"954,750.50",00.00,"955,196.93"
30-Mar-2021,Commission,"240,892.78",00.00,"1,196,089.71"
30-Mar-2021,Purchase,00.00,"398,696.57","797,393.14"
30-Mar-2021,RTGS,00.00,"398,696.57","398,696.57"
31-Mar-2021,Cash,00.00,"56,956.65","341,739.92"
31-Mar-2021,IMPS,00.00,"42,717.49","299,022.43"
31-Mar-2021,Debit Card,00.00,"299,022.43",00.00
31-Mar-2021,IMPS,"2,063.50",00.00,"2,063.50"
31-Mar-2021,NEFT,"536,916.50",00.00,"538,980.00"
31-Mar-2021,RTGS,"3,457.00",00.00,"542,437.00"
31-Mar-2021,RTGS,"1,946,062.00",00.00,"2,488,499.00"
31-Mar-2021,Purchase,17.10,00.00,"2,488,516.10"
31-Mar-2021,Miscellaneous,110.00,00.00,"2,488,626.10"
31-Mar-2021,Transfer,396.00,00.00,"2,489,022.10"
31-Mar-2021,RTGS,01.48,00.00,"2,489,023.58"
31-Mar-2021,NEFT,00.00,"248,902.36","2,240,121.22"
31-Mar-2021,Tax,00.00,"560,030.31","1,680,090.92"
01-Apr-2021,Transfer,02.00,00.00,"1,680,092.92"
01-Apr-2021,Transfer,04.00,00.00,"1,680,096.92"
01-Apr-2021,Reversal,"74,074.00",00.00,"1,754,170.92"
01-Apr-2021,Interest,"178,377.00",00.00,"1,932,547.92"
01-Apr-2021,IMPS,00.00,"193,254.79","1,739,293.13"
01-Apr-2021,Reversal,"2,210.00",00.00,"1,741,503.13"
01-Apr-2021,Debit Card,"31,424.04",00.00,"1,772,927.17"
01-Apr-2021,Interest,"28,530.00",00.00,"1,801,457.17"
01-Apr-2021,NEFT,696.30,00.00,"1,802,153.47"
01-Apr-2021,Cheque,03.00,00.00,"1,802,156.47"
01-Apr-2021,Debit Card,"3,733.00",00.00,"1,805,889.47"
01-Apr-2021,NEFT,00.00,"200,654.39","1,605,235.08"
01-Apr-2021,Miscellaneous,07.50,00.00,"1,605,242.58"
02-Apr-2021,Cheque,00.00,"802,621.29","802,621.29"
03-Apr-2021,IMPS,00.00,"80,262.13","722,359.16"
03-Apr-2021,NEFT,596.00,00.00,"722,955.16"
03-Apr-2021,Bill,00.00,"722,955.16",00.00
03-Apr-2021,Commission,"72,454.00",00.00,"72,454.00"
03-Apr-2021,Cash,00.00,"36,227.00","36,227.00"
04-Apr-2021,Miscellaneous,00.00,"5,175.29","31,051.71"
04-Apr-2021,Bill,00.00,"7,762.93","23,288.78"
04-Apr-2021,Commission,02.20,00.00,"23,290.98"
04-Apr-2021,Purchase,25.00,00.00,"23,315.98"
04-Apr-2021,Purchase,"1,655,212.00",00.00,"1,678,527.98"
04-Apr-2021,Cash,00.00,"419,632.00","1,258,895.98"
04-Apr-2021,Commission,00.00,"1,258,895.98",00.00
04-Apr-2021,Miscellaneous,"1,853.50",00.00,"1,853.50"
04-Apr-2021,Bill,00.00,463.38,"1,390.12"
04-Apr-2021,IMPS,00.00,347.53,"1,042.59"
04-Apr-2021,NEFT,00.00,208.52,834.07
04-Apr-2021,Purchase,00.00,417.04,417.04
04-Apr-2021,Reversal,00.00,59.58,357.46
04-Apr-2021,NEFT,"2,235.90",00.00,"2,593.36"
04-Apr-2021,Commission,"238,835.50",00.00,"241,428.86"
04-Apr-2021,NEFT,113.40,00.00,"241,542.26"
04-Apr-2021,NEFT,"826,782.00",00.00,"1,068,324.26"
04-Apr-2021,Bill,04.00,00.00,"1,068,328.26"
04-Apr-2021,Commission,00.00,"178,054.71","890,273.55"
04-Apr-2021,Bill,"12,992.40",00.00,"903,265.95"
04-Apr-2021,Transfer,"28,035.38",00.00,"931,301.33"
04-Apr-2021,NEFT,41.10,00.00,"931,342.43"
04-Apr-2021,Interest,00.00,"310,447.48","620,894.95"
04-Apr-2021,Cheque,18.99,00.00,"620,913.94"
04-Apr-2021,NEFT,00.00,"103,485.66","517,428.28"
04-Apr-2021,Miscellaneous,00.00,"517,428.28",00.00
05-Apr-2021,Miscellaneous,304.89,00.00,304.89
05-Apr-2021,Miscellaneous,02.64,00.00,307.53
05-Apr-2021,Commission,00.00,38.44,269.09
05-Apr-2021,Purchase,00.00,33.64,235.45
05-Apr-2021,Commission,00.00,29.43,206.02
05-Apr-2021,RTGS,00.00,68.67,137.35
05-Apr-2021,Debit Card,00.00,15.26,122.09
05-Apr-2021,Cheque,00.00,61.05,61.04
06-Apr-2021,Purchase,00.00,06.78,54.26
06-Apr-2021,IMPS,"2,319.60",00.00,"2,373.86"
06-Apr-2021,Cash,00.00,237.39,"2,136.47"
06-Apr-2021,Bill,00.00,712.16,"1,424.31"
06-Apr-2021,Purchase,00.00,356.08,"1,068.23"
06-Apr-2021,Bill,"7,393.90",00.00,"8,462.13"
06-Apr-2021,Tax,"12,285.49",00.00,"20,747.62"
06-Apr-2021,Debit Card,00.00,"6,915.87","13,831.75"
06-Apr-2021,Commission,"1,647,401.00",00.00,"1,661,232.75"
06-Apr-2021,Tax,00.00,"166,123.28","1,495,109.48"
06-Apr-2021,IMPS,958.18,00.00,"1,496,067.66"
06-Apr-2021,Cheque,48.70,00.00,"1,496,116.36"
06-Apr-2021,Tax,"300,148.00",00.00,"1,796,264.36"
06-Apr-2021,Cheque,372.56,00.00,"1,796,636.92"
06-Apr-2021,Reversal,00.00,"224,579.62","1,572,057.30"
06-Apr-2021,Purchase,00.00,"224,579.61","1,347,477.69"
06-Apr-2021,Cheque,"79,339.88",00.00,"1,426,817.57"
06-Apr-2021,Transfer,00.00,"285,363.51","1,141,454.06"
06-Apr-2021,ATM,51.60,00.00,"1,141,505.66"
06-Apr-2021,Miscellaneous,101.40,00.00,"1,141,607.06"
06-Apr-2021,Debit Card,00.00,"163,086.72","978,520.34"
06-Apr-2021,Tax,"1,790.01",00.00,"980,310.35"
06-Apr-2021,Cheque,00.00,"140,044.34","840,266.01"
06-Apr-2021,Tax,00.00,"93,362.89","746,903.12"
07-Apr-2021,Reversal,03.30,00.00,"746,906.42"
08-Apr-2021,Commission,00.00,"124,484.40","622,422.02"
08-Apr-2021,Reversal,"32,306.10",00.00,"654,728.12"
08-Apr-2021,Cash,"180,278.00",00.00,"835,006.12"
08-Apr-2021,ATM,00.00,"167,001.22","668,004.90"
08-Apr-2021,NEFT,"79,409.00",00.00,"747,413.90"
08-Apr-2021,Commission,"4,057.82",00.00,"751,471.72"
08-Apr-2021,Purchase,"23,318.30",00.00,"774,790.02"
08-Apr-2021,Cheque,"103,785.00",00.00,"878,575.02"
08-Apr-2021,Bill,49.70,00.00,"878,624.72"
08-Apr-2021,Bill,193.60,00.00,"878,818.32"
09-Apr-2021,Miscellaneous,00.00,"125,545.47","753,272.85"
09-Apr-2021,Cash,00.00,"150,654.57","602,618.28"
09-Apr-2021,NEFT,04.20,00.00,"602,622.48"
09-Apr-2021,Reversal,"224,440.00",00.00,"827,062.48"
09-Apr-2021,Debit Card,00.00,"413,531.24","413,531.24"
09-Apr-2021,Commission,00.00,"45,947.92","367,583.32"
09-Apr-2021,IMPS,00.00,"40,842.59","326,740.73"
09-Apr-2021,Commission,07.00,00.00,"326,747.73"
09-Apr-2021,Debit Card,00.00,"46,678.25","280,069.48"
09-Apr-2021,IMPS,00.00,"28,006.95","252,062.53"
09-Apr-2021,Cheque,"18,064.40",00.00,"270,126.93"
09-Apr-2021,IMPS,224.27,00.00,"270,351.20"
09-Apr-2021,Interest,"1,807.68",00.00,"272,158.88"
09-Apr-2021,RTGS,224.00,00.00,"272,382.88"
09-Apr-2021,ATM,"10,315.00",00.00,"282,697.88"
09-Apr-2021,Cheque,"123,953.00",00.00,"406,650.88"
09-Apr-2021,Cheque,00.00,"67,775.15","338,875.73"
09-Apr-2021,Cheque,00.00,"112,958.58","225,917.15"
09-Apr-2021,Purchase,00.00,"225,917.15",00.00
09-Apr-2021,RTGS,"1,497,699.50",00.00,"1,497,699.50"
09-Apr-2021,Transfer,"234,499.00",00.00,"1,732,198.50"
09-Apr-2021,Bill,21.00,00.00,"1,732,219.50"
09-Apr-2021,Purchase,00.00,"346,443.90","1,385,775.60"
09-Apr-2021,Cash,00.00,"197,967.94","1,187,807.66"
09-Apr-2021,Reversal,42.00,00.00,"1,187,849.66"
09-Apr-2021,Commission,00.40,00.00,"1,187,850.06"
09-Apr-2021,Tax,00.00,"1,187,850.06",00.00
09-Apr-2021,Interest,"240,095.20",00.00,"240,095.20"
09-Apr-2021,Interest,470.20,00.00,"240,565.40"
09-Apr-2021,Debit Card,00.00,"30,070.68","210,494.72"
09-Apr-2021,Miscellaneous,"1,621,846.75",00.00,"1,832,341.47"
09-Apr-2021,Reversal,07.47,00.00,"1,832,348.94"
09-Apr-2021,Transfer,00.00,"610,782.98","1,221,565.96"
09-Apr-2021,Cheque,00.00,"407,188.65","814,377.31"
09-Apr-2021,Tax,360.17,00.00,"814,737.48"
09-Apr-2021,Cheque,"8,968.20",00.00,"823,705.68"
09-Apr-2021,Transfer,00.00,"91,522.85","732,182.83"
09-Apr-2021,Cheque,"1,277.42",00.00,"733,460.25"
09-Apr-2021,Cash,"216,787.60",00.00,"950,247.85"
09-Apr-2021,Transfer,"465,162.50",00.00,"1,415,410.35"
09-Apr-2021,ATM,"1,836,434.20",00.00,"3,251,844.55"
09-Apr-2021,Purchase,00.00,"3,251,844.55",00.00
09-Apr-2021,Transfer,"115,942.00",00.00,"115,942.00"
09-Apr-2021,Cash,00.00,"38,647.33","77,294.67"
09-Apr-2021,Cheque,"61,982.66",00.00,"139,277.33"
09-Apr-2021,Commission,"3,037.53",00.00,"142,314.86"
09-Apr-2021,Miscellaneous,"22,145.54",00.00,"164,460.40"
09-Apr-2021,Cash,00.00,"23,494.34","140,966.06"
09-Apr-2021,Cash,285.70,00.00,"141,251.76"
09-Apr-2021,NEFT,00.00,"15,694.64","125,557.12"
09-Apr-2021,Bill,00.00,"12,555.71","113,001.41"
10-Apr-2021,Cheque,00.00,"16,143.06","96,858.35"
10-Apr-2021,Bill,00.00,"16,143.06","80,715.29"
10-Apr-2021,Transfer,00.00,"40,357.65","40,357.64"
10-Apr-2021,Transfer,00.00,"5,765.38","34,592.26"
10-Apr-2021,Transfer,00.00,"6,918.45","27,673.81"
10-Apr-2021,Interest,00.00,"6,918.45","20,755.36"
10-Apr-2021,Cash,00.00,"5,188.84","15,566.52"
10-Apr-2021,IMPS,00.00,"5,188.84","10,377.68"
10-Apr-2021,Tax,"1,385.00",00.00,"11,762.68"
10-Apr-2021,Cash,00.00,"2,352.54","9,410.14"
10-Apr-2021,Cash,"22,651.90",00.00,"32,062.04"
11-Apr-2021,ATM,"1,254.00",00.00,"33,316.04"
11-Apr-2021,Transfer,"10,828.00",00.00,"44,144.04"
11-Apr-2021,Interest,"3,058.63",00.00,"47,202.67"
11-Apr-2021,Cash,04.00,00.00,"47,206.67"
11-Apr-2021,Purchase,00.00,"7,867.78","39,338.89"
11-Apr-2021,Reversal,00.00,"5,619.84","33,719.05"
11-Apr-2021,Purchase,09.70,00.00,"33,728.75"
12-Apr-2021,NEFT,00.00,"33,728.75",00.00
12-Apr-2021,RTGS,248.79,00.00,248.79
12-Apr-2021,Interest,01.10,00.00,249.89
12-Apr-2021,Transfer,17.70,00.00,267.59
12-Apr-2021,Debit Card,00.00,89.20,178.39
12-Apr-2021,Tax,00.00,89.20,89.20
12-Apr-2021,Reversal,497.00,00.00,586.20
12-Apr-2021,NEFT,49.00,00.00,635.20
12-Apr-2021,Commission,00.00,63.52,571.68
12-Apr-2021,Miscellaneous,"540,794.80",00.00,"541,366.48"
12-Apr-2021,Miscellaneous,00.00,"54,136.65","487,229.83"
12-Apr-2021,Bill,00.00,"54,136.65","433,093.18"
13-Apr-2021,Cash,154.00,00.00,"433,247.18"
13-Apr-2021,RTGS,07.00,00.00,"433,254.18"
13-Apr-2021,Commission,53.32,00.00,"433,307.50"
13-Apr-2021,NEFT,"3,514.00",00.00,"436,821.50"
13-Apr-2021,Tax,03.90,00.00,"436,825.40"
13-Apr-2021,Miscellaneous,"248,024.10",00.00,"684,849.50"
13-Apr-2021,Purchase,00.00,"342,424.75","342,424.75"
13-Apr-2021,Interest,00.00,"48,917.82","293,506.93"
13-Apr-2021,Bill,00.00,"146,753.47","146,753.46"
13-Apr-2021,Cheque,343.00,00.00,"147,096.46"
13-Apr-2021,NEFT,00.00,"147,096.46",00.00
13-Apr-2021,NEFT,"366,169.20",00.00,"366,169.20"
13-Apr-2021,Commission,"1,897,683.00",00.00,"2,263,852.20"
13-Apr-2021,Debit Card,00.00,"1,131,926.10","1,131,926.10"
13-Apr-2021,Tax,"1,302.00",00.00,"1,133,228.10"
13-Apr-2021,Interest,00.00,"113,322.81","1,019,905.29"
13-Apr-2021,Debit Card,"203,099.80",00.00,"1,223,005.09"
13-Apr-2021,Bill,00.00,"152,875.64","1,070,129.45"
13-Apr-2021,Debit Card,466.00,00.00,"1,070,595.45"
13-Apr-2021,RTGS,"3,002.00",00.00,"1,073,597.45"
13-Apr-2021,Debit Card,00.00,"134,199.68","939,397.77"
13-Apr-2021,RTGS,00.00,"134,199.68","805,198.09"
13-Apr-2021,Interest,"677,306.50",00.00,"1,482,504.59"
13-Apr-2021,IMPS,00.00,"247,084.10","1,235,420.49"
13-Apr-2021,Tax,00.00,"308,855.12","926,565.37"
13-Apr-2021,Tax,00.00,"185,313.07","741,252.30"
13-Apr-2021,Cash,00.00,"247,084.10","494,168.20"
13-Apr-2021,Cheque,00.00,"61,771.03","432,397.18"
13-Apr-2021,ATM,00.00,"48,044.13","384,353.05"
13-Apr-2021,Miscellaneous,"131,346.34",00.00,"515,699.39"
13-Apr-2021,RTGS,00.00,"171,899.80","343,799.59"
13-Apr-2021,Purchase,00.00,"114,599.86","229,199.73"
13-Apr-2021,IMPS,"7,213.00",00.00,"236,412.73"
13-Apr-2021,Transfer,00.00,"39,402.12","197,010.61"
13-Apr-2021,NEFT,00.00,"21,890.07","175,120.54"
13-Apr-2021,Tax,00.00,"19,457.84","155,662.70"
13-Apr-2021,RTGS,920.73,00.00,"156,583.43"
13-Apr-2021,Cheque,00.00,"156,583.43",00.00
13-Apr-2021,Tax,32.00,00.00,32.00
13-Apr-2021,Purchase,"5,456.22",00.00,"5,488.22"
13-Apr-2021,NEFT,08.50,00.00,"5,496.72"
13-Apr-2021,Bill,00.00,"5,496.72",00.00
13-Apr-2021,Cash,"2,761.00",00.00,"2,761.00"
13-Apr-2021,Debit Card,"2,966.00",00.00,"5,727.00"
13-Apr-2021,Miscellaneous,83.17,00.00,"5,810.17"
13-Apr-2021,RTGS,07.84,00.00,"5,818.01"
13-Apr-2021,Tax,"21,166.95",00.00,"26,984.96"
13-Apr-2021,Commission,00.00,"3,373.12","23,611.84"
13-Apr-2021,Miscellaneous,07.85,00.00,"23,619.69"
13-Apr-2021,Interest,00.00,"23,619.69",00.00
13-Apr-2021,Bill,07.00,00.00,07.00
13-Apr-2021,Purchase,187.20,00.00,194.20
13-Apr-2021,Purchase,00.00,64.73,129.47
13-Apr-2021,Miscellaneous,00.00,12.95,116.52
13-Apr-2021,Interest,00.00,19.42,97.10
13-Apr-2021,Miscellaneous,00.00,16.18,80.92
13-Apr-2021,Debit Card,00.00,08.09,72.83
13-Apr-2021,Reversal,00.00,72.83,00.00
13-Apr-2021,Commission,"2,077,101.50",00.00,"2,077,101.50"
13-Apr-2021,ATM,00.00,"2,077,101.50",00.00
13-Apr-2021,Interest,01.00,00.00,01.00
13-Apr-2021,Interest,00.00,00.50,00.50
13-Apr-2021,Tax,00.00,00.17,00.33
13-Apr-2021,Miscellaneous,"1,927.38",00.00,"1,927.71"
13-Apr-2021,Interest,00.00,385.54,"1,542.17"
13-Apr-2021,Reversal,00.00,192.77,"1,349.40"
13-Apr-2021,IMPS,00.00,168.68,"1,180.73"
13-Apr-2021,Tax,159.00,00.00,"1,339.73"
13-Apr-2021,Debit Card,00.00,"1,339.73",00.00
13-Apr-2021,ATM,"3,465.50",00.00,"3,465.50"
13-Apr-2021,NEFT,"70,792.00",00.00,"74,257.50"
13-Apr-2021,Cheque,00.00,"9,282.19","64,975.31"
13-Apr-2021,Cheque,00.00,"64,975.31",00.00
13-Apr-2021,Tax,"1,460.00",00.00,"1,460.00"
13-Apr-2021,Commission,44.77,00.00,"1,504.77"
13-Apr-2021,Interest,"3,637.00",00.00,"5,141.77"
13-Apr-2021,Purchase,109.50,00.00,"5,251.27"
13-Apr-2021,Miscellaneous,00.00,750.18,"4,501.09"
13-Apr-2021,Interest,00.00,"4,501.09",00.00
13-Apr-2021,Tax,"164,513.50",00.00,"164,513.50"
13-Apr-2021,Bill,00.00,"18,279.28","146,234.22"
13-Apr-2021,Purchase,111.00,00.00,"146,345.22"
13-Apr-2021,Miscellaneous,"599,920.00",00.00,"746,265.22"
13-Apr-2021,Purchase,"209,765.91",00.00,"956,031.13"
13-Apr-2021,Debit Card,00.00,"478,015.57","478,015.56"
13-Apr-2021,Commission,19.00,00.00,"478,034.56"
13-Apr-2021,Purchase,00.00,"79,672.43","398,362.13"
13-Apr-2021,Purchase,"3,492.00",00.00,"401,854.13"
13-Apr-2021,Cheque,00.00,"44,650.46","357,203.67"
13-Apr-2021,Transfer,00.00,"51,029.10","306,174.57"
13-Apr-2021,Commission,"26,500.00",00.00,"332,674.57"
14-Apr-2021,Cash,158.46,00.00,"332,833.03"
14-Apr-2021,ATM,41.39,00.00,"332,874.42"
14-Apr-2021,Cheque,00.00,"33,287.44","299,586.98"
14-Apr-2021,NEFT,50.74,00.00,"299,637.72"
14-Apr-2021,Purchase,02.00,00.00,"299,639.72"
14-Apr-2021,Cash,00.00,"49,939.95","249,699.77"
14-Apr-2021,Reversal,537.00,00.00,"250,236.77"
14-Apr-2021,Tax,00.00,"62,559.19","187,677.58"
14-Apr-2021,Reversal,00.00,"18,767.76","168,909.82"
14-Apr-2021,IMPS,00.00,"21,113.73","147,796.09"
14-Apr-2021,Transfer,00.00,"14,779.61","133,016.48"
14-Apr-2021,Miscellaneous,00.00,"66,508.24","66,508.24"
14-Apr-2021,Miscellaneous,00.00,00.00,"66,508.24"
15-Apr-2021,Reversal,05.50,00.00,"66,513.74"
15-Apr-2021,Cheque,04.00,00.00,"66,517.74"
15-Apr-2021,Debit Card,00.00,"6,651.77","59,865.97"
15-Apr-2021,Commission,00.00,"11,973.19","47,892.78"
15-Apr-2021,RTGS,"1,697,371.00",00.00,"1,745,263.78"
15-Apr-2021,NEFT,"1,674,191.00",00.00,"3,419,454.78"
15-Apr-2021,Tax,"10,642.00",00.00,"3,430,096.78"
15-Apr-2021,Debit Card,32.25,00.00,"3,430,129.03"
15-Apr-2021,Miscellaneous,00.50,00.00,"3,430,129.53"
15-Apr-2021,Reversal,03.00,00.00,"3,430,132.53"
15-Apr-2021,Miscellaneous,"28,691.00",00.00,"3,458,823.53"
15-Apr-2021,NEFT,00.00,"432,352.94","3,026,470.59"
15-Apr-2021,Tax,02.42,00.00,"3,026,473.01"
15-Apr-2021,Commission,00.00,"756,618.25","2,269,854.76"
15-Apr-2021,Commission,"16,280.31",00.00,"2,286,135.07"
15-Apr-2021,Reversal,00.00,"571,533.77","1,714,601.30"
15-Apr-2021,IMPS,"1,830,492.00",00.00,"3,545,093.30"
15-Apr-2021,Reversal,00.00,"1,772,546.65","1,772,546.65"
15-Apr-2021,Debit Card,"130,827.69",00.00,"1,903,374.34"
15-Apr-2021,Purchase,"1,232.50",00.00,"1,904,606.84"
15-Apr-2021,NEFT,00.00,"1,904,606.84",00.00
15-Apr-2021,Tax,357.10,00.00,357.10
16-Apr-2021,Debit Card,04.00,00.00,361.10
16-Apr-2021,Cheque,00.00,72.22,288.88
16-Apr-2021,Cheque,00.00,48.15,240.73
16-Apr-2021,Interest,"18,206.71",00.00,"18,447.44"
16-Apr-2021,Transfer,00.00,"3,074.57","15,372.87"
16-Apr-2021,ATM,30.10,00.00,"15,402.97"
16-Apr-2021,Miscellaneous,"2,611.95",00.00,"18,014.92"
16-Apr-2021,NEFT,"4,604.51",00.00,"22,619.43"
16-Apr-2021,Purchase,228.00,00.00,"22,847.43"
16-Apr-2021,Miscellaneous,06.93,00.00,"22,854.36"
16-Apr-2021,IMPS,"3,132.00",00.00,"25,986.36"
16-Apr-2021,RTGS,00.00,"12,993.18","12,993.18"
16-Apr-2021,ATM,00.00,"6,496.59","6,496.59"
16-Apr-2021,Cheque,"15,255.16",00.00,"21,751.75"
16-Apr-2021,RTGS,"183,174.38",00.00,"204,926.13"
16-Apr-2021,NEFT,00.00,"68,308.71","136,617.42"
16-Apr-2021,Debit Card,00.00,"68,308.71","68,308.71"
16-Apr-2021,Reversal,05.64,00.00,"68,314.35"
16-Apr-2021,Bill,03.40,00.00,"68,317.75"
16-Apr-2021,RTGS,00.00,"22,772.58","45,545.17"
16-Apr-2021,IMPS,00.00,"11,386.29","34,158.88"
16-Apr-2021,IMPS,00.00,"34,158.88",00.00
16-Apr-2021,Miscellaneous,03.60,00.00,03.60
16-Apr-2021,Purchase,"1,856,300.80",00.00,"1,856,304.40"
16-Apr-2021,IMPS,00.00,"206,256.04","1,650,048.36"
16-Apr-2021,Tax,00.00,"206,256.05","1,443,792.32"
16-Apr-2021,Tax,05.65,00.00,"1,443,797.97"
16-Apr-2021,Cheque,"6,663.00",00.00,"1,450,460.97"
16-Apr-2021,Bill,00.00,"161,162.33","1,289,298.64"
16-Apr-2021,ATM,"25,610.10",00.00,"1,314,908.74"
16-Apr-2021,Commission,00.00,"657,454.37","657,454.37"
16-Apr-2021,NEFT,348.47,00.00,"657,802.84"
16-Apr-2021,Miscellaneous,93.00,00.00,"657,895.84"
16-Apr-2021,NEFT,00.00,"93,985.12","563,910.72"
16-Apr-2021,RTGS,01.43,00.00,"563,912.15"
16-Apr-2021,ATM,00.00,"70,489.02","493,423.13"
16-Apr-2021,ATM,00.00,"246,711.57","246,711.56"
16-Apr-2021,NEFT,00.00,"35,244.51","211,467.05"
16-Apr-2021,Bill,00.00,"26,433.38","185,033.67"
16-Apr-2021,Interest,"389,432.80",00.00,"574,466.47"
16-Apr-2021,Interest,246.00,00.00,"574,712.47"
16-Apr-2021,Commission,00.00,"57,471.25","517,241.22"
16-Apr-2021,NEFT,00.00,"517,241.22",00.00
17-Apr-2021,Interest,"209,225.47",00.00,"209,225.47"
17-Apr-2021,Interest,00.00,"52,306.37","156,919.10"
17-Apr-2021,IMPS,"18,505.00",00.00,"175,424.10"
17-Apr-2021,ATM,00.00,"25,060.59","150,363.51"
17-Apr-2021,Tax,00.00,"18,795.44","131,568.07"
17-Apr-2021,Miscellaneous,00.00,"32,892.02","98,676.05"
17-Apr-2021,Interest,08.40,00.00,"98,684.45"
17-Apr-2021,RTGS,"179,234.75",00.00,"277,919.20"
17-Apr-2021,Transfer,37.90,00.00,"277,957.10"
17-Apr-2021,Miscellaneous,04.90,00.00,"277,962.00"
17-Apr-2021,Purchase,00.00,"55,592.40","222,369.60"
17-Apr-2021,Tax,"10,471.00",00.00,"232,840.60"
17-Apr-2021,Miscellaneous,"1,333,573.00",00.00,"1,566,413.60"
17-Apr-2021,Miscellaneous,"22,821.80",00.00,"1,589,235.40"
17-Apr-2021,Commission,"3,022.86",00.00,"1,592,258.26"
17-Apr-2021,Commission,472.00,00.00,"1,592,730.26"
17-Apr-2021,Purchase,"148,378.97",00.00,"1,741,109.23"
17-Apr-2021,Miscellaneous,00.00,"348,221.85","1,392,887.38"
18-Apr-2021,ATM,32.10,00.00,"1,392,919.48"
18-Apr-2021,RTGS,00.00,"232,153.25","1,160,766.23"
18-Apr-2021,Bill,"231,713.00",00.00,"1,392,479.23"
18-Apr-2021,Cash,"18,833.00",00.00,"1,411,312.23"
18-Apr-2021,Miscellaneous,00.00,"201,616.03","1,209,696.20"
18-Apr-2021,Cash,00.00,"151,212.03","1,058,484.18"
18-Apr-2021,Transfer,00.00,"211,696.84","846,787.34"
18-Apr-2021,Miscellaneous,00.00,"105,848.42","740,938.92"
18-Apr-2021,Reversal,03.00,00.00,"740,941.92"
18-Apr-2021,Cheque,00.00,"123,490.32","617,451.60"
18-Apr-2021,Debit Card,424.71,00.00,"617,876.31"
18-Apr-2021,IMPS,"11,702.48",00.00,"629,578.79"
18-Apr-2021,IMPS,"3,324.10",00.00,"632,902.89"
18-Apr-2021,IMPS,"70,703.00",00.00,"703,605.89"
18-Apr-2021,Purchase,51.60,00.00,"703,657.49"
18-Apr-2021,RTGS,00.00,"234,552.50","469,104.99"
18-Apr-2021,IMPS,05.48,00.00,"469,110.47"
18-Apr-2021,RTGS,03.00,00.00,"469,113.47"
18-Apr-2021,ATM,00.00,"469,113.47",00.00
18-Apr-2021,Commission,05.19,00.00,05.19
18-Apr-2021,Cash,24.40,00.00,29.59
18-Apr-2021,Debit Card,00.00,04.93,24.66
18-Apr-2021,IMPS,00.00,02.74,21.92
18-Apr-2021,RTGS,00.00,07.31,14.61
18-Apr-2021,Interest,"1,165,711.20",00.00,"1,165,725.81"
19-Apr-2021,Tax,345.60,00.00,"1,166,071.41"
19-Apr-2021,Bill,00.00,"291,517.85","874,553.56"
19-Apr-2021,NEFT,00.00,"218,638.39","655,915.17"
19-Apr-2021,Miscellaneous,00.00,"327,957.59","327,957.59"
19-Apr-2021,Purchase,00.00,"36,439.73","291,517.86"
19-Apr-2021,Reversal,00.00,"29,151.79","262,366.07"
19-Apr-2021,Commission,00.00,"65,591.52","196,774.55"
19-Apr-2021,IMPS,13.50,00.00,"196,788.05"
19-Apr-2021,Transfer,00.00,"65,596.02","131,192.03"
19-Apr-2021,RTGS,00.00,"14,576.89","116,615.14"
19-Apr-2021,IMPS,"113,684.10",00.00,"230,299.24"
19-Apr-2021,Interest,00.00,"57,574.81","172,724.43"
19-Apr-2021,Purchase,00.00,"34,544.89","138,179.54"
19-Apr-2021,Miscellaneous,"1,467.48",00.00,"139,647.02"
19-Apr-2021,Miscellaneous,00.00,"139,647.02",00.00
19-Apr-2021,Interest,01.30,00.00,01.30
20-Apr-2021,ATM,"4,674.10",00.00,"4,675.40"
21-Apr-2021,NEFT,00.00,519.49,"4,155.91"
22-Apr-2021,Cheque,00.00,"1,038.98","3,116.93"
22-Apr-2021,ATM,00.00,311.69,"2,805.24"
22-Apr-2021,IMPS,00.00,"1,402.62","1,402.62"
22-Apr-2021,Bill,00.00,155.85,"1,246.77"
22-Apr-2021,NEFT,00.00,178.11,"1,068.66"
22-Apr-2021,Commission,"5,590.02",00.00,"6,658.68"
22-Apr-2021,Transfer,00.00,951.24,"5,707.44"
22-Apr-2021,Bill,"3,558.00",00.00,"9,265.44"
22-Apr-2021,RTGS,00.00,"1,158.18","8,107.26"
22-Apr-2021,Bill,"1,235,460.20",00.00,"1,243,567.46"
22-Apr-2021,Cash,440.90,00.00,"1,244,008.36"
22-Apr-2021,Cheque,336.78,00.00,"1,244,345.14"
22-Apr-2021,Tax,00.00,"1,244,345.14",00.00
22-Apr-2021,Purchase,"1,021.00",00.00,"1,021.00"
22-Apr-2021,Purchase,00.00,340.33,680.67
22-Apr-2021,IMPS,"3,311.00",00.00,"3,991.67"
23-Apr-2021,Cheque,28.40,00.00,"4,020.07"
23-Apr-2021,Interest,00.00,502.51,"3,517.56"
23-Apr-2021,Purchase,"172,599.50",00.00,"176,117.06"
23-Apr-2021,Reversal,00.00,"58,705.69","117,411.37"
23-Apr-2021,Debit Card,00.00,"11,741.14","105,670.23"
23-Apr-2021,IMPS,00.00,"15,095.75","90,574.48"
23-Apr-2021,NEFT,07.00,00.00,"90,581.48"
23-Apr-2021,Tax,"1,499,450.80",00.00,"1,590,032.28"
23-Apr-2021,Purchase,"2,082.50",00.00,"1,592,114.78"
23-Apr-2021,Purchase,"9,401.25",00.00,"1,601,516.03"
23-Apr-2021,Tax,00.00,00.00,"1,601,516.03"
23-Apr-2021,Commission,00.00,"400,379.01","1,201,137.02"
23-Apr-2021,Transfer,00.00,"1,201,137.02",00.00
23-Apr-2021,Tax,58.40,00.00,58.40
23-Apr-2021,Bill,"789,597.00",00.00,"789,655.40"
23-Apr-2021,Reversal,"29,918.00",00.00,"819,573.40"
23-Apr-2021,Tax,00.00,"204,893.35","614,680.05"
23-Apr-2021,ATM,00.00,"122,936.01","491,744.04"
23-Apr-2021,Cheque,00.00,"81,957.34","409,786.70"
24-Apr-2021,Interest,"205,298.47",00.00,"615,085.17"
24-Apr-2021,Interest,00.00,"205,028.39","410,056.78"
25-Apr-2021,RTGS,06.20,00.00,"410,062.98"
25-Apr-2021,Bill,00.00,"205,031.49","205,031.49"
26-Apr-2021,Interest,07.80,00.00,"205,039.29"
26-Apr-2021,Interest,03.89,00.00,"205,043.18"
26-Apr-2021,Debit Card,00.00,"34,173.86","170,869.32"
26-Apr-2021,Debit Card,"9,222.50",00.00,"180,091.82"
26-Apr-2021,Debit Card,453.00,00.00,"180,544.82"
26-Apr-2021,NEFT,"1,765,248.00",00.00,"1,945,792.82"
26-Apr-2021,Commission,"512,191.20",00.00,"2,457,984.02"
26-Apr-2021,ATM,00.00,"273,109.34","2,184,874.68"
26-Apr-2021,Transfer,"23,918.00",00.00,"2,208,792.68"
26-Apr-2021,ATM,440.50,00.00,"2,209,233.18"
26-Apr-2021,Debit Card,01.50,00.00,"2,209,234.68"
26-Apr-2021,Bill,00.00,"736,411.56","1,472,823.12"
27-Apr-2021,IMPS,00.00,"1,472,823.12",00.00
27-Apr-2021,Purchase,"9,236.34",00.00,"9,236.34"
27-Apr-2021,Reversal,04.77,00.00,"9,241.11"
27-Apr-2021,Reversal,"2,390.00",00.00,"11,631.11"
27-Apr-2021,Reversal,00.00,"3,877.04","7,754.07"
27-Apr-2021,Bill,00.00,"1,292.35","6,461.72"
27-Apr-2021,Cheque,00.00,"1,615.43","4,846.29"
27-Apr-2021,Bill,00.00,"4,846.29",00.00
27-Apr-2021,ATM,05.00,00.00,05.00
27-Apr-2021,Commission,"80,677.44",00.00,"80,682.44"
27-Apr-2021,Cash,"711,563.00",00.00,"792,245.44"
27-Apr-2021,Debit Card,"31,680.80",00.00,"823,926.24"
27-Apr-2021,Tax,"1,788,313.00",00.00,"2,612,239.24"
27-Apr-2021,Miscellaneous,00.00,"261,223.92","2,351,015.32"
27-Apr-2021,Debit Card,01.00,00.00,"2,351,016.32"
27-Apr-2021,ATM,09.80,00.00,"2,351,026.12"
27-Apr-2021,Interest,42.00,00.00,"2,351,068.12"
27-Apr-2021,Interest,"235,896.20",00.00,"2,586,964.32"
27-Apr-2021,Debit Card,00.00,"862,321.44","1,724,642.88"
27-Apr-2021,Miscellaneous,"3,297.00",00.00,"1,727,939.88"
27-Apr-2021,ATM,07.72,00.00,"1,727,947.60"
27-Apr-2021,IMPS,"1,134,204.00",00.00,"2,862,151.60"
27-Apr-2021,Commission,450.45,00.00,"2,862,602.05"
27-Apr-2021,Miscellaneous,"19,313.80",00.00,"2,881,915.85"
27-Apr-2021,Debit Card,"7,962.80",00.00,"2,889,878.65"
27-Apr-2021,Transfer,00.00,"963,292.88","1,926,585.77"
28-Apr-2021,Debit Card,00.00,"642,195.26","1,284,390.51"
28-Apr-2021,IMPS,01.00,00.00,"1,284,391.51"
28-Apr-2021,Debit Card,07.00,00.00,"1,284,398.51"
28-Apr-2021,NEFT,19.52,00.00,"1,284,418.03"
28-Apr-2021,Interest,00.00,"428,139.34","856,278.69"
28-Apr-2021,Purchase,00.00,"142,713.12","713,565.58"
28-Apr-2021,Transfer,97.60,00.00,"713,663.18"
28-Apr-2021,Interest,00.00,"71,366.32","642,296.86"
28-Apr-2021,Commission,"25,354.00",00.00,"667,650.86"
29-Apr-2021,Bill,06.00,00.00,"667,656.86"
30-Apr-2021,Commission,00.00,"333,828.43","333,828.43"
30-Apr-2021,Cash,00.00,"83,457.11","250,371.32"
30-Apr-2021,Miscellaneous,00.00,"83,457.11","166,914.21"
30-Apr-2021,Miscellaneous,"10,179.50",00.00,"177,093.71"
30-Apr-2021,Transfer,104.90,00.00,"177,198.61"
30-Apr-2021,ATM,"164,688.40",00.00,"341,887.01"
30-Apr-2021,Tax,00.00,"170,943.51","170,943.50"
30-Apr-2021,Purchase,00.00,"24,420.50","146,523.00"
30-Apr-2021,RTGS,200.20,00.00,"146,723.20"
30-Apr-2021,Bill,00.00,"16,302.58","130,420.62"
30-Apr-2021,Bill,00.00,"14,491.18","115,929.44"
30-Apr-2021,RTGS,"2,794.42",00.00,"118,723.86"
30-Apr-2021,ATM,00.00,"39,574.62","79,149.24"
30-Apr-2021,Miscellaneous,"1,187.55",00.00,"80,336.79"
30-Apr-2021,Purchase,"652,873.20",00.00,"733,209.99"
30-Apr-2021,Commission,851.60,00.00,"734,061.59"
30-Apr-2021,Commission,03.30,00.00,"734,064.89"
30-Apr-2021,Cheque,"1,439,444.50",00.00,"2,173,509.39"
30-Apr-2021,ATM,"1,892.90",00.00,"2,175,402.29"
30-Apr-2021,Bill,00.00,"362,567.05","1,812,835.24"
30-Apr-2021,Reversal,03.80,00.00,"1,812,839.04"
30-Apr-2021,Interest,697.00,00.00,"1,813,536.04"
30-Apr-2021,RTGS,00.00,"906,768.02","906,768.02"
30-Apr-2021,Bill,07.00,00.00,"906,775.02"
30-Apr-2021,Tax,00.00,"90,677.50","816,097.52"
30-Apr-2021,ATM,"2,162.58",00.00,"818,260.10"
30-Apr-2021,IMPS,"25,906.79",00.00,"844,166.89"
30-Apr-2021,Miscellaneous,00.00,"844,166.89",00.00
30-Apr-2021,Purchase,"102,282.00",00.00,"102,282.00"
30-Apr-2021,Bill,"24,559.10",00.00,"126,841.10"
30-Apr-2021,Commission,00.00,"12,684.11","114,156.99"
30-Apr-2021,IMPS,00.00,"19,026.17","95,130.83"
30-Apr-2021,NEFT,"1,208.76",00.00,"96,339.59"
30-Apr-2021,Tax,"138,304.06",00.00,"234,643.65"
30-Apr-2021,Cheque,353.60,00.00,"234,997.25"
30-Apr-2021,Bill,"2,484.00",00.00,"237,481.25"
30-Apr-2021,Reversal,42.46,00.00,"237,523.71"
30-Apr-2021,Reversal,00.00,"29,690.46","207,833.25"
30-Apr-2021,ATM,00.00,"69,277.75","138,555.50"
30-Apr-2021,RTGS,"454,629.00",00.00,"593,184.50"
30-Apr-2021,Miscellaneous,"72,889.00",00.00,"666,073.50"
30-Apr-2021,Cash,00.00,"666,073.50",00.00
30-Apr-2021,Purchase,19.00,00.00,19.00
30-Apr-2021,Interest,00.00,01.90,17.10
30-Apr-2021,Transfer,02.00,00.00,19.10
30-Apr-2021,Debit Card,"46,414.00",00.00,"46,433.10"
30-Apr-2021,IMPS,"1,580,001.25",00.00,"1,626,434.35"
30-Apr-2021,Miscellaneous,00.00,"813,217.18","813,217.18"
30-Apr-2021,IMPS,04.14,00.00,"813,221.32"
30-Apr-2021,Purchase,00.00,"116,174.47","697,046.85"
30-Apr-2021,ATM,00.00,"697,046.85",00.00
30-Apr-2021,Reversal,"227,652.75",00.00,"227,652.75"
30-Apr-2021,Debit Card,00.00,"56,913.19","170,739.56"
30-Apr-2021,Cheque,"61,936.90",00.00,"232,676.46"
30-Apr-2021,Cash,00.00,"38,779.41","193,897.05"
30-Apr-2021,Miscellaneous,"1,937,617.00",00.00,"2,131,514.05"
30-Apr-2021,NEFT,"27,415.00",00.00,"2,158,929.05"
30-Apr-2021,Purchase,"585,602.50",00.00,"2,744,531.55"
30-Apr-2021,Interest,00.00,"548,906.31","2,195,625.24"
30-Apr-2021,Interest,05.20,00.00,"2,195,630.44"
30-Apr-2021,Interest,00.00,"439,126.09","1,756,504.35"
30-Apr-2021,Commission,"109,155.69",00.00,"1,865,660.04"
30-Apr-2021,Tax,432.85,00.00,"1,866,092.89"
30-Apr-2021,Bill,00.00,"466,523.22","1,399,569.67"
30-Apr-2021,Transfer,"10,182.40",00.00,"1,409,752.07"
30-Apr-2021,Cheque,00.00,"140,975.21","1,268,776.86"
30-Apr-2021,Debit Card,00.00,"253,755.37","1,015,021.49"
30-Apr-2021,NEFT,"2,723.29",00.00,"1,017,744.78"
30-Apr-2021,Tax,00.00,"508,872.39","508,872.39"
30-Apr-2021,Bill,00.00,"101,774.48","407,097.91"
30-Apr-2021,Interest,"5,945.00",00.00,"413,042.91"
30-Apr-2021,Interest,00.00,"103,260.73","309,782.18"
30-Apr-2021,Reversal,00.00,"103,260.73","206,521.45"
30-Apr-2021,Cheque,00.00,"206,521.45",00.00
01-May-2021,Bill,19.00,00.00,19.00
01-May-2021,Tax,00.00,03.17,15.83
01-May-2021,Reversal,00.00,03.17,12.66
01-May-2021,Transfer,00.00,03.17,09.50
01-May-2021,RTGS,00.00,02.38,07.12
01-May-2021,Debit Card,00.00,01.78,05.34
01-May-2021,RTGS,"8,835.00",00.00,"8,840.34"
01-May-2021,Bill,00.00,"2,946.78","5,893.56"
01-May-2021,Purchase,"65,759.53",00.00,"71,653.09"
01-May-2021,Purchase,"1,390.50",00.00,"73,043.59"
01-May-2021,Bill,"1,247,738.00",00.00,"1,320,781.59"
01-May-2021,Reversal,"62,107.90",00.00,"1,382,889.49"
01-May-2021,Commission,00.00,"460,963.16","921,926.33"
01-May-2021,Reversal,470.04,00.00,"922,396.37"
01-May-2021,Interest,00.00,"461,198.19","461,198.18"
01-May-2021,ATM,00.00,"115,299.55","345,898.64"
01-May-2021,Bill,00.00,"34,589.86","311,308.78"
01-May-2021,Purchase,42.00,00.00,"311,350.78"
01-May-2021,Cash,"32,490.00",00.00,"343,840.78"
01-May-2021,Debit Card,06.00,00.00,"343,846.78"
01-May-2021,Debit Card,00.00,"114,615.59","229,231.19"
01-May-2021,IMPS,00.00,"28,653.90","200,577.29"
01-May-2021,Commission,00.00,"20,057.73","180,519.56"
01-May-2021,RTGS,"1,513.00",00.00,"182,032.56"
01-May-2021,Reversal,"786,248.25",00.00,"968,280.81"
01-May-2021,Bill,00.00,"322,760.27","645,520.54"
01-May-2021,Cheque,"1,414.80",00.00,"646,935.34"
01-May-2021,Debit Card,228.91,00.00,"647,164.25"
01-May-2021,Debit Card,00.00,"71,907.14","575,257.11"
01-May-2021,Debit Card,"3,656.00",00.00,"578,913.11"
01-May-2021,Transfer,00.80,00.00,"578,913.91"
01-May-2021,IMPS,00.00,"72,364.24","506,549.67"
01-May-2021,RTGS,"2,341.59",00.00,"508,891.26"
01-May-2021,Cheque,00.00,"101,778.25","407,113.01"
01-May-2021,Purchase,00.00,"58,159.00","348,954.01"
01-May-2021,Cash,00.00,"69,790.80","279,163.21"
01-May-2021,RTGS,373.94,00.00,"279,537.15"
02-May-2021,Debit Card,00.00,"39,933.88","239,603.27"
02-May-2021,Transfer,00.00,"239,603.27",00.00
02-May-2021,Transfer,"352,220.00",00.00,"352,220.00"
02-May-2021,Reversal,61.00,00.00,"352,281.00"
02-May-2021,IMPS,"183,034.80",00.00,"535,315.80"
02-May-2021,Cheque,"2,038,545.80",00.00,"2,573,861.60"
02-May-2021,Commission,59.00,00.00,"2,573,920.60"
02-May-2021,IMPS,08.00,00.00,"2,573,928.60"
02-May-2021,IMPS,330.00,00.00,"2,574,258.60"
02-May-2021,Interest,00.00,"367,751.23","2,206,507.37"
02-May-2021,Reversal,00.00,"551,626.84","1,654,880.53"
02-May-2021,Interest,00.00,"827,440.27","827,440.26"
02-May-2021,Debit Card,"194,252.00",00.00,"1,021,692.26"
02-May-2021,NEFT,"3,658.80",00.00,"1,025,351.06"
02-May-2021,NEFT,00.00,"256,337.77","769,013.30"
02-May-2021,Transfer,00.00,"85,445.92","683,567.38"
02-May-2021,NEFT,05.00,00.00,"683,572.38"
02-May-2021,IMPS,05.00,00.00,"683,577.38"
02-May-2021,Bill,"2,003.50",00.00,"685,580.88"
02-May-2021,Cheque,00.00,"685,580.88",00.00
02-May-2021,RTGS,"2,289.03",00.00,"2,289.03"
02-May-2021,Commission,281.30,00.00,"2,570.33"
02-May-2021,ATM,04.00,00.00,"2,574.33"
02-May-2021,Transfer,"1,838,467.00",00.00,"1,841,041.33"
02-May-2021,Cash,00.00,"306,840.22","1,534,201.11"
02-May-2021,Cheque,"17,392.26",00.00,"1,551,593.37"
02-May-2021,Cheque,"29,185.50",00.00,"1,580,778.87"
02-May-2021,Cheque,00.00,"175,642.10","1,405,136.77"
02-May-2021,Bill,"1,220.10",00.00,"1,406,356.87"
02-May-2021,Interest,00.00,"281,271.37","1,125,085.50"
02-May-2021,Cheque,03.00,00.00,"1,125,088.50"
02-May-2021,NEFT,00.00,"140,636.06","984,452.44"
02-May-2021,Bill,00.00,"123,056.56","861,395.88"
02-May-2021,Interest,40.50,00.00,"861,436.38"
02-May-2021,RTGS,11.00,00.00,"861,447.38"
02-May-2021,Cheque,00.00,"95,716.38","765,731.00"
02-May-2021,Transfer,00.00,"109,390.14","656,340.86"
02-May-2021,NEFT,00.00,"218,780.29","437,560.57"
02-May-2021,Tax,"10,993.94",00.00,"448,554.51"
02-May-2021,Commission,00.00,"74,759.09","373,795.42"
02-May-2021,Cheque,435.50,00.00,"374,230.92"
02-May-2021,Debit Card,105.51,00.00,"374,336.43"
02-May-2021,NEFT,00.00,"124,778.81","249,557.62"
02-May-2021,Miscellaneous,"1,576,722.25",00.00,"1,826,279.87"
02-May-2021,IMPS,219.00,00.00,"1,826,498.87"
02-May-2021,Transfer,441.50,00.00,"1,826,940.37"
02-May-2021,Cheque,01.20,00.00,"1,826,941.57"
02-May-2021,Reversal,03.98,00.00,"1,826,945.55"
02-May-2021,Cheque,04.65,00.00,"1,826,950.20"
02-May-2021,Cash,00.00,"456,737.55","1,370,212.65"
02-May-2021,Debit Card,306.00,00.00,"1,370,518.65"
02-May-2021,RTGS,"102,543.00",00.00,"1,473,061.65"
02-May-2021,Bill,58.65,00.00,"1,473,120.30"
02-May-2021,Tax,00.00,"1,473,120.30",00.00
03-May-2021,Purchase,"784,699.50",00.00,"784,699.50"
03-May-2021,ATM,01.00,00.00,"784,700.50"
03-May-2021,ATM,00.00,"78,470.05","706,230.45"
03-May-2021,Reversal,"654,888.80",00.00,"1,361,119.25"
03-May-2021,Miscellaneous,00.00,"680,559.63","680,559.62"
03-May-2021,Transfer,"242,827.80",00.00,"923,387.42"
03-May-2021,Debit Card,07.00,00.00,"923,394.42"
03-May-2021,ATM,"1,534,267.75",00.00,"2,457,662.17"
03-May-2021,Tax,"1,460,178.00",00.00,"3,917,840.17"
03-May-2021,Purchase,00.00,"1,958,920.09","1,958,920.08"
03-May-2021,Cash,"1,566.24",00.00,"1,960,486.32"
03-May-2021,IMPS,"1,559,790.75",00.00,"3,520,277.07"
03-May-2021,Commission,01.70,00.00,"3,520,278.77"
03-May-2021,Reversal,00.00,"440,034.85","3,080,243.92"
03-May-2021,NEFT,"2,582.09",00.00,"3,082,826.01"
03-May-2021,Transfer,00.00,"1,541,413.01","1,541,413.00"
03-May-2021,ATM,177.30,00.00,"1,541,590.30"
03-May-2021,Reversal,337.40,00.00,"1,541,927.70"
03-May-2021,Tax,"1,184.10",00.00,"1,543,111.80"
03-May-2021,Purchase,00.00,"308,622.36","1,234,489.44"
03-May-2021,ATM,290.60,00.00,"1,234,780.04"
03-May-2021,Commission,00.00,"246,956.01","987,824.03"
03-May-2021,Commission,"3,436.00",00.00,"991,260.03"
03-May-2021,RTGS,"1,360,839.75",00.00,"2,352,099.78"
03-May-2021,ATM,00.00,"261,344.42","2,090,755.36"
03-May-2021,Tax,"225,409.70",00.00,"2,316,165.06"
03-May-2021,RTGS,259.70,00.00,"2,316,424.76"
03-May-2021,Tax,"1,985.00",00.00,"2,318,409.76"
03-May-2021,Reversal,00.00,"257,601.08","2,060,808.68"
03-May-2021,Commission,00.00,00.00,"2,060,808.68"
03-May-2021,Interest,00.00,"343,468.11","1,717,340.57"
03-May-2021,Cash,00.00,"1,717,340.57",00.00
03-May-2021,Miscellaneous,"26,282.00",00.00,"26,282.00"
03-May-2021,Cash,142.80,00.00,"26,424.80"
03-May-2021,IMPS,00.00,"26,424.80",00.00
03-May-2021,Debit Card,02.00,00.00,02.00
03-May-2021,Bill,20.00,00.00,22.00
03-May-2021,Transfer,00.00,03.67,18.33
03-May-2021,NEFT,00.00,02.04,16.29
03-May-2021,Commission,"54,538.50",00.00,"54,554.79"
04-May-2021,Transfer,"668,457.50",00.00,"723,012.29"
04-May-2021,Transfer,"177,659.20",00.00,"900,671.49"
04-May-2021,ATM,00.00,"300,223.83","600,447.66"
04-May-2021,Bill,00.00,"300,223.83","300,223.83"
04-May-2021,Tax,00.00,"60,044.77","240,179.06"
04-May-2021,Miscellaneous,166.09,00.00,"240,345.15"
04-May-2021,Miscellaneous,00.00,"34,335.02","206,010.13"
04-May-2021,Miscellaneous,03.06,00.00,"206,013.19"
04-May-2021,Debit Card,"19,177.00",00.00,"225,190.19"
04-May-2021,Cash,00.00,"225,190.19",00.00
04-May-2021,Cheque,45.38,00.00,45.38
04-May-2021,Commission,00.00,22.69,22.69
04-May-2021,Cash,"55,143.31",00.00,"55,166.00"
04-May-2021,ATM,"27,656.30",00.00,"82,822.30"
04-May-2021,IMPS,"157,012.00",00.00,"239,834.30"
05-May-2021,IMPS,"5,855.80",00.00,"245,690.10"
05-May-2021,RTGS,336.00,00.00,"246,026.10"
05-May-2021,Transfer,364.40,00.00,"246,390.50"
05-May-2021,IMPS,00.00,"123,195.25","123,195.25"
05-May-2021,Cheque,"1,253.00",00.00,"124,448.25"
05-May-2021,Purchase,00.00,"17,778.32","106,669.93"
05-May-2021,Commission,00.00,"13,333.74","93,336.19"
05-May-2021,Bill,"21,219.20",00.00,"114,555.39"
05-May-2021,Interest,00.00,"14,319.42","100,235.97"
05-May-2021,Debit Card,00.00,"16,706.00","83,529.98"
05-May-2021,Cash,00.00,"41,764.99","41,764.99"
06-May-2021,Bill,00.00,"6,960.83","34,804.16"
06-May-2021,Bill,00.00,"3,480.42","31,323.74"
06-May-2021,Transfer,00.00,"15,661.87","15,661.87"
06-May-2021,Miscellaneous,"761,230.20",00.00,"776,892.07"
06-May-2021,Reversal,00.00,"77,689.21","699,202.86"
06-May-2021,Debit Card,05.00,00.00,"699,207.86"
06-May-2021,Reversal,"1,967,745.50",00.00,"2,666,953.36"
06-May-2021,Cash,"1,814.00",00.00,"2,668,767.36"
06-May-2021,Interest,00.00,"889,589.12","1,779,178.24"
06-May-2021,ATM,"150,435.80",00.00,"1,929,614.04"
06-May-2021,Reversal,127.08,00.00,"1,929,741.12"
07-May-2021,Cheque,00.00,"482,435.28","1,447,305.84"
07-May-2021,Tax,00.00,"1,447,305.84",00.00
07-May-2021,Reversal,"25,533.80",00.00,"25,533.80"
07-May-2021,NEFT,33.00,00.00,"25,566.80"
07-May-2021,Cheque,00.00,"4,261.13","21,305.67"
07-May-2021,Reversal,55.10,00.00,"21,360.77"
07-May-2021,Tax,00.00,"21,360.77",00.00
07-May-2021,Tax,"1,848,722.50",00.00,"1,848,722.50"
07-May-2021,Reversal,00.00,"462,180.63","1,386,541.88"
07-May-2021,Interest,00.00,"154,060.21","1,232,481.67"
07-May-2021,IMPS,345.10,00.00,"1,232,826.77"
07-May-2021,Purchase,00.00,"154,103.35","1,078,723.42"
07-May-2021,Interest,"26,300.96",00.00,"1,105,024.38"
08-May-2021,IMPS,"243,223.00",00.00,"1,348,247.38"
08-May-2021,Debit Card,00.00,"224,707.90","1,123,539.48"
08-May-2021,Miscellaneous,"33,037.00",00.00,"1,156,576.48"
08-May-2021,NEFT,"1,180.13",00.00,"1,157,756.61"
08-May-2021,Transfer,00.00,"1,157,756.61",00.00
08-May-2021,Cash,00.68,00.00,00.68
08-May-2021,Reversal,00.00,00.17,00.51
08-May-2021,Miscellaneous,"814,051.25",00.00,"814,051.76"
08-May-2021,Interest,00.00,"814,051.76",00.00
08-May-2021,Cheque,"521,329.00",00.00,"521,329.00"
08-May-2021,Interest,"707,006.50",00.00,"1,228,335.50"
08-May-2021,Purchase,00.00,"409,445.17","818,890.33"
08-May-2021,Tax,00.00,"409,445.17","409,445.16"
08-May-2021,Cheque,377.90,00.00,"409,823.06"
08-May-2021,Reversal,00.00,"102,455.77","307,367.30"
08-May-2021,Bill,00.00,"307,367.30",00.00
08-May-2021,Reversal,472.00,00.00,472.00
08-May-2021,Transfer,00.00,59.00,413.00
08-May-2021,Debit Card,"252,308.50",00.00,"252,721.50"
08-May-2021,Cheque,"159,697.53",00.00,"412,419.03"
08-May-2021,IMPS,29.00,00.00,"412,448.03"
08-May-2021,Purchase,00.00,"412,448.03",00.00
08-May-2021,IMPS,55.48,00.00,55.48
08-May-2021,Tax,00.00,06.94,48.54
08-May-2021,Miscellaneous,"16,158.89",00.00,"16,207.43"
08-May-2021,Reversal,510.00,00.00,"16,717.43"
08-May-2021,Bill,"1,355.96",00.00,"18,073.39"
08-May-2021,Purchase,00.00,"18,073.39",00.00
08-May-2021,Tax,00.20,00.00,00.20
08-May-2021,IMPS,00.00,00.04,00.16
08-May-2021,NEFT,00.00,00.03,00.13
08-May-2021,Purchase,07.06,00.00,07.19
08-May-2021,ATM,00.00,02.40,04.79
08-May-2021,Commission,00.00,00.48,04.31
08-May-2021,Commission,"2,451.00",00.00,"2,455.31"
08-May-2021,Miscellaneous,03.36,00.00,"2,458.67"
08-May-2021,Bill,00.00,491.73,"1,966.94"
08-May-2021,NEFT,260.30,00.00,"2,227.24"
08-May-2021,Miscellaneous,00.00,222.72,"2,004.52"
08-May-2021,Commission,"218,351.40",00.00,"220,355.92"
08-May-2021,Cash,"994,981.00",00.00,"1,215,336.92"
09-May-2021,ATM,473.41,00.00,"1,215,810.33"
09-May-2021,Bill,00.00,"151,976.29","1,063,834.04"
09-May-2021,RTGS,00.00,"118,203.78","945,630.26"
09-May-2021,Cash,"248,206.00",00.00,"1,193,836.26"
09-May-2021,NEFT,00.00,"397,945.42","795,890.84"
09-May-2021,Miscellaneous,00.00,"397,945.42","397,945.42"
09-May-2021,ATM,"13,219.00",00.00,"411,164.42"
09-May-2021,NEFT,00.00,"102,791.11","308,373.32"
09-May-2021,Tax,"1,150,286.80",00.00,"1,458,660.12"
09-May-2021,NEFT,426.60,00.00,"1,459,086.72"
09-May-2021,Bill,52.07,00.00,"1,459,138.79"
09-May-2021,Bill,00.00,"291,827.76","1,167,311.03"
09-May-2021,Tax,"252,212.00",00.00,"1,419,523.03"
09-May-2021,Cheque,"858,696.00",00.00,"2,278,219.03"
09-May-2021,Miscellaneous,"1,270,855.00",00.00,"3,549,074.03"
09-May-2021,Miscellaneous,"93,682.00",00.00,"3,642,756.03"
09-May-2021,Debit Card,"20,570.00",00.00,"3,663,326.03"
09-May-2021,Debit Card,00.00,"915,831.51","2,747,494.52"
09-May-2021,Miscellaneous,00.00,"305,277.17","2,442,217.35"
09-May-2021,Reversal,00.00,"814,072.45","1,628,144.90"
09-May-2021,Transfer,"3,968.10",00.00,"1,632,113.00"
09-May-2021,NEFT,"38,332.00",00.00,"1,670,445.00"
09-May-2021,ATM,"23,017.71",00.00,"1,693,462.71"
09-May-2021,Commission,03.20,00.00,"1,693,465.91"
09-May-2021,Interest,969.00,00.00,"1,694,434.91"
09-May-2021,Reversal,00.00,"564,811.64","1,129,623.27"
09-May-2021,Purchase,07.00,00.00,"1,129,630.27"
09-May-2021,ATM,"1,236,306.00",00.00,"2,365,936.27"
09-May-2021,Miscellaneous,00.00,"2,365,936.27",00.00
09-May-2021,Transfer,448.00,00.00,448.00
09-May-2021,Tax,837.54,00.00,"1,285.54"
09-May-2021,Cash,00.00,257.11,"1,028.43"
09-May-2021,Commission,00.00,146.92,881.51
09-May-2021,Cash,00.00,88.15,793.36
09-May-2021,Purchase,00.00,793.36,00.00
09-May-2021,Reversal,930.64,00.00,930.64
09-May-2021,Purchase,00.00,930.64,00.00
09-May-2021,Tax,"1,144.27",00.00,"1,144.27"
09-May-2021,Cheque,00.00,127.14,"1,017.13"
09-May-2021,Tax,"3,708.80",00.00,"4,725.93"
09-May-2021,Transfer,00.00,787.66,"3,938.28"
09-May-2021,Miscellaneous,08.80,00.00,"3,947.08"
09-May-2021,Cash,00.00,493.39,"3,453.70"
09-May-2021,NEFT,"136,126.00",00.00,"139,579.70"
09-May-2021,Cheque,"65,111.22",00.00,"204,690.92"
09-May-2021,ATM,00.00,"22,743.44","181,947.48"
09-May-2021,Bill,"23,663.50",00.00,"205,610.98"
09-May-2021,Tax,"6,653.64",00.00,"212,264.62"
09-May-2021,NEFT,00.00,"26,533.08","185,731.54"
09-May-2021,Reversal,00.00,"30,955.26","154,776.28"
09-May-2021,Reversal,00.00,"25,796.05","128,980.23"
09-May-2021,Debit Card,"70,934.00",00.00,"199,914.23"
09-May-2021,Cheque,00.00,"199,914.23",00.00
09-May-2021,RTGS,03.00,00.00,03.00
09-May-2021,RTGS,00.00,03.00,00.00
09-May-2021,Interest,87.73,00.00,87.73
09-May-2021,Tax,"53,070.30",00.00,"53,158.03"
09-May-2021,Reversal,"12,118.00",00.00,"65,276.03"
09-May-2021,Commission,"1,770.02",00.00,"67,046.05"
09-May-2021,Bill,00.00,"22,348.68","44,697.37"
09-May-2021,ATM,00.00,"14,899.12","29,798.25"
09-May-2021,Reversal,"2,396.60",00.00,"32,194.85"
09-May-2021,NEFT,00.00,"10,731.62","21,463.23"
09-May-2021,Purchase,00.00,"2,384.80","19,078.43"
09-May-2021,Bill,00.00,"4,769.61","14,308.82"
09-May-2021,Commission,00.00,"1,430.88","12,877.94"
09-May-2021,Purchase,00.00,"2,575.59","10,302.35"
09-May-2021,Tax,00.00,"1,287.79","9,014.56"
09-May-2021,Bill,371.70,00.00,"9,386.26"
09-May-2021,Miscellaneous,00.00,"2,346.57","7,039.70"
09-May-2021,Miscellaneous,00.00,"2,346.57","4,693.13"
09-May-2021,Reversal,04.34,00.00,"4,697.47"
09-May-2021,Interest,00.00,671.07,"4,026.40"
09-May-2021,Miscellaneous,50.00,00.00,"4,076.40"
09-May-2021,IMPS,"202,324.25",00.00,"206,400.65"
09-May-2021,Transfer,"1,101,462.00",00.00,"1,307,862.65"
09-May-2021,RTGS,05.30,00.00,"1,307,867.95"
09-May-2021,RTGS,24.81,00.00,"1,307,892.76"
10-May-2021,Cash,00.00,"145,321.42","1,162,571.34"
10-May-2021,Reversal,06.20,00.00,"1,162,577.54"
10-May-2021,Miscellaneous,32.00,00.00,"1,162,609.54"
10-May-2021,Bill,00.00,"129,178.84","1,033,430.70"
10-May-2021,Cheque,00.00,"103,343.07","930,087.63"
10-May-2021,NEFT,00.00,"103,343.07","826,744.56"
10-May-2021,NEFT,"139,722.97",00.00,"966,467.53"
10-May-2021,RTGS,00.00,"966,467.53",00.00
10-May-2021,Cheque,36.00,00.00,36.00
10-May-2021,Reversal,"11,829.90",00.00,"11,865.90"
10-May-2021,IMPS,37.10,00.00,"11,903.00"
10-May-2021,Purchase,00.00,"3,967.67","7,935.33"
10-May-2021,Purchase,00.00,881.70,"7,053.63"
10-May-2021,Cash,13.00,00.00,"7,066.63"
10-May-2021,Reversal,"1,005.46",00.00,"8,072.09"
10-May-2021,NEFT,"31,572.00",00.00,"39,644.09"
10-May-2021,RTGS,00.00,"4,955.51","34,688.58"
10-May-2021,RTGS,168.00,00.00,"34,856.58"
10-May-2021,IMPS,00.00,"5,809.43","29,047.15"
10-May-2021,Bill,00.00,"9,682.38","19,364.77"
10-May-2021,Cheque,480.50,00.00,"19,845.27"
10-May-2021,Interest,00.00,"9,922.64","9,922.64"
10-May-2021,ATM,"3,499.60",00.00,"13,422.24"
10-May-2021,Cash,00.00,"4,474.08","8,948.16"
11-May-2021,RTGS,00.00,"4,474.08","4,474.08"
11-May-2021,Bill,00.00,447.41,"4,026.67"
11-May-2021,Bill,00.00,671.11,"3,355.56"
11-May-2021,Transfer,00.00,559.26,"2,796.30"
11-May-2021,Cheque,00.00,399.47,"2,396.83"
11-May-2021,Tax,00.00,342.40,"2,054.43"
11-May-2021,Bill,00.00,205.44,"1,848.99"
11-May-2021,Tax,00.00,264.14,"1,584.85"
11-May-2021,Debit Card,"1,803,023.00",00.00,"1,804,607.85"
11-May-2021,NEFT,"3,436.00",00.00,"1,808,043.85"
12-May-2021,Miscellaneous,00.00,"452,010.96","1,356,032.89"
12-May-2021,Debit Card,00.00,"135,603.29","1,220,429.60"
12-May-2021,ATM,00.00,"174,347.09","1,046,082.51"
12-May-2021,Miscellaneous,06.60,00.00,"1,046,089.11"
12-May-2021,RTGS,168.72,00.00,"1,046,257.83"
12-May-2021,Debit Card,00.00,"116,250.87","930,006.96"
12-May-2021,Commission,396.00,00.00,"930,402.96"
12-May-2021,Reversal,00.00,"116,300.37","814,102.59"
12-May-2021,Purchase,00.00,"407,051.30","407,051.30"
12-May-2021,Tax,00.00,"67,841.88","339,209.42"
12-May-2021,RTGS,00.00,"42,401.18","296,808.24"
12-May-2021,Purchase,00.00,"148,404.12","148,404.12"
12-May-2021,Tax,00.00,"148,404.12",00.00
12-May-2021,Transfer,29.80,00.00,29.80
12-May-2021,Miscellaneous,00.00,07.45,22.35
12-May-2021,Transfer,"21,560.00",00.00,"21,582.35"
12-May-2021,Commission,00.00,"10,791.18","10,791.18"
12-May-2021,Purchase,00.00,"1,348.90","9,442.28"
12-May-2021,Cheque,84.60,00.00,"9,526.88"
12-May-2021,Tax,"565,200.00",00.00,"574,726.88"
12-May-2021,Debit Card,00.00,"57,472.69","517,254.19"
12-May-2021,Reversal,00.00,"86,209.03","431,045.16"
12-May-2021,Purchase,04.00,00.00,"431,049.16"
12-May-2021,Bill,00.00,"43,104.92","387,944.24"
12-May-2021,IMPS,07.50,00.00,"387,951.74"
12-May-2021,Miscellaneous,00.70,00.00,"387,952.44"
12-May-2021,Cash,00.00,"129,317.48","258,634.96"
12-May-2021,Miscellaneous,00.90,00.00,"258,635.86"
12-May-2021,ATM,"29,048.00",00.00,"287,683.86"
12-May-2021,Bill,00.00,"57,536.77","230,147.09"
12-May-2021,Purchase,"99,924.91",00.00,"330,072.00"
12-May-2021,Bill,"270,065.00",00.00,"600,137.00"
12-May-2021,Cheque,25.00,00.00,"600,162.00"
12-May-2021,ATM,00.00,"100,027.00","500,135.00"
12-May-2021,ATM,"2,260.00",00.00,"502,395.00"
12-May-2021,Reversal,00.00,"55,821.67","446,573.33"
12-May-2021,IMPS,00.00,"111,643.33","334,930.00"
12-May-2021,Cheque,00.00,"66,986.00","267,944.00"
12-May-2021,IMPS,00.00,"66,986.00","200,958.00"
12-May-2021,Purchase,00.00,"20,095.80","180,862.20"
12-May-2021,Cheque,"18,570.92",00.00,"199,433.12"
12-May-2021,Cheque,229.00,00.00,"199,662.12"
12-May-2021,IMPS,00.59,00.00,"199,662.71"
12-May-2021,Bill,"1,796,274.00",00.00,"1,995,936.71"
13-May-2021,NEFT,"146,829.75",00.00,"2,142,766.46"
13-May-2021,Interest,189.00,00.00,"2,142,955.46"
13-May-2021,RTGS,00.00,"214,295.55","1,928,659.91"
13-May-2021,Miscellaneous,"19,495.00",00.00,"1,948,154.91"
13-May-2021,Interest,"1,644,800.75",00.00,"3,592,955.66"
13-May-2021,Cash,"223,182.50",00.00,"3,816,138.16"
13-May-2021,Debit Card,"239,159.00",00.00,"4,055,297.16"
13-May-2021,IMPS,06.81,00.00,"4,055,303.97"
13-May-2021,Debit Card,00.00,"405,530.40","3,649,773.57"
13-May-2021,Cheque,00.00,"1,824,886.79","1,824,886.78"
13-May-2021,Commission,07.00,00.00,"1,824,893.78"
13-May-2021,Bill,01.70,00.00,"1,824,895.48"
13-May-2021,Interest,"1,294,790.75",00.00,"3,119,686.23"
13-May-2021,Cash,00.00,"1,039,895.41","2,079,790.82"
13-May-2021,Transfer,233.38,00.00,"2,080,024.20"
13-May-2021,Purchase,00.00,"260,003.03","1,820,021.18"
13-May-2021,Cheque,00.00,"910,010.59","910,010.59"
13-May-2021,Reversal,72.30,00.00,"910,082.89"
13-May-2021,IMPS,00.00,"303,360.96","606,721.93"
14-May-2021,Interest,00.00,"121,344.39","485,377.54"
14-May-2021,Transfer,"3,647.00",00.00,"489,024.54"
14-May-2021,RTGS,191.00,00.00,"489,215.54"
14-May-2021,Bill,00.00,"122,303.89","366,911.66"
14-May-2021,Miscellaneous,"175,490.00",00.00,"542,401.66"
14-May-2021,Bill,"68,084.00",00.00,"610,485.66"
14-May-2021,ATM,"22,762.34",00.00,"633,248.00"
14-May-2021,RTGS,09.00,00.00,"633,257.00"
14-May-2021,Bill,00.00,"63,325.70","569,931.30"
14-May-2021,Purchase,00.00,"81,418.76","488,512.54"
15-May-2021,IMPS,00.00,"81,418.76","407,093.78"
15-May-2021,Miscellaneous,28.99,00.00,"407,122.77"
15-May-2021,RTGS,05.00,00.00,"407,127.77"
15-May-2021,Purchase,54.00,00.00,"407,181.77"
15-May-2021,IMPS,00.00,"67,863.63","339,318.14"
15-May-2021,Interest,109.00,00.00,"339,427.14"
15-May-2021,Reversal,00.00,"37,714.13","301,713.01"
15-May-2021,Reversal,00.00,"75,428.25","226,284.76"
15-May-2021,Reversal,00.00,"113,142.38","113,142.38"
15-May-2021,Debit Card,476.10,00.00,"113,618.48"
15-May-2021,RTGS,"20,710.00",00.00,"134,328.48"
15-May-2021,Reversal,462.50,00.00,"134,790.98"
15-May-2021,Interest,00.00,"16,848.87","117,942.11"
15-May-2021,Transfer,"6,217.00",00.00,"124,159.11"
15-May-2021,Cash,04.00,00.00,"124,163.11"
15-May-2021,Purchase,03.00,00.00,"124,166.11"
15-May-2021,ATM,00.00,"15,520.76","108,645.35"
15-May-2021,Tax,00.00,"54,322.68","54,322.68"
15-May-2021,NEFT,00.00,"18,107.56","36,215.12"
15-May-2021,Reversal,40.00,00.00,"36,255.12"
15-May-2021,IMPS,"2,217.17",00.00,"38,472.29"
15-May-2021,IMPS,00.00,"38,472.29",00.00
15-May-2021,NEFT,"1,651.31",00.00,"1,651.31"
15-May-2021,RTGS,00.00,235.90,"1,415.41"
15-May-2021,Commission,00.00,471.80,943.61
15-May-2021,IMPS,"203,059.30",00.00,"204,002.91"
15-May-2021,Interest,00.00,"204,002.91",00.00
15-May-2021,Cheque,"123,223.00",00.00,"123,223.00"
15-May-2021,Debit Card,"84,029.69",00.00,"207,252.69"
15-May-2021,Transfer,01.20,00.00,"207,253.89"
15-May-2021,Reversal,"648,407.00",00.00,"855,660.89"
16-May-2021,Reversal,00.00,"427,830.45","427,830.44"
16-May-2021,IMPS,00.00,"53,478.81","374,351.64"
16-May-2021,Miscellaneous,340.81,00.00,"374,692.45"
16-May-2021,Commission,05.00,00.00,"374,697.45"
16-May-2021,Debit Card,00.00,"187,348.73","187,348.72"
16-May-2021,Cash,00.00,"20,816.52","166,532.20"
16-May-2021,Bill,07.16,00.00,"166,539.36"
16-May-2021,Interest,00.00,"55,513.12","111,026.24"
17-May-2021,Miscellaneous,00.00,"22,205.25","88,820.99"
18-May-2021,Interest,00.00,"14,803.50","74,017.49"
18-May-2021,Interest,00.00,"7,401.75","66,615.74"
18-May-2021,Interest,02.91,00.00,"66,618.65"
18-May-2021,ATM,"2,268.00",00.00,"68,886.65"
18-May-2021,Tax,00.00,"34,443.33","34,443.32"
18-May-2021,Miscellaneous,"3,135.10",00.00,"37,578.42"
18-May-2021,Interest,"166,040.38",00.00,"203,618.80"
18-May-2021,Purchase,54.30,00.00,"203,673.10"
18-May-2021,Cheque,00.00,"50,918.28","152,754.83"
18-May-2021,ATM,00.00,"152,754.83",00.00
18-May-2021,Miscellaneous,"12,851.00",00.00,"12,851.00"
18-May-2021,RTGS,00.00,"1,285.10","11,565.90"
18-May-2021,Interest,00.00,"2,891.48","8,674.42"
18-May-2021,ATM,00.00,"1,084.30","7,590.12"
18-May-2021,Cheque,00.00,843.35,"6,746.77"
18-May-2021,IMPS,00.00,"1,686.69","5,060.08"
18-May-2021,Reversal,00.00,506.01,"4,554.07"
18-May-2021,Transfer,00.00,650.58,"3,903.49"
18-May-2021,Debit Card,00.00,433.72,"3,469.77"
18-May-2021,RTGS,00.00,433.72,"3,036.05"
18-May-2021,Tax,00.00,"3,036.05",00.00
18-May-2021,Bill,70.80,00.00,70.80
18-May-2021,Miscellaneous,"27,642.70",00.00,"27,713.50"
18-May-2021,Tax,"28,876.00",00.00,"56,589.50"
18-May-2021,Commission,00.00,"11,317.90","45,271.60"
18-May-2021,Debit Card,236.22,00.00,"45,507.82"
18-May-2021,Cash,04.20,00.00,"45,512.02"
18-May-2021,Reversal,42.60,00.00,"45,554.62"
18-May-2021,Commission,00.00,"4,555.46","40,999.16"
18-May-2021,Interest,06.00,00.00,"41,005.16"
18-May-2021,Debit Card,00.00,"6,834.19","34,170.97"
18-May-2021,Interest,00.00,"3,796.77","30,374.20"
18-May-2021,Interest,00.00,"15,187.10","15,187.10"
18-May-2021,Interest,00.00,"1,898.39","13,288.71"
18-May-2021,Miscellaneous,00.00,"1,661.09","11,627.62"
18-May-2021,Reversal,"2,647.20",00.00,"14,274.82"
18-May-2021,Purchase,498.00,00.00,"14,772.82"
18-May-2021,Cash,00.00,"3,693.21","11,079.62"
19-May-2021,IMPS,"594,587.00",00.00,"605,666.62"
19-May-2021,IMPS,457.00,00.00,"606,123.62"
19-May-2021,Commission,00.00,"67,347.07","538,776.55"
19-May-2021,NEFT,00.00,"53,877.66","484,898.90"
19-May-2021,Debit Card,00.00,"48,489.89","436,409.01"
19-May-2021,Purchase,00.00,"48,489.89","387,919.12"
20-May-2021,Commission,25.00,00.00,"387,944.12"
20-May-2021,Interest,07.88,00.00,"387,952.00"
20-May-2021,Commission,00.00,"55,421.71","332,530.29"
20-May-2021,NEFT,00.00,"41,566.29","290,964.00"
20-May-2021,RTGS,618.50,00.00,"291,582.50"
20-May-2021,RTGS,00.00,"48,597.08","242,985.42"
21-May-2021,Reversal,"2,593.30",00.00,"245,578.72"
21-May-2021,Purchase,00.00,"27,286.52","218,292.20"
21-May-2021,Bill,00.00,"31,184.60","187,107.60"
21-May-2021,Transfer,"28,572.70",00.00,"215,680.30"
21-May-2021,Interest,"77,841.00",00.00,"293,521.30"
21-May-2021,Interest,"996,122.80",00.00,"1,289,644.10"
21-May-2021,RTGS,"1,333.92",00.00,"1,290,978.02"
21-May-2021,NEFT,00.00,"215,163.00","1,075,815.02"
21-May-2021,Transfer,167.30,00.00,"1,075,982.32"
21-May-2021,RTGS,13.00,00.00,"1,075,995.32"
21-May-2021,ATM,37.00,00.00,"1,076,032.32"
21-May-2021,Reversal,04.32,00.00,"1,076,036.64"
22-May-2021,Reversal,"106,792.00",00.00,"1,182,828.64"
22-May-2021,Transfer,"14,662.00",00.00,"1,197,490.64"
22-May-2021,Bill,00.00,"171,070.09","1,026,420.55"
22-May-2021,Reversal,54.30,00.00,"1,026,474.85"
22-May-2021,Commission,05.40,00.00,"1,026,480.25"
22-May-2021,Purchase,00.00,"102,648.03","923,832.22"
22-May-2021,ATM,00.00,"923,832.22",00.00
22-May-2021,Cheque,48.02,00.00,48.02
22-May-2021,Transfer,00.00,16.01,32.01
22-May-2021,Commission,"467,494.80",00.00,"467,526.81"
22-May-2021,Cheque,"1,754,372.50",00.00,"2,221,899.31"
22-May-2021,Tax,00.00,"370,316.55","1,851,582.76"
22-May-2021,Commission,"2,469.25",00.00,"1,854,052.01"
22-May-2021,Reversal,00.00,"618,017.34","1,236,034.67"
22-May-2021,NEFT,00.00,"309,008.67","927,026.00"
22-May-2021,Tax,04.12,00.00,"927,030.12"
22-May-2021,ATM,02.40,00.00,"927,032.52"
22-May-2021,Cheque,"1,312,108.80",00.00,"2,239,141.32"
22-May-2021,IMPS,00.00,"319,877.33","1,919,263.99"
22-May-2021,Cash,00.00,"383,852.80","1,535,411.19"
22-May-2021,Bill,00.00,"511,803.73","1,023,607.46"
22-May-2021,Transfer,00.00,"170,601.24","853,006.22"
22-May-2021,Bill,00.00,"85,300.62","767,705.60"
22-May-2021,Cheque,"24,856.66",00.00,"792,562.26"
22-May-2021,Miscellaneous,00.00,"158,512.45","634,049.81"
22-May-2021,Commission,00.00,"79,256.23","554,793.58"
22-May-2021,Cheque,01.46,00.00,"554,795.04"
22-May-2021,Cheque,"210,201.00",00.00,"764,996.04"
22-May-2021,IMPS,51.70,00.00,"765,047.74"
22-May-2021,Interest,"132,064.70",00.00,"897,112.44"
22-May-2021,Cash,00.00,"149,518.74","747,593.70"
22-May-2021,Commission,00.00,"747,593.70",00.00
23-May-2021,Interest,05.01,00.00,05.01
23-May-2021,RTGS,55.03,00.00,60.04
23-May-2021,Cheque,"1,759,110.50",00.00,"1,759,170.54"
23-May-2021,Commission,00.00,"219,896.32","1,539,274.22"
23-May-2021,Debit Card,06.08,00.00,"1,539,280.30"
23-May-2021,Transfer,01.30,00.00,"1,539,281.60"
23-May-2021,NEFT,73.90,00.00,"1,539,355.50"
23-May-2021,Tax,64.00,00.00,"1,539,419.50"
23-May-2021,Cash,"452,171.00",00.00,"1,991,590.50"
23-May-2021,Interest,"1,236,543.00",00.00,"3,228,133.50"
23-May-2021,Tax,"6,805.45",00.00,"3,234,938.95"
23-May-2021,Debit Card,00.00,"539,156.49","2,695,782.46"
23-May-2021,Purchase,00.00,"1,347,891.23","1,347,891.23"
23-May-2021,Debit Card,"1,404,050.00",00.00,"2,751,941.23"
23-May-2021,Miscellaneous,"32,351.00",00.00,"2,784,292.23"
24-May-2021,Commission,00.00,"2,784,292.23",00.00
24-May-2021,Debit Card,"191,168.00",00.00,"191,168.00"
24-May-2021,Cash,00.00,"23,896.00","167,272.00"
24-May-2021,ATM,00.00,"83,636.00","83,636.00"
24-May-2021,Tax,00.00,"8,363.60","75,272.40"
24-May-2021,ATM,00.00,"15,054.48","60,217.92"
24-May-2021,Tax,"15,900.40",00.00,"76,118.32"
24-May-2021,RTGS,00.00,"12,686.39","63,431.93"
24-May-2021,RTGS,"2,281.00",00.00,"65,712.93"
24-May-2021,NEFT,08.00,00.00,"65,720.93"
24-May-2021,Tax,"103,785.00",00.00,"169,505.93"
24-May-2021,IMPS,00.00,"21,188.24","148,317.69"
24-May-2021,IMPS,"27,742.00",00.00,"176,059.69"
24-May-2021,Debit Card,00.00,"88,029.85","88,029.84"
24-May-2021,NEFT,156.26,00.00,"88,186.10"
24-May-2021,ATM,00.00,"14,697.68","73,488.42"
24-May-2021,NEFT,00.00,"8,165.38","65,323.04"
24-May-2021,Cash,00.00,"6,532.30","58,790.74"
24-May-2021,Miscellaneous,"228,274.09",00.00,"287,064.83"
24-May-2021,Transfer,"828,894.50",00.00,"1,115,959.33"
24-May-2021,RTGS,00.00,"278,989.83","836,969.50"
24-May-2021,Tax,00.00,"104,621.19","732,348.31"
24-May-2021,Cheque,00.60,00.00,"732,348.91"
24-May-2021,Bill,"31,975.90",00.00,"764,324.81"
24-May-2021,Transfer,00.00,"84,924.98","679,399.83"
24-May-2021,IMPS,07.98,00.00,"679,407.81"
24-May-2021,Interest,"1,557,078.80",00.00,"2,236,486.61"
24-May-2021,IMPS,"2,742.85",00.00,"2,239,229.46"
24-May-2021,Cash,404.85,00.00,"2,239,634.31"
24-May-2021,Debit Card,23.30,00.00,"2,239,657.61"
24-May-2021,ATM,150.65,00.00,"2,239,808.26"
24-May-2021,Purchase,03.90,00.00,"2,239,812.16"
24-May-2021,Commission,00.00,"447,962.43","1,791,849.73"
24-May-2021,NEFT,00.00,"255,978.53","1,535,871.20"
24-May-2021,Cheque,00.00,"170,652.36","1,365,218.84"
25-May-2021,Commission,00.00,"273,043.77","1,092,175.07"
25-May-2021,Reversal,56.00,00.00,"1,092,231.07"
25-May-2021,IMPS,00.00,"1,092,231.07",00.00
25-May-2021,NEFT,04.30,00.00,04.30
25-May-2021,Transfer,17.99,00.00,22.29
25-May-2021,Miscellaneous,34.00,00.00,56.29
25-May-2021,Purchase,00.00,08.04,48.25
25-May-2021,Cheque,"58,476.30",00.00,"58,524.55"
25-May-2021,Cheque,06.35,00.00,"58,530.90"
25-May-2021,Commission,243.00,00.00,"58,773.90"
25-May-2021,NEFT,"393,370.00",00.00,"452,143.90"
25-May-2021,Transfer,00.00,"113,035.98","339,107.93"
25-May-2021,NEFT,00.00,"84,776.98","254,330.95"
25-May-2021,Transfer,"250,963.40",00.00,"505,294.35"
25-May-2021,Tax,08.60,00.00,"505,302.95"
25-May-2021,Cheque,00.00,"168,434.32","336,868.63"
25-May-2021,Cheque,00.00,"168,434.32","168,434.32"
25-May-2021,RTGS,00.00,"21,054.29","147,380.03"
25-May-2021,Cheque,00.00,"24,563.34","122,816.69"
25-May-2021,Cash,00.00,"24,563.34","98,253.35"
25-May-2021,Miscellaneous,00.00,"24,563.34","73,690.01"
25-May-2021,Reversal,00.00,"73,690.01",00.00
25-May-2021,Bill,"10,599.90",00.00,"10,599.90"
25-May-2021,Tax,"113,101.84",00.00,"123,701.74"
25-May-2021,Reversal,00.00,"12,370.17","111,331.57"
25-May-2021,NEFT,508.00,00.00,"111,839.57"
25-May-2021,IMPS,00.00,"11,183.96","100,655.61"
25-May-2021,Interest,00.00,"10,065.56","90,590.05"
25-May-2021,Interest,"83,276.90",00.00,"173,866.95"
25-May-2021,RTGS,00.00,"34,773.39","139,093.56"
25-May-2021,Cash,00.00,"17,386.70","121,706.86"
25-May-2021,Reversal,"1,363,892.75",00.00,"1,485,599.61"
25-May-2021,Transfer,00.00,"495,199.87","990,399.74"
25-May-2021,Reversal,478.80,00.00,"990,878.54"
26-May-2021,Commission,05.10,00.00,"990,883.64"
26-May-2021,Purchase,203.30,00.00,"991,086.94"
26-May-2021,Commission,00.00,"110,120.77","880,966.17"
26-May-2021,NEFT,"6,518.00",00.00,"887,484.17"
26-May-2021,Cash,"78,588.90",00.00,"966,073.07"
26-May-2021,Interest,492.00,00.00,"966,565.07"
26-May-2021,Cheque,00.00,"966,565.07",00.00
26-May-2021,ATM,"14,258.00",00.00,"14,258.00"
26-May-2021,IMPS,00.00,"1,425.80","12,832.20"
26-May-2021,Purchase,00.00,"2,566.44","10,265.76"
26-May-2021,IMPS,00.00,"1,283.22","8,982.54"
26-May-2021,Commission,"3,891.10",00.00,"12,873.64"
26-May-2021,NEFT,00.00,"1,287.36","11,586.28"
26-May-2021,Bill,"2,820.90",00.00,"14,407.18"
26-May-2021,Transfer,00.00,"1,800.90","12,606.28"
26-May-2021,Bill,"164,558.80",00.00,"177,165.08"
26-May-2021,ATM,45.20,00.00,"177,210.28"
26-May-2021,Interest,00.00,"17,721.03","159,489.25"
26-May-2021,Transfer,"3,604.00",00.00,"163,093.25"
26-May-2021,Reversal,00.00,"32,618.65","130,474.60"
27-May-2021,Reversal,"3,863.90",00.00,"134,338.50"
27-May-2021,NEFT,00.00,"26,867.70","107,470.80"
27-May-2021,Miscellaneous,00.00,"11,941.20","95,529.60"
27-May-2021,Cash,00.00,"10,614.40","84,915.20"
27-May-2021,Transfer,"177,339.75",00.00,"262,254.95"
27-May-2021,RTGS,00.00,"65,563.74","196,691.21"
27-May-2021,Cash,00.00,"32,781.87","163,909.34"
27-May-2021,Bill,"171,232.00",00.00,"335,141.34"
27-May-2021,ATM,"1,895,817.00",00.00,"2,230,958.34"
28-May-2021,RTGS,00.00,"223,095.83","2,007,862.51"
28-May-2021,Cash,00.00,"501,965.63","1,505,896.88"
28-May-2021,IMPS,"232,760.30",00.00,"1,738,657.18"
28-May-2021,NEFT,"20,058.50",00.00,"1,758,715.68"
28-May-2021,ATM,00.00,"195,412.85","1,563,302.83"
28-May-2021,Interest,00.00,"781,651.42","781,651.42"
28-May-2021,NEFT,00.00,"86,850.16","694,801.26"
28-May-2021,Interest,04.78,00.00,"694,806.04"
28-May-2021,Cash,"1,478.00",00.00,"696,284.04"
28-May-2021,Miscellaneous,00.00,"232,094.68","464,189.36"
28-May-2021,IMPS,00.00,"92,837.87","371,351.49"
28-May-2021,Debit Card,"681,546.00",00.00,"1,052,897.49"
28-May-2021,Tax,00.00,"350,965.83","701,931.66"
28-May-2021,NEFT,225.59,00.00,"702,157.25"
28-May-2021,Cash,00.00,"100,308.18","601,849.07"
28-May-2021,Transfer,278.23,00.00,"602,127.30"
28-May-2021,Cash,07.96,00.00,"602,135.26"
28-May-2021,Purchase,00.00,"60,213.53","541,921.73"
28-May-2021,Bill,414.00,00.00,"542,335.73"
29-May-2021,Commission,00.00,"542,335.73",00.00
29-May-2021,Miscellaneous,252.10,00.00,252.10
29-May-2021,RTGS,"14,832.00",00.00,"15,084.10"
29-May-2021,Miscellaneous,40.74,00.00,"15,124.84"
30-May-2021,Reversal,00.00,"2,160.69","12,964.15"
30-May-2021,ATM,00.00,"2,592.83","10,371.32"
30-May-2021,IMPS,06.43,00.00,"10,377.75"
30-May-2021,Bill,00.00,"3,459.25","6,918.50"
30-May-2021,Tax,"9,474.80",00.00,"16,393.30"
30-May-2021,NEFT,404.06,00.00,"16,797.36"
30-May-2021,NEFT,"101,282.94",00.00,"118,080.30"
30-May-2021,Reversal,00.00,"11,808.03","106,272.27"
30-May-2021,RTGS,"198,828.10",00.00,"305,100.37"
30-May-2021,Bill,"947,172.75",00.00,"1,252,273.12"
30-May-2021,Commission,00.00,"250,454.62","1,001,818.50"
30-May-2021,Cheque,00.00,"200,363.70","801,454.80"
30-May-2021,Bill,00.00,"801,454.80",00.00
30-May-2021,Cheque,"1,213,303.75",00.00,"1,213,303.75"
30-May-2021,Purchase,"1,514,669.50",00.00,"2,727,973.25"
30-May-2021,Purchase,51.07,00.00,"2,728,024.32"
30-May-2021,Debit Card,02.50,00.00,"2,728,026.82"
30-May-2021,Commission,00.00,"1,364,013.41","1,364,013.41"
30-May-2021,Purchase,"429,544.00",00.00,"1,793,557.41"
30-May-2021,Reversal,00.00,"448,389.35","1,345,168.06"
30-May-2021,RTGS,467.32,00.00,"1,345,635.38"
30-May-2021,ATM,00.00,"224,272.56","1,121,362.82"
30-May-2021,Interest,"400,067.50",00.00,"1,521,430.32"
30-May-2021,Purchase,00.00,"190,178.79","1,331,251.53"
30-May-2021,Purchase,"83,721.62",00.00,"1,414,973.15"
30-May-2021,ATM,"29,528.00",00.00,"1,444,501.15"
30-May-2021,RTGS,00.00,"206,357.31","1,238,143.84"
30-May-2021,NEFT,00.00,"1,238,143.84",00.00
30-May-2021,Purchase,"1,733.00",00.00,"1,733.00"
30-May-2021,Tax,00.00,247.57,"1,485.43"
30-May-2021,NEFT,395.46,00.00,"1,880.89"
30-May-2021,Tax,00.00,376.18,"1,504.71"
30-May-2021,Cash,00.00,"1,504.71",00.00
30-May-2021,IMPS,"7,050.90",00.00,"7,050.90"
30-May-2021,Commission,217.94,00.00,"7,268.84"
30-May-2021,Tax,00.00,807.65,"6,461.19"
30-May-2021,NEFT,04.30,00.00,"6,465.49"
30-May-2021,Interest,"4,712.20",00.00,"11,177.69"
30-May-2021,Transfer,00.00,"1,596.81","9,580.88"
30-May-2021,Transfer,"1,080.74",00.00,"10,661.62"
30-May-2021,Transfer,00.00,"10,661.62",00.00
30-May-2021,Debit Card,"30,727.95",00.00,"30,727.95"
30-May-2021,Transfer,00.00,"7,681.99","23,045.96"
30-May-2021,Commission,00.00,"4,609.19","18,436.77"
30-May-2021,RTGS,00.00,"3,687.35","14,749.42"
30-May-2021,Reversal,"829,071.75",00.00,"843,821.17"
30-May-2021,Miscellaneous,"117,120.70",00.00,"960,941.87"
30-May-2021,Miscellaneous,06.00,00.00,"960,947.87"
30-May-2021,Purchase,"6,581.70",00.00,"967,529.57"
30-May-2021,Commission,00.00,"483,764.79","483,764.78"
30-May-2021,Bill,00.00,"69,109.25","414,655.53"
30-May-2021,Bill,52.20,00.00,"414,707.73"
30-May-2021,Cheque,04.11,00.00,"414,711.84"
30-May-2021,Reversal,00.00,"207,355.92","207,355.92"
30-May-2021,RTGS,00.00,"25,919.49","181,436.43"
30-May-2021,Miscellaneous,"2,072,827.25",00.00,"2,254,263.68"
30-May-2021,Tax,03.00,00.00,"2,254,266.68"
30-May-2021,Tax,09.94,00.00,"2,254,276.62"
30-May-2021,Bill,31.00,00.00,"2,254,307.62"
30-May-2021,NEFT,00.00,"225,430.76","2,028,876.86"
30-May-2021,ATM,00.00,"405,775.37","1,623,101.49"
30-May-2021,Interest,03.00,00.00,"1,623,104.49"
30-May-2021,Transfer,"19,306.77",00.00,"1,642,411.26"
30-May-2021,Reversal,00.00,"234,630.18","1,407,781.08"
30-May-2021,NEFT,01.00,00.00,"1,407,782.08"
30-May-2021,IMPS,35.10,00.00,"1,407,817.18"
30-May-2021,Debit Card,37.90,00.00,"1,407,855.08"
30-May-2021,NEFT,23.90,00.00,"1,407,878.98"
30-May-2021,Purchase,00.00,"703,939.49","703,939.49"
30-May-2021,Interest,"33,636.20",00.00,"737,575.69"
30-May-2021,Cash,792.00,00.00,"738,367.69"
30-May-2021,Reversal,"1,416,647.20",00.00,"2,155,014.89"
30-May-2021,RTGS,"173,474.10",00.00,"2,328,488.99"
30-May-2021,Interest,01.18,00.00,"2,328,490.17"
30-May-2021,Tax,00.00,"258,721.13","2,069,769.04"
30-May-2021,NEFT,00.00,"295,681.29","1,774,087.75"
31-May-2021,Tax,00.00,"197,120.86","1,576,966.89"
31-May-2021,IMPS,120.83,00.00,"1,577,087.72"
31-May-2021,Interest,00.00,"1,577,087.72",00.00
31-May-2021,Debit Card,03.00,00.00,03.00
31-May-2021,Purchase,00.00,03.00,00.00
31-May-2021,Transfer,"54,234.75",00.00,"54,234.75"
31-May-2021,Reversal,02.00,00.00,"54,236.75"
31-May-2021,NEFT,38.93,00.00,"54,275.68"
31-May-2021,Bill,00.00,"6,030.63","48,245.05"
31-May-2021,Cash,00.00,"6,030.63","42,214.42"
31-May-2021,ATM,00.00,"4,690.49","37,523.93"
31-May-2021,Cash,12.00,00.00,"37,535.93"
31-May-2021,Debit Card,09.10,00.00,"37,545.03"
31-May-2021,Purchase,00.00,"6,257.51","31,287.52"
31-May-2021,Purchase,13.00,00.00,"31,300.52"
31-May-2021,RTGS,31.00,00.00,"31,331.52"
31-May-2021,Bill,00.00,"3,133.15","28,198.37"
31-May-2021,Commission,563.10,00.00,"28,761.47"
31-May-2021,RTGS,41.80,00.00,"28,803.27"
31-May-2021,IMPS,"246,263.16",00.00,"275,066.43"
01-Jun-2021,Debit Card,"1,483.60",00.00,"276,550.03"
01-Jun-2021,Transfer,00.00,"138,275.02","138,275.02"
01-Jun-2021,Transfer,00.00,"34,568.76","103,706.26"
01-Jun-2021,ATM,00.00,"14,815.18","88,891.08"
01-Jun-2021,Debit Card,61.01,00.00,"88,952.09"
01-Jun-2021,Miscellaneous,00.00,"17,790.42","71,161.67"
01-Jun-2021,NEFT,04.99,00.00,"71,166.66"
01-Jun-2021,Cheque,00.00,"10,166.67","60,999.99"
01-Jun-2021,Bill,00.00,"20,333.33","40,666.66"
01-Jun-2021,ATM,00.00,"4,518.52","36,148.14"
01-Jun-2021,Bill,"1,079,834.00",00.00,"1,115,982.14"
01-Jun-2021,NEFT,00.00,"159,426.02","956,556.12"
01-Jun-2021,Reversal,00.00,"956,556.12",00.00
01-Jun-2021,NEFT,"7,571.00",00.00,"7,571.00"
01-Jun-2021,Bill,17.00,00.00,"7,588.00"
01-Jun-2021,Transfer,"1,029,509.20",00.00,"1,037,097.20"
01-Jun-2021,Miscellaneous,00.00,"207,419.44","829,677.76"
01-Jun-2021,NEFT,00.00,"138,279.63","691,398.13"
01-Jun-2021,Cheque,413.68,00.00,"691,811.81"
01-Jun-2021,Tax,00.00,"138,362.36","553,449.45"
01-Jun-2021,Miscellaneous,"24,646.70",00.00,"578,096.15"
01-Jun-2021,Purchase,00.00,"578,096.15",00.00
01-Jun-2021,Commission,02.40,00.00,02.40
01-Jun-2021,Bill,04.10,00.00,06.50
01-Jun-2021,Interest,00.00,02.17,04.33
01-Jun-2021,Tax,00.00,00.54,03.79
01-Jun-2021,ATM,"1,223,238.00",00.00,"1,223,241.79"
01-Jun-2021,RTGS,15.00,00.00,"1,223,256.79"
01-Jun-2021,Cash,"163,444.00",00.00,"1,386,700.79"
01-Jun-2021,Interest,463.00,00.00,"1,387,163.79"
01-Jun-2021,Cash,00.00,"173,395.47","1,213,768.32"
01-Jun-2021,Interest,00.00,"606,884.16","606,884.16"
01-Jun-2021,Commission,"183,969.00",00.00,"790,853.16"
01-Jun-2021,Transfer,"1,728,254.80",00.00,"2,519,107.96"
01-Jun-2021,ATM,00.00,"503,821.59","2,015,286.37"
02-Jun-2021,ATM,"81,914.50",00.00,"2,097,200.87"
02-Jun-2021,Commission,316.00,00.00,"2,097,516.87"
02-Jun-2021,Debit Card,505.33,00.00,"2,098,022.20"
02-Jun-2021,NEFT,00.00,"262,252.78","1,835,769.43"
02-Jun-2021,RTGS,"161,438.91",00.00,"1,997,208.34"
02-Jun-2021,NEFT,00.00,"399,441.67","1,597,766.67"
02-Jun-2021,ATM,00.00,"199,720.83","1,398,045.84"
02-Jun-2021,Bill,00.00,"466,015.28","932,030.56"
02-Jun-2021,Purchase,21.00,00.00,"932,051.56"
02-Jun-2021,Miscellaneous,"29,484.00",00.00,"961,535.56"
02-Jun-2021,IMPS,"1,572,823.75",00.00,"2,534,359.31"
02-Jun-2021,IMPS,00.00,"281,595.48","2,252,763.83"
02-Jun-2021,ATM,00.00,"250,307.09","2,002,456.74"
02-Jun-2021,RTGS,"97,631.00",00.00,"2,100,087.74"
02-Jun-2021,IMPS,"1,100,811.00",00.00,"3,200,898.74"
02-Jun-2021,Miscellaneous,"28,137.06",00.00,"3,229,035.80"
02-Jun-2021,RTGS,"50,564.00",00.00,"3,279,599.80"
02-Jun-2021,Interest,00.00,"364,399.98","2,915,199.82"
03-Jun-2021,Transfer,"29,235.50",00.00,"2,944,435.32"
03-Jun-2021,Miscellaneous,403.00,00.00,"2,944,838.32"
03-Jun-2021,IMPS,"96,376.40",00.00,"3,041,214.72"
03-Jun-2021,Debit Card,"102,133.60",00.00,"3,143,348.32"
03-Jun-2021,Commission,00.00,"523,891.39","2,619,456.93"
03-Jun-2021,ATM,00.00,"654,864.23","1,964,592.70"
03-Jun-2021,Debit Card,13.10,00.00,"1,964,605.80"
03-Jun-2021,Cash,00.00,"654,868.60","1,309,737.20"
03-Jun-2021,Debit Card,00.00,"327,434.30","982,302.90"
03-Jun-2021,Bill,00.00,"163,717.15","818,585.75"
03-Jun-2021,Reversal,00.00,"90,953.97","727,631.78"
03-Jun-2021,Miscellaneous,"218,972.00",00.00,"946,603.78"
03-Jun-2021,ATM,"1,090.00",00.00,"947,693.78"
03-Jun-2021,Purchase,"166,414.56",00.00,"1,114,108.34"
03-Jun-2021,Transfer,00.00,"371,369.45","742,738.89"
03-Jun-2021,Cash,07.00,00.00,"742,745.89"
03-Jun-2021,Debit Card,184.90,00.00,"742,930.79"
03-Jun-2021,ATM,00.00,"247,643.60","495,287.19"
03-Jun-2021,Commission,"867,471.25",00.00,"1,362,758.44"
03-Jun-2021,Debit Card,"66,195.12",00.00,"1,428,953.56"
03-Jun-2021,Purchase,317.00,00.00,"1,429,270.56"
03-Jun-2021,IMPS,00.00,"178,658.82","1,250,611.74"
03-Jun-2021,Commission,"13,429.00",00.00,"1,264,040.74"
03-Jun-2021,Purchase,20.00,00.00,"1,264,060.74"
03-Jun-2021,IMPS,00.00,"316,015.19","948,045.56"
03-Jun-2021,Tax,00.00,"158,007.59","790,037.97"
03-Jun-2021,RTGS,02.00,00.00,"790,039.97"
03-Jun-2021,Transfer,222.30,00.00,"790,262.27"
03-Jun-2021,Reversal,00.00,"112,894.61","677,367.66"
03-Jun-2021,NEFT,00.00,"75,263.07","602,104.59"
03-Jun-2021,RTGS,"1,016,504.20",00.00,"1,618,608.79"
03-Jun-2021,Commission,00.00,"1,618,608.79",00.00
03-Jun-2021,Bill,"32,360.00",00.00,"32,360.00"
03-Jun-2021,IMPS,00.00,"32,360.00",00.00
03-Jun-2021,Cash,"3,472.00",00.00,"3,472.00"
03-Jun-2021,Debit Card,00.00,694.40,"2,777.60"
03-Jun-2021,Bill,337.03,00.00,"3,114.63"
03-Jun-2021,IMPS,"79,326.81",00.00,"82,441.44"
03-Jun-2021,ATM,37.10,00.00,"82,478.54"
03-Jun-2021,IMPS,00.00,"13,746.42","68,732.12"
03-Jun-2021,Miscellaneous,"553,851.80",00.00,"622,583.92"
03-Jun-2021,Commission,00.00,"69,175.99","553,407.93"
03-Jun-2021,RTGS,00.00,"553,407.93",00.00
03-Jun-2021,Cash,262.55,00.00,262.55
03-Jun-2021,IMPS,"511,790.75",00.00,"512,053.30"
03-Jun-2021,Bill,00.00,"73,150.47","438,902.83"
03-Jun-2021,Cash,01.00,00.00,"438,903.83"
03-Jun-2021,Bill,00.00,"62,700.55","376,203.28"
03-Jun-2021,Purchase,02.90,00.00,"376,206.18"
03-Jun-2021,Interest,00.00,"376,206.18",00.00
03-Jun-2021,Commission,391.00,00.00,391.00
03-Jun-2021,Miscellaneous,00.00,130.33,260.67
03-Jun-2021,Transfer,00.00,86.89,173.78
03-Jun-2021,Purchase,416.10,00.00,589.88
03-Jun-2021,Commission,00.00,84.27,505.61
04-Jun-2021,RTGS,00.00,168.54,337.07
04-Jun-2021,Transfer,00.00,42.13,294.94
04-Jun-2021,IMPS,00.00,147.47,147.47
04-Jun-2021,Bill,"707,149.00",00.00,"707,296.47"
04-Jun-2021,Cheque,00.00,"141,459.29","565,837.18"
05-Jun-2021,Tax,"21,904.90",00.00,"587,742.08"
05-Jun-2021,Reversal,00.00,"65,304.68","522,437.40"
05-Jun-2021,Cash,"3,589.00",00.00,"526,026.40"
05-Jun-2021,Commission,07.60,00.00,"526,034.00"
05-Jun-2021,Cheque,05.60,00.00,"526,039.60"
05-Jun-2021,Commission,00.00,"52,603.96","473,435.64"
05-Jun-2021,RTGS,00.00,"157,811.88","315,623.76"
05-Jun-2021,RTGS,"2,077.45",00.00,"317,701.21"
05-Jun-2021,Commission,00.00,"31,770.12","285,931.09"
05-Jun-2021,IMPS,00.00,"142,965.55","142,965.55"
05-Jun-2021,IMPS,00.00,"20,423.65","122,541.90"
05-Jun-2021,Miscellaneous,192.38,00.00,"122,734.28"
06-Jun-2021,Interest,00.00,"30,683.57","92,050.71"
06-Jun-2021,Tax,"795,497.50",00.00,"887,548.21"
07-Jun-2021,IMPS,00.00,"295,849.40","591,698.81"
07-Jun-2021,Reversal,03.87,00.00,"591,702.68"
07-Jun-2021,Cheque,00.00,"98,617.11","493,085.57"
07-Jun-2021,NEFT,00.00,"164,361.86","328,723.71"
07-Jun-2021,Cheque,"1,376,156.20",00.00,"1,704,879.91"
07-Jun-2021,ATM,"908,446.00",00.00,"2,613,325.91"
07-Jun-2021,ATM,383.54,00.00,"2,613,709.45"
07-Jun-2021,Commission,"1,448,575.50",00.00,"4,062,284.95"
07-Jun-2021,Debit Card,"1,697.87",00.00,"4,063,982.82"
07-Jun-2021,RTGS,"461,897.00",00.00,"4,525,879.82"
07-Jun-2021,ATM,00.00,"1,131,469.96","3,394,409.86"
07-Jun-2021,Cheque,"4,430.00",00.00,"3,398,839.86"
07-Jun-2021,IMPS,00.00,"424,854.98","2,973,984.88"
07-Jun-2021,RTGS,00.00,"991,328.29","1,982,656.59"
07-Jun-2021,Debit Card,"1,491,232.00",00.00,"3,473,888.59"
07-Jun-2021,Debit Card,"749,590.00",00.00,"4,223,478.59"
07-Jun-2021,IMPS,"30,511.60",00.00,"4,253,990.19"
07-Jun-2021,Bill,00.00,"4,253,990.19",00.00
07-Jun-2021,Purchase,182.77,00.00,182.77
07-Jun-2021,IMPS,00.00,20.31,162.46
08-Jun-2021,Cheque,"26,783.63",00.00,"26,946.09"
08-Jun-2021,Bill,00.00,"6,736.52","20,209.57"
08-Jun-2021,Debit Card,00.00,"2,020.96","18,188.61"
08-Jun-2021,Cheque,"28,805.44",00.00,"46,994.05"
08-Jun-2021,IMPS,00.00,"11,748.51","35,245.54"
08-Jun-2021,Reversal,"125,749.00",00.00,"160,994.54"
08-Jun-2021,NEFT,00.00,"160,994.54",00.00
08-Jun-2021,Transfer,"166,516.81",00.00,"166,516.81"
08-Jun-2021,Cash,00.00,"166,516.81",00.00
08-Jun-2021,Miscellaneous,02.90,00.00,02.90
08-Jun-2021,IMPS,"825,771.80",00.00,"825,774.70"
08-Jun-2021,Cheque,00.00,"82,577.47","743,197.23"
08-Jun-2021,Debit Card,25.00,00.00,"743,222.23"
08-Jun-2021,Debit Card,00.00,"148,644.45","594,577.78"
08-Jun-2021,ATM,00.00,"66,064.20","528,513.58"
08-Jun-2021,IMPS,00.00,"176,171.19","352,342.39"
08-Jun-2021,Reversal,05.50,00.00,"352,347.89"
08-Jun-2021,Miscellaneous,00.00,"176,173.95","176,173.94"
08-Jun-2021,Reversal,00.00,"58,724.65","117,449.29"
08-Jun-2021,Miscellaneous,03.00,00.00,"117,452.29"
08-Jun-2021,Interest,00.00,"58,726.15","58,726.14"
08-Jun-2021,RTGS,07.41,00.00,"58,733.55"
08-Jun-2021,Cheque,00.00,"8,390.51","50,343.04"
08-Jun-2021,Bill,00.00,"10,068.61","40,274.43"
08-Jun-2021,Debit Card,00.00,"6,712.41","33,562.02"
08-Jun-2021,NEFT,00.00,"3,356.20","30,205.82"
08-Jun-2021,Cash,00.00,"3,020.58","27,185.24"
08-Jun-2021,Commission,07.50,00.00,"27,192.74"
08-Jun-2021,Cash,"1,602,941.00",00.00,"1,630,133.74"
08-Jun-2021,NEFT,00.00,"815,066.87","815,066.87"
08-Jun-2021,Debit Card,29.20,00.00,"815,096.07"
08-Jun-2021,Purchase,00.00,"163,019.21","652,076.86"
09-Jun-2021,Debit Card,00.00,"163,019.22","489,057.64"
09-Jun-2021,Miscellaneous,00.00,"489,057.64",00.00
09-Jun-2021,Bill,155.10,00.00,155.10
09-Jun-2021,Reversal,00.00,38.78,116.32
09-Jun-2021,Commission,00.00,12.92,103.40
09-Jun-2021,Debit Card,"5,340.20",00.00,"5,443.60"
09-Jun-2021,Interest,00.00,777.66,"4,665.94"
09-Jun-2021,Cheque,"17,416.00",00.00,"22,081.94"
09-Jun-2021,Cheque,00.00,"5,520.49","16,561.45"
09-Jun-2021,ATM,00.00,"5,520.48","11,040.97"
09-Jun-2021,RTGS,"4,003.10",00.00,"15,044.07"
09-Jun-2021,Tax,"58,947.20",00.00,"73,991.27"
09-Jun-2021,Tax,"4,261.14",00.00,"78,252.41"
09-Jun-2021,Miscellaneous,158.10,00.00,"78,410.51"
09-Jun-2021,RTGS,"29,326.00",00.00,"107,736.51"
09-Jun-2021,Cash,00.00,"35,912.17","71,824.34"
09-Jun-2021,RTGS,00.00,"7,182.43","64,641.91"
09-Jun-2021,RTGS,"2,045.20",00.00,"66,687.11"
09-Jun-2021,IMPS,"21,515.15",00.00,"88,202.26"
09-Jun-2021,Cheque,00.00,"9,800.25","78,402.01"
09-Jun-2021,Debit Card,"163,165.90",00.00,"241,567.91"
09-Jun-2021,Interest,"3,727.89",00.00,"245,295.80"
09-Jun-2021,NEFT,56.00,00.00,"245,351.80"
09-Jun-2021,Reversal,"161,285.31",00.00,"406,637.11"
09-Jun-2021,Miscellaneous,43.00,00.00,"406,680.11"
09-Jun-2021,Bill,"27,949.00",00.00,"434,629.11"
09-Jun-2021,Bill,181.96,00.00,"434,811.07"
09-Jun-2021,Cheque,"1,337,030.00",00.00,"1,771,841.07"
09-Jun-2021,Bill,00.00,"295,306.85","1,476,534.22"
09-Jun-2021,Reversal,"12,144.70",00.00,"1,488,678.92"
09-Jun-2021,NEFT,00.00,"186,084.87","1,302,594.06"
09-Jun-2021,ATM,04.73,00.00,"1,302,598.79"
09-Jun-2021,Cash,00.00,"260,519.76","1,042,079.03"
09-Jun-2021,RTGS,00.00,"130,259.88","911,819.15"
09-Jun-2021,Debit Card,00.00,"91,181.92","820,637.24"
09-Jun-2021,Miscellaneous,00.00,"205,159.31","615,477.93"
09-Jun-2021,RTGS,"2,191.00",00.00,"617,668.93"
09-Jun-2021,Transfer,00.00,"308,834.47","308,834.47"
09-Jun-2021,Reversal,00.00,"38,604.31","270,230.16"
09-Jun-2021,NEFT,00.00,"45,038.36","225,191.80"
09-Jun-2021,Debit Card,00.00,"37,531.97","187,659.83"
09-Jun-2021,IMPS,476.04,00.00,"188,135.87"
09-Jun-2021,Miscellaneous,00.00,"62,711.96","125,423.91"
10-Jun-2021,NEFT,00.00,"125,423.91",00.00
10-Jun-2021,Tax,116.90,00.00,116.90
10-Jun-2021,Transfer,00.00,16.70,100.20
10-Jun-2021,Bill,"135,665.80",00.00,"135,766.00"
10-Jun-2021,NEFT,12.14,00.00,"135,778.14"
10-Jun-2021,Bill,00.00,"67,889.07","67,889.07"
10-Jun-2021,Tax,"7,828.59",00.00,"75,717.66"
10-Jun-2021,ATM,00.00,"10,816.81","64,900.85"
10-Jun-2021,Commission,"1,686,151.50",00.00,"1,751,052.35"
10-Jun-2021,NEFT,00.00,"250,150.34","1,500,902.01"
10-Jun-2021,Miscellaneous,00.00,"250,150.34","1,250,751.68"
10-Jun-2021,Purchase,"28,707.00",00.00,"1,279,458.68"
10-Jun-2021,Tax,140.00,00.00,"1,279,598.68"
10-Jun-2021,RTGS,497.30,00.00,"1,280,095.98"
10-Jun-2021,NEFT,00.00,"142,232.89","1,137,863.09"
10-Jun-2021,Purchase,"138,573.00",00.00,"1,276,436.09"
10-Jun-2021,Tax,02.00,00.00,"1,276,438.09"
10-Jun-2021,Bill,00.00,"638,219.05","638,219.05"
10-Jun-2021,Debit Card,00.00,"106,369.84","531,849.21"
10-Jun-2021,Tax,"3,642.00",00.00,"535,491.21"
10-Jun-2021,Cheque,"245,291.00",00.00,"780,782.21"
10-Jun-2021,Bill,00.00,"78,078.22","702,703.99"
10-Jun-2021,Transfer,976.80,00.00,"703,680.79"
10-Jun-2021,Bill,04.30,00.00,"703,685.09"
10-Jun-2021,Cheque,00.00,"70,368.51","633,316.58"
10-Jun-2021,ATM,"311,635.25",00.00,"944,951.83"
10-Jun-2021,ATM,00.00,"134,993.12","809,958.71"
10-Jun-2021,Cash,"231,004.10",00.00,"1,040,962.81"
10-Jun-2021,IMPS,04.30,00.00,"1,040,967.11"
10-Jun-2021,IMPS,"5,302.35",00.00,"1,046,269.46"
10-Jun-2021,ATM,00.00,"1,046,269.46",00.00
10-Jun-2021,RTGS,"2,687.50",00.00,"2,687.50"
10-Jun-2021,Bill,"1,923.10",00.00,"4,610.60"
10-Jun-2021,Miscellaneous,00.00,922.12,"3,688.48"
10-Jun-2021,Cheque,"1,267.00",00.00,"4,955.48"
10-Jun-2021,RTGS,"1,745.83",00.00,"6,701.31"
10-Jun-2021,Commission,00.00,957.33,"5,743.98"
10-Jun-2021,Cheque,00.00,"5,743.98",00.00
10-Jun-2021,NEFT,"243,710.00",00.00,"243,710.00"
10-Jun-2021,IMPS,00.00,"243,710.00",00.00
10-Jun-2021,Transfer,"1,490,911.50",00.00,"1,490,911.50"
10-Jun-2021,Commission,153.06,00.00,"1,491,064.56"
10-Jun-2021,Commission,07.46,00.00,"1,491,072.02"
10-Jun-2021,Bill,00.00,"372,768.01","1,118,304.02"
10-Jun-2021,Interest,"6,835.00",00.00,"1,125,139.02"
11-Jun-2021,RTGS,00.00,"562,569.51","562,569.51"
11-Jun-2021,Transfer,45.00,00.00,"562,614.51"
11-Jun-2021,Commission,"70,576.00",00.00,"633,190.51"
11-Jun-2021,Cash,"1,663.00",00.00,"634,853.51"
11-Jun-2021,ATM,"52,296.66",00.00,"687,150.17"
11-Jun-2021,Interest,"1,443.94",00.00,"688,594.11"
11-Jun-2021,Cheque,369.79,00.00,"688,963.90"
11-Jun-2021,Reversal,"64,438.00",00.00,"753,401.90"
11-Jun-2021,Purchase,00.00,"150,680.38","602,721.52"
11-Jun-2021,IMPS,"56,589.00",00.00,"659,310.52"
11-Jun-2021,Bill,00.00,"65,931.05","593,379.47"
11-Jun-2021,Transfer,"3,581.00",00.00,"596,960.47"
11-Jun-2021,Interest,03.51,00.00,"596,963.98"
11-Jun-2021,Purchase,"160,083.00",00.00,"757,046.98"
11-Jun-2021,ATM,"3,570.00",00.00,"760,616.98"
11-Jun-2021,Cheque,00.00,"380,308.49","380,308.49"
11-Jun-2021,Cash,00.00,"380,308.49",00.00
11-Jun-2021,RTGS,"9,833.50",00.00,"9,833.50"
11-Jun-2021,Interest,07.69,00.00,"9,841.19"
11-Jun-2021,Cash,06.00,00.00,"9,847.19"
11-Jun-2021,Debit Card,00.00,"1,641.20","8,205.99"
12-Jun-2021,Miscellaneous,121.40,00.00,"8,327.39"
12-Jun-2021,Tax,"12,159.00",00.00,"20,486.39"
12-Jun-2021,Bill,"130,395.56",00.00,"150,881.95"
12-Jun-2021,Bill,03.10,00.00,"150,885.05"
12-Jun-2021,Miscellaneous,00.00,"16,765.01","134,120.04"
12-Jun-2021,RTGS,39.48,00.00,"134,159.52"
12-Jun-2021,IMPS,00.00,"33,539.88","100,619.64"
12-Jun-2021,Purchase,"1,832.90",00.00,"102,452.54"
12-Jun-2021,ATM,00.00,"102,452.54",00.00
12-Jun-2021,NEFT,"93,444.75",00.00,"93,444.75"
12-Jun-2021,Commission,"5,660.79",00.00,"99,105.54"
12-Jun-2021,Commission,07.34,00.00,"99,112.88"
12-Jun-2021,Purchase,08.00,00.00,"99,120.88"
12-Jun-2021,IMPS,"686,232.00",00.00,"785,352.88"
12-Jun-2021,Miscellaneous,"31,891.21",00.00,"817,244.09"
12-Jun-2021,ATM,"128,379.70",00.00,"945,623.79"
12-Jun-2021,Purchase,00.00,"157,603.97","788,019.82"
12-Jun-2021,NEFT,00.00,"78,801.98","709,217.84"
12-Jun-2021,IMPS,"569,864.00",00.00,"1,279,081.84"
12-Jun-2021,Reversal,00.00,"142,120.20","1,136,961.64"
12-Jun-2021,Cheque,00.00,"227,392.33","909,569.31"
12-Jun-2021,Transfer,"3,243.00",00.00,"912,812.31"
12-Jun-2021,RTGS,00.00,"101,423.59","811,388.72"
12-Jun-2021,Interest,00.00,"405,694.36","405,694.36"
12-Jun-2021,Tax,40.90,00.00,"405,735.26"
12-Jun-2021,Miscellaneous,29.50,00.00,"405,764.76"
12-Jun-2021,ATM,613.70,00.00,"406,378.46"
12-Jun-2021,Debit Card,00.00,"406,378.46",00.00
12-Jun-2021,Miscellaneous,04.00,00.00,04.00
12-Jun-2021,Bill,00.00,00.40,03.60
12-Jun-2021,Cash,00.00,00.40,03.20
12-Jun-2021,Cheque,00.00,01.07,02.13
12-Jun-2021,IMPS,00.00,00.43,01.70
12-Jun-2021,Transfer,00.00,00.85,00.85
12-Jun-2021,RTGS,00.00,00.17,00.68
12-Jun-2021,Miscellaneous,00.00,00.07,00.61
13-Jun-2021,Purchase,00.00,00.20,00.41
13-Jun-2021,IMPS,00.00,00.41,00.00
14-Jun-2021,Bill,03.00,00.00,03.00
14-Jun-2021,Debit Card,"1,382,735.00",00.00,"1,382,738.00"
14-Jun-2021,Interest,05.43,00.00,"1,382,743.43"
14-Jun-2021,IMPS,05.70,00.00,"1,382,749.13"
14-Jun-2021,Bill,58.60,00.00,"1,382,807.73"
14-Jun-2021,Cheque,00.00,"460,935.91","921,871.82"
14-Jun-2021,Bill,00.00,"102,430.20","819,441.62"
14-Jun-2021,Interest,00.00,"163,888.32","655,553.30"
14-Jun-2021,Debit Card,00.00,"93,650.47","561,902.83"
14-Jun-2021,NEFT,49.23,00.00,"561,952.06"
14-Jun-2021,NEFT,"2,674.00",00.00,"564,626.06"
14-Jun-2021,Transfer,00.00,"141,156.52","423,469.55"
14-Jun-2021,NEFT,"200,140.10",00.00,"623,609.65"
15-Jun-2021,Cash,00.00,"69,289.96","554,319.69"
15-Jun-2021,Debit Card,"1,486,362.00",00.00,"2,040,681.69"
15-Jun-2021,Purchase,"242,775.00",00.00,"2,283,456.69"
15-Jun-2021,ATM,00.00,"326,208.10","1,957,248.59"
15-Jun-2021,Debit Card,"13,187.00",00.00,"1,970,435.59"
15-Jun-2021,Cash,00.00,"328,405.93","1,642,029.66"
15-Jun-2021,Cash,00.00,"410,507.42","1,231,522.24"
15-Jun-2021,Cash,160.11,00.00,"1,231,682.35"
15-Jun-2021,ATM,00.00,"153,960.29","1,077,722.06"
15-Jun-2021,IMPS,00.00,"215,544.41","862,177.65"
15-Jun-2021,Commission,00.00,"215,544.41","646,633.24"
15-Jun-2021,Cash,83.18,00.00,"646,716.42"
15-Jun-2021,RTGS,16.92,00.00,"646,733.34"
15-Jun-2021,Transfer,00.00,"107,788.89","538,944.45"
15-Jun-2021,NEFT,00.00,"134,736.11","404,208.34"
15-Jun-2021,ATM,00.00,"202,104.17","202,104.17"
15-Jun-2021,Reversal,31.26,00.00,"202,135.43"
15-Jun-2021,Interest,"2,434.10",00.00,"204,569.53"
15-Jun-2021,Tax,00.00,"204,569.53",00.00
15-Jun-2021,Bill,"17,663.62",00.00,"17,663.62"
15-Jun-2021,IMPS,216.56,00.00,"17,880.18"
15-Jun-2021,IMPS,00.00,"2,980.03","14,900.15"
15-Jun-2021,Cash,00.00,"7,450.08","7,450.08"
15-Jun-2021,Miscellaneous,00.00,"3,725.04","3,725.04"
15-Jun-2021,Debit Card,"167,637.00",00.00,"171,362.04"
15-Jun-2021,Transfer,"179,823.50",00.00,"351,185.54"
15-Jun-2021,Commission,00.00,"87,796.39","263,389.15"
15-Jun-2021,Tax,00.00,"87,796.38","175,592.77"
15-Jun-2021,ATM,00.00,"21,949.10","153,643.67"
15-Jun-2021,Bill,"11,222.00",00.00,"164,865.67"
15-Jun-2021,Miscellaneous,00.00,"23,552.24","141,313.43"
15-Jun-2021,RTGS,241.17,00.00,"141,554.60"
15-Jun-2021,Miscellaneous,49.00,00.00,"141,603.60"
15-Jun-2021,Debit Card,46.00,00.00,"141,649.60"
15-Jun-2021,Miscellaneous,00.00,"141,649.60",00.00
15-Jun-2021,Transfer,"1,987,987.50",00.00,"1,987,987.50"
15-Jun-2021,RTGS,"228,342.41",00.00,"2,216,329.91"
15-Jun-2021,RTGS,536.45,00.00,"2,216,866.36"
16-Jun-2021,IMPS,00.00,"443,373.27","1,773,493.09"
16-Jun-2021,Purchase,00.00,"443,373.27","1,330,119.82"
16-Jun-2021,Cash,"32,639.85",00.00,"1,362,759.67"
16-Jun-2021,Cash,00.00,"151,417.74","1,211,341.93"
16-Jun-2021,Transfer,134.00,00.00,"1,211,475.93"
16-Jun-2021,ATM,353.89,00.00,"1,211,829.82"
16-Jun-2021,Cheque,28.00,00.00,"1,211,857.82"
16-Jun-2021,Interest,"219,562.40",00.00,"1,431,420.22"
16-Jun-2021,Debit Card,59.00,00.00,"1,431,479.22"
16-Jun-2021,RTGS,00.00,"238,579.87","1,192,899.35"
16-Jun-2021,Debit Card,00.00,"149,112.42","1,043,786.93"
16-Jun-2021,NEFT,00.00,00.00,"1,043,786.93"
16-Jun-2021,NEFT,254.08,00.00,"1,044,041.01"
16-Jun-2021,Miscellaneous,"1,434,943.50",00.00,"2,478,984.51"
16-Jun-2021,Cheque,"1,024,127.00",00.00,"3,503,111.51"
16-Jun-2021,Bill,00.00,"875,777.88","2,627,333.63"
16-Jun-2021,IMPS,00.00,"262,733.36","2,364,600.27"
16-Jun-2021,Bill,00.00,"295,575.03","2,069,025.24"
16-Jun-2021,Tax,58.90,00.00,"2,069,084.14"
16-Jun-2021,RTGS,"86,026.50",00.00,"2,155,110.64"
16-Jun-2021,IMPS,463.60,00.00,"2,155,574.24"
16-Jun-2021,IMPS,00.00,"431,114.85","1,724,459.39"
16-Jun-2021,Interest,00.00,"574,819.80","1,149,639.59"
16-Jun-2021,IMPS,"11,261.00",00.00,"1,160,900.59"
16-Jun-2021,Transfer,00.00,"165,842.94","995,057.65"
16-Jun-2021,Purchase,73.90,00.00,"995,131.55"
16-Jun-2021,Cheque,00.00,"199,026.31","796,105.24"
16-Jun-2021,Miscellaneous,00.00,"265,368.41","530,736.83"
16-Jun-2021,Miscellaneous,"2,012,389.75",00.00,"2,543,126.58"
16-Jun-2021,Bill,00.00,"423,854.43","2,119,272.15"
16-Jun-2021,Tax,"12,077.20",00.00,"2,131,349.35"
16-Jun-2021,Bill,"3,541.00",00.00,"2,134,890.35"
16-Jun-2021,RTGS,"671,065.00",00.00,"2,805,955.35"
16-Jun-2021,IMPS,"25,804.80",00.00,"2,831,760.15"
16-Jun-2021,Purchase,00.00,"471,960.03","2,359,800.12"
16-Jun-2021,Miscellaneous,"1,815.00",00.00,"2,361,615.12"
16-Jun-2021,Transfer,"1,274,475.75",00.00,"3,636,090.87"
17-Jun-2021,Cash,00.00,"1,212,030.29","2,424,060.58"
17-Jun-2021,Tax,"122,638.20",00.00,"2,546,698.78"
17-Jun-2021,ATM,00.00,"848,899.59","1,697,799.19"
17-Jun-2021,RTGS,04.10,00.00,"1,697,803.29"
17-Jun-2021,Cheque,00.00,"565,934.43","1,131,868.86"
17-Jun-2021,Cash,03.36,00.00,"1,131,872.22"
17-Jun-2021,Miscellaneous,418.90,00.00,"1,132,291.12"
17-Jun-2021,Reversal,00.00,"1,132,291.12",00.00
17-Jun-2021,RTGS,"16,842.37",00.00,"16,842.37"
17-Jun-2021,Reversal,00.00,"2,406.05","14,436.32"
18-Jun-2021,IMPS,"3,713.00",00.00,"18,149.32"
18-Jun-2021,Reversal,00.00,"18,149.32",00.00
18-Jun-2021,ATM,"1,280.30",00.00,"1,280.30"
18-Jun-2021,RTGS,"27,743.40",00.00,"29,023.70"
18-Jun-2021,Interest,"1,144,108.00",00.00,"1,173,131.70"
19-Jun-2021,Cheque,00.00,"146,641.46","1,026,490.24"
19-Jun-2021,Commission,493.14,00.00,"1,026,983.38"
19-Jun-2021,Bill,00.00,00.00,"1,026,983.38"
19-Jun-2021,NEFT,00.00,"128,372.92","898,610.46"
19-Jun-2021,Interest,00.00,00.00,"898,610.46"
19-Jun-2021,IMPS,00.00,"149,768.41","748,842.05"
19-Jun-2021,Interest,345.00,00.00,"749,187.05"
19-Jun-2021,ATM,00.00,"749,187.05",00.00
19-Jun-2021,NEFT,"1,469.00",00.00,"1,469.00"
19-Jun-2021,Commission,"77,320.00",00.00,"78,789.00"
19-Jun-2021,IMPS,00.00,"26,263.00","52,526.00"
19-Jun-2021,Bill,00.00,"5,836.22","46,689.78"
19-Jun-2021,Purchase,"210,670.10",00.00,"257,359.88"
19-Jun-2021,RTGS,00.00,"85,786.63","171,573.25"
19-Jun-2021,NEFT,00.00,"171,573.25",00.00
19-Jun-2021,Tax,501.41,00.00,501.41
19-Jun-2021,Bill,"3,584.76",00.00,"4,086.17"
19-Jun-2021,Reversal,251.00,00.00,"4,337.17"
19-Jun-2021,Transfer,00.00,"2,168.59","2,168.58"
19-Jun-2021,NEFT,"95,776.00",00.00,"97,944.58"
19-Jun-2021,Miscellaneous,07.10,00.00,"97,951.68"
19-Jun-2021,Interest,00.00,"9,795.17","88,156.51"
19-Jun-2021,Purchase,"1,321.00",00.00,"89,477.51"
19-Jun-2021,Purchase,"569,614.00",00.00,"659,091.51"
19-Jun-2021,ATM,00.00,"131,818.30","527,273.21"
19-Jun-2021,Miscellaneous,00.00,"65,909.15","461,364.06"
19-Jun-2021,Bill,"2,147.84",00.00,"463,511.90"
19-Jun-2021,NEFT,00.00,"46,351.19","417,160.71"
19-Jun-2021,Tax,08.30,00.00,"417,169.01"
19-Jun-2021,Bill,00.00,"59,595.57","357,573.44"
20-Jun-2021,IMPS,00.00,"178,786.72","178,786.72"
21-Jun-2021,Purchase,00.70,00.00,"178,787.42"
21-Jun-2021,Tax,"2,572.03",00.00,"181,359.45"
21-Jun-2021,Miscellaneous,00.00,"25,908.49","155,450.96"
21-Jun-2021,Purchase,"3,193.90",00.00,"158,644.86"
21-Jun-2021,Cheque,00.00,"39,661.22","118,983.64"
21-Jun-2021,Cheque,"2,474.63",00.00,"121,458.27"
21-Jun-2021,Bill,03.10,00.00,"121,461.37"
21-Jun-2021,Purchase,00.00,"24,292.27","97,169.10"
21-Jun-2021,Interest,00.00,"10,796.57","86,372.53"
21-Jun-2021,Interest,"3,298.72",00.00,"89,671.25"
21-Jun-2021,ATM,414.00,00.00,"90,085.25"
21-Jun-2021,IMPS,"1,613.00",00.00,"91,698.25"
21-Jun-2021,ATM,"2,580.82",00.00,"94,279.07"
21-Jun-2021,IMPS,325.60,00.00,"94,604.67"
21-Jun-2021,Commission,254.69,00.00,"94,859.36"
21-Jun-2021,IMPS,00.00,"23,714.84","71,144.52"
21-Jun-2021,NEFT,01.73,00.00,"71,146.25"
21-Jun-2021,RTGS,00.00,"11,857.71","59,288.54"
21-Jun-2021,IMPS,"8,512.77",00.00,"67,801.31"
21-Jun-2021,Commission,66.00,00.00,"67,867.31"
22-Jun-2021,Purchase,"2,299.40",00.00,"70,166.71"
22-Jun-2021,NEFT,00.00,"8,770.84","61,395.87"
22-Jun-2021,NEFT,307.30,00.00,"61,703.17"
22-Jun-2021,ATM,00.00,"30,851.59","30,851.58"
22-Jun-2021,Tax,00.00,"15,425.79","15,425.79"
22-Jun-2021,Transfer,00.00,"2,570.97","12,854.82"
22-Jun-2021,Transfer,00.00,"4,284.94","8,569.88"
22-Jun-2021,Transfer,07.96,00.00,"8,577.84"
22-Jun-2021,ATM,00.00,"2,859.28","5,718.56"
23-Jun-2021,Bill,00.00,571.86,"5,146.70"
23-Jun-2021,RTGS,"144,808.30",00.00,"149,955.00"
23-Jun-2021,Reversal,05.00,00.00,"149,960.00"
23-Jun-2021,Tax,00.00,"18,745.00","131,215.00"
23-Jun-2021,Transfer,00.00,"32,803.75","98,411.25"
23-Jun-2021,Cash,97.55,00.00,"98,508.80"
23-Jun-2021,IMPS,"66,989.66",00.00,"165,498.46"
23-Jun-2021,Purchase,"3,526.39",00.00,"169,024.85"
23-Jun-2021,Bill,00.00,"169,024.85",00.00
23-Jun-2021,Cheque,"1,882.00",00.00,"1,882.00"
23-Jun-2021,NEFT,"2,384.20",00.00,"4,266.20"
23-Jun-2021,NEFT,26.40,00.00,"4,292.60"
23-Jun-2021,Cheque,00.00,613.23,"3,679.37"
23-Jun-2021,Tax,"1,846,003.50",00.00,"1,849,682.87"
23-Jun-2021,IMPS,00.00,"369,936.57","1,479,746.30"
23-Jun-2021,Debit Card,00.00,"1,479,746.30",00.00
23-Jun-2021,Bill,"148,596.10",00.00,"148,596.10"
23-Jun-2021,Transfer,00.00,"21,228.01","127,368.09"
23-Jun-2021,Bill,"5,193.00",00.00,"132,561.09"
23-Jun-2021,Bill,58.00,00.00,"132,619.09"
23-Jun-2021,IMPS,00.00,"26,523.82","106,095.27"
23-Jun-2021,RTGS,00.00,"35,365.09","70,730.18"
23-Jun-2021,Commission,00.00,"23,576.73","47,153.45"
23-Jun-2021,Reversal,00.00,"47,153.45",00.00
23-Jun-2021,ATM,64.00,00.00,64.00
23-Jun-2021,IMPS,51.85,00.00,115.85
23-Jun-2021,NEFT,00.00,14.48,101.37
23-Jun-2021,ATM,00.00,101.37,00.00
23-Jun-2021,Cheque,63.20,00.00,63.20
23-Jun-2021,Purchase,00.00,09.03,54.17
23-Jun-2021,Reversal,00.00,06.77,47.40
23-Jun-2021,Commission,00.00,09.48,37.92
23-Jun-2021,Cash,"46,837.60",00.00,"46,875.52"
23-Jun-2021,Bill,00.00,"5,859.44","41,016.08"
23-Jun-2021,Transfer,00.00,"4,101.61","36,914.47"
23-Jun-2021,Reversal,00.00,"18,457.24","18,457.24"
23-Jun-2021,Tax,00.00,"2,636.75","15,820.49"
23-Jun-2021,Miscellaneous,00.00,"3,955.12","11,865.37"
23-Jun-2021,Interest,02.00,00.00,"11,867.37"
23-Jun-2021,Cash,19.00,00.00,"11,886.37"
23-Jun-2021,ATM,00.00,"5,943.19","5,943.18"
23-Jun-2021,RTGS,00.00,"1,188.64","4,754.54"
23-Jun-2021,Interest,00.00,594.32,"4,160.22"
23-Jun-2021,Purchase,31.49,00.00,"4,191.71"
23-Jun-2021,Cheque,00.00,"4,191.71",00.00
23-Jun-2021,Transfer,"549,964.00",00.00,"549,964.00"
23-Jun-2021,Debit Card,00.00,"274,982.00","274,982.00"
23-Jun-2021,Debit Card,"215,338.60",00.00,"490,320.60"
23-Jun-2021,Cheque,00.00,"122,580.15","367,740.45"
23-Jun-2021,Commission,04.10,00.00,"367,744.55"
23-Jun-2021,Tax,00.00,"122,581.52","245,163.03"
23-Jun-2021,IMPS,"25,860.50",00.00,"271,023.53"
23-Jun-2021,Cheque,"1,359.40",00.00,"272,382.93"
23-Jun-2021,Debit Card,"76,252.00",00.00,"348,634.93"
23-Jun-2021,Commission,"64,474.16",00.00,"413,109.09"
23-Jun-2021,Miscellaneous,"29,265.40",00.00,"442,374.49"
23-Jun-2021,Bill,00.00,"147,458.16","294,916.33"
23-Jun-2021,Interest,184.90,00.00,"295,101.23"
23-Jun-2021,IMPS,00.00,"36,887.65","258,213.58"
23-Jun-2021,Miscellaneous,00.00,"25,821.36","232,392.22"
23-Jun-2021,Debit Card,00.00,"38,732.04","193,660.18"
23-Jun-2021,NEFT,"177,918.94",00.00,"371,579.12"
23-Jun-2021,Commission,00.00,"61,929.85","309,649.27"
23-Jun-2021,Miscellaneous,00.00,"61,929.85","247,719.42"
23-Jun-2021,Interest,42.00,00.00,"247,761.42"
23-Jun-2021,Commission,00.00,"24,776.14","222,985.28"
23-Jun-2021,IMPS,"14,906.25",00.00,"237,891.53"
23-Jun-2021,Reversal,"350,348.00",00.00,"588,239.53"
23-Jun-2021,Bill,00.00,"196,079.84","392,159.69"
23-Jun-2021,Cash,"1,900,429.50",00.00,"2,292,589.19"
23-Jun-2021,Purchase,"111,379.66",00.00,"2,403,968.85"
23-Jun-2021,Cash,05.00,00.00,"2,403,973.85"
23-Jun-2021,Purchase,00.00,"300,496.73","2,103,477.12"
23-Jun-2021,Bill,16.00,00.00,"2,103,493.12"
23-Jun-2021,Bill,"1,725,856.20",00.00,"3,829,349.32"
23-Jun-2021,NEFT,00.00,"425,483.26","3,403,866.06"
23-Jun-2021,IMPS,"7,773.75",00.00,"3,411,639.81"
23-Jun-2021,Commission,45.00,00.00,"3,411,684.81"
23-Jun-2021,RTGS,131.80,00.00,"3,411,816.61"
23-Jun-2021,Transfer,"2,874.60",00.00,"3,414,691.21"
23-Jun-2021,RTGS,00.00,"426,836.40","2,987,854.81"
23-Jun-2021,Transfer,"1,564,190.50",00.00,"4,552,045.31"
23-Jun-2021,Cash,00.00,"1,138,011.33","3,414,033.98"
23-Jun-2021,NEFT,00.00,"487,719.14","2,926,314.84"
23-Jun-2021,IMPS,"1,822,179.80",00.00,"4,748,494.64"
23-Jun-2021,Cheque,00.40,00.00,"4,748,495.04"
23-Jun-2021,Purchase,54.00,00.00,"4,748,549.04"
23-Jun-2021,Bill,"31,073.55",00.00,"4,779,622.59"
23-Jun-2021,Debit Card,00.00,"1,593,207.53","3,186,415.06"
23-Jun-2021,NEFT,00.00,"3,186,415.06",00.00
23-Jun-2021,ATM,432.00,00.00,432.00
23-Jun-2021,RTGS,00.00,86.40,345.60
23-Jun-2021,Reversal,06.00,00.00,351.60
23-Jun-2021,Reversal,"380,239.50",00.00,"380,591.10"
23-Jun-2021,Interest,00.00,"126,863.70","253,727.40"
23-Jun-2021,ATM,00.00,"25,372.74","228,354.66"
23-Jun-2021,Cash,00.00,"114,177.33","114,177.33"
23-Jun-2021,Interest,447.80,00.00,"114,625.13"
23-Jun-2021,Tax,00.00,"22,925.03","91,700.10"
23-Jun-2021,RTGS,04.00,00.00,"91,704.10"
23-Jun-2021,RTGS,"3,610.20",00.00,"95,314.30"
23-Jun-2021,Cash,"149,980.70",00.00,"245,295.00"
23-Jun-2021,Cash,00.00,"35,042.14","210,252.86"
23-Jun-2021,IMPS,00.00,"52,563.22","157,689.64"
23-Jun-2021,Cash,"1,699.00",00.00,"159,388.64"
23-Jun-2021,Debit Card,00.00,"31,877.73","127,510.91"
23-Jun-2021,Tax,00.00,"25,502.18","102,008.73"
23-Jun-2021,NEFT,00.00,"51,004.37","51,004.36"
23-Jun-2021,Commission,00.00,"25,502.18","25,502.18"
23-Jun-2021,Miscellaneous,00.00,"2,550.22","22,951.96"
23-Jun-2021,Debit Card,00.00,"3,825.33","19,126.63"
23-Jun-2021,RTGS,224.60,00.00,"19,351.23"
23-Jun-2021,Bill,00.00,"3,870.25","15,480.98"
23-Jun-2021,IMPS,00.00,"7,740.49","7,740.49"
23-Jun-2021,Purchase,15.72,00.00,"7,756.21"
23-Jun-2021,ATM,10.50,00.00,"7,766.71"
23-Jun-2021,Miscellaneous,00.00,862.97,"6,903.74"
23-Jun-2021,Miscellaneous,"650,641.50",00.00,"657,545.24"
23-Jun-2021,Interest,"1,720,833.20",00.00,"2,378,378.44"
23-Jun-2021,RTGS,"689,723.00",00.00,"3,068,101.44"
23-Jun-2021,Purchase,00.00,"340,900.16","2,727,201.28"
23-Jun-2021,Purchase,00.00,"545,440.26","2,181,761.02"
23-Jun-2021,Tax,00.00,"727,253.67","1,454,507.35"
23-Jun-2021,Bill,00.00,"363,626.84","1,090,880.51"
23-Jun-2021,Debit Card,00.00,"1,090,880.51",00.00
23-Jun-2021,ATM,07.00,00.00,07.00
23-Jun-2021,NEFT,03.00,00.00,10.00
23-Jun-2021,Purchase,00.00,01.43,08.57
23-Jun-2021,Debit Card,"1,248.98",00.00,"1,257.55"
23-Jun-2021,ATM,23.80,00.00,"1,281.35"
23-Jun-2021,Interest,491.71,00.00,"1,773.06"
23-Jun-2021,IMPS,"243,528.00",00.00,"245,301.06"
23-Jun-2021,Miscellaneous,02.90,00.00,"245,303.96"
23-Jun-2021,Commission,00.00,"122,651.98","122,651.98"
23-Jun-2021,Cheque,00.00,"20,442.00","102,209.98"
23-Jun-2021,Reversal,05.28,00.00,"102,215.26"
23-Jun-2021,Purchase,00.00,"102,215.26",00.00
23-Jun-2021,Reversal,57.70,00.00,57.70
23-Jun-2021,Interest,"12,971.25",00.00,"13,028.95"
23-Jun-2021,NEFT,00.00,"3,257.24","9,771.71"
23-Jun-2021,Cheque,"93,201.70",00.00,"102,973.41"
23-Jun-2021,Cheque,00.00,"12,871.68","90,101.73"
23-Jun-2021,Commission,"209,806.41",00.00,"299,908.14"
23-Jun-2021,NEFT,"1,639,645.00",00.00,"1,939,553.14"
23-Jun-2021,Debit Card,141.80,00.00,"1,939,694.94"
23-Jun-2021,Bill,03.00,00.00,"1,939,697.94"
23-Jun-2021,Commission,00.00,"277,099.71","1,662,598.23"
23-Jun-2021,Interest,"316,328.00",00.00,"1,978,926.23"
23-Jun-2021,Purchase,00.00,"1,978,926.23",00.00
23-Jun-2021,Purchase,"1,710,313.50",00.00,"1,710,313.50"
23-Jun-2021,Debit Card,00.00,"171,031.35","1,539,282.15"
23-Jun-2021,Cash,01.80,00.00,"1,539,283.95"
23-Jun-2021,Bill,42.00,00.00,"1,539,325.95"
23-Jun-2021,RTGS,"2,287.32",00.00,"1,541,613.27"
23-Jun-2021,RTGS,00.00,"770,806.64","770,806.64"
23-Jun-2021,Debit Card,197.00,00.00,"771,003.64"
23-Jun-2021,Tax,"145,731.22",00.00,"916,734.86"
23-Jun-2021,Miscellaneous,00.00,"183,346.97","733,387.89"
23-Jun-2021,ATM,"229,288.00",00.00,"962,675.89"
23-Jun-2021,RTGS,00.00,"320,891.96","641,783.93"
23-Jun-2021,Interest,61.50,00.00,"641,845.43"
23-Jun-2021,Reversal,01.20,00.00,"641,846.63"
23-Jun-2021,IMPS,00.00,"128,369.33","513,477.30"
23-Jun-2021,NEFT,00.00,"256,738.65","256,738.65"
23-Jun-2021,Reversal,00.00,"51,347.73","205,390.92"
23-Jun-2021,IMPS,138.30,00.00,"205,529.22"
23-Jun-2021,Cash,62.00,00.00,"205,591.22"
23-Jun-2021,Reversal,"912,895.00",00.00,"1,118,486.22"
23-Jun-2021,Interest,"9,399.29",00.00,"1,127,885.51"
23-Jun-2021,Bill,00.00,"281,971.38","845,914.13"
23-Jun-2021,Cash,"1,769.00",00.00,"847,683.13"
23-Jun-2021,Cheque,60.00,00.00,"847,743.13"
23-Jun-2021,Transfer,147.85,00.00,"847,890.98"
23-Jun-2021,Transfer,00.00,"94,210.11","753,680.87"
23-Jun-2021,ATM,"186,625.00",00.00,"940,305.87"
23-Jun-2021,Debit Card,"1,009,845.00",00.00,"1,950,150.87"
23-Jun-2021,Miscellaneous,61.00,00.00,"1,950,211.87"
23-Jun-2021,RTGS,"784,678.50",00.00,"2,734,890.37"
23-Jun-2021,Miscellaneous,"677,198.00",00.00,"3,412,088.37"
23-Jun-2021,Interest,00.00,"853,022.09","2,559,066.28"
23-Jun-2021,Transfer,"4,396.70",00.00,"2,563,462.98"
24-Jun-2021,Bill,00.00,"640,865.75","1,922,597.24"
24-Jun-2021,Purchase,06.80,00.00,"1,922,604.04"
24-Jun-2021,Debit Card,00.00,"240,325.51","1,682,278.54"
24-Jun-2021,Cheque,"17,283.50",00.00,"1,699,562.04"
24-Jun-2021,Tax,00.00,"169,956.20","1,529,605.84"
24-Jun-2021,NEFT,"121,975.00",00.00,"1,651,580.84"
24-Jun-2021,Commission,00.00,"412,895.21","1,238,685.63"
24-Jun-2021,Debit Card,00.00,"619,342.82","619,342.81"
24-Jun-2021,Commission,00.00,"77,417.85","541,924.96"
24-Jun-2021,IMPS,00.00,"108,384.99","433,539.97"
24-Jun-2021,Miscellaneous,05.60,00.00,"433,545.57"
24-Jun-2021,Miscellaneous,00.00,"48,171.73","385,373.84"
24-Jun-2021,Bill,"3,898.00",00.00,"389,271.84"
24-Jun-2021,ATM,00.00,"77,854.37","311,417.47"
24-Jun-2021,Transfer,63.00,00.00,"311,480.47"
25-Jun-2021,Transfer,00.00,"38,935.06","272,545.41"
25-Jun-2021,Tax,"26,292.00",00.00,"298,837.41"
25-Jun-2021,Cheque,"1,330,941.25",00.00,"1,629,778.66"
26-Jun-2021,Transfer,"6,783.36",00.00,"1,636,562.02"
26-Jun-2021,Tax,00.00,"163,656.20","1,472,905.82"
26-Jun-2021,Transfer,00.00,"294,581.16","1,178,324.66"
26-Jun-2021,Bill,"1,232.00",00.00,"1,179,556.66"
26-Jun-2021,NEFT,"3,389.00",00.00,"1,182,945.66"
26-Jun-2021,NEFT,46.50,00.00,"1,182,992.16"
26-Jun-2021,Purchase,00.00,"1,182,992.16",00.00
26-Jun-2021,ATM,25.70,00.00,25.70
26-Jun-2021,Reversal,00.00,08.57,17.13
26-Jun-2021,Interest,02.00,00.00,19.13
26-Jun-2021,Interest,370.47,00.00,389.60
26-Jun-2021,Tax,08.87,00.00,398.47
26-Jun-2021,Miscellaneous,"998,744.00",00.00,"999,142.47"
26-Jun-2021,Transfer,07.53,00.00,"999,150.00"
26-Jun-2021,Miscellaneous,"148,723.20",00.00,"1,147,873.20"
26-Jun-2021,Bill,00.00,"229,574.64","918,298.56"
26-Jun-2021,IMPS,00.00,"306,099.52","612,199.04"
26-Jun-2021,Tax,01.54,00.00,"612,200.58"
26-Jun-2021,Miscellaneous,00.00,"122,440.12","489,760.46"
27-Jun-2021,Miscellaneous,00.00,"489,760.46",00.00
27-Jun-2021,IMPS,"3,507.90",00.00,"3,507.90"
27-Jun-2021,Cash,39.70,00.00,"3,547.60"
27-Jun-2021,Bill,00.00,591.27,"2,956.33"
27-Jun-2021,Cash,00.00,369.54,"2,586.79"
27-Jun-2021,Tax,37.76,00.00,"2,624.55"
27-Jun-2021,Cash,00.00,374.94,"2,249.61"
28-Jun-2021,Cheque,273.35,00.00,"2,522.96"
28-Jun-2021,Cheque,00.00,252.30,"2,270.66"
28-Jun-2021,NEFT,00.00,"1,135.33","1,135.33"
28-Jun-2021,Cheque,01.70,00.00,"1,137.03"
28-Jun-2021,Bill,"1,870.10",00.00,"3,007.13"
28-Jun-2021,Commission,"598,165.20",00.00,"601,172.33"
28-Jun-2021,Cheque,"309,679.00",00.00,"910,851.33"
28-Jun-2021,Debit Card,"26,328.00",00.00,"937,179.33"
28-Jun-2021,Reversal,00.00,"93,717.93","843,461.40"
28-Jun-2021,Miscellaneous,48.18,00.00,"843,509.58"
28-Jun-2021,Commission,00.00,"105,438.70","738,070.88"
28-Jun-2021,Tax,00.00,"147,614.18","590,456.70"
28-Jun-2021,IMPS,"115,804.00",00.00,"706,260.70"
28-Jun-2021,RTGS,05.00,00.00,"706,265.70"
28-Jun-2021,Debit Card,"249,100.60",00.00,"955,366.30"
28-Jun-2021,Debit Card,00.00,"106,151.81","849,214.49"
28-Jun-2021,Debit Card,00.00,"283,071.50","566,142.99"
28-Jun-2021,Reversal,00.00,"113,228.60","452,914.39"
28-Jun-2021,Transfer,00.00,"113,228.60","339,685.79"
28-Jun-2021,NEFT,97.00,00.00,"339,782.79"
28-Jun-2021,ATM,00.00,"84,945.70","254,837.09"
28-Jun-2021,ATM,"714,849.00",00.00,"969,686.09"
28-Jun-2021,Reversal,00.00,"323,228.70","646,457.39"
28-Jun-2021,Debit Card,"1,609.00",00.00,"648,066.39"
28-Jun-2021,Cheque,"3,371.80",00.00,"651,438.19"
28-Jun-2021,ATM,36.00,00.00,"651,474.19"
28-Jun-2021,RTGS,"1,675,942.00",00.00,"2,327,416.19"
28-Jun-2021,Debit Card,369.30,00.00,"2,327,785.49"
28-Jun-2021,Cheque,"121,344.94",00.00,"2,449,130.43"
28-Jun-2021,Cheque,00.00,"349,875.78","2,099,254.65"
28-Jun-2021,NEFT,364.58,00.00,"2,099,619.23"
28-Jun-2021,Transfer,00.00,"699,873.08","1,399,746.15"
28-Jun-2021,Cheque,00.00,"199,963.74","1,199,782.41"
28-Jun-2021,Tax,00.00,"171,397.49","1,028,384.92"
28-Jun-2021,Miscellaneous,00.00,"257,096.23","771,288.69"
29-Jun-2021,Interest,29.70,00.00,"771,318.39"
29-Jun-2021,Miscellaneous,"32,206.46",00.00,"803,524.85"
29-Jun-2021,Cash,00.00,"114,789.26","688,735.59"
29-Jun-2021,Interest,00.00,"688,735.59",00.00
29-Jun-2021,Reversal,35.40,00.00,35.40
29-Jun-2021,Reversal,407.40,00.00,442.80
29-Jun-2021,NEFT,"2,202.60",00.00,"2,645.40"
29-Jun-2021,NEFT,"839,442.00",00.00,"842,087.40"
29-Jun-2021,Miscellaneous,07.54,00.00,"842,094.94"
29-Jun-2021,Debit Card,"1,267,123.50",00.00,"2,109,218.44"
29-Jun-2021,Commission,00.00,"2,109,218.44",00.00
29-Jun-2021,Commission,01.80,00.00,01.80
29-Jun-2021,Cheque,36.20,00.00,38.00
29-Jun-2021,Cash,00.00,05.43,32.57
29-Jun-2021,Debit Card,29.90,00.00,62.47
29-Jun-2021,Commission,00.00,08.92,53.55
29-Jun-2021,Bill,40.38,00.00,93.93
30-Jun-2021,ATM,"80,585.00",00.00,"80,678.93"
30-Jun-2021,Transfer,00.00,"20,169.73","60,509.20"
30-Jun-2021,Cash,"1,344,371.00",00.00,"1,404,880.20"
30-Jun-2021,IMPS,450.30,00.00,"1,405,330.50"
30-Jun-2021,Interest,49.00,00.00,"1,405,379.50"
30-Jun-2021,Interest,00.00,"175,672.44","1,229,707.06"
30-Jun-2021,Transfer,450.30,00.00,"1,230,157.36"
01-Jul-2021,Cheque,00.00,"410,052.45","820,104.91"
01-Jul-2021,Miscellaneous,"84,651.94",00.00,"904,756.85"
01-Jul-2021,ATM,52.00,00.00,"904,808.85"
01-Jul-2021,Tax,52.00,00.00,"904,860.85"
01-Jul-2021,RTGS,"10,529.70",00.00,"915,390.55"
01-Jul-2021,IMPS,02.10,00.00,"915,392.65"
01-Jul-2021,Commission,00.00,"457,696.33","457,696.32"
01-Jul-2021,Bill,204.70,00.00,"457,901.02"
01-Jul-2021,Reversal,"74,208.00",00.00,"532,109.02"
01-Jul-2021,Cash,00.00,"266,054.51","266,054.51"
01-Jul-2021,Bill,"1,162,181.20",00.00,"1,428,235.71"
01-Jul-2021,Commission,00.00,"238,039.29","1,190,196.42"
01-Jul-2021,Bill,00.00,"119,019.64","1,071,176.78"
01-Jul-2021,Miscellaneous,00.00,"178,529.46","892,647.32"
01-Jul-2021,ATM,00.00,"178,529.46","714,117.86"
01-Jul-2021,Purchase,"2,378.96",00.00,"716,496.82"
01-Jul-2021,Commission,04.56,00.00,"716,501.38"
01-Jul-2021,Commission,237.00,00.00,"716,738.38"
01-Jul-2021,Reversal,00.00,"358,369.19","358,369.19"
02-Jul-2021,Bill,00.00,"39,818.80","318,550.39"
02-Jul-2021,ATM,01.07,00.00,"318,551.46"
02-Jul-2021,IMPS,00.00,"45,507.35","273,044.11"
02-Jul-2021,NEFT,00.00,"34,130.51","238,913.60"
02-Jul-2021,Cheque,"2,975.50",00.00,"241,889.10"
02-Jul-2021,Interest,07.47,00.00,"241,896.57"
02-Jul-2021,Interest,153.00,00.00,"242,049.57"
02-Jul-2021,Commission,"75,122.00",00.00,"317,171.57"
02-Jul-2021,Interest,00.00,"317,171.57",00.00
02-Jul-2021,Reversal,"13,189.00",00.00,"13,189.00"
02-Jul-2021,Interest,00.00,00.00,"13,189.00"
02-Jul-2021,IMPS,245.88,00.00,"13,434.88"
02-Jul-2021,Tax,00.00,"1,492.76","11,942.12"
02-Jul-2021,Cheque,00.00,"1,326.90","10,615.22"
02-Jul-2021,Transfer,00.00,"1,179.47","9,435.75"
02-Jul-2021,RTGS,"1,580.86",00.00,"11,016.61"
02-Jul-2021,RTGS,00.00,"1,573.80","9,442.81"
02-Jul-2021,RTGS,"1,248,901.00",00.00,"1,258,343.81"
02-Jul-2021,Bill,00.00,"251,668.76","1,006,675.05"
02-Jul-2021,Debit Card,20.00,00.00,"1,006,695.05"
02-Jul-2021,Cheque,"5,098.00",00.00,"1,011,793.05"
02-Jul-2021,ATM,00.00,"202,358.61","809,434.44"
02-Jul-2021,Tax,00.00,"115,633.49","693,800.95"
02-Jul-2021,ATM,00.00,"99,114.42","594,686.53"
02-Jul-2021,Cheque,"1,013,559.00",00.00,"1,608,245.53"
02-Jul-2021,Debit Card,"25,785.17",00.00,"1,634,030.70"
02-Jul-2021,Bill,155.80,00.00,"1,634,186.50"
02-Jul-2021,Tax,00.00,"817,093.25","817,093.25"
02-Jul-2021,NEFT,00.00,"817,093.25",00.00
02-Jul-2021,Transfer,"1,107,741.75",00.00,"1,107,741.75"
02-Jul-2021,Miscellaneous,00.00,"276,935.44","830,806.31"
02-Jul-2021,Purchase,00.00,"118,686.62","712,119.69"
02-Jul-2021,Debit Card,00.00,"118,686.62","593,433.07"
02-Jul-2021,NEFT,"630,929.00",00.00,"1,224,362.07"
02-Jul-2021,Bill,00.00,"612,181.04","612,181.04"
02-Jul-2021,Cheque,70.00,00.00,"612,251.04"
02-Jul-2021,RTGS,00.00,"102,041.84","510,209.20"
02-Jul-2021,Cash,"23,764.50",00.00,"533,973.70"
02-Jul-2021,RTGS,"1,171.90",00.00,"535,145.60"
02-Jul-2021,IMPS,"1,689,897.20",00.00,"2,225,042.80"
02-Jul-2021,Bill,00.00,"741,680.93","1,483,361.87"
03-Jul-2021,Purchase,"1,492,311.00",00.00,"2,975,672.87"
03-Jul-2021,Commission,"106,262.56",00.00,"3,081,935.43"
03-Jul-2021,Interest,"1,552.34",00.00,"3,083,487.77"
03-Jul-2021,ATM,29.02,00.00,"3,083,516.79"
03-Jul-2021,Interest,00.00,"770,879.20","2,312,637.59"
03-Jul-2021,Transfer,"1,775,632.00",00.00,"4,088,269.59"
03-Jul-2021,Tax,00.00,"4,088,269.59",00.00
03-Jul-2021,RTGS,"253,467.00",00.00,"253,467.00"
03-Jul-2021,Commission,00.00,"28,163.00","225,304.00"
03-Jul-2021,Tax,00.00,"32,186.29","193,117.71"
03-Jul-2021,Purchase,00.00,"21,457.52","171,660.19"
03-Jul-2021,Debit Card,00.00,"17,166.02","154,494.17"
03-Jul-2021,RTGS,00.00,"22,070.60","132,423.57"
03-Jul-2021,Purchase,02.40,00.00,"132,425.97"
03-Jul-2021,Commission,00.00,"16,553.25","115,872.72"
03-Jul-2021,ATM,00.00,"19,312.12","96,560.60"
03-Jul-2021,Debit Card,"201,932.00",00.00,"298,492.60"
03-Jul-2021,Interest,"2,061,280.50",00.00,"2,359,773.10"
03-Jul-2021,NEFT,200.00,00.00,"2,359,973.10"
03-Jul-2021,NEFT,00.00,"471,994.62","1,887,978.48"
03-Jul-2021,IMPS,00.00,"235,997.31","1,651,981.17"
03-Jul-2021,Cash,00.00,"825,990.59","825,990.58"
03-Jul-2021,Cash,"824,731.25",00.00,"1,650,721.83"
03-Jul-2021,IMPS,00.00,"825,360.92","825,360.92"
03-Jul-2021,Cheque,"214,101.10",00.00,"1,039,462.02"
03-Jul-2021,Cheque,"25,244.90",00.00,"1,064,706.92"
03-Jul-2021,ATM,00.00,"1,064,706.92",00.00
03-Jul-2021,Commission,"2,737.00",00.00,"2,737.00"
03-Jul-2021,Cash,"1,277,372.00",00.00,"1,280,109.00"
03-Jul-2021,ATM,"1,108.20",00.00,"1,281,217.20"
04-Jul-2021,NEFT,353.00,00.00,"1,281,570.20"
04-Jul-2021,Interest,"250,527.38",00.00,"1,532,097.58"
04-Jul-2021,Debit Card,"1,167,726.80",00.00,"2,699,824.38"
04-Jul-2021,Interest,00.00,"385,689.20","2,314,135.18"
05-Jul-2021,Interest,00.00,"771,378.39","1,542,756.79"
05-Jul-2021,IMPS,"937,478.00",00.00,"2,480,234.79"
05-Jul-2021,Miscellaneous,"1,749.00",00.00,"2,481,983.79"
05-Jul-2021,Bill,342.00,00.00,"2,482,325.79"
05-Jul-2021,RTGS,348.15,00.00,"2,482,673.94"
05-Jul-2021,Purchase,00.00,"413,778.99","2,068,894.95"
05-Jul-2021,ATM,"3,337.35",00.00,"2,072,232.30"
05-Jul-2021,ATM,"97,068.00",00.00,"2,169,300.30"
05-Jul-2021,Tax,00.00,"361,550.05","1,807,750.25"
05-Jul-2021,RTGS,"2,064,636.00",00.00,"3,872,386.25"
05-Jul-2021,Cash,"1,349,704.00",00.00,"5,222,090.25"
05-Jul-2021,Commission,414.00,00.00,"5,222,504.25"
05-Jul-2021,IMPS,00.00,"746,072.04","4,476,432.21"
05-Jul-2021,Transfer,00.00,"639,490.32","3,836,941.89"
05-Jul-2021,RTGS,"174,287.34",00.00,"4,011,229.23"
05-Jul-2021,Debit Card,00.00,"2,005,614.62","2,005,614.62"
05-Jul-2021,Reversal,00.00,"2,005,614.62",00.00
05-Jul-2021,ATM,"183,118.25",00.00,"183,118.25"
05-Jul-2021,Purchase,00.00,"18,311.83","164,806.42"
05-Jul-2021,Miscellaneous,"830,227.50",00.00,"995,033.92"
05-Jul-2021,Cash,00.00,"995,033.92",00.00
05-Jul-2021,Reversal,03.00,00.00,03.00
05-Jul-2021,IMPS,00.00,00.60,02.40
05-Jul-2021,Cash,00.00,00.80,01.60
05-Jul-2021,RTGS,"161,071.00",00.00,"161,072.60"
05-Jul-2021,Reversal,00.00,"53,690.87","107,381.73"
05-Jul-2021,RTGS,00.00,"26,845.43","80,536.30"
05-Jul-2021,Tax,00.00,"10,067.04","70,469.26"
05-Jul-2021,RTGS,"180,107.16",00.00,"250,576.42"
05-Jul-2021,Reversal,00.00,"25,057.64","225,518.78"
05-Jul-2021,IMPS,"22,550.10",00.00,"248,068.88"
05-Jul-2021,ATM,212.09,00.00,"248,280.97"
05-Jul-2021,Cheque,"3,278.93",00.00,"251,559.90"
05-Jul-2021,Commission,"151,579.80",00.00,"403,139.70"
05-Jul-2021,IMPS,"243,291.00",00.00,"646,430.70"
05-Jul-2021,Tax,00.00,"323,215.35","323,215.35"
05-Jul-2021,Interest,37.00,00.00,"323,252.35"
05-Jul-2021,ATM,02.82,00.00,"323,255.17"
05-Jul-2021,RTGS,16.60,00.00,"323,271.77"
05-Jul-2021,Transfer,"781,242.50",00.00,"1,104,514.27"
05-Jul-2021,NEFT,00.00,"368,171.42","736,342.85"
05-Jul-2021,Reversal,00.00,"81,815.87","654,526.98"
05-Jul-2021,Interest,"486,239.75",00.00,"1,140,766.73"
05-Jul-2021,Debit Card,"247,818.69",00.00,"1,388,585.42"
05-Jul-2021,Cash,00.00,"138,858.54","1,249,726.88"
05-Jul-2021,ATM,174.00,00.00,"1,249,900.88"
05-Jul-2021,Commission,01.76,00.00,"1,249,902.64"
05-Jul-2021,Cash,138.00,00.00,"1,250,040.64"
05-Jul-2021,Cheque,00.00,"156,255.08","1,093,785.56"
05-Jul-2021,Miscellaneous,03.00,00.00,"1,093,788.56"
05-Jul-2021,Cash,476.40,00.00,"1,094,264.96"
05-Jul-2021,NEFT,00.00,"109,426.50","984,838.46"
05-Jul-2021,Debit Card,"1,506.40",00.00,"986,344.86"
05-Jul-2021,RTGS,"3,731.73",00.00,"990,076.59"
05-Jul-2021,Interest,00.00,"110,008.51","880,068.08"
05-Jul-2021,Cash,00.00,"176,013.62","704,054.46"
05-Jul-2021,Tax,00.00,"140,810.89","563,243.57"
05-Jul-2021,IMPS,00.00,"563,243.57",00.00
05-Jul-2021,IMPS,"255,101.50",00.00,"255,101.50"
05-Jul-2021,Bill,"7,580.02",00.00,"262,681.52"
05-Jul-2021,Tax,"143,934.00",00.00,"406,615.52"
05-Jul-2021,Commission,"1,698.67",00.00,"408,314.19"
06-Jul-2021,Miscellaneous,00.00,"45,368.24","362,945.95"
06-Jul-2021,Cheque,00.00,"60,490.99","302,454.96"
06-Jul-2021,RTGS,"1,726,580.00",00.00,"2,029,034.96"
06-Jul-2021,RTGS,00.00,"338,172.49","1,690,862.47"
06-Jul-2021,Interest,286.00,00.00,"1,691,148.47"
06-Jul-2021,Miscellaneous,00.00,"187,905.39","1,503,243.08"
06-Jul-2021,Debit Card,"16,998.00",00.00,"1,520,241.08"
06-Jul-2021,Cash,00.00,"380,060.27","1,140,180.81"
06-Jul-2021,NEFT,00.00,"114,018.08","1,026,162.73"
06-Jul-2021,Reversal,"1,651.00",00.00,"1,027,813.73"
06-Jul-2021,ATM,00.00,"205,562.75","822,250.98"
06-Jul-2021,Cheque,00.00,"274,083.66","548,167.32"
06-Jul-2021,NEFT,01.00,00.00,"548,168.32"
06-Jul-2021,IMPS,"952,238.00",00.00,"1,500,406.32"
06-Jul-2021,Reversal,34.50,00.00,"1,500,440.82"
06-Jul-2021,Bill,"970,391.00",00.00,"2,470,831.82"
06-Jul-2021,Miscellaneous,00.00,"1,235,415.91","1,235,415.91"
06-Jul-2021,Cash,00.00,"617,707.96","617,707.95"
06-Jul-2021,Commission,01.93,00.00,"617,709.88"
06-Jul-2021,ATM,03.00,00.00,"617,712.88"
06-Jul-2021,Bill,208.72,00.00,"617,921.60"
06-Jul-2021,Cheque,"170,168.44",00.00,"788,090.04"
06-Jul-2021,Cash,00.00,"394,045.02","394,045.02"
06-Jul-2021,Miscellaneous,291.00,00.00,"394,336.02"
06-Jul-2021,ATM,00.00,"39,433.60","354,902.42"
06-Jul-2021,Interest,"10,056.00",00.00,"364,958.42"
06-Jul-2021,RTGS,"1,273.00",00.00,"366,231.42"
06-Jul-2021,Transfer,00.00,"45,778.93","320,452.49"
06-Jul-2021,Tax,02.55,00.00,"320,455.04"
06-Jul-2021,Interest,"1,873.17",00.00,"322,328.21"
07-Jul-2021,Bill,13.00,00.00,"322,341.21"
07-Jul-2021,NEFT,00.00,"32,234.12","290,107.09"
07-Jul-2021,Interest,00.00,"32,234.12","257,872.97"
07-Jul-2021,Miscellaneous,"206,146.60",00.00,"464,019.57"
07-Jul-2021,Tax,03.00,00.00,"464,022.57"
07-Jul-2021,Miscellaneous,02.00,00.00,"464,024.57"
07-Jul-2021,Miscellaneous,00.00,"464,024.57",00.00
07-Jul-2021,Cheque,447.00,00.00,447.00
07-Jul-2021,RTGS,"1,088.60",00.00,"1,535.60"
07-Jul-2021,Commission,00.00,"1,535.60",00.00
07-Jul-2021,RTGS,04.60,00.00,04.60
07-Jul-2021,Cash,00.00,01.53,03.07
07-Jul-2021,Cheque,55.00,00.00,58.07
07-Jul-2021,Reversal,"261,104.00",00.00,"261,162.07"
07-Jul-2021,Interest,07.00,00.00,"261,169.07"
07-Jul-2021,Debit Card,00.00,"261,169.07",00.00
07-Jul-2021,Cash,"216,405.20",00.00,"216,405.20"
07-Jul-2021,Reversal,00.00,"27,050.65","189,354.55"
07-Jul-2021,Purchase,20.00,00.00,"189,374.55"
07-Jul-2021,Reversal,26.92,00.00,"189,401.47"
07-Jul-2021,Tax,00.00,"47,350.37","142,051.10"
07-Jul-2021,Tax,00.00,"28,410.22","113,640.88"
07-Jul-2021,Reversal,00.00,"56,820.44","56,820.44"
07-Jul-2021,ATM,00.00,"28,410.22","28,410.22"
07-Jul-2021,Miscellaneous,03.16,00.00,"28,413.38"
07-Jul-2021,Miscellaneous,00.00,"28,413.38",00.00
07-Jul-2021,NEFT,"96,097.10",00.00,"96,097.10"
07-Jul-2021,NEFT,00.00,"12,012.14","84,084.96"
07-Jul-2021,Tax,00.00,"8,408.50","75,676.46"
07-Jul-2021,Bill,922.50,00.00,"76,598.96"
07-Jul-2021,Cash,00.00,"38,299.48","38,299.48"
07-Jul-2021,Reversal,"47,286.19",00.00,"85,585.67"
07-Jul-2021,Miscellaneous,00.00,"9,509.52","76,076.15"
07-Jul-2021,Cheque,165.77,00.00,"76,241.92"
07-Jul-2021,Cash,"9,799.23",00.00,"86,041.15"
07-Jul-2021,Tax,"225,101.56",00.00,"311,142.71"
07-Jul-2021,Cash,16.00,00.00,"311,158.71"
07-Jul-2021,Cheque,19.10,00.00,"311,177.81"
07-Jul-2021,Purchase,107.90,00.00,"311,285.71"
08-Jul-2021,Reversal,00.00,"51,880.95","259,404.76"
08-Jul-2021,RTGS,"2,312.39",00.00,"261,717.15"
08-Jul-2021,ATM,00.00,"261,717.15",00.00
08-Jul-2021,Interest,"245,603.00",00.00,"245,603.00"
08-Jul-2021,Purchase,00.00,"40,933.83","204,669.17"
08-Jul-2021,Interest,462.20,00.00,"205,131.37"
08-Jul-2021,Miscellaneous,"214,155.50",00.00,"419,286.87"
08-Jul-2021,Reversal,57.66,00.00,"419,344.53"
08-Jul-2021,IMPS,05.00,00.00,"419,349.53"
08-Jul-2021,Commission,"106,717.66",00.00,"526,067.19"
08-Jul-2021,Interest,"31,657.11",00.00,"557,724.30"
08-Jul-2021,Cash,"1,451.00",00.00,"559,175.30"
08-Jul-2021,Purchase,00.00,"55,917.53","503,257.77"
08-Jul-2021,Purchase,00.00,"55,917.53","447,340.24"
08-Jul-2021,Debit Card,"52,410.20",00.00,"499,750.44"
08-Jul-2021,Cheque,07.00,00.00,"499,757.44"
08-Jul-2021,Cash,00.00,"249,878.72","249,878.72"
08-Jul-2021,Purchase,57.90,00.00,"249,936.62"
08-Jul-2021,IMPS,00.00,"83,312.21","166,624.41"
08-Jul-2021,Reversal,448.00,00.00,"167,072.41"
09-Jul-2021,Bill,"104,925.80",00.00,"271,998.21"
09-Jul-2021,Miscellaneous,05.70,00.00,"272,003.91"
09-Jul-2021,Reversal,"241,096.00",00.00,"513,099.91"
09-Jul-2021,Debit Card,"22,822.00",00.00,"535,921.91"
09-Jul-2021,Interest,00.00,"267,960.96","267,960.96"
09-Jul-2021,Purchase,00.00,"29,773.44","238,187.52"
09-Jul-2021,Commission,00.00,"238,187.52",00.00
09-Jul-2021,Interest,00.60,00.00,00.60
09-Jul-2021,Miscellaneous,33.00,00.00,33.60
09-Jul-2021,Purchase,"36,615.53",00.00,"36,649.13"
09-Jul-2021,Bill,245.77,00.00,"36,894.90"
09-Jul-2021,Cash,00.00,"4,611.86","32,283.04"
09-Jul-2021,Debit Card,00.00,"3,587.00","28,696.04"
09-Jul-2021,Reversal,00.00,"14,348.02","14,348.02"
09-Jul-2021,NEFT,"2,045,929.00",00.00,"2,060,277.02"
09-Jul-2021,Commission,"1,628,460.80",00.00,"3,688,737.82"
09-Jul-2021,Reversal,00.00,"1,844,368.91","1,844,368.91"
09-Jul-2021,Reversal,"2,431.60",00.00,"1,846,800.51"
09-Jul-2021,Debit Card,00.00,"369,360.10","1,477,440.41"
09-Jul-2021,Cash,"8,479.00",00.00,"1,485,919.41"
09-Jul-2021,Bill,364.86,00.00,"1,486,284.27"
09-Jul-2021,Commission,102.50,00.00,"1,486,386.77"
09-Jul-2021,Cheque,00.00,"165,154.09","1,321,232.68"
09-Jul-2021,IMPS,00.00,"1,321,232.68",00.00
09-Jul-2021,Debit Card,"1,779.00",00.00,"1,779.00"
09-Jul-2021,Cheque,21.60,00.00,"1,800.60"
09-Jul-2021,IMPS,00.00,360.12,"1,440.48"
09-Jul-2021,Commission,23.60,00.00,"1,464.08"
09-Jul-2021,Cash,00.00,292.82,"1,171.26"
09-Jul-2021,Miscellaneous,04.00,00.00,"1,175.26"
09-Jul-2021,Commission,05.40,00.00,"1,180.66"
09-Jul-2021,Tax,14.90,00.00,"1,195.56"
09-Jul-2021,Tax,"2,811.00",00.00,"4,006.56"
09-Jul-2021,Debit Card,00.00,667.76,"3,338.80"
09-Jul-2021,Purchase,"6,714.00",00.00,"10,052.80"
09-Jul-2021,Tax,00.00,"10,052.80",00.00
09-Jul-2021,Debit Card,"246,881.50",00.00,"246,881.50"
09-Jul-2021,Debit Card,00.00,"35,268.79","211,612.71"
09-Jul-2021,IMPS,00.00,"26,451.59","185,161.12"
09-Jul-2021,Cash,"1,860,094.75",00.00,"2,045,255.87"
09-Jul-2021,Purchase,"137,828.00",00.00,"2,183,083.87"
09-Jul-2021,Tax,253.00,00.00,"2,183,336.87"
09-Jul-2021,ATM,00.00,"363,889.48","1,819,447.39"
09-Jul-2021,IMPS,"1,564.16",00.00,"1,821,011.55"
09-Jul-2021,Purchase,"1,822,072.00",00.00,"3,643,083.55"
09-Jul-2021,Cash,06.54,00.00,"3,643,090.09"
09-Jul-2021,Commission,00.00,"520,441.44","3,122,648.65"
09-Jul-2021,RTGS,429.95,00.00,"3,123,078.60"
09-Jul-2021,NEFT,"1,695,602.50",00.00,"4,818,681.10"
09-Jul-2021,IMPS,"1,950,650.25",00.00,"6,769,331.35"
09-Jul-2021,Cheque,"22,424.00",00.00,"6,791,755.35"
09-Jul-2021,Debit Card,59.77,00.00,"6,791,815.12"
09-Jul-2021,Interest,"6,868.20",00.00,"6,798,683.32"
09-Jul-2021,Debit Card,953.00,00.00,"6,799,636.32"
09-Jul-2021,Purchase,"38,079.00",00.00,"6,837,715.32"
09-Jul-2021,Transfer,00.00,"3,418,857.66","3,418,857.66"
09-Jul-2021,RTGS,"167,753.00",00.00,"3,586,610.66"
09-Jul-2021,Transfer,360.00,00.00,"3,586,970.66"
09-Jul-2021,Cheque,"7,024.20",00.00,"3,593,994.86"
09-Jul-2021,Miscellaneous,00.00,"898,498.72","2,695,496.14"
09-Jul-2021,Miscellaneous,445.70,00.00,"2,695,941.84"
09-Jul-2021,Reversal,203.42,00.00,"2,696,145.26"
09-Jul-2021,Debit Card,00.00,"898,715.09","1,797,430.17"
09-Jul-2021,Cash,12.10,00.00,"1,797,442.27"
09-Jul-2021,Cheque,00.00,"449,360.57","1,348,081.70"
09-Jul-2021,Miscellaneous,"1,991,942.25",00.00,"3,340,023.95"
09-Jul-2021,RTGS,00.00,"1,113,341.32","2,226,682.63"
09-Jul-2021,Commission,05.00,00.00,"2,226,687.63"
09-Jul-2021,Interest,00.00,"247,409.74","1,979,277.89"
09-Jul-2021,Cash,00.00,"1,979,277.89",00.00
09-Jul-2021,RTGS,"10,199.50",00.00,"10,199.50"
09-Jul-2021,NEFT,"127,171.00",00.00,"137,370.50"
09-Jul-2021,ATM,318.00,00.00,"137,688.50"
09-Jul-2021,Tax,"120,172.00",00.00,"257,860.50"
10-Jul-2021,Interest,00.00,"85,953.50","171,907.00"
10-Jul-2021,Miscellaneous,"239,149.20",00.00,"411,056.20"
10-Jul-2021,Reversal,00.00,"102,764.05","308,292.15"
10-Jul-2021,Reversal,00.00,"102,764.05","205,528.10"
10-Jul-2021,Bill,53.12,00.00,"205,581.22"
10-Jul-2021,RTGS,00.00,"22,842.36","182,738.86"
10-Jul-2021,Cash,00.00,"60,912.95","121,825.91"
10-Jul-2021,Interest,00.00,"17,403.70","104,422.21"
10-Jul-2021,Bill,"484,068.00",00.00,"588,490.21"
10-Jul-2021,Commission,00.00,"84,070.03","504,420.18"
10-Jul-2021,RTGS,00.00,"56,046.69","448,373.49"
10-Jul-2021,Bill,02.00,00.00,"448,375.49"
10-Jul-2021,Miscellaneous,00.00,"64,053.64","384,321.85"
10-Jul-2021,ATM,"114,916.00",00.00,"499,237.85"
10-Jul-2021,ATM,02.50,00.00,"499,240.35"
10-Jul-2021,Debit Card,41.70,00.00,"499,282.05"
10-Jul-2021,Transfer,"1,225,306.00",00.00,"1,724,588.05"
10-Jul-2021,ATM,"20,211.80",00.00,"1,744,799.85"
10-Jul-2021,Interest,"19,599.44",00.00,"1,764,399.29"
10-Jul-2021,Cheque,00.00,"294,066.55","1,470,332.74"
10-Jul-2021,Cheque,05.63,00.00,"1,470,338.37"
10-Jul-2021,Reversal,04.00,00.00,"1,470,342.37"
10-Jul-2021,Bill,00.00,"490,114.12","980,228.25"
10-Jul-2021,Debit Card,00.00,"490,114.13","490,114.12"
10-Jul-2021,NEFT,"258,314.00",00.00,"748,428.12"
11-Jul-2021,ATM,00.00,"106,918.30","641,509.82"
11-Jul-2021,NEFT,00.00,"641,509.82",00.00
11-Jul-2021,ATM,55.71,00.00,55.71
11-Jul-2021,Commission,00.00,13.93,41.78
12-Jul-2021,Transfer,00.00,05.97,35.81
12-Jul-2021,Interest,00.00,05.97,29.84
13-Jul-2021,ATM,37.00,00.00,66.84
13-Jul-2021,Commission,00.00,16.71,50.13
13-Jul-2021,Transfer,"19,024.20",00.00,"19,074.33"
13-Jul-2021,Reversal,00.00,"1,907.43","17,166.90"
13-Jul-2021,Transfer,02.22,00.00,"17,169.12"
13-Jul-2021,IMPS,"481,137.00",00.00,"498,306.12"
13-Jul-2021,Bill,05.10,00.00,"498,311.22"
13-Jul-2021,Cheque,742.10,00.00,"499,053.32"
13-Jul-2021,Reversal,00.00,"83,175.55","415,877.77"
13-Jul-2021,Cash,"1,787,836.00",00.00,"2,203,713.77"
13-Jul-2021,Debit Card,00.00,"734,571.26","1,469,142.51"
13-Jul-2021,Purchase,"83,832.00",00.00,"1,552,974.51"
14-Jul-2021,Reversal,00.00,"1,552,974.51",00.00
14-Jul-2021,Miscellaneous,00.00,00.00,00.00
14-Jul-2021,Tax,39.80,00.00,39.80
14-Jul-2021,ATM,"416,504.00",00.00,"416,543.80"
14-Jul-2021,NEFT,00.00,"41,654.38","374,889.42"
14-Jul-2021,Transfer,07.20,00.00,"374,896.62"
14-Jul-2021,IMPS,00.00,"41,655.18","333,241.44"
14-Jul-2021,Bill,00.00,"37,026.83","296,214.61"
14-Jul-2021,IMPS,00.00,"49,369.10","246,845.51"
14-Jul-2021,NEFT,384.00,00.00,"247,229.51"
14-Jul-2021,Interest,00.00,"27,469.95","219,759.56"
14-Jul-2021,Cheque,07.70,00.00,"219,767.26"
14-Jul-2021,RTGS,00.00,"24,418.58","195,348.68"
14-Jul-2021,Commission,00.00,"97,674.34","97,674.34"
14-Jul-2021,Tax,"30,550.30",00.00,"128,224.64"
15-Jul-2021,Bill,32.10,00.00,"128,256.74"
16-Jul-2021,ATM,00.00,"16,032.09","112,224.65"
16-Jul-2021,ATM,"1,620,371.00",00.00,"1,732,595.65"
16-Jul-2021,Cash,00.00,"1,732,595.65",00.00
16-Jul-2021,Commission,338.00,00.00,338.00
16-Jul-2021,Transfer,00.00,37.56,300.44
16-Jul-2021,IMPS,04.68,00.00,305.12
16-Jul-2021,IMPS,313.73,00.00,618.85
16-Jul-2021,NEFT,"1,131,903.50",00.00,"1,132,522.35"
16-Jul-2021,Purchase,00.00,"188,753.73","943,768.63"
16-Jul-2021,Interest,00.00,"134,824.09","808,944.54"
16-Jul-2021,RTGS,"228,402.00",00.00,"1,037,346.54"
16-Jul-2021,Miscellaneous,00.00,"207,469.31","829,877.23"
16-Jul-2021,Bill,160.09,00.00,"830,037.32"
16-Jul-2021,NEFT,153.00,00.00,"830,190.32"
16-Jul-2021,Reversal,"762,911.75",00.00,"1,593,102.07"
16-Jul-2021,Interest,00.00,"318,620.41","1,274,481.66"
16-Jul-2021,Interest,17.00,00.00,"1,274,498.66"
16-Jul-2021,Cash,00.00,"1,274,498.66",00.00
16-Jul-2021,ATM,29.87,00.00,29.87
16-Jul-2021,Cheque,00.00,29.87,00.00
16-Jul-2021,Cheque,"1,213.45",00.00,"1,213.45"
16-Jul-2021,Tax,00.00,151.68,"1,061.77"
16-Jul-2021,Cheque,"231,908.72",00.00,"232,970.49"
16-Jul-2021,NEFT,00.00,"23,297.05","209,673.44"
16-Jul-2021,IMPS,00.00,"52,418.36","157,255.08"
17-Jul-2021,Bill,00.00,"78,627.54","78,627.54"
17-Jul-2021,Reversal,77.00,00.00,"78,704.54"
17-Jul-2021,Debit Card,00.00,"19,676.14","59,028.40"
17-Jul-2021,Interest,07.00,00.00,"59,035.40"
17-Jul-2021,Interest,05.00,00.00,"59,040.40"
17-Jul-2021,Miscellaneous,00.00,"29,520.20","29,520.20"
17-Jul-2021,Cash,61.00,00.00,"29,581.20"
17-Jul-2021,Debit Card,04.47,00.00,"29,585.67"
17-Jul-2021,IMPS,00.00,"14,792.84","14,792.84"
17-Jul-2021,ATM,31.80,00.00,"14,824.64"
17-Jul-2021,NEFT,486.30,00.00,"15,310.94"
17-Jul-2021,Miscellaneous,"16,181.00",00.00,"31,491.94"
17-Jul-2021,Miscellaneous,00.00,"3,936.49","27,555.45"
17-Jul-2021,Tax,00.00,"9,185.15","18,370.30"
17-Jul-2021,Reversal,51.00,00.00,"18,421.30"
17-Jul-2021,NEFT,"247,498.91",00.00,"265,920.21"
17-Jul-2021,Tax,00.00,"33,240.03","232,680.18"
17-Jul-2021,Transfer,00.00,"58,170.05","174,510.14"
17-Jul-2021,Reversal,"174,874.30",00.00,"349,384.44"
17-Jul-2021,Purchase,"23,960.41",00.00,"373,344.85"
17-Jul-2021,Transfer,00.00,"93,336.21","280,008.64"
17-Jul-2021,Reversal,00.00,"31,112.07","248,896.57"
17-Jul-2021,Commission,470.20,00.00,"249,366.77"
17-Jul-2021,Transfer,00.00,"31,170.85","218,195.92"
17-Jul-2021,Miscellaneous,271.80,00.00,"218,467.72"
17-Jul-2021,RTGS,370.00,00.00,"218,837.72"
17-Jul-2021,Tax,00.00,"31,262.53","187,575.19"
17-Jul-2021,NEFT,252.59,00.00,"187,827.78"
17-Jul-2021,Reversal,"27,291.50",00.00,"215,119.28"
17-Jul-2021,ATM,25.66,00.00,"215,144.94"
17-Jul-2021,RTGS,"94,340.00",00.00,"309,484.94"
17-Jul-2021,Reversal,00.00,"51,580.82","257,904.12"
17-Jul-2021,Commission,339.13,00.00,"258,243.25"
17-Jul-2021,Miscellaneous,05.00,00.00,"258,248.25"
17-Jul-2021,Bill,84.81,00.00,"258,333.06"
17-Jul-2021,Purchase,00.00,"25,833.31","232,499.75"
17-Jul-2021,Reversal,00.00,"23,249.98","209,249.78"
17-Jul-2021,Interest,303.10,00.00,"209,552.88"
17-Jul-2021,Cash,01.28,00.00,"209,554.16"
17-Jul-2021,Reversal,485.77,00.00,"210,039.93"
17-Jul-2021,Cheque,210.00,00.00,"210,249.93"
17-Jul-2021,Debit Card,00.00,"26,281.24","183,968.69"
17-Jul-2021,Interest,464.80,00.00,"184,433.49"
17-Jul-2021,Tax,00.00,"46,108.37","138,325.12"
17-Jul-2021,Cash,00.00,"27,665.02","110,660.10"
17-Jul-2021,Interest,00.00,"12,295.57","98,364.53"
17-Jul-2021,Cash,"16,160.74",00.00,"114,525.27"
17-Jul-2021,Reversal,"220,655.20",00.00,"335,180.47"
17-Jul-2021,Commission,00.00,"83,795.12","251,385.35"
17-Jul-2021,Commission,00.00,"31,423.17","219,962.18"
18-Jul-2021,Purchase,00.00,"27,495.27","192,466.91"
18-Jul-2021,RTGS,00.00,"32,077.82","160,389.09"
18-Jul-2021,NEFT,00.00,"22,912.73","137,476.36"
18-Jul-2021,Interest,02.60,00.00,"137,478.96"
18-Jul-2021,RTGS,33.64,00.00,"137,512.60"
18-Jul-2021,IMPS,00.00,"45,837.53","91,675.07"
18-Jul-2021,RTGS,00.00,"45,837.54","45,837.54"
18-Jul-2021,NEFT,572.00,00.00,"46,409.54"
18-Jul-2021,Interest,00.00,"6,629.93","39,779.61"
18-Jul-2021,Interest,02.19,00.00,"39,781.80"
18-Jul-2021,IMPS,00.00,"3,978.18","35,803.62"
18-Jul-2021,Cash,"5,637.34",00.00,"41,440.96"
18-Jul-2021,Miscellaneous,07.90,00.00,"41,448.86"
18-Jul-2021,Interest,00.00,"4,605.43","36,843.43"
18-Jul-2021,Purchase,00.00,"36,843.43",00.00
18-Jul-2021,Interest,102.74,00.00,102.74
18-Jul-2021,ATM,497.70,00.00,600.44
18-Jul-2021,Interest,363.50,00.00,963.94
18-Jul-2021,Miscellaneous,00.00,96.39,867.55
18-Jul-2021,Reversal,00.00,216.89,650.66
18-Jul-2021,Cash,00.00,72.30,578.36
18-Jul-2021,Transfer,"184,380.00",00.00,"184,958.36"
18-Jul-2021,Transfer,"44,387.40",00.00,"229,345.76"
18-Jul-2021,Miscellaneous,00.00,"38,224.29","191,121.47"
18-Jul-2021,Cheque,06.00,00.00,"191,127.47"
18-Jul-2021,Transfer,00.00,"63,709.16","127,418.31"
18-Jul-2021,Purchase,00.00,"18,202.62","109,215.69"
18-Jul-2021,NEFT,00.00,"109,215.69",00.00
18-Jul-2021,Purchase,"779,656.00",00.00,"779,656.00"
18-Jul-2021,Debit Card,00.00,"86,628.44","693,027.56"
18-Jul-2021,Miscellaneous,01.10,00.00,"693,028.66"
18-Jul-2021,Interest,00.00,"69,302.87","623,725.79"
18-Jul-2021,Interest,"8,726.04",00.00,"632,451.83"
18-Jul-2021,Debit Card,"132,329.30",00.00,"764,781.13"
18-Jul-2021,Commission,00.00,"764,781.13",00.00
18-Jul-2021,NEFT,"170,412.97",00.00,"170,412.97"
18-Jul-2021,RTGS,20.60,00.00,"170,433.57"
18-Jul-2021,RTGS,00.00,"34,086.71","136,346.86"
19-Jul-2021,Bill,00.00,"17,043.36","119,303.50"
19-Jul-2021,IMPS,00.00,"23,860.70","95,442.80"
19-Jul-2021,Transfer,00.00,"9,544.28","85,898.52"
20-Jul-2021,Debit Card,00.00,"21,474.63","64,423.89"
20-Jul-2021,Commission,"26,610.00",00.00,"91,033.89"
20-Jul-2021,RTGS,00.00,"9,103.39","81,930.50"
20-Jul-2021,Purchase,00.00,"16,386.10","65,544.40"
20-Jul-2021,Tax,07.40,00.00,"65,551.80"
20-Jul-2021,Tax,00.00,"65,551.80",00.00
20-Jul-2021,Transfer,"1,045,984.80",00.00,"1,045,984.80"
20-Jul-2021,Tax,00.00,"104,598.48","941,386.32"
20-Jul-2021,Debit Card,"49,302.20",00.00,"990,688.52"
20-Jul-2021,Tax,00.00,"198,137.70","792,550.82"
20-Jul-2021,Transfer,00.00,"88,061.20","704,489.62"
20-Jul-2021,Debit Card,06.00,00.00,"704,495.62"
20-Jul-2021,Cash,00.00,"117,415.94","587,079.68"
20-Jul-2021,Transfer,00.00,"195,693.23","391,386.45"
20-Jul-2021,Cash,00.00,"65,231.08","326,155.38"
20-Jul-2021,Miscellaneous,00.00,"326,155.38",00.00
20-Jul-2021,Bill,"210,336.00",00.00,"210,336.00"
20-Jul-2021,Transfer,00.00,"23,370.67","186,965.33"
20-Jul-2021,Cheque,00.00,"31,160.89","155,804.44"
20-Jul-2021,Debit Card,01.50,00.00,"155,805.94"
20-Jul-2021,Commission,53.29,00.00,"155,859.23"
20-Jul-2021,Interest,00.00,"15,585.92","140,273.31"
20-Jul-2021,Purchase,"142,654.00",00.00,"282,927.31"
20-Jul-2021,ATM,"227,290.50",00.00,"510,217.81"
20-Jul-2021,IMPS,"754,658.25",00.00,"1,264,876.06"
20-Jul-2021,RTGS,"710,644.00",00.00,"1,975,520.06"
20-Jul-2021,ATM,00.00,"329,253.34","1,646,266.72"
20-Jul-2021,Bill,00.00,"823,133.36","823,133.36"
20-Jul-2021,NEFT,81.00,00.00,"823,214.36"
21-Jul-2021,Debit Card,496.18,00.00,"823,710.54"
21-Jul-2021,Cash,00.00,"164,742.11","658,968.43"
22-Jul-2021,ATM,00.00,"329,484.22","329,484.22"
22-Jul-2021,Debit Card,"152,745.03",00.00,"482,229.25"
22-Jul-2021,Transfer,801.71,00.00,"483,030.96"
22-Jul-2021,ATM,04.00,00.00,"483,034.96"
22-Jul-2021,Commission,00.00,"120,758.74","362,276.22"
22-Jul-2021,IMPS,00.00,"362,276.22",00.00
22-Jul-2021,Reversal,21.00,00.00,21.00
22-Jul-2021,Cash,00.00,03.00,18.00
22-Jul-2021,Commission,"129,280.80",00.00,"129,298.80"
22-Jul-2021,IMPS,00.00,"18,471.26","110,827.54"
22-Jul-2021,Reversal,"4,309.50",00.00,"115,137.04"
22-Jul-2021,Transfer,00.00,"28,784.26","86,352.78"
22-Jul-2021,IMPS,00.00,"10,794.10","75,558.68"
22-Jul-2021,Interest,156.30,00.00,"75,714.98"
23-Jul-2021,Commission,20.49,00.00,"75,735.47"
23-Jul-2021,NEFT,00.00,"10,819.35","64,916.12"
23-Jul-2021,Debit Card,00.00,"7,212.90","57,703.22"
23-Jul-2021,IMPS,00.00,"6,411.47","51,291.75"
23-Jul-2021,Bill,"2,103.30",00.00,"53,395.05"
23-Jul-2021,Reversal,00.00,"17,798.35","35,596.70"
23-Jul-2021,Miscellaneous,00.00,"5,085.24","30,511.46"
24-Jul-2021,Tax,00.00,"3,390.16","27,121.30"
24-Jul-2021,Transfer,00.00,"5,424.26","21,697.04"
24-Jul-2021,Reversal,203.00,00.00,"21,900.04"
24-Jul-2021,Interest,07.83,00.00,"21,907.87"
24-Jul-2021,Commission,00.00,"2,434.21","19,473.66"
24-Jul-2021,Reversal,00.00,"9,736.83","9,736.83"
24-Jul-2021,Cash,00.00,"1,217.10","8,519.73"
24-Jul-2021,Bill,00.00,"1,419.96","7,099.78"
24-Jul-2021,Cash,07.00,00.00,"7,106.78"
24-Jul-2021,Commission,"20,306.86",00.00,"27,413.64"
24-Jul-2021,ATM,"1,798,090.75",00.00,"1,825,504.39"
24-Jul-2021,Debit Card,03.48,00.00,"1,825,507.87"
24-Jul-2021,Tax,00.00,"260,786.84","1,564,721.03"
24-Jul-2021,Tax,"1,765,954.00",00.00,"3,330,675.03"
24-Jul-2021,NEFT,00.00,"555,112.51","2,775,562.52"
24-Jul-2021,Interest,706.90,00.00,"2,776,269.42"
24-Jul-2021,Purchase,00.00,"555,253.88","2,221,015.54"
24-Jul-2021,Miscellaneous,06.10,00.00,"2,221,021.64"
24-Jul-2021,Commission,00.00,"555,255.41","1,665,766.23"
24-Jul-2021,IMPS,209.00,00.00,"1,665,975.23"
24-Jul-2021,ATM,868.90,00.00,"1,666,844.13"
24-Jul-2021,NEFT,"3,167.11",00.00,"1,670,011.24"
24-Jul-2021,RTGS,"989,220.00",00.00,"2,659,231.24"
24-Jul-2021,Commission,"924,282.00",00.00,"3,583,513.24"
24-Jul-2021,Reversal,00.00,"511,930.46","3,071,582.78"
24-Jul-2021,Cheque,"55,444.00",00.00,"3,127,026.78"
24-Jul-2021,NEFT,37.00,00.00,"3,127,063.78"
24-Jul-2021,RTGS,"1,359,412.00",00.00,"4,486,475.78"
24-Jul-2021,Commission,"100,908.00",00.00,"4,587,383.78"
24-Jul-2021,Cheque,"3,576.34",00.00,"4,590,960.12"
24-Jul-2021,Cash,53.00,00.00,"4,591,013.12"
24-Jul-2021,Bill,39.40,00.00,"4,591,052.52"
24-Jul-2021,Cash,00.00,"573,881.57","4,017,170.95"
24-Jul-2021,RTGS,"132,555.12",00.00,"4,149,726.07"
24-Jul-2021,Purchase,00.00,"1,383,242.02","2,766,484.05"
24-Jul-2021,Miscellaneous,00.00,"395,212.01","2,371,272.04"
24-Jul-2021,ATM,00.00,"296,409.01","2,074,863.04"
24-Jul-2021,Reversal,02.50,00.00,"2,074,865.54"
24-Jul-2021,RTGS,00.00,"2,074,865.54",00.00
24-Jul-2021,ATM,"368,421.50",00.00,"368,421.50"
24-Jul-2021,Bill,00.00,"368,421.50",00.00
24-Jul-2021,Cash,"14,394.23",00.00,"14,394.23"
25-Jul-2021,Bill,26.81,00.00,"14,421.04"
25-Jul-2021,RTGS,00.00,"2,884.21","11,536.83"
25-Jul-2021,Cash,"7,337.88",00.00,"18,874.71"
25-Jul-2021,Bill,"16,420.00",00.00,"35,294.71"
25-Jul-2021,Cash,00.00,"3,921.63","31,373.08"
25-Jul-2021,Reversal,436.95,00.00,"31,810.03"
26-Jul-2021,Transfer,00.00,"3,181.00","28,629.03"
26-Jul-2021,Purchase,00.00,"28,629.03",00.00
26-Jul-2021,Miscellaneous,"127,109.10",00.00,"127,109.10"
26-Jul-2021,Miscellaneous,31.00,00.00,"127,140.10"
26-Jul-2021,RTGS,05.00,00.00,"127,145.10"
26-Jul-2021,Purchase,07.37,00.00,"127,152.47"
26-Jul-2021,IMPS,00.00,"127,152.47",00.00
26-Jul-2021,ATM,"164,794.20",00.00,"164,794.20"
26-Jul-2021,Cash,00.00,"41,198.55","123,595.65"
26-Jul-2021,Tax,"21,194.00",00.00,"144,789.65"
26-Jul-2021,ATM,"4,073.00",00.00,"148,862.65"
26-Jul-2021,Purchase,00.00,"37,215.66","111,646.99"
26-Jul-2021,Miscellaneous,00.00,"37,215.66","74,431.33"
26-Jul-2021,Debit Card,285.80,00.00,"74,717.13"
26-Jul-2021,Cash,"1,005.00",00.00,"75,722.13"
26-Jul-2021,Miscellaneous,00.00,"9,465.27","66,256.86"
26-Jul-2021,Reversal,765.95,00.00,"67,022.81"
26-Jul-2021,Miscellaneous,"1,586,737.00",00.00,"1,653,759.81"
26-Jul-2021,NEFT,49.00,00.00,"1,653,808.81"
26-Jul-2021,Tax,00.00,"183,756.53","1,470,052.28"
26-Jul-2021,RTGS,00.00,"183,756.54","1,286,295.75"
26-Jul-2021,ATM,34.11,00.00,"1,286,329.86"
26-Jul-2021,ATM,00.00,"643,164.93","643,164.93"
26-Jul-2021,Debit Card,00.00,"91,880.70","551,284.23"
26-Jul-2021,Interest,00.00,"68,910.53","482,373.70"
26-Jul-2021,Tax,01.42,00.00,"482,375.12"
26-Jul-2021,ATM,456.50,00.00,"482,831.62"
26-Jul-2021,Transfer,00.00,"482,831.62",00.00
26-Jul-2021,Transfer,"5,540.25",00.00,"5,540.25"
27-Jul-2021,Purchase,"3,780.00",00.00,"9,320.25"
27-Jul-2021,RTGS,52.00,00.00,"9,372.25"
27-Jul-2021,Cheque,00.00,"9,372.25",00.00
27-Jul-2021,Purchase,30.00,00.00,30.00
27-Jul-2021,Purchase,"31,236.00",00.00,"31,266.00"
27-Jul-2021,Purchase,"2,775.00",00.00,"34,041.00"
27-Jul-2021,RTGS,03.60,00.00,"34,044.60"
27-Jul-2021,Commission,04.00,00.00,"34,048.60"
27-Jul-2021,Purchase,00.00,"3,404.86","30,643.74"
27-Jul-2021,ATM,00.00,"3,404.86","27,238.88"
27-Jul-2021,IMPS,"133,418.00",00.00,"160,656.88"
27-Jul-2021,ATM,778.92,00.00,"161,435.80"
27-Jul-2021,NEFT,00.00,"40,358.95","121,076.85"
27-Jul-2021,Interest,00.00,"15,134.61","105,942.24"
27-Jul-2021,NEFT,00.00,"17,657.04","88,285.20"
27-Jul-2021,NEFT,00.00,"44,142.60","44,142.60"
27-Jul-2021,Bill,"13,241.50",00.00,"57,384.10"
27-Jul-2021,Tax,00.00,"8,197.73","49,186.37"
27-Jul-2021,Interest,06.30,00.00,"49,192.67"
28-Jul-2021,Tax,00.00,"4,919.27","44,273.40"
28-Jul-2021,Debit Card,"32,408.14",00.00,"76,681.54"
28-Jul-2021,Reversal,06.36,00.00,"76,687.90"
28-Jul-2021,Interest,00.00,"25,562.63","51,125.27"
28-Jul-2021,Debit Card,"3,011.10",00.00,"54,136.37"
28-Jul-2021,Purchase,00.00,"9,022.73","45,113.64"
28-Jul-2021,Cash,00.00,"5,012.63","40,101.01"
28-Jul-2021,ATM,00.00,"5,012.63","35,088.38"
28-Jul-2021,Cash,00.00,"3,898.71","31,189.67"
28-Jul-2021,IMPS,00.00,"5,198.28","25,991.39"
28-Jul-2021,Reversal,"6,658.30",00.00,"32,649.69"
28-Jul-2021,Purchase,00.00,"4,664.24","27,985.45"
28-Jul-2021,IMPS,"413,608.25",00.00,"441,593.70"
28-Jul-2021,NEFT,06.90,00.00,"441,600.60"
28-Jul-2021,Debit Card,"317,414.00",00.00,"759,014.60"
28-Jul-2021,Debit Card,00.00,"108,430.66","650,583.94"
28-Jul-2021,Reversal,"161,737.00",00.00,"812,320.94"
28-Jul-2021,Bill,"435,445.00",00.00,"1,247,765.94"
28-Jul-2021,IMPS,368.00,00.00,"1,248,133.94"
28-Jul-2021,Tax,00.00,"1,248,133.94",00.00
28-Jul-2021,Cheque,332.22,00.00,332.22
28-Jul-2021,Transfer,"29,475.00",00.00,"29,807.22"
28-Jul-2021,Reversal,00.00,"4,967.87","24,839.35"
28-Jul-2021,Transfer,00.00,"4,967.87","19,871.48"
28-Jul-2021,Miscellaneous,00.00,"2,207.94","17,663.54"
28-Jul-2021,Tax,00.00,"8,831.77","8,831.77"
28-Jul-2021,Interest,00.00,"1,766.35","7,065.42"
28-Jul-2021,NEFT,00.00,"3,532.71","3,532.71"
29-Jul-2021,Interest,00.00,706.54,"2,826.17"
29-Jul-2021,ATM,00.00,403.74,"2,422.43"
29-Jul-2021,Reversal,00.00,605.61,"1,816.82"
29-Jul-2021,Tax,"1,088,920.00",00.00,"1,090,736.82"
29-Jul-2021,Tax,00.00,"155,819.55","934,917.27"
29-Jul-2021,Interest,00.00,"93,491.73","841,425.54"
29-Jul-2021,Transfer,00.00,"841,425.54",00.00
29-Jul-2021,Interest,"1,559,442.00",00.00,"1,559,442.00"
29-Jul-2021,Debit Card,00.00,"389,860.50","1,169,581.50"
29-Jul-2021,Interest,00.00,"389,860.50","779,721.00"
29-Jul-2021,Interest,"3,244.00",00.00,"782,965.00"
29-Jul-2021,Cheque,00.00,"391,482.50","391,482.50"
29-Jul-2021,Cash,00.00,"130,494.17","260,988.33"
29-Jul-2021,Debit Card,"107,907.00",00.00,"368,895.33"
29-Jul-2021,IMPS,00.00,"61,482.56","307,412.78"
29-Jul-2021,Interest,00.00,"30,741.28","276,671.50"
29-Jul-2021,Debit Card,00.00,"276,671.50",00.00
29-Jul-2021,Cash,28.00,00.00,28.00
29-Jul-2021,Debit Card,00.00,03.50,24.50
29-Jul-2021,Tax,02.03,00.00,26.53
29-Jul-2021,Interest,00.00,13.27,13.26
29-Jul-2021,RTGS,"2,328.00",00.00,"2,341.26"
29-Jul-2021,Cheque,"1,469.20",00.00,"3,810.46"
29-Jul-2021,NEFT,00.00,"1,905.23","1,905.23"
29-Jul-2021,Miscellaneous,"27,377.00",00.00,"29,282.23"
29-Jul-2021,Bill,00.00,"3,253.58","26,028.65"
29-Jul-2021,Cheque,"3,216.00",00.00,"29,244.65"
30-Jul-2021,Reversal,"176,891.19",00.00,"206,135.84"
30-Jul-2021,Cash,00.00,"103,067.92","103,067.92"
30-Jul-2021,Bill,00.00,"12,883.49","90,184.43"
30-Jul-2021,Commission,00.00,"9,018.44","81,165.99"
30-Jul-2021,IMPS,00.00,"9,018.44","72,147.55"
30-Jul-2021,Cheque,02.00,00.00,"72,149.55"
30-Jul-2021,Tax,00.00,"14,429.91","57,719.64"
30-Jul-2021,Reversal,"1,904,266.00",00.00,"1,961,985.64"
30-Jul-2021,RTGS,"180,829.94",00.00,"2,142,815.58"
30-Jul-2021,Bill,00.00,"714,271.86","1,428,543.72"
30-Jul-2021,Bill,00.00,"357,135.93","1,071,407.79"
30-Jul-2021,Purchase,00.00,"357,135.93","714,271.86"
30-Jul-2021,Purchase,23.00,00.00,"714,294.86"
30-Jul-2021,Debit Card,00.00,"238,098.29","476,196.57"
31-Jul-2021,RTGS,"322,820.00",00.00,"799,016.57"
31-Jul-2021,Transfer,00.00,"88,779.62","710,236.95"
31-Jul-2021,Bill,"204,177.00",00.00,"914,413.95"
31-Jul-2021,Purchase,00.00,"130,630.56","783,783.39"
31-Jul-2021,Reversal,"13,336.00",00.00,"797,119.39"
31-Jul-2021,NEFT,17.69,00.00,"797,137.08"
31-Jul-2021,Cash,"23,019.00",00.00,"820,156.08"
31-Jul-2021,Cheque,00.00,"136,692.68","683,463.40"
31-Jul-2021,Reversal,00.00,"227,821.13","455,642.27"
31-Jul-2021,NEFT,264.63,00.00,"455,906.90"
31-Jul-2021,Purchase,00.00,"65,129.56","390,777.34"
31-Jul-2021,Reversal,00.00,"39,077.73","351,699.61"
01-Aug-2021,Transfer,06.29,00.00,"351,705.90"
01-Aug-2021,RTGS,"1,422.00",00.00,"353,127.90"
01-Aug-2021,Miscellaneous,147.00,00.00,"353,274.90"
01-Aug-2021,ATM,"25,971.00",00.00,"379,245.90"
01-Aug-2021,Debit Card,31.00,00.00,"379,276.90"
02-Aug-2021,Bill,"3,597.80",00.00,"382,874.70"
02-Aug-2021,Interest,22.46,00.00,"382,897.16"
02-Aug-2021,IMPS,00.00,"42,544.13","340,353.03"
02-Aug-2021,Commission,00.00,"37,817.00","302,536.03"
02-Aug-2021,Commission,"1,613.00",00.00,"304,149.03"
02-Aug-2021,NEFT,00.00,"76,037.26","228,111.77"
02-Aug-2021,Reversal,00.00,"38,018.63","190,093.14"
02-Aug-2021,Interest,"1,537,766.00",00.00,"1,727,859.14"
02-Aug-2021,IMPS,00.00,"863,929.57","863,929.57"
02-Aug-2021,Transfer,"1,473.10",00.00,"865,402.67"
02-Aug-2021,Debit Card,24.58,00.00,"865,427.25"
02-Aug-2021,RTGS,307.00,00.00,"865,734.25"
02-Aug-2021,Cheque,00.00,"288,578.08","577,156.17"
02-Aug-2021,Commission,407.50,00.00,"577,563.67"
02-Aug-2021,Commission,00.00,"115,512.73","462,050.94"
02-Aug-2021,RTGS,00.00,"231,025.47","231,025.47"
02-Aug-2021,Transfer,"1,492,519.75",00.00,"1,723,545.22"
03-Aug-2021,RTGS,00.00,"574,515.07","1,149,030.15"
03-Aug-2021,RTGS,"1,695,853.25",00.00,"2,844,883.40"
03-Aug-2021,NEFT,00.00,"711,220.85","2,133,662.55"
03-Aug-2021,RTGS,"29,281.42",00.00,"2,162,943.97"
03-Aug-2021,NEFT,05.44,00.00,"2,162,949.41"
03-Aug-2021,Transfer,00.00,"720,983.14","1,441,966.27"
03-Aug-2021,NEFT,00.00,"480,655.42","961,310.85"
03-Aug-2021,NEFT,00.00,"240,327.71","720,983.14"
03-Aug-2021,Cash,41.70,00.00,"721,024.84"
03-Aug-2021,Transfer,00.00,"103,003.55","618,021.29"
03-Aug-2021,Commission,"2,496.20",00.00,"620,517.49"
03-Aug-2021,Cash,00.00,"124,103.50","496,413.99"
03-Aug-2021,Purchase,"783,470.50",00.00,"1,279,884.49"
03-Aug-2021,Bill,17.00,00.00,"1,279,901.49"
03-Aug-2021,IMPS,00.00,"213,316.92","1,066,584.58"
03-Aug-2021,ATM,00.00,"106,658.46","959,926.12"
03-Aug-2021,NEFT,00.00,"319,975.37","639,950.75"
03-Aug-2021,Purchase,00.00,"91,421.54","548,529.21"
03-Aug-2021,Transfer,00.00,"182,843.07","365,686.14"
03-Aug-2021,RTGS,00.00,"73,137.23","292,548.91"
03-Aug-2021,Interest,247.50,00.00,"292,796.41"
03-Aug-2021,Cheque,00.00,"36,599.55","256,196.86"
03-Aug-2021,ATM,08.00,00.00,"256,204.86"
03-Aug-2021,Cheque,00.00,"32,025.61","224,179.25"
03-Aug-2021,Miscellaneous,21.42,00.00,"224,200.67"
03-Aug-2021,Debit Card,"3,328.94",00.00,"227,529.61"
03-Aug-2021,Transfer,00.00,"28,441.20","199,088.41"
03-Aug-2021,Purchase,319.70,00.00,"199,408.11"
03-Aug-2021,Cash,"1,813,146.50",00.00,"2,012,554.61"
03-Aug-2021,Cheque,00.00,"402,510.92","1,610,043.69"
03-Aug-2021,Bill,00.00,"1,610,043.69",00.00
03-Aug-2021,IMPS,"309,568.00",00.00,"309,568.00"
04-Aug-2021,RTGS,00.00,"77,392.00","232,176.00"
04-Aug-2021,Cheque,00.00,"46,435.20","185,740.80"
04-Aug-2021,Transfer,00.00,"18,574.08","167,166.72"
04-Aug-2021,Interest,00.00,"83,583.36","83,583.36"
04-Aug-2021,Cheque,"1,305,456.50",00.00,"1,389,039.86"
04-Aug-2021,Bill,00.00,"694,519.93","694,519.93"
04-Aug-2021,RTGS,00.00,"86,814.99","607,704.94"
04-Aug-2021,Reversal,461.77,00.00,"608,166.71"
04-Aug-2021,Cheque,480.96,00.00,"608,647.67"
04-Aug-2021,Transfer,"262,037.40",00.00,"870,685.07"
04-Aug-2021,Interest,00.00,"108,835.63","761,849.44"
04-Aug-2021,Purchase,00.00,"190,462.36","571,387.08"
04-Aug-2021,Interest,07.21,00.00,"571,394.29"
04-Aug-2021,Reversal,00.00,"571,394.29",00.00
05-Aug-2021,Transfer,"1,825,824.00",00.00,"1,825,824.00"
05-Aug-2021,Purchase,"3,840.90",00.00,"1,829,664.90"
05-Aug-2021,IMPS,99.62,00.00,"1,829,764.52"
05-Aug-2021,Tax,02.30,00.00,"1,829,766.82"
05-Aug-2021,Transfer,"2,790.77",00.00,"1,832,557.59"
05-Aug-2021,RTGS,51.00,00.00,"1,832,608.59"
05-Aug-2021,Bill,"3,852.30",00.00,"1,836,460.89"
05-Aug-2021,NEFT,03.70,00.00,"1,836,464.59"
05-Aug-2021,Commission,00.00,"459,116.15","1,377,348.44"
05-Aug-2021,Interest,00.00,"275,469.69","1,101,878.75"
05-Aug-2021,Cheque,19.77,00.00,"1,101,898.52"
05-Aug-2021,NEFT,00.00,"367,299.51","734,599.01"
05-Aug-2021,Transfer,00.00,"367,299.51","367,299.50"
05-Aug-2021,Purchase,"557,253.00",00.00,"924,552.50"
05-Aug-2021,Miscellaneous,00.00,"92,455.25","832,097.25"
05-Aug-2021,Purchase,00.00,"416,048.63","416,048.62"
05-Aug-2021,RTGS,00.00,"83,209.72","332,838.90"
05-Aug-2021,Miscellaneous,57.66,00.00,"332,896.56"
05-Aug-2021,NEFT,00.00,"41,612.07","291,284.49"
05-Aug-2021,Transfer,"1,189.81",00.00,"292,474.30"
05-Aug-2021,Miscellaneous,00.00,"29,247.43","263,226.87"
05-Aug-2021,Interest,00.00,"29,247.43","233,979.44"
05-Aug-2021,Bill,"73,721.00",00.00,"307,700.44"
05-Aug-2021,Tax,"1,747,104.25",00.00,"2,054,804.69"
05-Aug-2021,Debit Card,00.00,"410,960.94","1,643,843.75"
05-Aug-2021,Commission,500.09,00.00,"1,644,343.84"
05-Aug-2021,IMPS,00.00,"548,114.61","1,096,229.23"
05-Aug-2021,RTGS,"3,224.00",00.00,"1,099,453.23"
05-Aug-2021,Purchase,"2,496.70",00.00,"1,101,949.93"
05-Aug-2021,Bill,00.00,"110,194.99","991,754.94"
05-Aug-2021,IMPS,02.04,00.00,"991,756.98"
05-Aug-2021,Interest,00.00,"123,969.62","867,787.36"
05-Aug-2021,Reversal,"29,855.00",00.00,"897,642.36"
05-Aug-2021,RTGS,323.10,00.00,"897,965.46"
05-Aug-2021,Tax,00.00,"99,773.94","798,191.52"
05-Aug-2021,Purchase,279.00,00.00,"798,470.52"
05-Aug-2021,Purchase,00.00,"79,847.05","718,623.47"
05-Aug-2021,Tax,62.06,00.00,"718,685.53"
05-Aug-2021,RTGS,"2,000.00",00.00,"720,685.53"
05-Aug-2021,IMPS,00.00,"180,171.38","540,514.15"
05-Aug-2021,NEFT,00.00,"135,128.54","405,385.61"
05-Aug-2021,ATM,00.00,"405,385.61",00.00
05-Aug-2021,Debit Card,368.00,00.00,368.00
05-Aug-2021,NEFT,00.00,61.33,306.67
05-Aug-2021,ATM,509.00,00.00,815.67
05-Aug-2021,Reversal,00.00,90.63,725.04
05-Aug-2021,IMPS,00.00,80.56,644.48
05-Aug-2021,Cheque,84.00,00.00,728.48
05-Aug-2021,Miscellaneous,00.00,242.83,485.65
05-Aug-2021,Cash,00.00,60.71,424.94
05-Aug-2021,Interest,00.00,106.24,318.70
05-Aug-2021,Transfer,574.60,00.00,893.30
05-Aug-2021,Interest,00.00,893.30,00.00
05-Aug-2021,NEFT,364.50,00.00,364.50
05-Aug-2021,Purchase,"1,662.10",00.00,"2,026.60"
05-Aug-2021,Reversal,"28,647.00",00.00,"30,673.60"
05-Aug-2021,Transfer,00.00,"10,224.53","20,449.07"
05-Aug-2021,Miscellaneous,00.00,"5,112.27","15,336.80"
05-Aug-2021,Commission,00.00,"3,067.36","12,269.44"
05-Aug-2021,NEFT,"3,077.93",00.00,"15,347.37"
05-Aug-2021,Reversal,02.00,00.00,"15,349.37"
05-Aug-2021,IMPS,00.00,"1,918.67","13,430.70"
05-Aug-2021,Debit Card,00.00,"2,238.45","11,192.25"
05-Aug-2021,Cheque,20.87,00.00,"11,213.12"
05-Aug-2021,Tax,"1,879.20",00.00,"13,092.32"
05-Aug-2021,Interest,00.00,"1,636.54","11,455.78"
05-Aug-2021,Miscellaneous,866.27,00.00,"12,322.05"
05-Aug-2021,Miscellaneous,00.00,"6,161.03","6,161.02"
05-Aug-2021,Cash,00.00,770.13,"5,390.89"
05-Aug-2021,Interest,00.00,770.13,"4,620.76"
05-Aug-2021,ATM,449.10,00.00,"5,069.86"
05-Aug-2021,Miscellaneous,"6,566.07",00.00,"11,635.93"
06-Aug-2021,IMPS,00.00,"1,939.32","9,696.61"
06-Aug-2021,Debit Card,02.00,00.00,"9,698.61"
06-Aug-2021,Commission,00.00,"2,424.65","7,273.96"
06-Aug-2021,Transfer,209.54,00.00,"7,483.50"
06-Aug-2021,Cash,00.00,"7,483.50",00.00
06-Aug-2021,NEFT,"460,020.80",00.00,"460,020.80"
06-Aug-2021,Debit Card,00.00,"153,340.27","306,680.53"
06-Aug-2021,IMPS,00.00,"76,670.13","230,010.40"
06-Aug-2021,Interest,13.33,00.00,"230,023.73"
06-Aug-2021,Bill,00.00,"57,505.93","172,517.80"
06-Aug-2021,Purchase,"204,327.69",00.00,"376,845.49"
06-Aug-2021,Reversal,00.00,"47,105.69","329,739.80"
06-Aug-2021,NEFT,00.00,"164,869.90","164,869.90"
06-Aug-2021,Cheque,00.00,"32,973.98","131,895.92"
06-Aug-2021,Interest,"195,599.06",00.00,"327,494.98"
06-Aug-2021,Cheque,00.00,"40,936.87","286,558.11"
06-Aug-2021,Miscellaneous,00.00,"35,819.76","250,738.35"
06-Aug-2021,Reversal,"21,006.20",00.00,"271,744.55"
06-Aug-2021,Cash,82.70,00.00,"271,827.25"
06-Aug-2021,Cheque,"2,631.70",00.00,"274,458.95"
06-Aug-2021,Bill,00.00,"27,445.90","247,013.06"
06-Aug-2021,Bill,"1,613,569.00",00.00,"1,860,582.06"
06-Aug-2021,Interest,00.00,"232,572.76","1,628,009.30"
06-Aug-2021,RTGS,25.00,00.00,"1,628,034.30"
06-Aug-2021,Debit Card,00.00,"325,606.86","1,302,427.44"
06-Aug-2021,Transfer,00.00,"1,302,427.44",00.00
06-Aug-2021,Miscellaneous,"14,351.60",00.00,"14,351.60"
06-Aug-2021,RTGS,00.00,"1,435.16","12,916.44"
06-Aug-2021,ATM,"207,586.40",00.00,"220,502.84"
06-Aug-2021,RTGS,"2,787.89",00.00,"223,290.73"
06-Aug-2021,RTGS,"28,070.57",00.00,"251,361.30"
06-Aug-2021,Reversal,00.00,"31,420.16","219,941.14"
06-Aug-2021,Interest,00.00,"219,941.14",00.00
06-Aug-2021,NEFT,58.85,00.00,58.85
06-Aug-2021,Miscellaneous,00.00,06.54,52.31
06-Aug-2021,Debit Card,00.00,08.72,43.59
06-Aug-2021,NEFT,00.00,21.80,21.80
06-Aug-2021,RTGS,00.00,21.80,00.00
06-Aug-2021,NEFT,"241,791.31",00.00,"241,791.31"
07-Aug-2021,Cheque,30.00,00.00,"241,821.31"
07-Aug-2021,Bill,05.41,00.00,"241,826.72"
07-Aug-2021,Debit Card,"1,185,184.00",00.00,"1,427,010.72"
07-Aug-2021,RTGS,06.80,00.00,"1,427,017.52"
07-Aug-2021,IMPS,00.00,"158,557.50","1,268,460.02"
07-Aug-2021,Debit Card,07.00,00.00,"1,268,467.02"
07-Aug-2021,Miscellaneous,07.00,00.00,"1,268,474.02"
07-Aug-2021,Commission,214.40,00.00,"1,268,688.42"
07-Aug-2021,Miscellaneous,00.00,"253,737.68","1,014,950.74"
07-Aug-2021,Bill,00.00,"126,868.84","888,081.90"
07-Aug-2021,RTGS,"2,992.32",00.00,"891,074.22"
07-Aug-2021,Interest,12.04,00.00,"891,086.26"
07-Aug-2021,Tax,13.00,00.00,"891,099.26"
07-Aug-2021,IMPS,00.00,"891,099.26",00.00
07-Aug-2021,Cheque,"1,257,752.80",00.00,"1,257,752.80"
08-Aug-2021,Cheque,00.00,"179,678.97","1,078,073.83"
08-Aug-2021,Interest,367.00,00.00,"1,078,440.83"
08-Aug-2021,Transfer,23.00,00.00,"1,078,463.83"
08-Aug-2021,Debit Card,"95,685.00",00.00,"1,174,148.83"
08-Aug-2021,Cash,00.00,"130,460.98","1,043,687.85"
08-Aug-2021,Transfer,"2,108.10",00.00,"1,045,795.95"
08-Aug-2021,Commission,00.00,"104,579.60","941,216.36"
08-Aug-2021,Purchase,45.80,00.00,"941,262.16"
08-Aug-2021,Cheque,00.00,"470,631.08","470,631.08"
08-Aug-2021,Reversal,00.00,"58,828.89","411,802.20"
08-Aug-2021,IMPS,00.00,"102,950.55","308,851.65"
08-Aug-2021,Cash,"175,046.20",00.00,"483,897.85"
08-Aug-2021,ATM,00.00,"483,897.85",00.00
08-Aug-2021,Cash,"191,994.91",00.00,"191,994.91"
08-Aug-2021,Tax,00.00,"19,199.49","172,795.42"
08-Aug-2021,IMPS,00.00,"172,795.42",00.00
08-Aug-2021,Cash,40.00,00.00,40.00
08-Aug-2021,Cheque,00.00,13.33,26.67
08-Aug-2021,ATM,00.00,02.67,24.00
08-Aug-2021,Miscellaneous,00.00,24.00,00.00
08-Aug-2021,ATM,145.50,00.00,145.50
08-Aug-2021,Debit Card,"32,831.70",00.00,"32,977.20"
08-Aug-2021,Debit Card,07.00,00.00,"32,984.20"
08-Aug-2021,RTGS,374.00,00.00,"33,358.20"
08-Aug-2021,Bill,38.10,00.00,"33,396.30"
08-Aug-2021,NEFT,00.00,"3,339.63","30,056.67"
08-Aug-2021,Interest,01.00,00.00,"30,057.67"
08-Aug-2021,IMPS,"10,647.00",00.00,"40,704.67"
08-Aug-2021,Tax,00.00,"13,568.22","27,136.45"
08-Aug-2021,Reversal,839.32,00.00,"27,975.77"
08-Aug-2021,Transfer,00.00,"9,325.26","18,650.51"
08-Aug-2021,RTGS,00.23,00.00,"18,650.74"
08-Aug-2021,Interest,00.00,"2,072.30","16,578.44"
08-Aug-2021,Tax,00.00,"16,578.44",00.00
08-Aug-2021,Cheque,"1,235,032.00",00.00,"1,235,032.00"
08-Aug-2021,Interest,"1,342.60",00.00,"1,236,374.60"
08-Aug-2021,Debit Card,00.00,"1,236,374.60",00.00
08-Aug-2021,NEFT,05.87,00.00,05.87
09-Aug-2021,Transfer,"27,371.00",00.00,"27,376.87"
09-Aug-2021,Commission,00.00,"4,562.81","22,814.06"
09-Aug-2021,Commission,00.00,"3,802.34","19,011.72"
09-Aug-2021,Tax,00.00,"1,901.17","17,110.55"
09-Aug-2021,Interest,00.00,"4,277.64","12,832.91"
09-Aug-2021,IMPS,00.00,"4,277.64","8,555.27"
09-Aug-2021,Cash,00.00,"1,222.18","7,333.09"
09-Aug-2021,Bill,369.46,00.00,"7,702.55"
10-Aug-2021,ATM,00.00,"2,567.52","5,135.03"
10-Aug-2021,RTGS,01.00,00.00,"5,136.03"
10-Aug-2021,NEFT,01.00,00.00,"5,137.03"
10-Aug-2021,Cheque,"11,760.80",00.00,"16,897.83"
10-Aug-2021,RTGS,00.00,"3,379.57","13,518.26"
10-Aug-2021,Bill,00.00,"1,931.18","11,587.08"
10-Aug-2021,Purchase,00.00,"1,287.45","10,299.63"
10-Aug-2021,Cheque,00.00,"2,059.93","8,239.70"
10-Aug-2021,Debit Card,00.00,"1,647.94","6,591.76"
10-Aug-2021,Bill,"2,973.00",00.00,"9,564.76"
10-Aug-2021,Reversal,"1,179,008.50",00.00,"1,188,573.26"
10-Aug-2021,Interest,00.00,00.00,"1,188,573.26"
10-Aug-2021,Debit Card,00.00,"297,143.32","891,429.94"
11-Aug-2021,Cash,00.00,"445,714.97","445,714.97"
11-Aug-2021,Reversal,695.70,00.00,"446,410.67"
11-Aug-2021,NEFT,03.01,00.00,"446,413.68"
11-Aug-2021,ATM,"11,661.58",00.00,"458,075.26"
11-Aug-2021,Purchase,52.00,00.00,"458,127.26"
11-Aug-2021,Purchase,00.00,"152,709.09","305,418.17"
11-Aug-2021,Miscellaneous,00.00,"152,709.09","152,709.08"
11-Aug-2021,Debit Card,53.00,00.00,"152,762.08"
11-Aug-2021,Tax,05.90,00.00,"152,767.98"
11-Aug-2021,Reversal,05.00,00.00,"152,772.98"
11-Aug-2021,Cheque,"662,369.20",00.00,"815,142.18"
11-Aug-2021,Cash,00.00,"271,714.06","543,428.12"
11-Aug-2021,Transfer,00.00,"60,380.90","483,047.22"
11-Aug-2021,NEFT,"220,245.60",00.00,"703,292.82"
11-Aug-2021,Cheque,00.00,"351,646.41","351,646.41"
11-Aug-2021,Commission,00.00,"50,235.20","301,411.21"
11-Aug-2021,Interest,00.00,"50,235.20","251,176.01"
11-Aug-2021,NEFT,00.00,"41,862.67","209,313.34"
11-Aug-2021,RTGS,00.00,"69,771.11","139,542.23"
11-Aug-2021,Commission,"1,721,425.00",00.00,"1,860,967.23"
11-Aug-2021,Interest,"1,699,156.75",00.00,"3,560,123.98"
11-Aug-2021,Tax,01.00,00.00,"3,560,124.98"
11-Aug-2021,Reversal,331.05,00.00,"3,560,456.03"
11-Aug-2021,Miscellaneous,00.00,"3,560,456.03",00.00
11-Aug-2021,Transfer,"2,811.60",00.00,"2,811.60"
11-Aug-2021,NEFT,"1,135.30",00.00,"3,946.90"
11-Aug-2021,Commission,00.00,789.38,"3,157.52"
11-Aug-2021,Interest,46.00,00.00,"3,203.52"
11-Aug-2021,Transfer,"2,588.55",00.00,"5,792.07"
11-Aug-2021,IMPS,02.10,00.00,"5,794.17"
11-Aug-2021,ATM,00.00,"1,158.83","4,635.34"
11-Aug-2021,Purchase,00.00,927.07,"3,708.27"
11-Aug-2021,IMPS,00.00,"3,708.27",00.00
11-Aug-2021,Cheque,"2,560.35",00.00,"2,560.35"
11-Aug-2021,Interest,"15,543.30",00.00,"18,103.65"
11-Aug-2021,Commission,127.62,00.00,"18,231.27"
11-Aug-2021,Debit Card,00.00,"2,604.47","15,626.80"
11-Aug-2021,ATM,00.00,"2,604.47","13,022.33"
11-Aug-2021,Cash,00.00,"1,446.93","11,575.40"
11-Aug-2021,Commission,04.22,00.00,"11,579.62"
11-Aug-2021,Tax,21.00,00.00,"11,600.62"
11-Aug-2021,NEFT,"18,181.10",00.00,"29,781.72"
11-Aug-2021,Transfer,"3,359.16",00.00,"33,140.88"
11-Aug-2021,Reversal,27.90,00.00,"33,168.78"
11-Aug-2021,Commission,"140,548.80",00.00,"173,717.58"
11-Aug-2021,Cash,00.00,"24,816.80","148,900.78"
11-Aug-2021,Commission,"17,103.50",00.00,"166,004.28"
11-Aug-2021,NEFT,00.00,"83,002.14","83,002.14"
11-Aug-2021,IMPS,"6,278.00",00.00,"89,280.14"
11-Aug-2021,Bill,00.00,"29,760.05","59,520.09"
11-Aug-2021,Interest,431.30,00.00,"59,951.39"
11-Aug-2021,Cheque,169.30,00.00,"60,120.69"
11-Aug-2021,Commission,00.00,"60,120.69",00.00
11-Aug-2021,IMPS,03.50,00.00,03.50
11-Aug-2021,Debit Card,"3,398.69",00.00,"3,402.19"
11-Aug-2021,Purchase,00.00,567.03,"2,835.16"
11-Aug-2021,Commission,249.00,00.00,"3,084.16"
11-Aug-2021,Debit Card,00.00,771.04,"2,313.12"
11-Aug-2021,ATM,00.00,"2,313.12",00.00
11-Aug-2021,Interest,"2,672.19",00.00,"2,672.19"
11-Aug-2021,Cash,00.00,"1,336.10","1,336.10"
11-Aug-2021,Interest,00.00,133.61,"1,202.49"
11-Aug-2021,IMPS,00.00,"1,202.49",00.00
11-Aug-2021,Interest,"1,988.00",00.00,"1,988.00"
11-Aug-2021,Reversal,00.00,284.00,"1,704.00"
12-Aug-2021,Debit Card,00.00,426.00,"1,278.00"
12-Aug-2021,Transfer,01.99,00.00,"1,279.99"
13-Aug-2021,Cash,00.00,"1,279.99",00.00
13-Aug-2021,Miscellaneous,"854,393.00",00.00,"854,393.00"
13-Aug-2021,Purchase,00.00,"142,398.83","711,994.17"
13-Aug-2021,Tax,00.00,"88,999.27","622,994.90"
13-Aug-2021,Miscellaneous,00.00,"124,598.98","498,395.92"
13-Aug-2021,RTGS,00.00,"55,377.32","443,018.60"
13-Aug-2021,ATM,29.00,00.00,"443,047.60"
13-Aug-2021,Miscellaneous,37.00,00.00,"443,084.60"
13-Aug-2021,Cheque,"1,793,099.00",00.00,"2,236,183.60"
13-Aug-2021,Transfer,00.00,"745,394.53","1,490,789.07"
13-Aug-2021,Commission,00.00,"165,643.23","1,325,145.84"
13-Aug-2021,Purchase,"13,508.30",00.00,"1,338,654.14"
13-Aug-2021,Commission,00.00,"223,109.02","1,115,545.12"
13-Aug-2021,Miscellaneous,"251,474.22",00.00,"1,367,019.34"
13-Aug-2021,Cheque,00.00,"170,877.42","1,196,141.92"
13-Aug-2021,Debit Card,00.00,"119,614.19","1,076,527.73"
13-Aug-2021,Commission,05.00,00.00,"1,076,532.73"
13-Aug-2021,RTGS,"938,373.00",00.00,"2,014,905.73"
13-Aug-2021,Cheque,00.00,"251,863.22","1,763,042.51"
13-Aug-2021,Tax,"21,576.00",00.00,"1,784,618.51"
13-Aug-2021,Miscellaneous,"2,269.15",00.00,"1,786,887.66"
13-Aug-2021,Commission,00.00,"446,721.92","1,340,165.74"
13-Aug-2021,Commission,00.00,"167,520.72","1,172,645.02"
13-Aug-2021,Reversal,00.00,"146,580.63","1,026,064.39"
13-Aug-2021,Reversal,200.86,00.00,"1,026,265.25"
13-Aug-2021,Bill,91.08,00.00,"1,026,356.33"
14-Aug-2021,Reversal,00.00,"256,589.08","769,767.25"
14-Aug-2021,Miscellaneous,02.93,00.00,"769,770.18"
14-Aug-2021,IMPS,00.00,"76,977.02","692,793.16"
14-Aug-2021,Interest,00.00,"86,599.15","606,194.02"
14-Aug-2021,Interest,"449,379.50",00.00,"1,055,573.52"
15-Aug-2021,Interest,"945,411.00",00.00,"2,000,984.52"
15-Aug-2021,Miscellaneous,00.00,"666,994.84","1,333,989.68"
15-Aug-2021,Tax,00.00,"166,748.71","1,167,240.97"
15-Aug-2021,NEFT,"29,935.50",00.00,"1,197,176.47"
15-Aug-2021,Bill,00.00,"171,025.21","1,026,151.26"
15-Aug-2021,NEFT,00.00,"342,050.42","684,100.84"
15-Aug-2021,Commission,00.00,"342,050.42","342,050.42"
15-Aug-2021,IMPS,"3,135.90",00.00,"345,186.32"
15-Aug-2021,Bill,00.00,"43,148.29","302,038.03"
15-Aug-2021,Reversal,00.00,"60,407.61","241,630.42"
15-Aug-2021,IMPS,"178,443.00",00.00,"420,073.42"
15-Aug-2021,IMPS,09.03,00.00,"420,082.45"
15-Aug-2021,Debit Card,00.00,"42,008.25","378,074.20"
15-Aug-2021,ATM,00.00,"63,012.37","315,061.83"
15-Aug-2021,NEFT,00.00,"45,008.83","270,053.00"
15-Aug-2021,RTGS,"20,748.00",00.00,"290,801.00"
15-Aug-2021,RTGS,00.00,"41,543.00","249,258.00"
15-Aug-2021,Interest,02.36,00.00,"249,260.36"
15-Aug-2021,RTGS,"27,902.40",00.00,"277,162.76"
15-Aug-2021,RTGS,00.00,"30,795.86","246,366.90"
15-Aug-2021,ATM,"231,378.30",00.00,"477,745.20"
15-Aug-2021,Reversal,00.00,"47,774.52","429,970.68"
15-Aug-2021,Tax,"23,360.75",00.00,"453,331.43"
15-Aug-2021,Cheque,00.00,"113,332.86","339,998.57"
15-Aug-2021,Tax,00.00,"56,666.43","283,332.14"
15-Aug-2021,Miscellaneous,"2,166.03",00.00,"285,498.17"
15-Aug-2021,NEFT,"665,954.75",00.00,"951,452.92"
15-Aug-2021,RTGS,00.00,"475,726.46","475,726.46"
15-Aug-2021,Interest,00.00,"118,931.62","356,794.84"
15-Aug-2021,NEFT,395.41,00.00,"357,190.25"
15-Aug-2021,Interest,"3,932.80",00.00,"361,123.05"
15-Aug-2021,Bill,00.00,"40,124.78","320,998.27"
15-Aug-2021,Reversal,07.00,00.00,"321,005.27"
15-Aug-2021,Transfer,00.00,"160,502.64","160,502.64"
15-Aug-2021,Cheque,00.00,"32,100.53","128,402.11"
15-Aug-2021,Cheque,03.50,00.00,"128,405.61"
15-Aug-2021,Miscellaneous,"98,939.80",00.00,"227,345.41"
15-Aug-2021,Purchase,06.50,00.00,"227,351.91"
15-Aug-2021,RTGS,"203,799.50",00.00,"431,151.41"
15-Aug-2021,RTGS,969.70,00.00,"432,121.11"
15-Aug-2021,Interest,"1,185.00",00.00,"433,306.11"
15-Aug-2021,Reversal,"154,111.38",00.00,"587,417.49"
15-Aug-2021,Purchase,44.00,00.00,"587,461.49"
15-Aug-2021,Bill,"67,202.00",00.00,"654,663.49"
15-Aug-2021,NEFT,00.00,"130,932.70","523,730.79"
15-Aug-2021,NEFT,00.00,"52,373.08","471,357.71"
15-Aug-2021,Debit Card,07.07,00.00,"471,364.78"
15-Aug-2021,RTGS,00.00,"58,920.60","412,444.18"
15-Aug-2021,RTGS,00.00,"41,244.42","371,199.76"
15-Aug-2021,Bill,00.00,"123,733.25","247,466.51"
15-Aug-2021,Purchase,00.00,"24,746.65","222,719.86"
15-Aug-2021,Cash,"128,140.31",00.00,"350,860.17"
15-Aug-2021,RTGS,00.00,"116,953.39","233,906.78"
15-Aug-2021,Debit Card,00.00,"58,476.70","175,430.08"
15-Aug-2021,NEFT,00.00,"19,492.23","155,937.85"
15-Aug-2021,Interest,00.00,"19,492.23","136,445.62"
15-Aug-2021,IMPS,00.00,"136,445.62",00.00
15-Aug-2021,Bill,"3,974.95",00.00,"3,974.95"
15-Aug-2021,NEFT,23.60,00.00,"3,998.55"
15-Aug-2021,ATM,00.00,"1,332.85","2,665.70"
15-Aug-2021,RTGS,04.60,00.00,"2,670.30"
15-Aug-2021,Debit Card,"1,626.72",00.00,"4,297.02"
15-Aug-2021,Bill,"2,022.20",00.00,"6,319.22"
15-Aug-2021,Purchase,"1,368.30",00.00,"7,687.52"
15-Aug-2021,Miscellaneous,68.80,00.00,"7,756.32"
15-Aug-2021,RTGS,"3,263.00",00.00,"11,019.32"
15-Aug-2021,Transfer,"364,481.00",00.00,"375,500.32"
15-Aug-2021,Reversal,00.00,"41,722.26","333,778.06"
15-Aug-2021,Cash,00.00,"47,682.58","286,095.48"
15-Aug-2021,RTGS,"3,306.70",00.00,"289,402.18"
15-Aug-2021,Debit Card,"1,351,635.80",00.00,"1,641,037.98"
15-Aug-2021,IMPS,00.00,"234,434.00","1,406,603.98"
15-Aug-2021,Cheque,00.00,"140,660.40","1,265,943.58"
15-Aug-2021,Miscellaneous,00.00,"1,265,943.58",00.00
15-Aug-2021,RTGS,62.00,00.00,62.00
15-Aug-2021,Purchase,00.00,06.20,55.80
15-Aug-2021,Interest,00.00,06.98,48.82
15-Aug-2021,Tax,00.00,09.76,39.06
15-Aug-2021,ATM,"2,218.93",00.00,"2,257.99"
15-Aug-2021,Miscellaneous,"23,190.99",00.00,"25,448.98"
15-Aug-2021,Reversal,"2,022.00",00.00,"27,470.98"
16-Aug-2021,NEFT,00.00,"13,735.49","13,735.49"
16-Aug-2021,RTGS,00.00,"2,289.25","11,446.24"
16-Aug-2021,Tax,00.00,"2,861.56","8,584.68"
16-Aug-2021,NEFT,"2,119.90",00.00,"10,704.58"
16-Aug-2021,RTGS,"2,388.40",00.00,"13,092.98"
16-Aug-2021,NEFT,"20,793.50",00.00,"33,886.48"
16-Aug-2021,Purchase,"202,090.69",00.00,"235,977.17"
16-Aug-2021,Bill,03.00,00.00,"235,980.17"
16-Aug-2021,Interest,"21,239.90",00.00,"257,220.07"
16-Aug-2021,ATM,"21,042.30",00.00,"278,262.37"
16-Aug-2021,Miscellaneous,139.00,00.00,"278,401.37"
16-Aug-2021,Reversal,00.00,"27,840.14","250,561.23"
16-Aug-2021,Interest,274.00,00.00,"250,835.23"
16-Aug-2021,Cheque,"20,389.59",00.00,"271,224.82"
16-Aug-2021,ATM,"1,142,635.50",00.00,"1,413,860.32"
16-Aug-2021,Reversal,07.44,00.00,"1,413,867.76"
16-Aug-2021,Miscellaneous,"24,714.00",00.00,"1,438,581.76"
16-Aug-2021,Cheque,06.30,00.00,"1,438,588.06"
17-Aug-2021,ATM,00.00,"143,858.81","1,294,729.25"
18-Aug-2021,Interest,00.00,"1,294,729.25",00.00
18-Aug-2021,Reversal,00.00,00.00,00.00
18-Aug-2021,Tax,232.40,00.00,232.40
18-Aug-2021,Tax,328.00,00.00,560.40
18-Aug-2021,RTGS,"1,890.47",00.00,"2,450.87"
18-Aug-2021,Commission,00.00,490.17,"1,960.70"
18-Aug-2021,Interest,00.00,653.57,"1,307.13"
18-Aug-2021,Interest,00.07,00.00,"1,307.20"
18-Aug-2021,IMPS,194.70,00.00,"1,501.90"
18-Aug-2021,ATM,00.00,150.19,"1,351.71"
18-Aug-2021,NEFT,168.40,00.00,"1,520.11"
18-Aug-2021,Bill,00.00,380.03,"1,140.08"
18-Aug-2021,RTGS,00.00,"1,140.08",00.00
18-Aug-2021,IMPS,435.71,00.00,435.71
18-Aug-2021,Miscellaneous,00.00,87.14,348.57
18-Aug-2021,Reversal,"1,369.00",00.00,"1,717.57"
18-Aug-2021,IMPS,00.00,343.51,"1,374.06"
18-Aug-2021,Bill,00.00,274.81,"1,099.25"
18-Aug-2021,RTGS,44.57,00.00,"1,143.82"
18-Aug-2021,Debit Card,00.00,571.91,571.91
18-Aug-2021,ATM,00.00,190.64,381.27
18-Aug-2021,Transfer,00.00,54.47,326.80
18-Aug-2021,Transfer,"6,663.00",00.00,"6,989.80"
18-Aug-2021,IMPS,00.00,"6,989.80",00.00
18-Aug-2021,Interest,515.88,00.00,515.88
18-Aug-2021,Reversal,00.00,51.59,464.29
18-Aug-2021,Miscellaneous,00.00,154.76,309.53
18-Aug-2021,RTGS,"3,523.00",00.00,"3,832.53"
18-Aug-2021,NEFT,"137,580.00",00.00,"141,412.53"
18-Aug-2021,IMPS,"1,715,789.00",00.00,"1,857,201.53"
18-Aug-2021,Debit Card,00.70,00.00,"1,857,202.23"
18-Aug-2021,Transfer,216.00,00.00,"1,857,418.23"
18-Aug-2021,Tax,04.88,00.00,"1,857,423.11"
18-Aug-2021,Cash,00.00,"928,711.56","928,711.56"
18-Aug-2021,Interest,"250,560.47",00.00,"1,179,272.03"
18-Aug-2021,ATM,582.67,00.00,"1,179,854.70"
18-Aug-2021,RTGS,00.00,"196,642.45","983,212.25"
18-Aug-2021,Debit Card,00.00,"122,901.53","860,310.72"
18-Aug-2021,Debit Card,"105,751.00",00.00,"966,061.72"
18-Aug-2021,Transfer,75.00,00.00,"966,136.72"
18-Aug-2021,Tax,"1,095.02",00.00,"967,231.74"
18-Aug-2021,Tax,00.00,"96,723.17","870,508.57"
18-Aug-2021,Cheque,00.00,"87,050.86","783,457.71"
18-Aug-2021,Debit Card,00.00,"130,576.29","652,881.42"
18-Aug-2021,Miscellaneous,255.30,00.00,"653,136.72"
18-Aug-2021,Tax,00.00,"65,313.67","587,823.05"
18-Aug-2021,Commission,836.00,00.00,"588,659.05"
18-Aug-2021,Reversal,00.00,"588,659.05",00.00
18-Aug-2021,Cash,"192,542.30",00.00,"192,542.30"
18-Aug-2021,NEFT,287.70,00.00,"192,830.00"
18-Aug-2021,Purchase,"27,058.20",00.00,"219,888.20"
18-Aug-2021,IMPS,00.00,"27,486.03","192,402.18"
18-Aug-2021,Miscellaneous,00.00,"32,067.03","160,335.15"
19-Aug-2021,Debit Card,"1,265.72",00.00,"161,600.87"
19-Aug-2021,NEFT,"1,996.90",00.00,"163,597.77"
19-Aug-2021,ATM,00.00,"54,532.59","109,065.18"
19-Aug-2021,Interest,00.00,"12,118.35","96,946.83"
19-Aug-2021,NEFT,"91,199.20",00.00,"188,146.03"
19-Aug-2021,Reversal,73.70,00.00,"188,219.73"
19-Aug-2021,Transfer,00.00,"37,643.95","150,575.78"
19-Aug-2021,Transfer,00.00,"75,287.89","75,287.89"
19-Aug-2021,NEFT,47.00,00.00,"75,334.89"
19-Aug-2021,Miscellaneous,295.88,00.00,"75,630.77"
19-Aug-2021,Reversal,29.70,00.00,"75,660.47"
19-Aug-2021,Transfer,"1,877,566.00",00.00,"1,953,226.47"
19-Aug-2021,Miscellaneous,63.60,00.00,"1,953,290.07"
19-Aug-2021,Cheque,57.60,00.00,"1,953,347.67"
19-Aug-2021,Commission,00.00,"244,168.46","1,709,179.21"
19-Aug-2021,Transfer,46.51,00.00,"1,709,225.72"
19-Aug-2021,Commission,"2,379.70",00.00,"1,711,605.42"
19-Aug-2021,RTGS,00.00,"1,711,605.42",00.00
19-Aug-2021,Debit Card,64.34,00.00,64.34
19-Aug-2021,Bill,07.00,00.00,71.34
19-Aug-2021,Tax,"109,708.80",00.00,"109,780.14"
19-Aug-2021,Cash,00.00,"36,593.38","73,186.76"
19-Aug-2021,Cash,00.00,"8,131.86","65,054.90"
19-Aug-2021,Cheque,00.00,"13,010.98","52,043.92"
19-Aug-2021,Miscellaneous,00.00,"13,010.98","39,032.94"
19-Aug-2021,Interest,"2,975.04",00.00,"42,007.98"
19-Aug-2021,Cash,"613,826.00",00.00,"655,833.98"
19-Aug-2021,ATM,762.80,00.00,"656,596.78"
19-Aug-2021,NEFT,00.00,"82,074.60","574,522.18"
19-Aug-2021,IMPS,"1,619,880.00",00.00,"2,194,402.18"
20-Aug-2021,Miscellaneous,00.00,"1,097,201.09","1,097,201.09"
20-Aug-2021,RTGS,236.00,00.00,"1,097,437.09"
20-Aug-2021,Transfer,"30,357.11",00.00,"1,127,794.20"
20-Aug-2021,Commission,00.00,"161,113.46","966,680.74"
20-Aug-2021,NEFT,00.00,"138,097.25","828,583.49"
20-Aug-2021,Interest,00.00,"828,583.49",00.00
20-Aug-2021,Tax,"17,155.28",00.00,"17,155.28"
20-Aug-2021,Interest,19.00,00.00,"17,174.28"
20-Aug-2021,Bill,"107,886.40",00.00,"125,060.68"
20-Aug-2021,Interest,00.00,"17,865.81","107,194.87"
20-Aug-2021,Purchase,00.00,"35,731.62","71,463.25"
21-Aug-2021,ATM,00.00,"23,821.08","47,642.17"
21-Aug-2021,Tax,00.00,"7,940.36","39,701.81"
21-Aug-2021,RTGS,00.00,"4,962.73","34,739.08"
21-Aug-2021,Debit Card,18.60,00.00,"34,757.68"
21-Aug-2021,RTGS,00.00,"34,757.68",00.00
21-Aug-2021,Cheque,"2,654.00",00.00,"2,654.00"
21-Aug-2021,Commission,"183,991.20",00.00,"186,645.20"
21-Aug-2021,RTGS,"1,445,171.00",00.00,"1,631,816.20"
22-Aug-2021,Cash,"257,308.84",00.00,"1,889,125.04"
22-Aug-2021,Reversal,00.00,"269,875.01","1,619,250.03"
22-Aug-2021,Commission,00.00,"231,321.43","1,387,928.60"
23-Aug-2021,Cheque,03.45,00.00,"1,387,932.05"
23-Aug-2021,Miscellaneous,00.00,"138,793.21","1,249,138.84"
23-Aug-2021,Cheque,00.00,"1,249,138.84",00.00
23-Aug-2021,Bill,"1,489,759.00",00.00,"1,489,759.00"
23-Aug-2021,Miscellaneous,00.00,"186,219.88","1,303,539.12"
23-Aug-2021,RTGS,00.00,"162,942.39","1,140,596.73"
23-Aug-2021,Debit Card,52.10,00.00,"1,140,648.83"
23-Aug-2021,RTGS,00.00,"190,108.14","950,540.69"
23-Aug-2021,IMPS,"27,568.81",00.00,"978,109.50"
23-Aug-2021,Purchase,00.00,"326,036.50","652,073.00"
23-Aug-2021,Bill,00.00,"326,036.50","326,036.50"
23-Aug-2021,Bill,"238,448.70",00.00,"564,485.20"
23-Aug-2021,ATM,00.00,"188,161.73","376,323.47"
23-Aug-2021,Cash,00.00,"62,720.58","313,602.89"
23-Aug-2021,NEFT,248.50,00.00,"313,851.39"
23-Aug-2021,Cash,"50,289.00",00.00,"364,140.39"
23-Aug-2021,Commission,00.00,"121,380.13","242,760.26"
23-Aug-2021,Debit Card,00.00,"34,680.04","208,080.22"
23-Aug-2021,Transfer,"1,369,291.50",00.00,"1,577,371.72"
23-Aug-2021,NEFT,00.00,"175,263.52","1,402,108.20"
23-Aug-2021,Miscellaneous,10.00,00.00,"1,402,118.20"
23-Aug-2021,Bill,00.00,"175,264.78","1,226,853.42"
23-Aug-2021,Debit Card,06.00,00.00,"1,226,859.42"
23-Aug-2021,Commission,00.00,"153,357.43","1,073,501.99"
23-Aug-2021,Interest,402.60,00.00,"1,073,904.59"
23-Aug-2021,Tax,473.60,00.00,"1,074,378.19"
23-Aug-2021,Commission,04.17,00.00,"1,074,382.36"
23-Aug-2021,Purchase,00.00,"537,191.18","537,191.18"
23-Aug-2021,Miscellaneous,431.00,00.00,"537,622.18"
23-Aug-2021,Commission,00.00,"53,762.22","483,859.96"
23-Aug-2021,Reversal,00.00,"69,122.85","414,737.11"
23-Aug-2021,Debit Card,"1,418,708.00",00.00,"1,833,445.11"
23-Aug-2021,Bill,00.00,"366,689.02","1,466,756.09"
23-Aug-2021,RTGS,"25,453.28",00.00,"1,492,209.37"
23-Aug-2021,Reversal,00.00,"149,220.94","1,342,988.43"
23-Aug-2021,IMPS,00.00,"1,342,988.43",00.00
23-Aug-2021,Cash,426.67,00.00,426.67
23-Aug-2021,Commission,00.00,42.67,384.00
23-Aug-2021,Miscellaneous,"764,530.50",00.00,"764,914.50"
23-Aug-2021,Cheque,00.00,"127,485.75","637,428.75"
23-Aug-2021,ATM,"15,364.19",00.00,"652,792.94"
23-Aug-2021,Miscellaneous,482.92,00.00,"653,275.86"
23-Aug-2021,Debit Card,"148,482.00",00.00,"801,757.86"
23-Aug-2021,Cheque,00.00,"133,626.31","668,131.55"
23-Aug-2021,Bill,00.00,"66,813.16","601,318.40"
23-Aug-2021,Interest,00.00,"66,813.16","534,505.24"
23-Aug-2021,Transfer,00.00,"267,252.62","267,252.62"
23-Aug-2021,Purchase,00.00,"89,084.21","178,168.41"
23-Aug-2021,Cash,00.00,"89,084.21","89,084.20"
23-Aug-2021,Miscellaneous,429.20,00.00,"89,513.40"
23-Aug-2021,Miscellaneous,00.00,"8,951.34","80,562.06"
23-Aug-2021,IMPS,00.00,"16,112.41","64,449.65"
23-Aug-2021,Debit Card,00.00,"32,224.83","32,224.82"
23-Aug-2021,Transfer,00.00,"3,580.54","28,644.28"
23-Aug-2021,Miscellaneous,"1,575.30",00.00,"30,219.58"
23-Aug-2021,Commission,"28,640.00",00.00,"58,859.58"
23-Aug-2021,Purchase,00.00,"19,619.86","39,239.72"
23-Aug-2021,RTGS,00.00,"4,359.97","34,879.75"
23-Aug-2021,Commission,00.00,"17,439.88","17,439.88"
23-Aug-2021,Miscellaneous,"69,917.20",00.00,"87,357.08"
23-Aug-2021,Miscellaneous,403.10,00.00,"87,760.18"
23-Aug-2021,NEFT,00.00,"10,970.02","76,790.16"
23-Aug-2021,Miscellaneous,00.00,"10,970.02","65,820.14"
23-Aug-2021,NEFT,00.00,"7,313.35","58,506.79"
23-Aug-2021,Transfer,"2,442.46",00.00,"60,949.25"
23-Aug-2021,Interest,29.70,00.00,"60,978.95"
23-Aug-2021,Bill,02.90,00.00,"60,981.85"
23-Aug-2021,Miscellaneous,00.00,"30,490.93","30,490.92"
23-Aug-2021,Cheque,"13,354.39",00.00,"43,845.31"
23-Aug-2021,RTGS,69.02,00.00,"43,914.33"
23-Aug-2021,RTGS,44.35,00.00,"43,958.68"
23-Aug-2021,Bill,"239,722.00",00.00,"283,680.68"
23-Aug-2021,Bill,00.00,"56,736.14","226,944.54"
23-Aug-2021,NEFT,00.00,"226,944.54",00.00
23-Aug-2021,NEFT,"24,044.69",00.00,"24,044.69"
23-Aug-2021,Tax,02.21,00.00,"24,046.90"
23-Aug-2021,Reversal,405.70,00.00,"24,452.60"
23-Aug-2021,Bill,02.00,00.00,"24,454.60"
23-Aug-2021,Debit Card,00.00,"3,056.83","21,397.78"
23-Aug-2021,Reversal,00.00,"2,377.53","19,020.25"
23-Aug-2021,NEFT,00.00,"9,510.13","9,510.12"
23-Aug-2021,Reversal,00.00,"3,170.04","6,340.08"
23-Aug-2021,Debit Card,"16,879.00",00.00,"23,219.08"
23-Aug-2021,Interest,112.30,00.00,"23,331.38"
23-Aug-2021,Miscellaneous,00.00,"2,333.14","20,998.24"
23-Aug-2021,Debit Card,00.00,"5,249.56","15,748.68"
23-Aug-2021,Reversal,01.10,00.00,"15,749.78"
23-Aug-2021,Debit Card,05.93,00.00,"15,755.71"
23-Aug-2021,NEFT,00.00,"3,938.93","11,816.78"
23-Aug-2021,Purchase,06.00,00.00,"11,822.78"
23-Aug-2021,Commission,132.90,00.00,"11,955.68"
23-Aug-2021,Reversal,"23,610.02",00.00,"35,565.70"
23-Aug-2021,ATM,02.20,00.00,"35,567.90"
23-Aug-2021,Tax,00.00,"3,556.79","32,011.11"
23-Aug-2021,Reversal,00.00,"6,402.22","25,608.89"
23-Aug-2021,Miscellaneous,37.19,00.00,"25,646.08"
23-Aug-2021,Transfer,400.00,00.00,"26,046.08"
23-Aug-2021,RTGS,"3,194.80",00.00,"29,240.88"
24-Aug-2021,Transfer,00.00,"2,924.09","26,316.79"
24-Aug-2021,NEFT,00.00,"3,289.60","23,027.19"
24-Aug-2021,Tax,"447,089.00",00.00,"470,116.19"
24-Aug-2021,ATM,00.00,"470,116.19",00.00
24-Aug-2021,Purchase,"18,012.50",00.00,"18,012.50"
24-Aug-2021,Miscellaneous,229.50,00.00,"18,242.00"
24-Aug-2021,IMPS,04.00,00.00,"18,246.00"
24-Aug-2021,NEFT,00.00,"2,280.75","15,965.25"
24-Aug-2021,Commission,"1,025,725.50",00.00,"1,041,690.75"
24-Aug-2021,Debit Card,"2,840.20",00.00,"1,044,530.95"
24-Aug-2021,Commission,00.00,"174,088.49","870,442.46"
24-Aug-2021,Interest,"1,206,843.00",00.00,"2,077,285.46"
24-Aug-2021,RTGS,04.35,00.00,"2,077,289.81"
24-Aug-2021,Debit Card,00.00,"259,661.23","1,817,628.58"
24-Aug-2021,Debit Card,06.82,00.00,"1,817,635.40"
24-Aug-2021,Tax,"1,381,646.00",00.00,"3,199,281.40"
24-Aug-2021,Cash,00.00,"399,910.18","2,799,371.22"
24-Aug-2021,Debit Card,00.00,"279,937.12","2,519,434.10"
24-Aug-2021,Debit Card,00.00,"503,886.82","2,015,547.28"
24-Aug-2021,Tax,"3,648.25",00.00,"2,019,195.53"
24-Aug-2021,Interest,00.00,"252,399.44","1,766,796.09"
24-Aug-2021,Tax,00.00,"883,398.05","883,398.04"
24-Aug-2021,Tax,00.00,"88,339.80","795,058.24"
24-Aug-2021,Bill,00.00,"132,509.71","662,548.53"
24-Aug-2021,Purchase,00.00,"94,649.79","567,898.74"
24-Aug-2021,Transfer,"1,182.05",00.00,"569,080.79"
24-Aug-2021,RTGS,00.00,"569,080.79",00.00
24-Aug-2021,Interest,"2,341.00",00.00,"2,341.00"
24-Aug-2021,IMPS,07.00,00.00,"2,348.00"
24-Aug-2021,Miscellaneous,"251,059.53",00.00,"253,407.53"
24-Aug-2021,Cash,00.00,"31,675.94","221,731.59"
24-Aug-2021,RTGS,243.90,00.00,"221,975.49"
24-Aug-2021,Commission,00.00,"55,493.87","166,481.62"
24-Aug-2021,Miscellaneous,00.00,"20,810.20","145,671.42"
24-Aug-2021,Cheque,585.00,00.00,"146,256.42"
24-Aug-2021,Interest,00.00,"29,251.28","117,005.14"
24-Aug-2021,Reversal,00.00,"16,715.02","100,290.12"
24-Aug-2021,Commission,"3,594.30",00.00,"103,884.42"
24-Aug-2021,Debit Card,02.40,00.00,"103,886.82"
24-Aug-2021,Tax,00.10,00.00,"103,886.92"
24-Aug-2021,Cash,260.38,00.00,"104,147.30"
24-Aug-2021,ATM,"19,655.58",00.00,"123,802.88"
24-Aug-2021,Debit Card,00.00,"123,802.88",00.00
24-Aug-2021,Reversal,04.60,00.00,04.60
24-Aug-2021,Commission,19.00,00.00,23.60
24-Aug-2021,Cheque,00.00,02.95,20.65
24-Aug-2021,Interest,"3,020.00",00.00,"3,040.65"
24-Aug-2021,Transfer,00.00,337.85,"2,702.80"
24-Aug-2021,RTGS,00.00,337.85,"2,364.95"
24-Aug-2021,IMPS,"701,579.20",00.00,"703,944.15"
24-Aug-2021,IMPS,00.00,"234,648.05","469,296.10"
24-Aug-2021,RTGS,"9,802.00",00.00,"479,098.10"
24-Aug-2021,ATM,00.00,"479,098.10",00.00
24-Aug-2021,Transfer,06.30,00.00,06.30
24-Aug-2021,Purchase,"1,621,248.00",00.00,"1,621,254.30"
24-Aug-2021,Purchase,437.98,00.00,"1,621,692.28"
24-Aug-2021,Interest,00.00,"162,169.23","1,459,523.05"
24-Aug-2021,Debit Card,00.00,"182,440.38","1,277,082.67"
24-Aug-2021,Purchase,"29,130.00",00.00,"1,306,212.67"
24-Aug-2021,ATM,94.00,00.00,"1,306,306.67"
24-Aug-2021,ATM,41.87,00.00,"1,306,348.54"
24-Aug-2021,Cheque,00.00,"326,587.14","979,761.40"
24-Aug-2021,Miscellaneous,"552,310.00",00.00,"1,532,071.40"
24-Aug-2021,RTGS,00.00,"383,017.85","1,149,053.55"
24-Aug-2021,Commission,00.00,"191,508.93","957,544.62"
24-Aug-2021,Commission,49.30,00.00,"957,593.92"
24-Aug-2021,Reversal,00.00,"159,598.99","797,994.93"
24-Aug-2021,Miscellaneous,04.00,00.00,"797,998.93"
24-Aug-2021,ATM,00.00,"88,666.55","709,332.38"
24-Aug-2021,Reversal,"3,901.00",00.00,"713,233.38"
24-Aug-2021,Interest,05.80,00.00,"713,239.18"
24-Aug-2021,NEFT,00.00,"101,891.31","611,347.87"
24-Aug-2021,Reversal,00.00,"61,134.79","550,213.08"
24-Aug-2021,Purchase,"3,054.00",00.00,"553,267.08"
24-Aug-2021,Bill,00.00,"55,326.71","497,940.37"
24-Aug-2021,Commission,00.00,"49,794.04","448,146.33"
24-Aug-2021,Commission,00.00,"56,018.29","392,128.04"
24-Aug-2021,RTGS,"1,318,016.00",00.00,"1,710,144.04"
24-Aug-2021,Reversal,00.00,"285,024.01","1,425,120.03"
24-Aug-2021,Commission,31.93,00.00,"1,425,151.96"
24-Aug-2021,Cheque,00.00,"178,144.00","1,247,007.96"
24-Aug-2021,Transfer,00.00,"623,503.98","623,503.98"
24-Aug-2021,RTGS,00.00,"311,751.99","311,751.99"
24-Aug-2021,ATM,"642,225.00",00.00,"953,976.99"
24-Aug-2021,Cheque,06.40,00.00,"953,983.39"
24-Aug-2021,Transfer,00.00,"190,796.68","763,186.71"
24-Aug-2021,Bill,"136,379.00",00.00,"899,565.71"
24-Aug-2021,Transfer,00.00,"99,951.75","799,613.96"
24-Aug-2021,Debit Card,00.00,"799,613.96",00.00
24-Aug-2021,Transfer,06.00,00.00,06.00
24-Aug-2021,Debit Card,33.00,00.00,39.00
24-Aug-2021,Commission,37.30,00.00,76.30
25-Aug-2021,Cheque,04.10,00.00,80.40
25-Aug-2021,Miscellaneous,"1,786,572.25",00.00,"1,786,652.65"
25-Aug-2021,IMPS,03.40,00.00,"1,786,656.05"
25-Aug-2021,Debit Card,00.00,"1,786,656.05",00.00
25-Aug-2021,Interest,"5,068.70",00.00,"5,068.70"
25-Aug-2021,Bill,00.00,844.78,"4,223.92"
25-Aug-2021,Miscellaneous,00.00,703.99,"3,519.93"
25-Aug-2021,Cash,"2,636.00",00.00,"6,155.93"
25-Aug-2021,NEFT,00.00,769.49,"5,386.44"
25-Aug-2021,Transfer,00.00,"1,077.29","4,309.15"
25-Aug-2021,Reversal,04.00,00.00,"4,313.15"
25-Aug-2021,Commission,00.00,"1,437.72","2,875.43"
25-Aug-2021,Miscellaneous,"1,694.40",00.00,"4,569.83"
25-Aug-2021,Cheque,"28,852.30",00.00,"33,422.13"
25-Aug-2021,Transfer,00.00,"3,342.21","30,079.92"
25-Aug-2021,ATM,"1,178,242.75",00.00,"1,208,322.67"
25-Aug-2021,NEFT,00.00,"151,040.33","1,057,282.34"
25-Aug-2021,Cheque,33.20,00.00,"1,057,315.54"
25-Aug-2021,ATM,07.00,00.00,"1,057,322.54"
25-Aug-2021,Tax,"111,754.72",00.00,"1,169,077.26"
25-Aug-2021,Transfer,38.54,00.00,"1,169,115.80"
25-Aug-2021,Transfer,641.90,00.00,"1,169,757.70"
25-Aug-2021,Debit Card,"1,958,117.00",00.00,"3,127,874.70"
25-Aug-2021,Tax,42.37,00.00,"3,127,917.07"
25-Aug-2021,Cheque,00.00,"446,845.30","2,681,071.77"
25-Aug-2021,Cash,00.00,"268,107.18","2,412,964.59"
25-Aug-2021,Purchase,495.42,00.00,"2,413,460.01"
25-Aug-2021,Commission,"99,515.00",00.00,"2,512,975.01"
25-Aug-2021,Purchase,00.00,"314,121.88","2,198,853.13"
25-Aug-2021,IMPS,00.00,"1,099,426.57","1,099,426.56"
25-Aug-2021,Cheque,43.30,00.00,"1,099,469.86"
25-Aug-2021,NEFT,04.15,00.00,"1,099,474.01"
25-Aug-2021,Commission,"58,629.56",00.00,"1,158,103.57"
25-Aug-2021,Cash,23.10,00.00,"1,158,126.67"
25-Aug-2021,IMPS,00.00,"115,812.67","1,042,314.00"
25-Aug-2021,Cash,"90,428.00",00.00,"1,132,742.00"
25-Aug-2021,NEFT,07.52,00.00,"1,132,749.52"
25-Aug-2021,Transfer,07.66,00.00,"1,132,757.18"
25-Aug-2021,Miscellaneous,00.00,"141,594.65","991,162.53"
25-Aug-2021,Transfer,00.00,"99,116.25","892,046.28"
25-Aug-2021,Reversal,"544,898.50",00.00,"1,436,944.78"
25-Aug-2021,Commission,00.00,"1,436,944.78",00.00
25-Aug-2021,IMPS,"10,264.44",00.00,"10,264.44"
25-Aug-2021,Transfer,"25,281.60",00.00,"35,546.04"
25-Aug-2021,IMPS,"209,539.69",00.00,"245,085.73"
25-Aug-2021,Cash,"1,582,765.00",00.00,"1,827,850.73"
25-Aug-2021,Cheque,00.00,"182,785.07","1,645,065.66"
25-Aug-2021,Miscellaneous,"96,923.00",00.00,"1,741,988.66"
25-Aug-2021,Miscellaneous,448.46,00.00,"1,742,437.12"
25-Aug-2021,Bill,00.00,"193,604.12","1,548,833.00"
25-Aug-2021,Bill,"101,106.00",00.00,"1,649,939.00"
25-Aug-2021,Cash,02.87,00.00,"1,649,941.87"
25-Aug-2021,Miscellaneous,00.00,"1,649,941.87",00.00
25-Aug-2021,Cheque,340.00,00.00,340.00
25-Aug-2021,Debit Card,00.00,85.00,255.00
25-Aug-2021,Purchase,00.00,127.50,127.50
25-Aug-2021,Transfer,"14,002.70",00.00,"14,130.20"
25-Aug-2021,Reversal,453.00,00.00,"14,583.20"
25-Aug-2021,ATM,00.00,"1,620.36","12,962.84"
25-Aug-2021,Bill,00.00,"12,962.84",00.00
25-Aug-2021,Tax,283.42,00.00,283.42
25-Aug-2021,Reversal,00.00,35.43,247.99
25-Aug-2021,Miscellaneous,558.00,00.00,805.99
26-Aug-2021,Cash,378.60,00.00,"1,184.59"
26-Aug-2021,Cheque,04.00,00.00,"1,188.59"
26-Aug-2021,ATM,"1,212,412.00",00.00,"1,213,600.59"
26-Aug-2021,Interest,"21,943.97",00.00,"1,235,544.56"
26-Aug-2021,Commission,00.00,"1,235,544.56",00.00
26-Aug-2021,NEFT,42.17,00.00,42.17
26-Aug-2021,Reversal,00.00,06.02,36.15
26-Aug-2021,Bill,61.64,00.00,97.79
26-Aug-2021,Cash,05.92,00.00,103.71
26-Aug-2021,Interest,04.18,00.00,107.89
26-Aug-2021,ATM,35.00,00.00,142.89
26-Aug-2021,Reversal,"31,691.81",00.00,"31,834.70"
26-Aug-2021,Bill,00.00,"3,537.19","28,297.51"
26-Aug-2021,Reversal,52.00,00.00,"28,349.51"
26-Aug-2021,IMPS,00.00,"14,174.76","14,174.76"
26-Aug-2021,Purchase,00.00,"2,362.46","11,812.30"
26-Aug-2021,Tax,785.30,00.00,"12,597.60"
26-Aug-2021,Bill,00.00,"1,259.76","11,337.84"
26-Aug-2021,Commission,00.00,"1,619.69","9,718.15"
26-Aug-2021,Tax,00.00,"4,859.08","4,859.08"
26-Aug-2021,Interest,"11,985.00",00.00,"16,844.08"
26-Aug-2021,Tax,00.00,"2,105.51","14,738.57"
26-Aug-2021,Miscellaneous,44.00,00.00,"14,782.57"
26-Aug-2021,NEFT,00.00,"14,782.57",00.00
26-Aug-2021,Tax,26.80,00.00,26.80
26-Aug-2021,Purchase,"27,724.10",00.00,"27,750.90"
26-Aug-2021,NEFT,"263,214.00",00.00,"290,964.90"
26-Aug-2021,NEFT,"252,428.00",00.00,"543,392.90"
26-Aug-2021,ATM,00.00,"77,627.56","465,765.34"
26-Aug-2021,NEFT,03.23,00.00,"465,768.57"
26-Aug-2021,Cash,00.00,"465,768.57",00.00
26-Aug-2021,Bill,"167,737.00",00.00,"167,737.00"
26-Aug-2021,Miscellaneous,"2,090,430.80",00.00,"2,258,167.80"
26-Aug-2021,Interest,00.00,"1,129,083.90","1,129,083.90"
26-Aug-2021,Transfer,00.00,"376,361.30","752,722.60"
26-Aug-2021,NEFT,00.00,"250,907.53","501,815.07"
26-Aug-2021,NEFT,00.00,"50,181.51","451,633.56"
26-Aug-2021,RTGS,"2,061.00",00.00,"453,694.56"
26-Aug-2021,Reversal,00.00,"113,423.64","340,270.92"
26-Aug-2021,Commission,00.00,"34,027.09","306,243.83"
26-Aug-2021,Cash,00.00,"38,280.48","267,963.35"
26-Aug-2021,Bill,00.00,"33,495.42","234,467.93"
26-Aug-2021,Commission,362.00,00.00,"234,829.93"
26-Aug-2021,NEFT,00.00,"117,414.97","117,414.96"
26-Aug-2021,Cash,00.00,"58,707.48","58,707.48"
27-Aug-2021,NEFT,765.00,00.00,"59,472.48"
27-Aug-2021,Bill,00.00,"7,434.06","52,038.42"
27-Aug-2021,Debit Card,00.00,"7,434.06","44,604.36"
27-Aug-2021,ATM,00.00,"5,575.55","39,028.82"
27-Aug-2021,Reversal,00.00,"4,336.54","34,692.28"
27-Aug-2021,RTGS,00.00,"8,673.07","26,019.21"
27-Aug-2021,NEFT,00.00,"8,673.07","17,346.14"
27-Aug-2021,RTGS,00.00,"5,782.05","11,564.09"
27-Aug-2021,Transfer,00.00,"1,927.35","9,636.74"
27-Aug-2021,NEFT,00.00,"1,204.59","8,432.15"
27-Aug-2021,ATM,00.00,936.91,"7,495.24"
27-Aug-2021,Interest,00.00,"1,873.81","5,621.43"
28-Aug-2021,Cash,43.00,00.00,"5,664.43"
28-Aug-2021,NEFT,"1,582.39",00.00,"7,246.82"
28-Aug-2021,Bill,00.00,"7,246.82",00.00
28-Aug-2021,Cash,07.87,00.00,07.87
28-Aug-2021,Debit Card,00.00,00.00,07.87
28-Aug-2021,Bill,00.00,07.87,00.00
28-Aug-2021,Reversal,"245,748.38",00.00,"245,748.38"
28-Aug-2021,Bill,00.00,"245,748.38",00.00
28-Aug-2021,Cash,"231,718.60",00.00,"231,718.60"
28-Aug-2021,Tax,558.59,00.00,"232,277.19"
28-Aug-2021,Bill,"969,646.00",00.00,"1,201,923.19"
28-Aug-2021,RTGS,"1,326,377.80",00.00,"2,528,300.99"
28-Aug-2021,Purchase,00.00,"252,830.10","2,275,470.89"
28-Aug-2021,Interest,00.00,"252,830.10","2,022,640.79"
28-Aug-2021,ATM,00.00,"505,660.20","1,516,980.59"
28-Aug-2021,Interest,00.00,"189,622.57","1,327,358.02"
28-Aug-2021,NEFT,"712,586.50",00.00,"2,039,944.52"
28-Aug-2021,Cash,00.00,"679,981.51","1,359,963.01"
28-Aug-2021,Debit Card,00.00,"169,995.38","1,189,967.63"
29-Aug-2021,Debit Card,00.00,"169,995.38","1,019,972.25"
30-Aug-2021,NEFT,"2,821.10",00.00,"1,022,793.35"
30-Aug-2021,Transfer,00.00,"255,698.34","767,095.01"
30-Aug-2021,Bill,00.00,"85,232.78","681,862.23"
30-Aug-2021,ATM,00.00,"136,372.45","545,489.78"
30-Aug-2021,Tax,00.00,"272,744.89","272,744.89"
30-Aug-2021,IMPS,00.00,"38,963.56","233,781.33"
30-Aug-2021,Debit Card,150.30,00.00,"233,931.63"
30-Aug-2021,NEFT,00.00,"33,418.80","200,512.83"
30-Aug-2021,Purchase,"3,048.93",00.00,"203,561.76"
30-Aug-2021,Miscellaneous,07.38,00.00,"203,569.14"
30-Aug-2021,Interest,"2,400.10",00.00,"205,969.24"
30-Aug-2021,RTGS,00.00,"34,328.21","171,641.03"
30-Aug-2021,RTGS,00.00,"24,520.15","147,120.88"
30-Aug-2021,Tax,"109,484.00",00.00,"256,604.88"
30-Aug-2021,Commission,48.60,00.00,"256,653.48"
30-Aug-2021,Reversal,05.89,00.00,"256,659.37"
30-Aug-2021,Miscellaneous,49.00,00.00,"256,708.37"
30-Aug-2021,IMPS,238.00,00.00,"256,946.37"
30-Aug-2021,IMPS,00.00,"32,118.30","224,828.07"
30-Aug-2021,Debit Card,00.00,"32,118.30","192,709.77"
30-Aug-2021,Miscellaneous,"948,620.50",00.00,"1,141,330.27"
30-Aug-2021,Miscellaneous,00.00,"114,133.03","1,027,197.24"
30-Aug-2021,Bill,267.00,00.00,"1,027,464.24"
30-Aug-2021,Debit Card,"32,377.00",00.00,"1,059,841.24"
30-Aug-2021,IMPS,07.40,00.00,"1,059,848.64"
30-Aug-2021,IMPS,"3,895.45",00.00,"1,063,744.09"
30-Aug-2021,Bill,00.00,"106,374.41","957,369.68"
30-Aug-2021,Debit Card,27.90,00.00,"957,397.58"
30-Aug-2021,Cash,00.00,"191,479.52","765,918.06"
30-Aug-2021,Interest,"2,006,186.00",00.00,"2,772,104.06"
30-Aug-2021,IMPS,00.00,"693,026.02","2,079,078.04"
30-Aug-2021,Bill,07.00,00.00,"2,079,085.04"
30-Aug-2021,Bill,00.00,"2,079,085.04",00.00
31-Aug-2021,ATM,"168,865.66",00.00,"168,865.66"
31-Aug-2021,Commission,06.70,00.00,"168,872.36"
31-Aug-2021,RTGS,00.00,"168,872.36",00.00
31-Aug-2021,Bill,42.32,00.00,42.32
31-Aug-2021,Debit Card,"506,896.20",00.00,"506,938.52"
31-Aug-2021,Miscellaneous,"3,979.78",00.00,"510,918.30"
01-Sep-2021,Transfer,"286,157.75",00.00,"797,076.05"
01-Sep-2021,Debit Card,00.00,"265,692.02","531,384.03"
01-Sep-2021,Bill,00.00,"531,384.03",00.00
01-Sep-2021,Bill,"29,168.50",00.00,"29,168.50"
01-Sep-2021,Interest,"30,149.00",00.00,"59,317.50"
01-Sep-2021,Cash,00.00,"9,886.25","49,431.25"
01-Sep-2021,ATM,00.00,"4,943.13","44,488.12"
01-Sep-2021,Tax,00.00,"4,448.81","40,039.31"
01-Sep-2021,Cash,00.00,"5,719.90","34,319.41"
01-Sep-2021,Purchase,00.00,"6,863.88","27,455.53"
01-Sep-2021,NEFT,"1,984,729.20",00.00,"2,012,184.73"
01-Sep-2021,Reversal,00.00,"201,218.47","1,810,966.26"
01-Sep-2021,IMPS,00.00,"362,193.25","1,448,773.01"
02-Sep-2021,Transfer,00.00,"206,967.57","1,241,805.44"
02-Sep-2021,RTGS,00.00,"206,967.57","1,034,837.87"
02-Sep-2021,Transfer,00.00,"114,981.99","919,855.88"
02-Sep-2021,Transfer,00.00,"114,981.99","804,873.90"
02-Sep-2021,RTGS,452.00,00.00,"805,325.90"
02-Sep-2021,IMPS,"1,347.00",00.00,"806,672.90"
02-Sep-2021,Tax,322.10,00.00,"806,995.00"
02-Sep-2021,IMPS,315.00,00.00,"807,310.00"
03-Sep-2021,Reversal,00.00,"100,913.75","706,396.25"
03-Sep-2021,Bill,"1,153,346.20",00.00,"1,859,742.45"
03-Sep-2021,Bill,00.00,"206,638.05","1,653,104.40"
03-Sep-2021,Cash,"1,490,911.80",00.00,"3,144,016.20"
03-Sep-2021,Cheque,00.47,00.00,"3,144,016.67"
03-Sep-2021,Cheque,"15,227.00",00.00,"3,159,243.67"
04-Sep-2021,IMPS,00.00,"351,027.07","2,808,216.60"
04-Sep-2021,Commission,00.00,"702,054.15","2,106,162.45"
04-Sep-2021,Purchase,09.41,00.00,"2,106,171.86"
04-Sep-2021,Bill,00.00,"210,617.19","1,895,554.67"
04-Sep-2021,Purchase,00.00,"379,110.93","1,516,443.74"
04-Sep-2021,NEFT,00.00,"379,110.94","1,137,332.80"
04-Sep-2021,Bill,00.00,"162,476.11","974,856.69"
04-Sep-2021,Cheque,00.00,"108,317.41","866,539.28"
04-Sep-2021,Bill,00.00,"144,423.21","722,116.07"
04-Sep-2021,Debit Card,"246,616.75",00.00,"968,732.82"
04-Sep-2021,Transfer,00.00,"968,732.82",00.00
04-Sep-2021,Bill,"25,946.20",00.00,"25,946.20"
05-Sep-2021,Transfer,00.00,"6,486.55","19,459.65"
05-Sep-2021,Interest,00.00,"3,243.28","16,216.38"
05-Sep-2021,Bill,"3,171.80",00.00,"19,388.18"
05-Sep-2021,ATM,18.70,00.00,"19,406.88"
05-Sep-2021,Debit Card,00.00,"19,406.88",00.00
05-Sep-2021,Miscellaneous,"101,571.80",00.00,"101,571.80"
05-Sep-2021,RTGS,00.00,"50,785.90","50,785.90"
05-Sep-2021,Cheque,"1,119,476.20",00.00,"1,170,262.10"
05-Sep-2021,RTGS,00.00,"234,052.42","936,209.68"
05-Sep-2021,Miscellaneous,38.00,00.00,"936,247.68"
05-Sep-2021,Commission,00.00,"156,041.28","780,206.40"
05-Sep-2021,RTGS,00.00,"97,525.80","682,680.60"
05-Sep-2021,ATM,00.00,"68,268.06","614,412.54"
05-Sep-2021,ATM,00.00,"614,412.54",00.00
05-Sep-2021,NEFT,89.41,00.00,89.41
05-Sep-2021,Interest,"1,654,234.00",00.00,"1,654,323.41"
05-Sep-2021,Tax,"226,661.50",00.00,"1,880,984.91"
05-Sep-2021,Cash,07.00,00.00,"1,880,991.91"
05-Sep-2021,Cash,219.00,00.00,"1,881,210.91"
05-Sep-2021,NEFT,00.00,"313,535.15","1,567,675.76"
05-Sep-2021,Cheque,04.00,00.00,"1,567,679.76"
05-Sep-2021,Miscellaneous,00.00,"1,567,679.76",00.00
05-Sep-2021,Debit Card,22.32,00.00,22.32
05-Sep-2021,Purchase,00.00,04.46,17.86
05-Sep-2021,Bill,"2,146.53",00.00,"2,164.39"
05-Sep-2021,Transfer,00.00,"2,164.39",00.00
05-Sep-2021,Purchase,108.40,00.00,108.40
05-Sep-2021,Cheque,"214,243.00",00.00,"214,351.40"
05-Sep-2021,Cash,00.00,"53,587.85","160,763.55"
05-Sep-2021,Purchase,58.48,00.00,"160,822.03"
05-Sep-2021,Transfer,00.00,"16,082.20","144,739.83"
05-Sep-2021,Tax,"20,796.60",00.00,"165,536.43"
05-Sep-2021,Purchase,"184,723.00",00.00,"350,259.43"
05-Sep-2021,Bill,00.00,"175,129.72","175,129.72"
05-Sep-2021,Reversal,00.00,"19,458.86","155,670.86"
05-Sep-2021,Commission,"531,465.00",00.00,"687,135.86"
05-Sep-2021,Transfer,00.00,"687,135.86",00.00
05-Sep-2021,Interest,04.80,00.00,04.80
05-Sep-2021,Miscellaneous,"1,473,172.00",00.00,"1,473,176.80"
05-Sep-2021,Purchase,"1,570,700.20",00.00,"3,043,877.00"
05-Sep-2021,Reversal,00.00,"380,484.63","2,663,392.38"
05-Sep-2021,Purchase,00.00,"665,848.10","1,997,544.28"
05-Sep-2021,Cheque,00.00,"285,363.47","1,712,180.81"
05-Sep-2021,Purchase,63.40,00.00,"1,712,244.21"
05-Sep-2021,Miscellaneous,"1,783,993.00",00.00,"3,496,237.21"
05-Sep-2021,IMPS,00.00,"874,059.30","2,622,177.91"
05-Sep-2021,RTGS,00.00,"655,544.48","1,966,633.43"
05-Sep-2021,Reversal,00.00,"393,326.69","1,573,306.74"
06-Sep-2021,IMPS,00.00,"524,435.58","1,048,871.16"
06-Sep-2021,IMPS,00.00,"1,048,871.16",00.00
07-Sep-2021,NEFT,469.00,00.00,469.00
07-Sep-2021,Purchase,04.59,00.00,473.59
07-Sep-2021,Tax,"15,107.70",00.00,"15,581.29"
07-Sep-2021,Purchase,00.00,"1,558.13","14,023.16"
07-Sep-2021,ATM,00.00,00.00,"14,023.16"
07-Sep-2021,Tax,"1,140,696.20",00.00,"1,154,719.36"
07-Sep-2021,Miscellaneous,"178,671.25",00.00,"1,333,390.61"
07-Sep-2021,Interest,00.00,"1,333,390.61",00.00
07-Sep-2021,Commission,04.30,00.00,04.30
07-Sep-2021,Cash,00.00,00.72,03.58
07-Sep-2021,Commission,"30,846.60",00.00,"30,850.18"
07-Sep-2021,Tax,240.00,00.00,"31,090.18"
07-Sep-2021,Cheque,321.00,00.00,"31,411.18"
07-Sep-2021,Cheque,"1,015.87",00.00,"32,427.05"
07-Sep-2021,Transfer,00.00,"4,053.38","28,373.67"
07-Sep-2021,Commission,01.37,00.00,"28,375.04"
07-Sep-2021,Cheque,00.00,"5,675.01","22,700.03"
07-Sep-2021,Miscellaneous,"151,604.16",00.00,"174,304.19"
07-Sep-2021,Cheque,04.68,00.00,"174,308.87"
07-Sep-2021,IMPS,"9,817.00",00.00,"184,125.87"
07-Sep-2021,NEFT,549.46,00.00,"184,675.33"
07-Sep-2021,Purchase,"30,216.60",00.00,"214,891.93"
07-Sep-2021,Reversal,"741,862.00",00.00,"956,753.93"
07-Sep-2021,Tax,05.70,00.00,"956,759.63"
07-Sep-2021,Transfer,00.00,"106,306.63","850,453.00"
07-Sep-2021,NEFT,395.80,00.00,"850,848.80"
08-Sep-2021,Tax,"244,754.00",00.00,"1,095,602.80"
08-Sep-2021,Bill,00.00,"219,120.56","876,482.24"
08-Sep-2021,ATM,00.00,"876,482.24",00.00
08-Sep-2021,Commission,831.50,00.00,831.50
08-Sep-2021,NEFT,"21,299.44",00.00,"22,130.94"
08-Sep-2021,Transfer,00.70,00.00,"22,131.64"
08-Sep-2021,Bill,00.00,"7,377.21","14,754.43"
08-Sep-2021,Tax,02.89,00.00,"14,757.32"
08-Sep-2021,Transfer,00.00,"1,844.67","12,912.66"
08-Sep-2021,Cash,"23,661.40",00.00,"36,574.06"
08-Sep-2021,RTGS,00.00,"4,063.78","32,510.28"
08-Sep-2021,Interest,00.00,"3,251.03","29,259.25"
09-Sep-2021,NEFT,00.00,"29,259.25",00.00
09-Sep-2021,Cash,508.10,00.00,508.10
09-Sep-2021,Cheque,00.00,101.62,406.48
09-Sep-2021,Interest,54.80,00.00,461.28
09-Sep-2021,Purchase,"5,614.00",00.00,"6,075.28"
09-Sep-2021,ATM,00.00,"1,518.82","4,556.46"
09-Sep-2021,Cheque,"147,310.50",00.00,"151,866.96"
10-Sep-2021,Bill,00.00,"37,966.74","113,900.22"
10-Sep-2021,Debit Card,00.00,"37,966.74","75,933.48"
10-Sep-2021,Transfer,"12,662.80",00.00,"88,596.28"
10-Sep-2021,Cheque,00.00,"29,532.09","59,064.19"
10-Sep-2021,NEFT,572.90,00.00,"59,637.09"
10-Sep-2021,ATM,00.00,"14,909.27","44,727.82"
10-Sep-2021,Tax,00.00,"4,969.76","39,758.06"
10-Sep-2021,ATM,00.00,"19,879.03","19,879.03"
10-Sep-2021,Reversal,00.00,"2,208.78","17,670.25"
10-Sep-2021,ATM,"38,039.75",00.00,"55,710.00"
10-Sep-2021,Cheque,"973,753.75",00.00,"1,029,463.75"
10-Sep-2021,IMPS,"1,922.00",00.00,"1,031,385.75"
10-Sep-2021,Cash,00.00,"114,598.42","916,787.33"
10-Sep-2021,Debit Card,00.00,"91,678.73","825,108.60"
10-Sep-2021,Tax,"18,357.60",00.00,"843,466.20"
10-Sep-2021,Debit Card,58.80,00.00,"843,525.00"
10-Sep-2021,Debit Card,00.00,"93,725.00","749,800.00"
10-Sep-2021,NEFT,"237,366.50",00.00,"987,166.50"
10-Sep-2021,Transfer,00.00,"141,023.79","846,142.71"
10-Sep-2021,Miscellaneous,02.11,00.00,"846,144.82"
10-Sep-2021,Cash,"167,585.00",00.00,"1,013,729.82"
10-Sep-2021,Tax,00.00,"126,716.23","887,013.59"
10-Sep-2021,NEFT,"5,133.80",00.00,"892,147.39"
10-Sep-2021,Tax,00.00,"111,518.42","780,628.97"
10-Sep-2021,RTGS,04.00,00.00,"780,632.97"
10-Sep-2021,Cash,"1,996,074.00",00.00,"2,776,706.97"
10-Sep-2021,Tax,367.95,00.00,"2,777,074.92"
10-Sep-2021,ATM,00.00,"396,724.99","2,380,349.93"
10-Sep-2021,Commission,55.87,00.00,"2,380,405.80"
10-Sep-2021,IMPS,06.00,00.00,"2,380,411.80"
10-Sep-2021,Transfer,00.00,"595,102.95","1,785,308.85"
10-Sep-2021,Interest,00.00,"223,163.61","1,562,145.24"
10-Sep-2021,Cheque,402.60,00.00,"1,562,547.84"
10-Sep-2021,Tax,07.62,00.00,"1,562,555.46"
10-Sep-2021,Cheque,"17,811.20",00.00,"1,580,366.66"
10-Sep-2021,Purchase,00.00,"1,580,366.66",00.00
10-Sep-2021,Bill,164.00,00.00,164.00
10-Sep-2021,Debit Card,00.00,54.67,109.33
10-Sep-2021,IMPS,"11,673.98",00.00,"11,783.31"
10-Sep-2021,Cash,00.00,"1,963.89","9,819.42"
10-Sep-2021,NEFT,00.00,"4,909.71","4,909.71"
10-Sep-2021,Tax,422.00,00.00,"5,331.71"
10-Sep-2021,Cash,03.00,00.00,"5,334.71"
10-Sep-2021,Reversal,"30,775.87",00.00,"36,110.58"
10-Sep-2021,Tax,00.00,"3,611.06","32,499.52"
10-Sep-2021,Cheque,50.80,00.00,"32,550.32"
10-Sep-2021,NEFT,"28,431.07",00.00,"60,981.39"
10-Sep-2021,Debit Card,00.00,"60,981.39",00.00
10-Sep-2021,Commission,816.00,00.00,816.00
10-Sep-2021,Debit Card,06.00,00.00,822.00
10-Sep-2021,ATM,"1,226,584.00",00.00,"1,227,406.00"
10-Sep-2021,ATM,00.00,"175,343.71","1,052,062.29"
10-Sep-2021,RTGS,09.99,00.00,"1,052,072.28"
10-Sep-2021,RTGS,00.00,"526,036.14","526,036.14"
10-Sep-2021,Miscellaneous,"5,002.80",00.00,"531,038.94"
10-Sep-2021,Bill,00.00,"132,759.74","398,279.20"
10-Sep-2021,Tax,00.00,"44,253.24","354,025.96"
10-Sep-2021,Miscellaneous,00.00,"177,012.98","177,012.98"
10-Sep-2021,IMPS,"31,121.46",00.00,"208,134.44"
10-Sep-2021,Commission,00.00,"23,126.05","185,008.39"
10-Sep-2021,RTGS,00.00,"46,252.10","138,756.29"
10-Sep-2021,Transfer,00.00,"27,751.26","111,005.03"
10-Sep-2021,Interest,00.00,"111,005.03",00.00
10-Sep-2021,Interest,48.91,00.00,48.91
10-Sep-2021,Cheque,"55,344.80",00.00,"55,393.71"
10-Sep-2021,Cash,00.00,"7,913.39","47,480.32"
10-Sep-2021,Tax,"103,036.50",00.00,"150,516.82"
10-Sep-2021,NEFT,"2,752.00",00.00,"153,268.82"
10-Sep-2021,Bill,00.00,"51,089.61","102,179.21"
10-Sep-2021,Purchase,00.00,"10,217.92","91,961.29"
10-Sep-2021,ATM,"1,444,503.00",00.00,"1,536,464.29"
10-Sep-2021,Tax,"31,919.82",00.00,"1,568,384.11"
10-Sep-2021,RTGS,00.00,"224,054.87","1,344,329.24"
10-Sep-2021,Transfer,00.00,"672,164.62","672,164.62"
10-Sep-2021,RTGS,58.00,00.00,"672,222.62"
10-Sep-2021,IMPS,00.00,"224,074.21","448,148.41"
10-Sep-2021,Reversal,477.75,00.00,"448,626.16"
10-Sep-2021,Debit Card,00.00,"448,626.16",00.00
10-Sep-2021,NEFT,"2,617.00",00.00,"2,617.00"
10-Sep-2021,Reversal,00.00,327.13,"2,289.88"
10-Sep-2021,RTGS,468.80,00.00,"2,758.68"
10-Sep-2021,RTGS,00.00,306.52,"2,452.16"
10-Sep-2021,Cash,"2,301.00",00.00,"4,753.16"
10-Sep-2021,Cheque,00.00,"4,753.16",00.00
10-Sep-2021,Bill,"1,388,597.00",00.00,"1,388,597.00"
10-Sep-2021,ATM,00.00,"173,574.63","1,215,022.38"
10-Sep-2021,Debit Card,00.00,"1,215,022.38",00.00
10-Sep-2021,Transfer,22.00,00.00,22.00
10-Sep-2021,Cheque,"3,177.10",00.00,"3,199.10"
10-Sep-2021,Commission,139.70,00.00,"3,338.80"
10-Sep-2021,Cheque,00.00,667.76,"2,671.04"
10-Sep-2021,Interest,"30,611.90",00.00,"33,282.94"
11-Sep-2021,Cash,479.93,00.00,"33,762.87"
12-Sep-2021,NEFT,00.00,"3,376.29","30,386.58"
12-Sep-2021,Debit Card,00.00,"15,193.29","15,193.29"
12-Sep-2021,Reversal,61.80,00.00,"15,255.09"
13-Sep-2021,Purchase,03.00,00.00,"15,258.09"
13-Sep-2021,Debit Card,00.00,"1,525.81","13,732.28"
13-Sep-2021,Purchase,00.00,"1,961.75","11,770.53"
13-Sep-2021,Miscellaneous,00.00,"1,471.32","10,299.21"
13-Sep-2021,Debit Card,00.00,"1,716.54","8,582.67"
13-Sep-2021,NEFT,00.00,"8,582.67",00.00
13-Sep-2021,Miscellaneous,04.46,00.00,04.46
13-Sep-2021,Commission,00.00,01.49,02.97
13-Sep-2021,ATM,00.00,01.49,01.48
13-Sep-2021,Transfer,"27,701.09",00.00,"27,702.57"
13-Sep-2021,Cheque,00.00,"4,617.10","23,085.48"
14-Sep-2021,Cash,06.03,00.00,"23,091.51"
14-Sep-2021,Interest,00.00,"4,618.30","18,473.21"
14-Sep-2021,NEFT,297.00,00.00,"18,770.21"
14-Sep-2021,IMPS,00.00,"9,385.11","9,385.10"
14-Sep-2021,Debit Card,"3,570.54",00.00,"12,955.64"
14-Sep-2021,Reversal,00.00,"1,619.46","11,336.18"
14-Sep-2021,ATM,"258,108.00",00.00,"269,444.18"
14-Sep-2021,ATM,"93,361.00",00.00,"362,805.18"
14-Sep-2021,NEFT,"1,838.00",00.00,"364,643.18"
14-Sep-2021,Tax,00.00,"36,464.32","328,178.86"
14-Sep-2021,Bill,00.00,"109,392.95","218,785.91"
14-Sep-2021,Bill,00.00,"21,878.59","196,907.32"
14-Sep-2021,Purchase,00.00,"32,817.89","164,089.43"
14-Sep-2021,Cash,"1,347.30",00.00,"165,436.73"
14-Sep-2021,Bill,103.60,00.00,"165,540.33"
14-Sep-2021,Tax,"3,795.00",00.00,"169,335.33"
14-Sep-2021,Interest,"146,122.00",00.00,"315,457.33"
14-Sep-2021,Cash,00.00,"63,091.47","252,365.86"
14-Sep-2021,Reversal,80.00,00.00,"252,445.86"
14-Sep-2021,Transfer,134.13,00.00,"252,579.99"
14-Sep-2021,Miscellaneous,00.00,"252,579.99",00.00
14-Sep-2021,Cheque,"256,694.25",00.00,"256,694.25"
14-Sep-2021,RTGS,00.00,"32,086.78","224,607.47"
14-Sep-2021,RTGS,00.00,"112,303.74","112,303.74"
14-Sep-2021,IMPS,00.00,"112,303.74",00.00
14-Sep-2021,Commission,"1,922,457.25",00.00,"1,922,457.25"
14-Sep-2021,Transfer,37.10,00.00,"1,922,494.35"
14-Sep-2021,NEFT,00.00,"240,311.79","1,682,182.56"
14-Sep-2021,Purchase,00.00,"841,091.28","841,091.28"
14-Sep-2021,IMPS,00.00,"168,218.26","672,873.02"
14-Sep-2021,IMPS,"1,441,822.00",00.00,"2,114,695.02"
14-Sep-2021,Reversal,"74,243.00",00.00,"2,188,938.02"
14-Sep-2021,Miscellaneous,"49,343.90",00.00,"2,238,281.92"
15-Sep-2021,Transfer,00.00,"746,093.97","1,492,187.95"
15-Sep-2021,Cheque,00.00,"1,492,187.95",00.00
15-Sep-2021,NEFT,52.38,00.00,52.38
15-Sep-2021,Tax,00.00,07.48,44.90
15-Sep-2021,Commission,"140,224.30",00.00,"140,269.20"
15-Sep-2021,Miscellaneous,00.00,"70,134.60","70,134.60"
15-Sep-2021,RTGS,00.00,"8,766.83","61,367.78"
15-Sep-2021,Purchase,"883,605.50",00.00,"944,973.28"
15-Sep-2021,NEFT,328.70,00.00,"945,301.98"
15-Sep-2021,Cash,00.00,"189,060.40","756,241.58"
15-Sep-2021,Cheque,"2,073.90",00.00,"758,315.48"
15-Sep-2021,Cheque,00.00,"84,257.28","674,058.20"
15-Sep-2021,RTGS,00.00,"168,514.55","505,543.65"
15-Sep-2021,Debit Card,00.00,"72,220.52","433,323.13"
15-Sep-2021,Reversal,"5,646.60",00.00,"438,969.73"
15-Sep-2021,RTGS,"16,063.00",00.00,"455,032.73"
15-Sep-2021,Debit Card,"185,793.00",00.00,"640,825.73"
15-Sep-2021,Bill,00.00,"91,546.53","549,279.20"
15-Sep-2021,Debit Card,"8,144.00",00.00,"557,423.20"
15-Sep-2021,Bill,424.90,00.00,"557,848.10"
15-Sep-2021,Purchase,"228,174.00",00.00,"786,022.10"
15-Sep-2021,NEFT,00.00,"98,252.76","687,769.34"
15-Sep-2021,ATM,04.77,00.00,"687,774.11"
15-Sep-2021,NEFT,00.00,"171,943.53","515,830.58"
15-Sep-2021,Purchase,00.00,"257,915.29","257,915.29"
15-Sep-2021,Purchase,"29,181.38",00.00,"287,096.67"
15-Sep-2021,Cheque,"236,763.84",00.00,"523,860.51"
15-Sep-2021,Purchase,00.00,"130,965.13","392,895.38"
15-Sep-2021,RTGS,00.00,"392,895.38",00.00
15-Sep-2021,Commission,"109,406.75",00.00,"109,406.75"
15-Sep-2021,Interest,"6,148.78",00.00,"115,555.53"
15-Sep-2021,Tax,00.00,"28,888.88","86,666.65"
15-Sep-2021,RTGS,"1,931.00",00.00,"88,597.65"
15-Sep-2021,IMPS,02.34,00.00,"88,599.99"
15-Sep-2021,Interest,00.00,"29,533.33","59,066.66"
15-Sep-2021,ATM,"657,746.50",00.00,"716,813.16"
15-Sep-2021,Miscellaneous,"1,966,746.20",00.00,"2,683,559.36"
15-Sep-2021,RTGS,00.00,"298,173.26","2,385,386.10"
15-Sep-2021,Reversal,203.23,00.00,"2,385,589.33"
15-Sep-2021,Interest,00.00,"298,198.67","2,087,390.66"
15-Sep-2021,ATM,"2,522.00",00.00,"2,089,912.66"
15-Sep-2021,IMPS,"5,591.00",00.00,"2,095,503.66"
15-Sep-2021,IMPS,04.00,00.00,"2,095,507.66"
15-Sep-2021,NEFT,00.00,"261,938.46","1,833,569.20"
15-Sep-2021,Miscellaneous,"18,712.00",00.00,"1,852,281.20"
15-Sep-2021,ATM,"11,454.00",00.00,"1,863,735.20"
15-Sep-2021,RTGS,07.38,00.00,"1,863,742.58"
15-Sep-2021,Commission,00.00,"372,748.52","1,490,994.06"
15-Sep-2021,RTGS,00.00,"372,748.52","1,118,245.54"
15-Sep-2021,Debit Card,00.00,"372,748.51","745,497.03"
15-Sep-2021,ATM,07.00,00.00,"745,504.03"
15-Sep-2021,Tax,00.00,"74,550.40","670,953.63"
15-Sep-2021,Bill,"242,662.20",00.00,"913,615.83"
15-Sep-2021,NEFT,00.00,"114,201.98","799,413.85"
15-Sep-2021,Purchase,06.00,00.00,"799,419.85"
15-Sep-2021,Cash,00.00,"159,883.97","639,535.88"
16-Sep-2021,Miscellaneous,03.32,00.00,"639,539.20"
16-Sep-2021,Bill,00.00,"127,907.84","511,631.36"
16-Sep-2021,Transfer,00.00,"56,847.93","454,783.43"
16-Sep-2021,Bill,"1,465,684.50",00.00,"1,920,467.93"
16-Sep-2021,RTGS,00.00,"192,046.79","1,728,421.14"
16-Sep-2021,ATM,00.00,"216,052.64","1,512,368.50"
16-Sep-2021,NEFT,00.00,"151,236.85","1,361,131.65"
16-Sep-2021,NEFT,00.00,"151,236.85","1,209,894.80"
16-Sep-2021,Commission,"1,477,231.20",00.00,"2,687,126.00"
16-Sep-2021,Commission,00.00,"268,712.60","2,418,413.40"
16-Sep-2021,Purchase,29.50,00.00,"2,418,442.90"
16-Sep-2021,RTGS,00.00,"302,305.36","2,116,137.54"
16-Sep-2021,Debit Card,"192,998.30",00.00,"2,309,135.84"
16-Sep-2021,Bill,00.00,"288,641.98","2,020,493.86"
16-Sep-2021,ATM,73.40,00.00,"2,020,567.26"
16-Sep-2021,Purchase,01.86,00.00,"2,020,569.12"
16-Sep-2021,IMPS,04.60,00.00,"2,020,573.72"
16-Sep-2021,ATM,00.00,"252,571.72","1,768,002.00"
16-Sep-2021,Cheque,"2,654.00",00.00,"1,770,656.00"
16-Sep-2021,Miscellaneous,"4,130.01",00.00,"1,774,786.01"
16-Sep-2021,Bill,00.00,"443,696.50","1,331,089.51"
16-Sep-2021,Purchase,34.39,00.00,"1,331,123.90"
16-Sep-2021,Debit Card,00.00,"133,112.39","1,198,011.51"
16-Sep-2021,Cash,00.00,"399,337.17","798,674.34"
16-Sep-2021,Cheque,01.50,00.00,"798,675.84"
16-Sep-2021,NEFT,00.00,"99,834.48","698,841.36"
16-Sep-2021,Miscellaneous,"3,144.10",00.00,"701,985.46"
16-Sep-2021,Miscellaneous,"10,063.40",00.00,"712,048.86"
16-Sep-2021,Cheque,00.00,"79,116.54","632,932.32"
16-Sep-2021,ATM,"11,536.75",00.00,"644,469.07"
16-Sep-2021,Debit Card,"579,420.00",00.00,"1,223,889.07"
17-Sep-2021,RTGS,00.00,"122,388.91","1,101,500.16"
17-Sep-2021,Reversal,"609,889.20",00.00,"1,711,389.36"
17-Sep-2021,Miscellaneous,00.00,"427,847.34","1,283,542.02"
18-Sep-2021,Commission,00.00,"320,885.51","962,656.52"
18-Sep-2021,Purchase,00.00,"106,961.84","855,694.68"
18-Sep-2021,Transfer,00.00,"106,961.84","748,732.85"
18-Sep-2021,Debit Card,"17,699.00",00.00,"766,431.85"
18-Sep-2021,NEFT,00.00,"191,607.96","574,823.89"
18-Sep-2021,Purchase,04.79,00.00,"574,828.68"
18-Sep-2021,Commission,461.63,00.00,"575,290.31"
18-Sep-2021,NEFT,"3,807.70",00.00,"579,098.01"
18-Sep-2021,RTGS,179.00,00.00,"579,277.01"
18-Sep-2021,NEFT,00.00,"82,753.86","496,523.15"
18-Sep-2021,Cheque,348.20,00.00,"496,871.35"
18-Sep-2021,Transfer,"26,190.40",00.00,"523,061.75"
18-Sep-2021,NEFT,00.00,"65,382.72","457,679.03"
19-Sep-2021,Bill,00.00,"76,279.84","381,399.19"
19-Sep-2021,ATM,00.00,"127,133.06","254,266.13"
19-Sep-2021,Tax,"897,415.00",00.00,"1,151,681.13"
19-Sep-2021,Debit Card,00.00,"143,960.14","1,007,720.99"
19-Sep-2021,Commission,"1,543,384.50",00.00,"2,551,105.49"
19-Sep-2021,ATM,00.00,"510,221.10","2,040,884.39"
19-Sep-2021,Reversal,35.00,00.00,"2,040,919.39"
19-Sep-2021,Interest,00.00,"204,091.94","1,836,827.45"
19-Sep-2021,Cheque,05.00,00.00,"1,836,832.45"
19-Sep-2021,Tax,00.00,"183,683.25","1,653,149.20"
19-Sep-2021,Interest,00.00,"183,683.24","1,469,465.96"
19-Sep-2021,ATM,00.00,"163,274.00","1,306,191.96"
19-Sep-2021,Transfer,00.00,"217,698.66","1,088,493.30"
19-Sep-2021,Tax,"50,082.78",00.00,"1,138,576.08"
19-Sep-2021,Commission,"949,512.00",00.00,"2,088,088.08"
19-Sep-2021,Interest,15.40,00.00,"2,088,103.48"
19-Sep-2021,IMPS,00.00,"232,011.50","1,856,091.98"
19-Sep-2021,Transfer,00.00,"265,156.00","1,590,935.98"
19-Sep-2021,NEFT,"981,363.00",00.00,"2,572,298.98"
19-Sep-2021,NEFT,12.30,00.00,"2,572,311.28"
19-Sep-2021,Cheque,"158,912.56",00.00,"2,731,223.84"
19-Sep-2021,Reversal,21.82,00.00,"2,731,245.66"
19-Sep-2021,RTGS,28.00,00.00,"2,731,273.66"
19-Sep-2021,Bill,00.00,"1,365,636.83","1,365,636.83"
19-Sep-2021,NEFT,00.00,"455,212.28","910,424.55"
19-Sep-2021,ATM,00.00,"182,084.91","728,339.64"
19-Sep-2021,RTGS,00.00,"80,926.63","647,413.01"
19-Sep-2021,ATM,00.00,"80,926.63","566,486.38"
19-Sep-2021,Cash,00.00,"62,942.93","503,543.45"
19-Sep-2021,RTGS,00.00,"83,923.91","419,619.54"
19-Sep-2021,RTGS,"1,376,372.00",00.00,"1,795,991.54"
19-Sep-2021,Interest,00.00,"199,554.62","1,596,436.92"
19-Sep-2021,Reversal,"139,551.00",00.00,"1,735,987.92"
19-Sep-2021,Interest,00.00,"347,197.58","1,388,790.34"
19-Sep-2021,Bill,"201,579.90",00.00,"1,590,370.24"
19-Sep-2021,ATM,00.00,"318,074.05","1,272,296.19"
19-Sep-2021,Bill,"1,276.60",00.00,"1,273,572.79"
19-Sep-2021,RTGS,00.00,"181,938.97","1,091,633.82"
19-Sep-2021,Reversal,00.00,"181,938.97","909,694.85"
19-Sep-2021,Miscellaneous,00.00,"113,711.86","795,982.99"
19-Sep-2021,RTGS,00.00,"198,995.75","596,987.24"
19-Sep-2021,Cheque,"12,209.70",00.00,"609,196.94"
20-Sep-2021,NEFT,"9,208.30",00.00,"618,405.24"
20-Sep-2021,Bill,00.00,"88,343.61","530,061.63"
20-Sep-2021,Interest,"833,670.50",00.00,"1,363,732.13"
20-Sep-2021,Debit Card,00.00,"170,466.52","1,193,265.61"
20-Sep-2021,Reversal,"24,695.50",00.00,"1,217,961.11"
21-Sep-2021,ATM,00.00,"152,245.14","1,065,715.97"
21-Sep-2021,Tax,04.84,00.00,"1,065,720.81"
21-Sep-2021,Cheque,"225,842.00",00.00,"1,291,562.81"
21-Sep-2021,Cash,"1,414,987.00",00.00,"2,706,549.81"
21-Sep-2021,Cheque,00.00,"2,706,549.81",00.00
21-Sep-2021,Reversal,"182,475.56",00.00,"182,475.56"
21-Sep-2021,Interest,00.00,"45,618.89","136,856.67"
21-Sep-2021,Miscellaneous,109.00,00.00,"136,965.67"
21-Sep-2021,Reversal,"3,414.30",00.00,"140,379.97"
21-Sep-2021,Debit Card,"20,578.87",00.00,"160,958.84"
21-Sep-2021,Commission,"3,896.60",00.00,"164,855.44"
21-Sep-2021,Cheque,00.00,"32,971.09","131,884.35"
21-Sep-2021,Purchase,00.00,"43,961.45","87,922.90"
21-Sep-2021,RTGS,00.00,"87,922.90",00.00
21-Sep-2021,Debit Card,00.30,00.00,00.30
21-Sep-2021,Commission,45.00,00.00,45.30
21-Sep-2021,IMPS,"1,176.05",00.00,"1,221.35"
21-Sep-2021,Miscellaneous,00.00,135.71,"1,085.64"
21-Sep-2021,Bill,57.80,00.00,"1,143.44"
21-Sep-2021,Tax,"2,166.61",00.00,"3,310.05"
21-Sep-2021,Transfer,36.40,00.00,"3,346.45"
21-Sep-2021,Debit Card,38.61,00.00,"3,385.06"
21-Sep-2021,NEFT,00.00,483.58,"2,901.48"
21-Sep-2021,RTGS,00.00,362.69,"2,538.80"
21-Sep-2021,RTGS,00.00,253.88,"2,284.92"
21-Sep-2021,RTGS,"1,561.55",00.00,"3,846.47"
21-Sep-2021,Transfer,00.00,"1,282.16","2,564.31"
21-Sep-2021,Tax,00.00,284.92,"2,279.39"
21-Sep-2021,Transfer,00.00,"1,139.70","1,139.70"
21-Sep-2021,Reversal,00.00,162.81,976.89
21-Sep-2021,ATM,00.00,244.22,732.67
21-Sep-2021,Debit Card,00.00,732.67,00.00
21-Sep-2021,ATM,"240,804.00",00.00,"240,804.00"
21-Sep-2021,ATM,00.00,"120,402.00","120,402.00"
21-Sep-2021,Reversal,"2,840.00",00.00,"123,242.00"
21-Sep-2021,Cheque,"22,132.55",00.00,"145,374.55"
21-Sep-2021,Cheque,"170,346.84",00.00,"315,721.39"
21-Sep-2021,Commission,"28,730.82",00.00,"344,452.21"
21-Sep-2021,Purchase,00.00,"57,408.70","287,043.51"
21-Sep-2021,NEFT,00.00,"41,006.22","246,037.29"
21-Sep-2021,Reversal,58.11,00.00,"246,095.40"
21-Sep-2021,Miscellaneous,215.00,00.00,"246,310.40"
21-Sep-2021,NEFT,00.00,"61,577.60","184,732.80"
21-Sep-2021,Miscellaneous,39.80,00.00,"184,772.60"
21-Sep-2021,ATM,"1,802,908.75",00.00,"1,987,681.35"
21-Sep-2021,IMPS,00.00,"1,987,681.35",00.00
21-Sep-2021,Reversal,07.10,00.00,07.10
21-Sep-2021,Tax,"27,721.00",00.00,"27,728.10"
21-Sep-2021,Reversal,00.00,"3,080.90","24,647.20"
21-Sep-2021,Tax,00.00,"6,161.80","18,485.40"
21-Sep-2021,Purchase,00.00,"4,621.35","13,864.05"
21-Sep-2021,Bill,"120,033.88",00.00,"133,897.93"
22-Sep-2021,Cash,06.92,00.00,"133,904.85"
22-Sep-2021,Debit Card,"94,524.00",00.00,"228,428.85"
22-Sep-2021,ATM,00.00,"76,142.95","152,285.90"
22-Sep-2021,NEFT,264.80,00.00,"152,550.70"
22-Sep-2021,Debit Card,"2,045.10",00.00,"154,595.80"
22-Sep-2021,Interest,"19,262.90",00.00,"173,858.70"
22-Sep-2021,NEFT,00.00,"57,952.90","115,905.80"
22-Sep-2021,Tax,02.00,00.00,"115,907.80"
22-Sep-2021,Debit Card,00.00,"11,590.78","104,317.02"
22-Sep-2021,Debit Card,00.00,"52,158.51","52,158.51"
22-Sep-2021,Tax,"1,484,510.25",00.00,"1,536,668.76"
22-Sep-2021,NEFT,"31,326.25",00.00,"1,567,995.01"
22-Sep-2021,Purchase,00.00,"156,799.50","1,411,195.51"
22-Sep-2021,Interest,00.00,"470,398.50","940,797.01"
22-Sep-2021,ATM,"3,642.38",00.00,"944,439.39"
22-Sep-2021,Transfer,"461,563.00",00.00,"1,406,002.39"
22-Sep-2021,Transfer,"3,307.72",00.00,"1,409,310.11"
22-Sep-2021,RTGS,57.49,00.00,"1,409,367.60"
22-Sep-2021,Commission,05.80,00.00,"1,409,373.40"
22-Sep-2021,ATM,"918,534.00",00.00,"2,327,907.40"
22-Sep-2021,IMPS,00.00,"581,976.85","1,745,930.55"
22-Sep-2021,IMPS,00.00,"436,482.64","1,309,447.91"
22-Sep-2021,RTGS,106.53,00.00,"1,309,554.44"
22-Sep-2021,Interest,00.00,"130,955.44","1,178,599.00"
22-Sep-2021,Miscellaneous,00.00,"589,299.50","589,299.50"
22-Sep-2021,Tax,00.00,"84,185.64","505,113.86"
22-Sep-2021,NEFT,00.00,"50,511.39","454,602.47"
22-Sep-2021,Commission,"2,779.00",00.00,"457,381.47"
22-Sep-2021,Debit Card,00.00,"228,690.74","228,690.74"
23-Sep-2021,Interest,331.00,00.00,"229,021.74"
23-Sep-2021,Cash,04.00,00.00,"229,025.74"
24-Sep-2021,ATM,00.00,"57,256.44","171,769.30"
24-Sep-2021,Transfer,294.00,00.00,"172,063.30"
24-Sep-2021,NEFT,"87,495.10",00.00,"259,558.40"
24-Sep-2021,Cheque,00.00,"129,779.20","129,779.20"
24-Sep-2021,Transfer,00.00,"129,779.20",00.00
24-Sep-2021,Tax,957.20,00.00,957.20
24-Sep-2021,Cheque,00.00,136.74,820.46
24-Sep-2021,Purchase,14.50,00.00,834.96
24-Sep-2021,Transfer,00.00,278.32,556.64
24-Sep-2021,Tax,"30,027.00",00.00,"30,583.64"
24-Sep-2021,NEFT,"908,174.50",00.00,"938,758.14"
24-Sep-2021,NEFT,00.00,"156,459.69","782,298.45"
24-Sep-2021,Debit Card,00.00,"195,574.61","586,723.84"
24-Sep-2021,Reversal,00.00,"58,672.38","528,051.46"
24-Sep-2021,Transfer,"2,036.80",00.00,"530,088.26"
24-Sep-2021,Interest,817.00,00.00,"530,905.26"
24-Sep-2021,Transfer,00.00,"530,905.26",00.00
24-Sep-2021,Purchase,"65,904.84",00.00,"65,904.84"
24-Sep-2021,Commission,261.50,00.00,"66,166.34"
24-Sep-2021,RTGS,00.00,"9,452.33","56,714.01"
24-Sep-2021,Purchase,00.00,"14,178.50","42,535.51"
24-Sep-2021,Cheque,00.00,"21,267.76","21,267.76"
24-Sep-2021,NEFT,00.00,"5,316.94","15,950.82"
24-Sep-2021,Transfer,"108,544.00",00.00,"124,494.82"
24-Sep-2021,NEFT,"10,618.00",00.00,"135,112.82"
24-Sep-2021,RTGS,"1,889,997.00",00.00,"2,025,109.82"
24-Sep-2021,NEFT,"110,647.30",00.00,"2,135,757.12"
24-Sep-2021,NEFT,00.00,"237,306.35","1,898,450.77"
24-Sep-2021,Transfer,"705,492.00",00.00,"2,603,942.77"
24-Sep-2021,Commission,152.69,00.00,"2,604,095.46"
24-Sep-2021,Reversal,00.00,"434,015.91","2,170,079.55"
24-Sep-2021,Commission,540.10,00.00,"2,170,619.65"
24-Sep-2021,NEFT,00.00,"241,179.96","1,929,439.69"
24-Sep-2021,Tax,"3,850.29",00.00,"1,933,289.98"
24-Sep-2021,Cash,139.70,00.00,"1,933,429.68"
24-Sep-2021,Bill,00.00,"966,714.84","966,714.84"
24-Sep-2021,Bill,"20,957.00",00.00,"987,671.84"
24-Sep-2021,Commission,00.00,"246,917.96","740,753.88"
24-Sep-2021,ATM,00.00,"740,753.88",00.00
24-Sep-2021,Purchase,"1,813,195.00",00.00,"1,813,195.00"
24-Sep-2021,RTGS,00.00,"302,199.17","1,510,995.83"
24-Sep-2021,RTGS,06.00,00.00,"1,511,001.83"
24-Sep-2021,Cheque,03.00,00.00,"1,511,004.83"
24-Sep-2021,Interest,"24,192.22",00.00,"1,535,197.05"
24-Sep-2021,Cash,"251,432.00",00.00,"1,786,629.05"
24-Sep-2021,Transfer,00.00,"178,662.91","1,607,966.14"
24-Sep-2021,Interest,"25,844.02",00.00,"1,633,810.16"
24-Sep-2021,ATM,03.00,00.00,"1,633,813.16"
24-Sep-2021,Interest,"1,973,931.00",00.00,"3,607,744.16"
24-Sep-2021,RTGS,00.00,"450,968.02","3,156,776.14"
24-Sep-2021,Cash,"15,198.95",00.00,"3,171,975.09"
24-Sep-2021,Debit Card,"245,710.53",00.00,"3,417,685.62"
24-Sep-2021,Transfer,00.00,"1,139,228.54","2,278,457.08"
24-Sep-2021,Commission,00.00,"2,278,457.08",00.00
24-Sep-2021,NEFT,57.70,00.00,57.70
24-Sep-2021,Interest,"176,115.00",00.00,"176,172.70"
24-Sep-2021,NEFT,03.00,00.00,"176,175.70"
24-Sep-2021,Bill,452.00,00.00,"176,627.70"
24-Sep-2021,Miscellaneous,00.00,"58,875.90","117,751.80"
24-Sep-2021,RTGS,00.00,"29,437.95","88,313.85"
24-Sep-2021,Cheque,00.00,"14,718.98","73,594.88"
24-Sep-2021,Bill,00.00,"24,531.63","49,063.25"
24-Sep-2021,Reversal,00.00,"4,906.33","44,156.92"
24-Sep-2021,Purchase,10.00,00.00,"44,166.92"
24-Sep-2021,Cash,00.00,"5,520.87","38,646.06"
24-Sep-2021,Cheque,"7,186.70",00.00,"45,832.76"
24-Sep-2021,ATM,"1,945,320.50",00.00,"1,991,153.26"
24-Sep-2021,Bill,00.00,"1,991,153.26",00.00
24-Sep-2021,Bill,"14,616.50",00.00,"14,616.50"
24-Sep-2021,NEFT,00.00,"7,308.25","7,308.25"
24-Sep-2021,Reversal,00.00,"1,218.04","6,090.21"
24-Sep-2021,Debit Card,59.49,00.00,"6,149.70"
24-Sep-2021,Tax,00.00,"6,149.70",00.00
24-Sep-2021,Debit Card,271.00,00.00,271.00
24-Sep-2021,ATM,00.00,30.11,240.89
24-Sep-2021,Reversal,00.00,24.09,216.80
24-Sep-2021,Reversal,00.00,36.13,180.67
24-Sep-2021,Interest,00.00,30.11,150.56
24-Sep-2021,Interest,00.00,16.73,133.83
24-Sep-2021,Cash,00.00,66.92,66.92
24-Sep-2021,Transfer,04.94,00.00,71.86
24-Sep-2021,Purchase,"2,091,958.75",00.00,"2,092,030.61"
24-Sep-2021,Debit Card,"1,064,980.50",00.00,"3,157,011.11"
24-Sep-2021,Tax,00.00,"631,402.22","2,525,608.89"
24-Sep-2021,IMPS,43.66,00.00,"2,525,652.55"
24-Sep-2021,NEFT,00.00,"252,565.26","2,273,087.30"
24-Sep-2021,NEFT,00.00,"227,308.73","2,045,778.57"
24-Sep-2021,Cash,47.00,00.00,"2,045,825.57"
24-Sep-2021,Purchase,"249,543.00",00.00,"2,295,368.57"
24-Sep-2021,Debit Card,00.00,"255,040.95","2,040,327.62"
24-Sep-2021,IMPS,00.00,"226,703.07","1,813,624.55"
24-Sep-2021,Tax,23.16,00.00,"1,813,647.71"
24-Sep-2021,Tax,"33,456.50",00.00,"1,847,104.21"
24-Sep-2021,Cash,00.00,"307,850.70","1,539,253.51"
24-Sep-2021,Purchase,00.00,"384,813.38","1,154,440.13"
24-Sep-2021,Cash,00.00,"128,271.13","1,026,169.00"
24-Sep-2021,RTGS,00.00,"114,018.78","912,150.22"
24-Sep-2021,Transfer,"21,619.04",00.00,"933,769.26"
24-Sep-2021,RTGS,03.10,00.00,"933,772.36"
24-Sep-2021,Commission,00.00,"186,754.47","747,017.89"
24-Sep-2021,Miscellaneous,00.00,"249,005.96","498,011.93"
24-Sep-2021,Reversal,00.00,"249,005.97","249,005.96"
24-Sep-2021,Commission,00.00,"27,667.33","221,338.63"
24-Sep-2021,Transfer,00.00,"110,669.32","110,669.32"
24-Sep-2021,Purchase,00.00,"27,667.33","83,001.99"
24-Sep-2021,Bill,"1,655,048.80",00.00,"1,738,050.79"
24-Sep-2021,Purchase,00.00,"434,512.70","1,303,538.09"
24-Sep-2021,Cash,54.00,00.00,"1,303,592.09"
24-Sep-2021,NEFT,00.00,"162,949.01","1,140,643.08"
24-Sep-2021,Interest,00.00,"162,949.01","977,694.07"
24-Sep-2021,Tax,"760,754.00",00.00,"1,738,448.07"
24-Sep-2021,Cheque,"1,294.00",00.00,"1,739,742.07"
24-Sep-2021,Bill,"219,723.40",00.00,"1,959,465.47"
24-Sep-2021,Purchase,00.00,"244,933.18","1,714,532.29"
24-Sep-2021,Tax,00.00,"428,633.07","1,285,899.22"
24-Sep-2021,Interest,00.00,"128,589.92","1,157,309.30"
24-Sep-2021,NEFT,00.00,"192,884.88","964,424.42"
24-Sep-2021,ATM,00.00,"241,106.11","723,318.32"
24-Sep-2021,Reversal,00.00,"361,659.16","361,659.16"
24-Sep-2021,Tax,"89,817.00",00.00,"451,476.16"
24-Sep-2021,Tax,00.00,"56,434.52","395,041.64"
24-Sep-2021,Tax,00.00,"65,840.27","329,201.37"
24-Sep-2021,ATM,00.29,00.00,"329,201.66"
24-Sep-2021,Bill,"15,394.00",00.00,"344,595.66"
24-Sep-2021,Purchase,"199,499.50",00.00,"544,095.16"
24-Sep-2021,Reversal,"2,637.30",00.00,"546,732.46"
24-Sep-2021,RTGS,00.00,"78,104.64","468,627.82"
24-Sep-2021,Cheque,00.00,"78,104.64","390,523.18"
24-Sep-2021,ATM,00.00,"43,391.46","347,131.72"
24-Sep-2021,ATM,00.00,"347,131.72",00.00
24-Sep-2021,Miscellaneous,24.60,00.00,24.60
24-Sep-2021,Transfer,"421,872.00",00.00,"421,896.60"
24-Sep-2021,ATM,00.00,"46,877.40","375,019.20"
24-Sep-2021,IMPS,00.00,"187,509.60","187,509.60"
24-Sep-2021,Commission,"22,361.80",00.00,"209,871.40"
24-Sep-2021,Miscellaneous,00.00,"52,467.85","157,403.55"
24-Sep-2021,Interest,02.60,00.00,"157,406.15"
24-Sep-2021,RTGS,"1,280,801.00",00.00,"1,438,207.15"
24-Sep-2021,Interest,00.00,"179,775.89","1,258,431.26"
24-Sep-2021,Transfer,00.00,"314,607.82","943,823.44"
24-Sep-2021,IMPS,00.00,"188,764.69","755,058.75"
24-Sep-2021,Commission,"4,039.60",00.00,"759,098.35"
24-Sep-2021,IMPS,00.00,"379,549.18","379,549.18"
24-Sep-2021,Transfer,"152,855.00",00.00,"532,404.18"
24-Sep-2021,ATM,"11,553.00",00.00,"543,957.18"
24-Sep-2021,Debit Card,454.74,00.00,"544,411.92"
24-Sep-2021,Interest,00.00,"60,490.21","483,921.71"
24-Sep-2021,Debit Card,97.89,00.00,"484,019.60"
24-Sep-2021,Purchase,"2,185.12",00.00,"486,204.72"
24-Sep-2021,Cash,02.00,00.00,"486,206.72"
24-Sep-2021,Miscellaneous,"9,688.00",00.00,"495,894.72"
24-Sep-2021,Cash,00.00,"165,298.24","330,596.48"
24-Sep-2021,Bill,"16,568.00",00.00,"347,164.48"
25-Sep-2021,Cheque,"1,400,620.80",00.00,"1,747,785.28"
25-Sep-2021,Cash,29.70,00.00,"1,747,814.98"
25-Sep-2021,Cheque,"1,938.57",00.00,"1,749,753.55"
25-Sep-2021,Purchase,01.80,00.00,"1,749,755.35"
25-Sep-2021,Interest,00.00,"437,438.84","1,312,316.51"
25-Sep-2021,Bill,"20,110.80",00.00,"1,332,427.31"
25-Sep-2021,Cash,05.00,00.00,"1,332,432.31"
25-Sep-2021,IMPS,00.00,"222,072.05","1,110,360.26"
25-Sep-2021,Cash,787.79,00.00,"1,111,148.05"
25-Sep-2021,Cash,00.00,"158,735.44","952,412.61"
25-Sep-2021,Commission,00.00,"952,412.61",00.00
25-Sep-2021,ATM,"246,869.20",00.00,"246,869.20"
25-Sep-2021,RTGS,00.13,00.00,"246,869.33"
25-Sep-2021,Bill,00.00,"27,429.93","219,439.40"
25-Sep-2021,Bill,"6,052.68",00.00,"225,492.08"
25-Sep-2021,Cheque,316.00,00.00,"225,808.08"
25-Sep-2021,Bill,143.80,00.00,"225,951.88"
25-Sep-2021,Bill,"233,832.81",00.00,"459,784.69"
25-Sep-2021,RTGS,"94,830.20",00.00,"554,614.89"
25-Sep-2021,Reversal,23.50,00.00,"554,638.39"
25-Sep-2021,Tax,00.00,"184,879.46","369,758.93"
25-Sep-2021,Purchase,00.00,"36,975.89","332,783.04"
25-Sep-2021,Reversal,"187,338.16",00.00,"520,121.20"
25-Sep-2021,Purchase,00.00,"52,012.12","468,109.08"
25-Sep-2021,Debit Card,00.00,"468,109.08",00.00
25-Sep-2021,ATM,"1,435,932.50",00.00,"1,435,932.50"
25-Sep-2021,Bill,00.00,"159,548.06","1,276,384.44"
25-Sep-2021,Transfer,212.82,00.00,"1,276,597.26"
25-Sep-2021,Bill,"45,002.22",00.00,"1,321,599.48"
25-Sep-2021,Debit Card,"33,903.00",00.00,"1,355,502.48"
25-Sep-2021,NEFT,902.98,00.00,"1,356,405.46"
25-Sep-2021,Miscellaneous,00.00,"1,356,405.46",00.00
25-Sep-2021,Cheque,"91,460.75",00.00,"91,460.75"
25-Sep-2021,Bill,00.00,"9,146.08","82,314.68"
25-Sep-2021,Commission,00.00,"41,157.34","41,157.34"
25-Sep-2021,NEFT,"8,304.19",00.00,"49,461.53"
25-Sep-2021,Interest,"9,891.37",00.00,"59,352.90"
25-Sep-2021,Purchase,"1,936,141.50",00.00,"1,995,494.40"
25-Sep-2021,Cheque,"2,021,405.00",00.00,"4,016,899.40"
25-Sep-2021,Bill,00.00,"573,842.77","3,443,056.63"
26-Sep-2021,Cash,03.60,00.00,"3,443,060.23"
26-Sep-2021,RTGS,00.00,"430,382.53","3,012,677.70"
26-Sep-2021,Cheque,00.00,"376,584.71","2,636,092.99"
26-Sep-2021,Interest,00.00,"878,697.66","1,757,395.33"
26-Sep-2021,Miscellaneous,02.00,00.00,"1,757,397.33"
26-Sep-2021,Miscellaneous,02.00,00.00,"1,757,399.33"
26-Sep-2021,Reversal,00.00,"351,479.87","1,405,919.46"
26-Sep-2021,Debit Card,"3,350.00",00.00,"1,409,269.46"
26-Sep-2021,Tax,"1,152,849.00",00.00,"2,562,118.46"
26-Sep-2021,Commission,03.00,00.00,"2,562,121.46"
26-Sep-2021,Bill,00.00,"320,265.18","2,241,856.28"
26-Sep-2021,Bill,"462,200.00",00.00,"2,704,056.28"
26-Sep-2021,Cheque,"39,084.50",00.00,"2,743,140.78"
26-Sep-2021,Miscellaneous,00.00,"548,628.16","2,194,512.62"
26-Sep-2021,RTGS,29.00,00.00,"2,194,541.62"
26-Sep-2021,Cash,16.84,00.00,"2,194,558.46"
26-Sep-2021,IMPS,00.00,"219,455.85","1,975,102.61"
26-Sep-2021,Tax,00.00,"329,183.77","1,645,918.84"
26-Sep-2021,Reversal,"24,045.69",00.00,"1,669,964.53"
26-Sep-2021,IMPS,00.00,"166,996.45","1,502,968.08"
26-Sep-2021,Purchase,477.70,00.00,"1,503,445.78"
26-Sep-2021,NEFT,"833,743.50",00.00,"2,337,189.28"
26-Sep-2021,Cheque,00.00,"233,718.93","2,103,470.35"
26-Sep-2021,Purchase,07.88,00.00,"2,103,478.23"
26-Sep-2021,Cash,00.00,"525,869.56","1,577,608.67"
26-Sep-2021,Purchase,79.00,00.00,"1,577,687.67"
26-Sep-2021,Purchase,85.00,00.00,"1,577,772.67"
27-Sep-2021,Bill,00.00,"225,396.10","1,352,376.57"
27-Sep-2021,Interest,00.00,"338,094.14","1,014,282.43"
27-Sep-2021,Cheque,00.00,"253,570.61","760,711.82"
27-Sep-2021,Commission,"625,077.20",00.00,"1,385,789.02"
27-Sep-2021,Commission,00.00,"138,578.90","1,247,210.12"
27-Sep-2021,Miscellaneous,00.00,"1,247,210.12",00.00
27-Sep-2021,Cheque,96.79,00.00,96.79
28-Sep-2021,Purchase,00.00,09.68,87.11
28-Sep-2021,Purchase,"175,371.00",00.00,"175,458.11"
28-Sep-2021,RTGS,"1,835,765.80",00.00,"2,011,223.91"
28-Sep-2021,Bill,"1,769.93",00.00,"2,012,993.84"
28-Sep-2021,Cash,00.00,"201,299.38","1,811,694.46"
28-Sep-2021,Reversal,00.00,"603,898.15","1,207,796.31"
28-Sep-2021,Cash,85.60,00.00,"1,207,881.91"
28-Sep-2021,Debit Card,00.00,"1,207,881.91",00.00
28-Sep-2021,Debit Card,"1,317.80",00.00,"1,317.80"
28-Sep-2021,ATM,"3,167.20",00.00,"4,485.00"
28-Sep-2021,Commission,00.00,747.50,"3,737.50"
28-Sep-2021,IMPS,"1,949.00",00.00,"5,686.50"
29-Sep-2021,Bill,00.00,947.75,"4,738.75"
29-Sep-2021,Bill,81.61,00.00,"4,820.36"
29-Sep-2021,Cash,"1,516.09",00.00,"6,336.45"
29-Sep-2021,Transfer,00.00,"1,584.11","4,752.34"
29-Sep-2021,Interest,290.40,00.00,"5,042.74"
29-Sep-2021,ATM,54.00,00.00,"5,096.74"
29-Sep-2021,Miscellaneous,31.00,00.00,"5,127.74"
29-Sep-2021,Debit Card,00.00,569.75,"4,557.99"
29-Sep-2021,RTGS,00.00,"1,139.50","3,418.49"
29-Sep-2021,Cheque,00.00,"1,709.25","1,709.24"
29-Sep-2021,Commission,"122,158.59",00.00,"123,867.83"
29-Sep-2021,Transfer,"240,708.30",00.00,"364,576.13"
29-Sep-2021,Transfer,"93,533.28",00.00,"458,109.41"
29-Sep-2021,NEFT,00.00,"458,109.41",00.00
29-Sep-2021,Cash,"60,128.97",00.00,"60,128.97"
29-Sep-2021,Transfer,00.00,"8,589.85","51,539.12"
29-Sep-2021,Cash,00.00,"12,884.78","38,654.34"
29-Sep-2021,Tax,699.83,00.00,"39,354.17"
29-Sep-2021,Interest,"2,167.00",00.00,"41,521.17"
29-Sep-2021,Commission,00.00,"4,613.46","36,907.71"
29-Sep-2021,Transfer,00.00,"6,151.29","30,756.42"
29-Sep-2021,NEFT,00.00,"3,417.38","27,339.04"
30-Sep-2021,Miscellaneous,00.00,"5,467.81","21,871.23"
30-Sep-2021,NEFT,00.00,"3,124.46","18,746.77"
30-Sep-2021,Miscellaneous,00.00,"6,248.92","12,497.85"
30-Sep-2021,Miscellaneous,00.00,"6,248.93","6,248.92"
30-Sep-2021,Bill,00.00,694.32,"5,554.60"
30-Sep-2021,Cash,00.00,793.51,"4,761.09"
01-Oct-2021,Commission,00.00,"1,190.27","3,570.82"
01-Oct-2021,Purchase,"3,179.58",00.00,"6,750.40"
01-Oct-2021,Bill,334.00,00.00,"7,084.40"
01-Oct-2021,RTGS,"24,465.60",00.00,"31,550.00"
01-Oct-2021,Reversal,"26,044.00",00.00,"57,594.00"
01-Oct-2021,Commission,"11,454.30",00.00,"69,048.30"
01-Oct-2021,Cheque,00.00,"34,524.15","34,524.15"
01-Oct-2021,Miscellaneous,"177,989.00",00.00,"212,513.15"
01-Oct-2021,Reversal,"3,554.00",00.00,"216,067.15"
01-Oct-2021,Purchase,00.00,"24,007.46","192,059.69"
01-Oct-2021,Bill,174.00,00.00,"192,233.69"
01-Oct-2021,IMPS,00.00,"64,077.90","128,155.79"
01-Oct-2021,IMPS,00.00,"12,815.58","115,340.21"
01-Oct-2021,IMPS,00.00,"28,835.05","86,505.16"
02-Oct-2021,Transfer,00.00,"86,505.16",00.00
02-Oct-2021,Interest,61.40,00.00,61.40
02-Oct-2021,Transfer,00.00,12.28,49.12
02-Oct-2021,Miscellaneous,"10,026.31",00.00,"10,075.43"
02-Oct-2021,RTGS,05.00,00.00,"10,080.43"
02-Oct-2021,Transfer,00.00,"1,680.07","8,400.36"
02-Oct-2021,Bill,59.80,00.00,"8,460.16"
02-Oct-2021,Reversal,00.00,"8,460.16",00.00
02-Oct-2021,Purchase,05.50,00.00,05.50
02-Oct-2021,Purchase,"2,270.66",00.00,"2,276.16"
02-Oct-2021,Cheque,02.00,00.00,"2,278.16"
02-Oct-2021,Commission,03.60,00.00,"2,281.76"
02-Oct-2021,Transfer,06.00,00.00,"2,287.76"
02-Oct-2021,Interest,"135,333.00",00.00,"137,620.76"
02-Oct-2021,NEFT,00.00,"34,405.19","103,215.57"
02-Oct-2021,Cheque,00.00,"25,803.89","77,411.68"
02-Oct-2021,Cheque,00.00,"15,482.34","61,929.34"
03-Oct-2021,NEFT,"1,717,414.50",00.00,"1,779,343.84"
03-Oct-2021,IMPS,"1,426,638.00",00.00,"3,205,981.84"
03-Oct-2021,IMPS,"256,768.00",00.00,"3,462,749.84"
03-Oct-2021,Debit Card,00.00,"577,124.97","2,885,624.87"
03-Oct-2021,Transfer,00.00,"2,885,624.87",00.00
03-Oct-2021,Debit Card,"1,852,593.20",00.00,"1,852,593.20"
03-Oct-2021,Commission,04.67,00.00,"1,852,597.87"
03-Oct-2021,ATM,00.00,"205,844.21","1,646,753.66"
03-Oct-2021,Debit Card,00.00,"411,688.42","1,235,065.24"
03-Oct-2021,Debit Card,00.00,"617,532.62","617,532.62"
03-Oct-2021,Miscellaneous,00.00,"68,614.74","548,917.88"
03-Oct-2021,ATM,00.00,"137,229.47","411,688.41"
03-Oct-2021,Interest,19.80,00.00,"411,708.21"
03-Oct-2021,IMPS,00.00,"68,618.04","343,090.18"
03-Oct-2021,Cheque,00.00,"85,772.55","257,317.64"
03-Oct-2021,Commission,00.00,"32,164.71","225,152.94"
04-Oct-2021,RTGS,02.00,00.00,"225,154.94"
04-Oct-2021,NEFT,00.00,"112,577.47","112,577.47"
04-Oct-2021,RTGS,09.00,00.00,"112,586.47"
05-Oct-2021,Interest,00.00,"22,517.29","90,069.18"
05-Oct-2021,Reversal,00.00,"10,007.69","80,061.49"
05-Oct-2021,Debit Card,00.00,"10,007.69","70,053.80"
05-Oct-2021,NEFT,00.00,"17,513.45","52,540.35"
05-Oct-2021,Debit Card,"66,733.30",00.00,"119,273.65"
05-Oct-2021,Transfer,"245,301.00",00.00,"364,574.65"
05-Oct-2021,Tax,"3,127.80",00.00,"367,702.45"
05-Oct-2021,Commission,"93,084.20",00.00,"460,786.65"
05-Oct-2021,Cash,00.00,"76,797.78","383,988.88"
05-Oct-2021,Interest,04.00,00.00,"383,992.88"
05-Oct-2021,Debit Card,00.00,"42,665.88","341,327.00"
05-Oct-2021,Cheque,"1,386,509.00",00.00,"1,727,836.00"
05-Oct-2021,RTGS,00.00,"246,833.71","1,481,002.29"
05-Oct-2021,Bill,"113,760.00",00.00,"1,594,762.29"
06-Oct-2021,RTGS,00.00,"1,594,762.29",00.00
06-Oct-2021,NEFT,08.51,00.00,08.51
06-Oct-2021,NEFT,"25,671.06",00.00,"25,679.57"
06-Oct-2021,Reversal,00.00,"25,679.57",00.00
06-Oct-2021,Debit Card,"153,673.20",00.00,"153,673.20"
07-Oct-2021,NEFT,04.89,00.00,"153,678.09"
07-Oct-2021,Cash,00.00,"30,735.62","122,942.47"
07-Oct-2021,Cash,00.00,"61,471.24","61,471.24"
07-Oct-2021,ATM,00.00,"15,367.81","46,103.43"
08-Oct-2021,NEFT,200.70,00.00,"46,304.13"
08-Oct-2021,Bill,00.00,"23,152.07","23,152.06"
08-Oct-2021,Cheque,00.00,"2,572.45","20,579.61"
08-Oct-2021,NEFT,00.00,"20,579.61",00.00
08-Oct-2021,Transfer,46.20,00.00,46.20
08-Oct-2021,Transfer,34.00,00.00,80.20
08-Oct-2021,Miscellaneous,"28,741.00",00.00,"28,821.20"
08-Oct-2021,Purchase,19.19,00.00,"28,840.39"
08-Oct-2021,Purchase,00.00,"7,210.10","21,630.29"
08-Oct-2021,Reversal,00.00,"7,210.10","14,420.19"
08-Oct-2021,IMPS,"632,774.00",00.00,"647,194.19"
08-Oct-2021,Commission,"138,242.66",00.00,"785,436.85"
08-Oct-2021,Bill,"205,222.00",00.00,"990,658.85"
08-Oct-2021,ATM,00.00,"99,065.89","891,592.96"
08-Oct-2021,Reversal,"1,641,984.50",00.00,"2,533,577.46"
08-Oct-2021,Cash,00.00,"281,508.61","2,252,068.85"
08-Oct-2021,Cheque,"72,311.20",00.00,"2,324,380.05"
08-Oct-2021,Miscellaneous,00.00,"332,054.29","1,992,325.76"
08-Oct-2021,Cheque,00.00,"664,108.59","1,328,217.17"
08-Oct-2021,IMPS,00.00,"265,643.43","1,062,573.74"
08-Oct-2021,Tax,53.70,00.00,"1,062,627.44"
08-Oct-2021,Purchase,00.00,"531,313.72","531,313.72"
08-Oct-2021,Transfer,00.00,"177,104.57","354,209.15"
08-Oct-2021,Transfer,495.00,00.00,"354,704.15"
08-Oct-2021,Debit Card,63.00,00.00,"354,767.15"
08-Oct-2021,Tax,00.00,"70,953.43","283,813.72"
08-Oct-2021,Tax,00.00,"47,302.29","236,511.43"
08-Oct-2021,Tax,"171,260.20",00.00,"407,771.63"
08-Oct-2021,Cheque,00.00,"203,885.82","203,885.82"
08-Oct-2021,Bill,00.00,"33,980.97","169,904.85"
08-Oct-2021,Purchase,"24,268.70",00.00,"194,173.55"
08-Oct-2021,Commission,"1,968.20",00.00,"196,141.75"
08-Oct-2021,ATM,00.00,"49,035.44","147,106.31"
08-Oct-2021,RTGS,"22,195.53",00.00,"169,301.84"
08-Oct-2021,Cheque,00.00,"28,216.97","141,084.87"
08-Oct-2021,Reversal,"201,607.00",00.00,"342,691.87"
08-Oct-2021,Miscellaneous,00.00,"85,672.97","257,018.90"
08-Oct-2021,ATM,"4,072.90",00.00,"261,091.80"
08-Oct-2021,Transfer,16.20,00.00,"261,108.00"
08-Oct-2021,Purchase,"18,741.20",00.00,"279,849.20"
08-Oct-2021,Miscellaneous,"1,122,588.00",00.00,"1,402,437.20"
08-Oct-2021,Interest,"29,261.62",00.00,"1,431,698.82"
08-Oct-2021,ATM,00.00,"238,616.47","1,193,082.35"
08-Oct-2021,NEFT,00.00,"1,193,082.35",00.00
08-Oct-2021,Purchase,10.10,00.00,10.10
08-Oct-2021,Bill,00.00,01.44,08.66
08-Oct-2021,Miscellaneous,00.00,00.96,07.70
08-Oct-2021,Cheque,00.00,02.57,05.13
08-Oct-2021,IMPS,"251,474.25",00.00,"251,479.38"
08-Oct-2021,IMPS,"25,201.71",00.00,"276,681.09"
08-Oct-2021,Cash,00.00,"46,113.52","230,567.58"
08-Oct-2021,Purchase,00.00,"230,567.58",00.00
08-Oct-2021,Bill,319.48,00.00,319.48
08-Oct-2021,Cheque,05.87,00.00,325.35
08-Oct-2021,NEFT,00.00,36.15,289.20
08-Oct-2021,Tax,"24,474.35",00.00,"24,763.55"
08-Oct-2021,Interest,"608,904.00",00.00,"633,667.55"
08-Oct-2021,Debit Card,16.00,00.00,"633,683.55"
08-Oct-2021,ATM,00.00,"158,420.89","475,262.66"
08-Oct-2021,IMPS,00.00,"52,806.96","422,455.70"
08-Oct-2021,Reversal,203.50,00.00,"422,659.20"
08-Oct-2021,IMPS,00.00,"46,962.13","375,697.07"
08-Oct-2021,NEFT,"247,152.60",00.00,"622,849.67"
09-Oct-2021,Interest,00.00,"155,712.42","467,137.25"
09-Oct-2021,RTGS,"936,190.00",00.00,"1,403,327.25"
09-Oct-2021,Purchase,281.37,00.00,"1,403,608.62"
09-Oct-2021,RTGS,68.05,00.00,"1,403,676.67"
09-Oct-2021,Reversal,"13,868.50",00.00,"1,417,545.17"
09-Oct-2021,Purchase,"2,051,241.00",00.00,"3,468,786.17"
09-Oct-2021,NEFT,00.00,"346,878.62","3,121,907.55"
09-Oct-2021,NEFT,00.00,"312,190.76","2,809,716.80"
10-Oct-2021,Transfer,378.62,00.00,"2,810,095.42"
10-Oct-2021,IMPS,304.87,00.00,"2,810,400.29"
10-Oct-2021,Transfer,00.00,"1,405,200.15","1,405,200.14"
10-Oct-2021,Debit Card,00.00,"234,200.02","1,171,000.12"
10-Oct-2021,Cash,00.00,"1,171,000.12",00.00
11-Oct-2021,Miscellaneous,"53,020.00",00.00,"53,020.00"
11-Oct-2021,Transfer,00.00,"5,302.00","47,718.00"
11-Oct-2021,Miscellaneous,"229,334.00",00.00,"277,052.00"
11-Oct-2021,RTGS,"25,901.13",00.00,"302,953.13"
11-Oct-2021,IMPS,"40,749.25",00.00,"343,702.38"
11-Oct-2021,IMPS,00.00,"49,100.34","294,602.04"
11-Oct-2021,Purchase,"326,283.50",00.00,"620,885.54"
11-Oct-2021,RTGS,158.00,00.00,"621,043.54"
11-Oct-2021,Bill,"1,604,501.00",00.00,"2,225,544.54"
11-Oct-2021,Reversal,"6,328.00",00.00,"2,231,872.54"
11-Oct-2021,ATM,815.01,00.00,"2,232,687.55"
11-Oct-2021,ATM,00.00,"318,955.36","1,913,732.19"
11-Oct-2021,Interest,00.00,"239,216.52","1,674,515.67"
11-Oct-2021,RTGS,956.20,00.00,"1,675,471.87"
11-Oct-2021,NEFT,00.00,"1,675,471.87",00.00
11-Oct-2021,Transfer,450.70,00.00,450.70
11-Oct-2021,RTGS,491.30,00.00,942.00
11-Oct-2021,Purchase,00.00,235.50,706.50
11-Oct-2021,NEFT,31.10,00.00,737.60
11-Oct-2021,Interest,"2,806.79",00.00,"3,544.39"
11-Oct-2021,Reversal,"1,761.90",00.00,"5,306.29"
11-Oct-2021,Tax,00.00,884.38,"4,421.91"
11-Oct-2021,Transfer,"116,166.94",00.00,"120,588.85"
11-Oct-2021,Transfer,00.00,"13,398.76","107,190.09"
11-Oct-2021,Bill,00.00,"26,797.52","80,392.57"
11-Oct-2021,Miscellaneous,00.00,"40,196.29","40,196.29"
11-Oct-2021,Purchase,"154,886.31",00.00,"195,082.60"
11-Oct-2021,Commission,283.00,00.00,"195,365.60"
11-Oct-2021,Bill,01.80,00.00,"195,367.40"
11-Oct-2021,RTGS,00.00,"27,909.63","167,457.77"
11-Oct-2021,Miscellaneous,00.00,"20,932.22","146,525.55"
11-Oct-2021,Commission,00.00,"36,631.39","109,894.16"
11-Oct-2021,Cash,42.60,00.00,"109,936.76"
11-Oct-2021,Debit Card,"2,618.90",00.00,"112,555.66"
11-Oct-2021,Tax,00.00,"16,079.38","96,476.28"
11-Oct-2021,NEFT,00.00,"48,238.14","48,238.14"
11-Oct-2021,Reversal,39.00,00.00,"48,277.14"
11-Oct-2021,Tax,"251,859.70",00.00,"300,136.84"
11-Oct-2021,ATM,00.00,"33,348.54","266,788.30"
11-Oct-2021,Transfer,00.00,"26,678.83","240,109.47"
11-Oct-2021,RTGS,"26,477.00",00.00,"266,586.47"
11-Oct-2021,Bill,16.00,00.00,"266,602.47"
11-Oct-2021,Purchase,07.42,00.00,"266,609.89"
11-Oct-2021,Cash,287.00,00.00,"266,896.89"
11-Oct-2021,Reversal,"8,144.88",00.00,"275,041.77"
11-Oct-2021,NEFT,00.00,"55,008.35","220,033.42"
12-Oct-2021,RTGS,00.00,"36,672.24","183,361.18"
12-Oct-2021,Cash,00.00,"30,560.20","152,800.98"
12-Oct-2021,Bill,"173,908.00",00.00,"326,708.98"
12-Oct-2021,Reversal,32.60,00.00,"326,741.58"
12-Oct-2021,Cash,"3,921.00",00.00,"330,662.58"
12-Oct-2021,Bill,01.80,00.00,"330,664.38"
12-Oct-2021,Debit Card,00.00,"330,664.38",00.00
12-Oct-2021,RTGS,"14,208.70",00.00,"14,208.70"
12-Oct-2021,Purchase,"6,158.20",00.00,"20,366.90"
12-Oct-2021,Cheque,"32,201.00",00.00,"52,567.90"
12-Oct-2021,Miscellaneous,00.00,"26,283.95","26,283.95"
12-Oct-2021,Miscellaneous,978.00,00.00,"27,261.95"
12-Oct-2021,Bill,26.70,00.00,"27,288.65"
12-Oct-2021,Purchase,00.00,"3,411.08","23,877.57"
12-Oct-2021,Cash,"6,271.00",00.00,"30,148.57"
12-Oct-2021,Reversal,114.00,00.00,"30,262.57"
12-Oct-2021,IMPS,"423,205.50",00.00,"453,468.07"
12-Oct-2021,IMPS,"1,226,357.00",00.00,"1,679,825.07"
12-Oct-2021,Commission,19.04,00.00,"1,679,844.11"
12-Oct-2021,Commission,"2,102.90",00.00,"1,681,947.01"
12-Oct-2021,Commission,00.00,"186,883.00","1,495,064.01"
12-Oct-2021,NEFT,"1,857.90",00.00,"1,496,921.91"
12-Oct-2021,Bill,00.69,00.00,"1,496,922.60"
12-Oct-2021,ATM,"147,831.00",00.00,"1,644,753.60"
12-Oct-2021,ATM,00.00,"411,188.40","1,233,565.20"
12-Oct-2021,Commission,00.00,"137,062.80","1,096,502.40"
12-Oct-2021,Reversal,"244,549.00",00.00,"1,341,051.40"
12-Oct-2021,Transfer,"21,544.60",00.00,"1,362,596.00"
12-Oct-2021,Transfer,00.00,"151,399.56","1,211,196.44"
13-Oct-2021,Miscellaneous,00.00,"403,732.15","807,464.29"
14-Oct-2021,Transfer,00.00,"161,492.86","645,971.43"
14-Oct-2021,Cash,"1,658.60",00.00,"647,630.03"
14-Oct-2021,Interest,"147,066.20",00.00,"794,696.23"
14-Oct-2021,NEFT,00.00,"132,449.37","662,246.86"
14-Oct-2021,Transfer,00.00,"66,224.69","596,022.17"
14-Oct-2021,Cheque,"514,286.80",00.00,"1,110,308.97"
14-Oct-2021,IMPS,"155,794.00",00.00,"1,266,102.97"
14-Oct-2021,Miscellaneous,369.67,00.00,"1,266,472.64"
14-Oct-2021,Cheque,249.00,00.00,"1,266,721.64"
14-Oct-2021,Commission,00.00,"126,672.16","1,140,049.48"
14-Oct-2021,Tax,07.51,00.00,"1,140,056.99"
14-Oct-2021,Commission,"2,929.00",00.00,"1,142,985.99"
15-Oct-2021,ATM,114.76,00.00,"1,143,100.75"
15-Oct-2021,Miscellaneous,52.00,00.00,"1,143,152.75"
15-Oct-2021,Debit Card,00.33,00.00,"1,143,153.08"
15-Oct-2021,Cheque,00.00,"571,576.54","571,576.54"
15-Oct-2021,Purchase,00.00,"190,525.51","381,051.03"
16-Oct-2021,Miscellaneous,05.10,00.00,"381,056.13"
16-Oct-2021,Cheque,00.00,"76,211.23","304,844.90"
16-Oct-2021,Interest,"150,017.70",00.00,"454,862.60"
16-Oct-2021,Reversal,"27,802.00",00.00,"482,664.60"
16-Oct-2021,Commission,02.39,00.00,"482,666.99"
16-Oct-2021,ATM,"8,398.88",00.00,"491,065.87"
16-Oct-2021,ATM,20.00,00.00,"491,085.87"
16-Oct-2021,IMPS,00.00,"122,771.47","368,314.40"
16-Oct-2021,Purchase,704.40,00.00,"369,018.80"
16-Oct-2021,NEFT,00.00,"92,254.70","276,764.10"
16-Oct-2021,Tax,00.00,"39,537.73","237,226.37"
16-Oct-2021,Tax,"27,100.00",00.00,"264,326.37"
16-Oct-2021,Reversal,00.00,"132,163.19","132,163.18"
16-Oct-2021,IMPS,"1,245,454.50",00.00,"1,377,617.68"
16-Oct-2021,Bill,00.00,"275,523.54","1,102,094.14"
16-Oct-2021,Commission,00.00,"1,102,094.14",00.00
16-Oct-2021,Bill,"2,074.16",00.00,"2,074.16"
16-Oct-2021,Tax,00.00,230.46,"1,843.70"
16-Oct-2021,Cash,45.00,00.00,"1,888.70"
16-Oct-2021,Cash,03.62,00.00,"1,892.32"
16-Oct-2021,Miscellaneous,136.80,00.00,"2,029.12"
16-Oct-2021,Commission,00.00,289.87,"1,739.25"
16-Oct-2021,Tax,07.40,00.00,"1,746.65"
16-Oct-2021,IMPS,00.00,582.22,"1,164.43"
16-Oct-2021,Cash,07.00,00.00,"1,171.43"
16-Oct-2021,NEFT,"32,153.00",00.00,"33,324.43"
16-Oct-2021,Miscellaneous,00.00,"4,165.55","29,158.88"
16-Oct-2021,ATM,02.15,00.00,"29,161.03"
16-Oct-2021,Reversal,"14,305.20",00.00,"43,466.23"
16-Oct-2021,Transfer,00.00,"10,866.56","32,599.67"
16-Oct-2021,Debit Card,23.30,00.00,"32,622.97"
16-Oct-2021,Tax,00.00,"32,622.97",00.00
16-Oct-2021,Cash,314.20,00.00,314.20
16-Oct-2021,Miscellaneous,"12,591.30",00.00,"12,905.50"
16-Oct-2021,Interest,00.00,"12,905.50",00.00
16-Oct-2021,IMPS,04.38,00.00,04.38
16-Oct-2021,Interest,47.70,00.00,52.08
16-Oct-2021,Purchase,00.00,07.44,44.64
16-Oct-2021,Reversal,"1,373,608.00",00.00,"1,373,652.64"
16-Oct-2021,Reversal,00.00,"1,373,652.64",00.00
16-Oct-2021,RTGS,"17,528.00",00.00,"17,528.00"
16-Oct-2021,Cheque,00.00,"2,191.00","15,337.00"
16-Oct-2021,NEFT,07.30,00.00,"15,344.30"
16-Oct-2021,Purchase,"1,874,677.00",00.00,"1,890,021.30"
16-Oct-2021,Transfer,00.00,"315,003.55","1,575,017.75"
16-Oct-2021,IMPS,"1,053.60",00.00,"1,576,071.35"
16-Oct-2021,Debit Card,"1,960,334.00",00.00,"3,536,405.35"
16-Oct-2021,Cheque,00.00,"392,933.93","3,143,471.42"
16-Oct-2021,Bill,"1,153,899.80",00.00,"4,297,371.22"
16-Oct-2021,Debit Card,00.00,"4,297,371.22",00.00
16-Oct-2021,RTGS,361.10,00.00,361.10
16-Oct-2021,Bill,00.00,361.10,00.00
16-Oct-2021,ATM,02.60,00.00,02.60
16-Oct-2021,Tax,04.20,00.00,06.80
16-Oct-2021,RTGS,"1,239,028.20",00.00,"1,239,035.00"
17-Oct-2021,Interest,123.95,00.00,"1,239,158.95"
17-Oct-2021,Miscellaneous,00.00,"137,684.33","1,101,474.62"
17-Oct-2021,Transfer,00.00,"183,579.10","917,895.52"
17-Oct-2021,NEFT,00.00,"101,988.39","815,907.13"
17-Oct-2021,Tax,00.00,"815,907.13",00.00
17-Oct-2021,IMPS,510.00,00.00,510.00
17-Oct-2021,Commission,00.00,72.86,437.14
17-Oct-2021,Cash,00.00,145.71,291.43
17-Oct-2021,Tax,33.50,00.00,324.93
17-Oct-2021,Debit Card,00.00,32.49,292.44
17-Oct-2021,Tax,00.00,41.78,250.66
17-Oct-2021,Cheque,00.00,31.33,219.33
17-Oct-2021,Transfer,00.00,27.42,191.91
17-Oct-2021,RTGS,"2,467.00",00.00,"2,658.91"
17-Oct-2021,Purchase,"198,285.00",00.00,"200,943.91"
17-Oct-2021,Miscellaneous,00.00,"22,327.10","178,616.81"
17-Oct-2021,Reversal,00.00,"178,616.81",00.00
17-Oct-2021,Commission,"844,541.80",00.00,"844,541.80"
17-Oct-2021,Cash,00.00,"422,270.90","422,270.90"
17-Oct-2021,RTGS,"14,307.20",00.00,"436,578.10"
17-Oct-2021,NEFT,00.00,"436,578.10",00.00
17-Oct-2021,Transfer,03.75,00.00,03.75
17-Oct-2021,Interest,00.00,00.42,03.33
17-Oct-2021,IMPS,00.00,00.67,02.66
17-Oct-2021,RTGS,00.00,00.44,02.22
17-Oct-2021,Debit Card,00.00,00.74,01.48
17-Oct-2021,Commission,"93,658.00",00.00,"93,659.48"
17-Oct-2021,NEFT,"84,449.20",00.00,"178,108.68"
17-Oct-2021,IMPS,26.80,00.00,"178,135.48"
17-Oct-2021,Bill,"44,455.00",00.00,"222,590.48"
17-Oct-2021,Purchase,00.00,"37,098.41","185,492.07"
17-Oct-2021,Transfer,00.00,"37,098.41","148,393.66"
17-Oct-2021,Transfer,00.00,"14,839.37","133,554.29"
17-Oct-2021,ATM,00.00,"16,694.29","116,860.00"
17-Oct-2021,Tax,"2,100.47",00.00,"118,960.47"
17-Oct-2021,RTGS,00.00,"14,870.06","104,090.41"
17-Oct-2021,IMPS,00.00,"26,022.60","78,067.81"
17-Oct-2021,Debit Card,00.00,"13,011.30","65,056.51"
17-Oct-2021,Cash,"2,786.00",00.00,"67,842.51"
17-Oct-2021,Tax,00.00,"11,307.09","56,535.42"
18-Oct-2021,ATM,"74,848.50",00.00,"131,383.92"
18-Oct-2021,Tax,02.00,00.00,"131,385.92"
18-Oct-2021,Transfer,00.00,"131,385.92",00.00
18-Oct-2021,Purchase,240.80,00.00,240.80
18-Oct-2021,Purchase,"16,879.70",00.00,"17,120.50"
18-Oct-2021,Interest,"20,345.00",00.00,"37,465.50"
18-Oct-2021,Transfer,"10,819.00",00.00,"48,284.50"
18-Oct-2021,NEFT,00.00,"8,047.42","40,237.08"
18-Oct-2021,Cheque,405.20,00.00,"40,642.28"
18-Oct-2021,NEFT,00.00,"6,773.71","33,868.57"
18-Oct-2021,Cheque,00.00,"6,773.71","27,094.86"
18-Oct-2021,Miscellaneous,00.00,"27,094.86",00.00
18-Oct-2021,Bill,06.20,00.00,06.20
18-Oct-2021,Commission,"25,226.00",00.00,"25,232.20"
18-Oct-2021,NEFT,"3,558.00",00.00,"28,790.20"
18-Oct-2021,Miscellaneous,00.00,"3,598.78","25,191.42"
18-Oct-2021,Commission,00.00,"25,191.42",00.00
18-Oct-2021,Miscellaneous,"15,238.00",00.00,"15,238.00"
18-Oct-2021,RTGS,00.00,"2,539.67","12,698.33"
18-Oct-2021,Purchase,"1,242.31",00.00,"13,940.64"
18-Oct-2021,IMPS,00.00,"3,485.16","10,455.48"
18-Oct-2021,Miscellaneous,00.00,"1,742.58","8,712.90"
18-Oct-2021,NEFT,00.00,871.29,"7,841.61"
18-Oct-2021,ATM,00.00,"2,613.87","5,227.74"
18-Oct-2021,Miscellaneous,08.00,00.00,"5,235.74"
18-Oct-2021,Transfer,00.00,"1,745.25","3,490.49"
18-Oct-2021,Transfer,348.39,00.00,"3,838.88"
18-Oct-2021,IMPS,664.00,00.00,"4,502.88"
18-Oct-2021,Miscellaneous,00.00,562.86,"3,940.02"
18-Oct-2021,Cheque,00.00,492.50,"3,447.52"
18-Oct-2021,Purchase,145.00,00.00,"3,592.52"
19-Oct-2021,Interest,63.14,00.00,"3,655.66"
19-Oct-2021,Cheque,00.98,00.00,"3,656.64"
19-Oct-2021,Miscellaneous,00.00,731.33,"2,925.31"
19-Oct-2021,Tax,00.00,731.33,"2,193.98"
20-Oct-2021,Commission,00.00,219.40,"1,974.58"
20-Oct-2021,Tax,00.00,658.19,"1,316.39"
20-Oct-2021,NEFT,00.00,219.40,"1,096.99"
20-Oct-2021,Tax,00.00,548.50,548.50
20-Oct-2021,RTGS,00.00,78.36,470.14
20-Oct-2021,IMPS,56.60,00.00,526.74
20-Oct-2021,Bill,05.20,00.00,531.94
20-Oct-2021,Commission,00.00,265.97,265.97
20-Oct-2021,Cash,"19,170.40",00.00,"19,436.37"
20-Oct-2021,ATM,00.00,"2,429.55","17,006.82"
20-Oct-2021,Transfer,00.00,"8,503.41","8,503.41"
20-Oct-2021,Tax,00.00,"1,062.93","7,440.48"
20-Oct-2021,Bill,00.00,"1,488.10","5,952.38"
20-Oct-2021,Reversal,00.00,595.24,"5,357.14"
20-Oct-2021,Reversal,"3,424.35",00.00,"8,781.49"
20-Oct-2021,Reversal,00.00,"2,927.16","5,854.33"
20-Oct-2021,Transfer,25.52,00.00,"5,879.85"
20-Oct-2021,Cash,286.00,00.00,"6,165.85"
20-Oct-2021,Reversal,"7,093.60",00.00,"13,259.45"
20-Oct-2021,Bill,00.00,"1,473.27","11,786.18"
20-Oct-2021,Tax,00.00,"1,309.58","10,476.60"
20-Oct-2021,ATM,00.00,"5,238.30","5,238.30"
20-Oct-2021,Transfer,00.00,"1,746.10","3,492.20"
20-Oct-2021,Interest,"1,641,375.50",00.00,"1,644,867.70"
20-Oct-2021,Tax,"3,700.00",00.00,"1,648,567.70"
20-Oct-2021,NEFT,00.00,"549,522.57","1,099,045.13"
20-Oct-2021,Commission,33.00,00.00,"1,099,078.13"
20-Oct-2021,Miscellaneous,01.31,00.00,"1,099,079.44"
20-Oct-2021,NEFT,00.00,"274,769.86","824,309.58"
20-Oct-2021,Transfer,"205,462.50",00.00,"1,029,772.08"
20-Oct-2021,Tax,"53,224.00",00.00,"1,082,996.08"
20-Oct-2021,RTGS,"7,013.00",00.00,"1,090,009.08"
20-Oct-2021,Tax,00.00,"121,112.12","968,896.96"
20-Oct-2021,NEFT,326.50,00.00,"969,223.46"
20-Oct-2021,Commission,"296,563.00",00.00,"1,265,786.46"
20-Oct-2021,IMPS,07.00,00.00,"1,265,793.46"
20-Oct-2021,Cash,54.25,00.00,"1,265,847.71"
20-Oct-2021,IMPS,"47,621.00",00.00,"1,313,468.71"
20-Oct-2021,RTGS,274.00,00.00,"1,313,742.71"
20-Oct-2021,NEFT,00.00,"437,914.24","875,828.47"
20-Oct-2021,Tax,"3,057.00",00.00,"878,885.47"
20-Oct-2021,Miscellaneous,00.00,"109,860.68","769,024.79"
20-Oct-2021,RTGS,00.00,"153,804.96","615,219.83"
20-Oct-2021,Tax,163.05,00.00,"615,382.88"
20-Oct-2021,ATM,"18,159.72",00.00,"633,542.60"
20-Oct-2021,IMPS,17.10,00.00,"633,559.70"
20-Oct-2021,Purchase,"39,161.47",00.00,"672,721.17"
20-Oct-2021,Interest,00.00,"672,721.17",00.00
20-Oct-2021,RTGS,"11,743.27",00.00,"11,743.27"
20-Oct-2021,ATM,00.00,"1,304.81","10,438.46"
20-Oct-2021,ATM,00.00,"1,043.85","9,394.61"
20-Oct-2021,ATM,00.00,"9,394.61",00.00
20-Oct-2021,ATM,52.80,00.00,52.80
20-Oct-2021,Purchase,"1,053.29",00.00,"1,106.09"
20-Oct-2021,Cheque,00.00,368.70,737.39
21-Oct-2021,Tax,04.56,00.00,741.95
21-Oct-2021,Cheque,00.00,105.99,635.96
21-Oct-2021,Debit Card,"15,245.02",00.00,"15,880.98"
21-Oct-2021,Cheque,240.42,00.00,"16,121.40"
21-Oct-2021,NEFT,301.47,00.00,"16,422.87"
21-Oct-2021,Cheque,"77,415.00",00.00,"93,837.87"
21-Oct-2021,Interest,00.00,"93,837.87",00.00
21-Oct-2021,Purchase,"8,809.37",00.00,"8,809.37"
21-Oct-2021,Debit Card,"999,565.50",00.00,"1,008,374.87"
21-Oct-2021,Miscellaneous,"5,683.70",00.00,"1,014,058.57"
21-Oct-2021,Transfer,"14,821.86",00.00,"1,028,880.43"
21-Oct-2021,Debit Card,587.00,00.00,"1,029,467.43"
21-Oct-2021,Bill,00.00,"257,366.86","772,100.57"
21-Oct-2021,Interest,00.00,"85,788.95","686,311.62"
21-Oct-2021,Commission,"1,556,226.00",00.00,"2,242,537.62"
21-Oct-2021,Commission,"1,935,197.75",00.00,"4,177,735.37"
21-Oct-2021,IMPS,00.00,"835,547.07","3,342,188.30"
21-Oct-2021,RTGS,"221,896.41",00.00,"3,564,084.71"
21-Oct-2021,Purchase,00.00,"396,009.41","3,168,075.30"
21-Oct-2021,Commission,00.00,"1,056,025.10","2,112,050.20"
21-Oct-2021,Debit Card,00.00,"704,016.73","1,408,033.47"
21-Oct-2021,Cash,00.00,"201,147.64","1,206,885.83"
21-Oct-2021,Transfer,00.00,"1,206,885.83",00.00
21-Oct-2021,Commission,01.20,00.00,01.20
21-Oct-2021,Reversal,00.00,00.24,00.96
21-Oct-2021,Tax,00.00,00.10,00.86
21-Oct-2021,Purchase,"3,588.69",00.00,"3,589.55"
21-Oct-2021,Interest,00.00,717.91,"2,871.64"
21-Oct-2021,Miscellaneous,00.00,574.33,"2,297.31"
21-Oct-2021,Bill,00.00,"2,297.31",00.00
22-Oct-2021,Commission,07.84,00.00,07.84
22-Oct-2021,Commission,00.00,03.92,03.92
22-Oct-2021,Purchase,404.90,00.00,408.82
22-Oct-2021,RTGS,00.00,136.27,272.55
22-Oct-2021,Debit Card,10.00,00.00,282.55
22-Oct-2021,Interest,"13,011.45",00.00,"13,294.00"
22-Oct-2021,RTGS,390.00,00.00,"13,684.00"
22-Oct-2021,Reversal,"2,735.91",00.00,"16,419.91"
22-Oct-2021,Transfer,37.30,00.00,"16,457.21"
22-Oct-2021,IMPS,00.00,"3,291.44","13,165.77"
22-Oct-2021,IMPS,"1,806,310.00",00.00,"1,819,475.77"
22-Oct-2021,NEFT,94.20,00.00,"1,819,569.97"
22-Oct-2021,Tax,00.00,"363,913.99","1,455,655.98"
22-Oct-2021,Transfer,00.00,"363,914.00","1,091,741.98"
22-Oct-2021,Cash,"74,308.06",00.00,"1,166,050.04"
22-Oct-2021,NEFT,00.00,"233,210.01","932,840.03"
22-Oct-2021,Purchase,161.37,00.00,"933,001.40"
22-Oct-2021,ATM,00.00,"155,500.23","777,501.17"
22-Oct-2021,Tax,00.00,"155,500.23","622,000.94"
22-Oct-2021,Bill,63.00,00.00,"622,063.94"
22-Oct-2021,Interest,00.00,"77,757.99","544,305.95"
22-Oct-2021,Miscellaneous,00.00,"108,861.19","435,444.76"
22-Oct-2021,Tax,195.00,00.00,"435,639.76"
22-Oct-2021,Transfer,04.00,00.00,"435,643.76"
22-Oct-2021,Bill,00.00,"48,404.86","387,238.90"
22-Oct-2021,IMPS,00.00,"55,319.84","331,919.06"
22-Oct-2021,Miscellaneous,00.00,"66,383.81","265,535.25"
22-Oct-2021,IMPS,00.00,"29,503.92","236,031.33"
22-Oct-2021,ATM,243.00,00.00,"236,274.33"
22-Oct-2021,Debit Card,03.00,00.00,"236,277.33"
22-Oct-2021,RTGS,"21,661.00",00.00,"257,938.33"
22-Oct-2021,RTGS,"397,188.00",00.00,"655,126.33"
22-Oct-2021,Interest,"190,534.00",00.00,"845,660.33"
22-Oct-2021,Transfer,"2,933.00",00.00,"848,593.33"
22-Oct-2021,Cheque,00.00,"424,296.67","424,296.66"
22-Oct-2021,RTGS,00.00,"84,859.33","339,437.33"
22-Oct-2021,Debit Card,"16,734.10",00.00,"356,171.43"
22-Oct-2021,RTGS,00.00,"356,171.43",00.00
22-Oct-2021,Debit Card,62.60,00.00,62.60
22-Oct-2021,RTGS,"48,781.30",00.00,"48,843.90"
22-Oct-2021,Bill,"7,213.00",00.00,"56,056.90"
22-Oct-2021,Commission,00.00,"14,014.23","42,042.68"
22-Oct-2021,Transfer,00.00,"21,021.34","21,021.34"
22-Oct-2021,Cash,00.00,"21,021.34",00.00
22-Oct-2021,Miscellaneous,"709,927.00",00.00,"709,927.00"
22-Oct-2021,Debit Card,24.40,00.00,"709,951.40"
22-Oct-2021,Cash,00.00,"141,990.28","567,961.12"
22-Oct-2021,Commission,02.90,00.00,"567,964.02"
22-Oct-2021,NEFT,00.00,"81,137.72","486,826.30"
22-Oct-2021,RTGS,109.00,00.00,"486,935.30"
22-Oct-2021,Transfer,00.00,"48,693.53","438,241.77"
22-Oct-2021,Interest,"85,678.40",00.00,"523,920.17"
22-Oct-2021,ATM,00.00,"130,980.04","392,940.13"
22-Oct-2021,RTGS,"197,792.10",00.00,"590,732.23"
22-Oct-2021,Debit Card,00.00,"147,683.06","443,049.17"
22-Oct-2021,Interest,00.00,"49,227.69","393,821.48"
22-Oct-2021,Reversal,210.30,00.00,"394,031.78"
22-Oct-2021,Miscellaneous,00.00,"131,343.93","262,687.85"
23-Oct-2021,Commission,00.00,"37,526.84","225,161.01"
23-Oct-2021,ATM,00.00,"22,516.10","202,644.91"
23-Oct-2021,Commission,00.00,"50,661.23","151,983.68"
23-Oct-2021,Debit Card,00.00,"18,997.96","132,985.72"
23-Oct-2021,Purchase,00.00,"26,597.14","106,388.58"
23-Oct-2021,Interest,00.00,"106,388.58",00.00
23-Oct-2021,Miscellaneous,"11,116.47",00.00,"11,116.47"
23-Oct-2021,Purchase,00.00,"1,588.07","9,528.40"
24-Oct-2021,Transfer,275.10,00.00,"9,803.50"
24-Oct-2021,Miscellaneous,"1,857,087.20",00.00,"1,866,890.70"
24-Oct-2021,Reversal,00.00,"186,689.07","1,680,201.63"
24-Oct-2021,Transfer,00.00,"840,100.82","840,100.82"
24-Oct-2021,Cheque,30.00,00.00,"840,130.82"
24-Oct-2021,Purchase,00.00,"140,021.80","700,109.02"
24-Oct-2021,NEFT,00.00,"100,015.57","600,093.45"
24-Oct-2021,Interest,00.00,"66,677.05","533,416.40"
24-Oct-2021,Tax,"32,666.00",00.00,"566,082.40"
24-Oct-2021,ATM,00.00,"113,216.48","452,865.92"
24-Oct-2021,Tax,465.90,00.00,"453,331.82"
25-Oct-2021,NEFT,00.00,"226,665.91","226,665.91"
25-Oct-2021,NEFT,00.00,"37,777.65","188,888.26"
25-Oct-2021,Miscellaneous,00.00,"47,222.07","141,666.20"
25-Oct-2021,Interest,32.00,00.00,"141,698.20"
25-Oct-2021,IMPS,"160,981.00",00.00,"302,679.20"
25-Oct-2021,ATM,51.00,00.00,"302,730.20"
26-Oct-2021,Bill,13.00,00.00,"302,743.20"
26-Oct-2021,Commission,16.70,00.00,"302,759.90"
26-Oct-2021,ATM,459.44,00.00,"303,219.34"
26-Oct-2021,ATM,"1,896.60",00.00,"305,115.94"
26-Oct-2021,IMPS,257.00,00.00,"305,372.94"
26-Oct-2021,Bill,04.00,00.00,"305,376.94"
26-Oct-2021,IMPS,52.90,00.00,"305,429.84"
26-Oct-2021,Cheque,462.80,00.00,"305,892.64"
26-Oct-2021,Cheque,00.00,"33,988.07","271,904.57"
26-Oct-2021,NEFT,"10,027.67",00.00,"281,932.24"
26-Oct-2021,Purchase,00.00,"281,932.24",00.00
26-Oct-2021,Transfer,"19,199.90",00.00,"19,199.90"
26-Oct-2021,Cheque,197.80,00.00,"19,397.70"
26-Oct-2021,IMPS,04.00,00.00,"19,401.70"
26-Oct-2021,Transfer,00.00,"2,425.21","16,976.49"
26-Oct-2021,Cheque,00.00,"2,829.42","14,147.08"
26-Oct-2021,RTGS,00.00,"3,536.77","10,610.31"
26-Oct-2021,Transfer,"19,274.50",00.00,"29,884.81"
26-Oct-2021,Debit Card,"17,085.00",00.00,"46,969.81"
26-Oct-2021,Transfer,"32,593.29",00.00,"79,563.10"
26-Oct-2021,Commission,42.00,00.00,"79,605.10"
26-Oct-2021,Interest,46.10,00.00,"79,651.20"
26-Oct-2021,Commission,00.00,"9,956.40","69,694.80"
26-Oct-2021,NEFT,"519,661.50",00.00,"589,356.30"
26-Oct-2021,IMPS,00.00,"294,678.15","294,678.15"
26-Oct-2021,RTGS,00.00,"29,467.82","265,210.34"
26-Oct-2021,Debit Card,"68,829.34",00.00,"334,039.68"
26-Oct-2021,Miscellaneous,"102,117.10",00.00,"436,156.78"
26-Oct-2021,Bill,00.00,"145,385.59","290,771.19"
26-Oct-2021,Tax,39.08,00.00,"290,810.27"
26-Oct-2021,Purchase,"2,133.90",00.00,"292,944.17"
26-Oct-2021,Miscellaneous,00.00,"41,849.17","251,095.00"
26-Oct-2021,Cheque,04.10,00.00,"251,099.10"
26-Oct-2021,NEFT,18.30,00.00,"251,117.40"
26-Oct-2021,Miscellaneous,05.10,00.00,"251,122.50"
26-Oct-2021,Tax,01.00,00.00,"251,123.50"
26-Oct-2021,Purchase,00.00,"125,561.75","125,561.75"
26-Oct-2021,RTGS,00.00,"13,951.31","111,610.44"
26-Oct-2021,NEFT,417.63,00.00,"112,028.07"
26-Oct-2021,Bill,55.82,00.00,"112,083.89"
26-Oct-2021,Bill,00.00,"28,020.97","84,062.92"
26-Oct-2021,ATM,152.00,00.00,"84,214.92"
27-Oct-2021,Debit Card,00.00,"28,071.64","56,143.28"
27-Oct-2021,RTGS,06.48,00.00,"56,149.76"
27-Oct-2021,ATM,"3,775.60",00.00,"59,925.36"
27-Oct-2021,Bill,00.00,"19,975.12","39,950.24"
27-Oct-2021,ATM,"2,654.64",00.00,"42,604.88"
27-Oct-2021,Cheque,01.40,00.00,"42,606.28"
27-Oct-2021,Transfer,00.00,"6,086.61","36,519.67"
27-Oct-2021,Cash,357.00,00.00,"36,876.67"
27-Oct-2021,Tax,431.83,00.00,"37,308.50"
27-Oct-2021,Tax,00.00,"12,436.17","24,872.33"
27-Oct-2021,Debit Card,00.00,"12,436.17","12,436.16"
27-Oct-2021,Interest,00.00,"12,436.16",00.00
27-Oct-2021,Commission,"2,492.91",00.00,"2,492.91"
27-Oct-2021,RTGS,00.00,356.13,"2,136.78"
27-Oct-2021,Purchase,"23,782.30",00.00,"25,919.08"
27-Oct-2021,NEFT,00.00,"25,919.08",00.00
27-Oct-2021,Bill,"2,335.50",00.00,"2,335.50"
27-Oct-2021,Transfer,00.00,333.64,"2,001.86"
27-Oct-2021,Cash,00.00,285.98,"1,715.88"
27-Oct-2021,Reversal,"3,008.61",00.00,"4,724.49"
27-Oct-2021,Miscellaneous,00.00,674.93,"4,049.56"
27-Oct-2021,Miscellaneous,00.00,"1,012.39","3,037.17"
27-Oct-2021,Commission,63.90,00.00,"3,101.07"
27-Oct-2021,IMPS,00.00,"1,550.54","1,550.54"
27-Oct-2021,IMPS,"191,081.09",00.00,"192,631.63"
27-Oct-2021,IMPS,"728,790.50",00.00,"921,422.13"
27-Oct-2021,ATM,00.00,"153,570.36","767,851.78"
27-Oct-2021,IMPS,07.00,00.00,"767,858.78"
27-Oct-2021,Purchase,"26,857.43",00.00,"794,716.21"
27-Oct-2021,Debit Card,"11,056.00",00.00,"805,772.21"
27-Oct-2021,Tax,"557,409.25",00.00,"1,363,181.46"
27-Oct-2021,RTGS,"81,875.38",00.00,"1,445,056.84"
27-Oct-2021,Bill,00.00,"160,561.87","1,284,494.97"
27-Oct-2021,Commission,447.50,00.00,"1,284,942.47"
27-Oct-2021,Reversal,"1,700.95",00.00,"1,286,643.42"
27-Oct-2021,RTGS,00.00,"257,328.68","1,029,314.74"
27-Oct-2021,Reversal,111.90,00.00,"1,029,426.64"
27-Oct-2021,Commission,"21,828.12",00.00,"1,051,254.76"
27-Oct-2021,Debit Card,"141,728.91",00.00,"1,192,983.67"
27-Oct-2021,Commission,02.50,00.00,"1,192,986.17"
28-Oct-2021,ATM,"233,067.00",00.00,"1,426,053.17"
28-Oct-2021,Miscellaneous,"4,100.00",00.00,"1,430,153.17"
28-Oct-2021,ATM,45.68,00.00,"1,430,198.85"
28-Oct-2021,Cheque,266.91,00.00,"1,430,465.76"
28-Oct-2021,RTGS,"1,346.50",00.00,"1,431,812.26"
28-Oct-2021,Transfer,55.00,00.00,"1,431,867.26"
28-Oct-2021,Bill,00.67,00.00,"1,431,867.93"
28-Oct-2021,Tax,00.00,"715,933.97","715,933.96"
28-Oct-2021,NEFT,00.00,"89,491.75","626,442.22"
29-Oct-2021,NEFT,"54,011.00",00.00,"680,453.22"
29-Oct-2021,ATM,"1,559.10",00.00,"682,012.32"
29-Oct-2021,Debit Card,00.00,"97,430.33","584,581.99"
29-Oct-2021,Debit Card,00.00,"64,953.55","519,628.44"
29-Oct-2021,Transfer,00.00,"74,232.63","445,395.81"
29-Oct-2021,Bill,209.24,00.00,"445,605.05"
29-Oct-2021,Tax,41.90,00.00,"445,646.95"
29-Oct-2021,NEFT,07.00,00.00,"445,653.95"
29-Oct-2021,Commission,00.00,"89,130.79","356,523.16"
30-Oct-2021,Miscellaneous,00.00,"59,420.53","297,102.63"
30-Oct-2021,Commission,00.00,"74,275.66","222,826.97"
30-Oct-2021,Commission,374.00,00.00,"223,200.97"
30-Oct-2021,IMPS,00.00,"223,200.97",00.00
30-Oct-2021,Miscellaneous,18.00,00.00,18.00
30-Oct-2021,Interest,451.28,00.00,469.28
30-Oct-2021,Interest,00.00,52.14,417.14
30-Oct-2021,Interest,00.00,69.52,347.62
30-Oct-2021,Reversal,00.00,49.66,297.96
30-Oct-2021,Interest,06.00,00.00,303.96
30-Oct-2021,Commission,"44,271.22",00.00,"44,575.18"
30-Oct-2021,Reversal,"64,203.94",00.00,"108,779.12"
30-Oct-2021,Interest,00.00,"15,539.87","93,239.25"
30-Oct-2021,Reversal,00.00,"23,309.81","69,929.44"
30-Oct-2021,Bill,"107,054.00",00.00,"176,983.44"
30-Oct-2021,Cash,"7,629.00",00.00,"184,612.44"
30-Oct-2021,Commission,00.00,"61,537.48","123,074.96"
30-Oct-2021,RTGS,00.00,"15,384.37","107,690.59"
30-Oct-2021,Bill,"1,292,288.00",00.00,"1,399,978.59"
30-Oct-2021,Bill,"24,015.80",00.00,"1,423,994.39"
31-Oct-2021,NEFT,477.30,00.00,"1,424,471.69"
31-Oct-2021,RTGS,00.00,"158,274.63","1,266,197.06"
31-Oct-2021,Transfer,00.00,"180,885.29","1,085,311.77"
31-Oct-2021,RTGS,352.26,00.00,"1,085,664.03"
31-Oct-2021,Bill,00.00,"361,888.01","723,776.02"
31-Oct-2021,Cheque,00.00,"723,776.02",00.00
31-Oct-2021,Transfer,"202,080.72",00.00,"202,080.72"
31-Oct-2021,Reversal,125.00,00.00,"202,205.72"
31-Oct-2021,ATM,32.00,00.00,"202,237.72"
01-Nov-2021,Debit Card,"2,044.54",00.00,"204,282.26"
01-Nov-2021,IMPS,"31,293.90",00.00,"235,576.16"
01-Nov-2021,Miscellaneous,00.00,"78,525.39","157,050.77"
01-Nov-2021,Purchase,00.00,"19,631.35","137,419.42"
01-Nov-2021,Commission,00.00,"137,419.42",00.00
01-Nov-2021,Miscellaneous,298.03,00.00,298.03
01-Nov-2021,Cheque,06.07,00.00,304.10
01-Nov-2021,ATM,76.00,00.00,380.10
01-Nov-2021,Interest,00.00,76.02,304.08
01-Nov-2021,ATM,00.00,33.79,270.29
01-Nov-2021,Miscellaneous,00.00,45.05,225.24
01-Nov-2021,Transfer,00.00,75.08,150.16
01-Nov-2021,Cheque,"235,051.00",00.00,"235,201.16"
01-Nov-2021,Interest,00.00,"78,400.39","156,800.77"
01-Nov-2021,Debit Card,260.00,00.00,"157,060.77"
01-Nov-2021,RTGS,"3,698.00",00.00,"160,758.77"
01-Nov-2021,Cash,212.10,00.00,"160,970.87"
01-Nov-2021,Purchase,00.00,"80,485.44","80,485.44"
01-Nov-2021,Reversal,188.86,00.00,"80,674.30"
01-Nov-2021,Tax,00.00,"20,168.58","60,505.73"
01-Nov-2021,Tax,00.00,"8,643.68","51,862.05"
01-Nov-2021,Reversal,00.00,"17,287.35","34,574.70"
01-Nov-2021,Debit Card,00.00,"3,457.47","31,117.23"
01-Nov-2021,IMPS,01.20,00.00,"31,118.43"
01-Nov-2021,Cash,03.30,00.00,"31,121.73"
01-Nov-2021,RTGS,07.70,00.00,"31,129.43"
01-Nov-2021,Cash,00.00,"3,458.83","27,670.60"
01-Nov-2021,Purchase,"3,633.70",00.00,"31,304.30"
01-Nov-2021,Purchase,"22,359.00",00.00,"53,663.30"
01-Nov-2021,ATM,00.00,"26,831.65","26,831.65"
01-Nov-2021,ATM,451.10,00.00,"27,282.75"
01-Nov-2021,NEFT,332.00,00.00,"27,614.75"
01-Nov-2021,RTGS,00.00,"5,522.95","22,091.80"
01-Nov-2021,Cash,303.00,00.00,"22,394.80"
01-Nov-2021,RTGS,"1,769.00",00.00,"24,163.80"
01-Nov-2021,Commission,01.00,00.00,"24,164.80"
01-Nov-2021,Miscellaneous,00.00,"3,020.60","21,144.20"
01-Nov-2021,Bill,00.00,"10,572.10","10,572.10"
01-Nov-2021,Cheque,00.00,"3,524.03","7,048.07"
01-Nov-2021,ATM,00.00,"1,006.87","6,041.20"
01-Nov-2021,IMPS,00.00,604.12,"5,437.08"
01-Nov-2021,Reversal,00.00,776.73,"4,660.35"
01-Nov-2021,NEFT,"1,284,532.50",00.00,"1,289,192.85"
01-Nov-2021,Reversal,"37,686.00",00.00,"1,326,878.85"
01-Nov-2021,IMPS,"1,512,494.00",00.00,"2,839,372.85"
01-Nov-2021,Cash,107.10,00.00,"2,839,479.95"
01-Nov-2021,IMPS,01.65,00.00,"2,839,481.60"
01-Nov-2021,Debit Card,"29,871.20",00.00,"2,869,352.80"
01-Nov-2021,Debit Card,00.00,"286,935.28","2,582,417.52"
01-Nov-2021,Reversal,00.00,"286,935.28","2,295,482.24"
01-Nov-2021,Debit Card,00.00,"765,160.75","1,530,321.49"
01-Nov-2021,Purchase,00.00,"170,035.72","1,360,285.77"
01-Nov-2021,Cash,"1,649,956.00",00.00,"3,010,241.77"
01-Nov-2021,Debit Card,00.00,"334,471.31","2,675,770.46"
01-Nov-2021,ATM,"699,045.50",00.00,"3,374,815.96"
01-Nov-2021,Cash,49.00,00.00,"3,374,864.96"
01-Nov-2021,NEFT,00.00,"843,716.24","2,531,148.72"
01-Nov-2021,RTGS,26.40,00.00,"2,531,175.12"
02-Nov-2021,Commission,"18,004.00",00.00,"2,549,179.12"
02-Nov-2021,Bill,00.00,"1,274,589.56","1,274,589.56"
02-Nov-2021,NEFT,00.00,"318,647.39","955,942.17"
02-Nov-2021,RTGS,00.00,"106,215.80","849,726.37"
02-Nov-2021,Miscellaneous,167.70,00.00,"849,894.07"
02-Nov-2021,Tax,00.00,"106,236.76","743,657.31"
02-Nov-2021,IMPS,00.00,"247,885.77","495,771.54"
02-Nov-2021,Debit Card,04.60,00.00,"495,776.14"
03-Nov-2021,Debit Card,00.00,"61,972.02","433,804.12"
03-Nov-2021,Cash,02.00,00.00,"433,806.12"
03-Nov-2021,Transfer,00.00,"433,806.12",00.00
03-Nov-2021,Purchase,"3,738.93",00.00,"3,738.93"
03-Nov-2021,Transfer,86.58,00.00,"3,825.51"
03-Nov-2021,Bill,"16,031.00",00.00,"19,856.51"
03-Nov-2021,ATM,06.82,00.00,"19,863.33"
03-Nov-2021,Cash,"244,557.80",00.00,"264,421.13"
03-Nov-2021,Cash,00.00,"44,070.19","220,350.94"
03-Nov-2021,IMPS,"2,032,708.00",00.00,"2,253,058.94"
03-Nov-2021,Debit Card,00.00,"225,305.89","2,027,753.05"
03-Nov-2021,Purchase,00.00,"253,469.13","1,774,283.92"
03-Nov-2021,ATM,"23,244.94",00.00,"1,797,528.86"
03-Nov-2021,RTGS,"990,055.20",00.00,"2,787,584.06"
03-Nov-2021,Reversal,00.00,"348,448.01","2,439,136.05"
03-Nov-2021,NEFT,19.70,00.00,"2,439,155.75"
03-Nov-2021,Reversal,00.00,"304,894.47","2,134,261.28"
03-Nov-2021,Debit Card,00.00,"355,710.21","1,778,551.07"
03-Nov-2021,RTGS,00.00,"1,778,551.07",00.00
03-Nov-2021,Transfer,"1,568.64",00.00,"1,568.64"
03-Nov-2021,Tax,00.00,261.44,"1,307.20"
03-Nov-2021,Cash,00.00,130.72,"1,176.48"
03-Nov-2021,Commission,41.00,00.00,"1,217.48"
03-Nov-2021,Commission,"1,625,978.75",00.00,"1,627,196.23"
03-Nov-2021,IMPS,"112,423.00",00.00,"1,739,619.23"
03-Nov-2021,Tax,"23,778.25",00.00,"1,763,397.48"
03-Nov-2021,Miscellaneous,00.00,"220,424.69","1,542,972.80"
03-Nov-2021,Tax,00.00,"257,162.13","1,285,810.67"
03-Nov-2021,Tax,03.00,00.00,"1,285,813.67"
03-Nov-2021,Cheque,00.00,"321,453.42","964,360.25"
03-Nov-2021,Bill,"2,746.00",00.00,"967,106.25"
03-Nov-2021,IMPS,00.00,"138,158.04","828,948.21"
03-Nov-2021,Interest,02.40,00.00,"828,950.61"
03-Nov-2021,ATM,"18,825.80",00.00,"847,776.41"
03-Nov-2021,Interest,"29,742.00",00.00,"877,518.41"
03-Nov-2021,Purchase,00.00,"292,506.14","585,012.27"
03-Nov-2021,Tax,00.00,"146,253.07","438,759.20"
03-Nov-2021,IMPS,00.00,"87,751.84","351,007.36"
03-Nov-2021,Cheque,00.80,00.00,"351,008.16"
03-Nov-2021,Bill,34.00,00.00,"351,042.16"
03-Nov-2021,Cheque,00.00,"351,042.16",00.00
03-Nov-2021,Debit Card,"2,059.40",00.00,"2,059.40"
03-Nov-2021,Cash,00.00,686.47,"1,372.93"
03-Nov-2021,Miscellaneous,00.00,171.62,"1,201.31"
03-Nov-2021,Purchase,07.00,00.00,"1,208.31"
03-Nov-2021,Debit Card,03.00,00.00,"1,211.31"
03-Nov-2021,IMPS,"973,193.00",00.00,"974,404.31"
03-Nov-2021,RTGS,"58,170.00",00.00,"1,032,574.31"
03-Nov-2021,Miscellaneous,00.00,"206,514.86","826,059.45"
04-Nov-2021,ATM,09.40,00.00,"826,068.85"
04-Nov-2021,Bill,00.00,"826,068.85",00.00
04-Nov-2021,IMPS,225.30,00.00,225.30
04-Nov-2021,NEFT,00.00,45.06,180.24
04-Nov-2021,Miscellaneous,"56,676.66",00.00,"56,856.90"
04-Nov-2021,Interest,00.00,"9,476.15","47,380.75"
04-Nov-2021,Cheque,00.00,"5,922.59","41,458.16"
04-Nov-2021,Reversal,17.50,00.00,"41,475.66"
04-Nov-2021,Cash,00.00,"10,368.92","31,106.75"
04-Nov-2021,Cash,"1,561,162.00",00.00,"1,592,268.75"
04-Nov-2021,RTGS,23.70,00.00,"1,592,292.45"
04-Nov-2021,ATM,00.00,"227,470.35","1,364,822.10"
04-Nov-2021,NEFT,00.00,"194,974.59","1,169,847.51"
04-Nov-2021,Miscellaneous,00.00,"233,969.50","935,878.01"
04-Nov-2021,Commission,00.00,"155,979.67","779,898.34"
04-Nov-2021,Reversal,"3,670.50",00.00,"783,568.84"
04-Nov-2021,Commission,195.19,00.00,"783,764.03"
04-Nov-2021,Miscellaneous,00.00,"78,376.40","705,387.63"
04-Nov-2021,Cash,26.60,00.00,"705,414.23"
04-Nov-2021,Commission,00.00,"117,569.04","587,845.19"
04-Nov-2021,Miscellaneous,00.00,"195,948.40","391,896.79"
04-Nov-2021,Interest,00.00,"97,974.20","293,922.59"
04-Nov-2021,ATM,01.40,00.00,"293,923.99"
04-Nov-2021,Debit Card,00.00,"29,392.40","264,531.59"
04-Nov-2021,Transfer,00.00,"52,906.32","211,625.27"
04-Nov-2021,Interest,00.00,"35,270.88","176,354.39"
04-Nov-2021,IMPS,00.00,"19,594.93","156,759.46"
04-Nov-2021,Miscellaneous,00.00,"31,351.89","125,407.57"
04-Nov-2021,Cheque,00.00,"41,802.52","83,605.05"
04-Nov-2021,ATM,00.00,"8,360.51","75,244.54"
04-Nov-2021,NEFT,00.00,"18,811.14","56,433.40"
04-Nov-2021,Miscellaneous,00.00,"28,216.70","28,216.70"
04-Nov-2021,Bill,00.00,"7,054.18","21,162.52"
04-Nov-2021,Purchase,00.00,"2,645.32","18,517.21"
04-Nov-2021,Commission,00.00,"2,057.47","16,459.74"
05-Nov-2021,Tax,00.00,"2,351.39","14,108.35"
06-Nov-2021,Reversal,00.00,"1,763.54","12,344.81"
06-Nov-2021,Commission,00.00,"1,234.48","11,110.33"
06-Nov-2021,Debit Card,964.00,00.00,"12,074.33"
06-Nov-2021,Debit Card,"1,751,528.00",00.00,"1,763,602.33"
06-Nov-2021,Purchase,07.17,00.00,"1,763,609.50"
06-Nov-2021,IMPS,"3,920.57",00.00,"1,767,530.07"
06-Nov-2021,Bill,"3,898.20",00.00,"1,771,428.27"
06-Nov-2021,NEFT,00.00,"1,771,428.27",00.00
06-Nov-2021,Transfer,"87,596.40",00.00,"87,596.40"
06-Nov-2021,Cheque,00.00,"21,899.10","65,697.30"
06-Nov-2021,Debit Card,00.00,"32,848.65","32,848.65"
06-Nov-2021,RTGS,98.00,00.00,"32,946.65"
06-Nov-2021,Cheque,00.00,"10,982.22","21,964.43"
06-Nov-2021,IMPS,00.00,"2,440.49","19,523.94"
06-Nov-2021,Interest,117.80,00.00,"19,641.74"
06-Nov-2021,ATM,00.00,"3,273.62","16,368.12"
06-Nov-2021,IMPS,"23,970.00",00.00,"40,338.12"
06-Nov-2021,Miscellaneous,"122,864.00",00.00,"163,202.12"
06-Nov-2021,Miscellaneous,05.00,00.00,"163,207.12"
06-Nov-2021,ATM,444.70,00.00,"163,651.82"
06-Nov-2021,Tax,"1,455,116.00",00.00,"1,618,767.82"
06-Nov-2021,Transfer,25.37,00.00,"1,618,793.19"
06-Nov-2021,RTGS,"1,779,209.75",00.00,"3,398,002.94"
06-Nov-2021,IMPS,"720,495.50",00.00,"4,118,498.44"
06-Nov-2021,Commission,08.00,00.00,"4,118,506.44"
06-Nov-2021,IMPS,07.20,00.00,"4,118,513.64"
06-Nov-2021,RTGS,240.90,00.00,"4,118,754.54"
06-Nov-2021,Commission,00.00,"514,844.32","3,603,910.22"
06-Nov-2021,Miscellaneous,00.00,"360,391.02","3,243,519.20"
06-Nov-2021,Cheque,00.00,"463,359.89","2,780,159.31"
06-Nov-2021,NEFT,00.00,"926,719.77","1,853,439.54"
07-Nov-2021,Interest,08.00,00.00,"1,853,447.54"
07-Nov-2021,Reversal,00.00,"617,815.85","1,235,631.69"
07-Nov-2021,Commission,213.59,00.00,"1,235,845.28"
07-Nov-2021,Interest,00.00,"137,316.14","1,098,529.14"
07-Nov-2021,Commission,00.00,"122,058.79","976,470.35"
07-Nov-2021,Miscellaneous,"32,145.00",00.00,"1,008,615.35"
07-Nov-2021,Purchase,93.50,00.00,"1,008,708.85"
07-Nov-2021,Reversal,78.00,00.00,"1,008,786.85"
07-Nov-2021,Bill,00.00,"336,262.28","672,524.57"
07-Nov-2021,Cheque,01.86,00.00,"672,526.43"
07-Nov-2021,Reversal,25.51,00.00,"672,551.94"
07-Nov-2021,NEFT,00.00,"672,551.94",00.00
07-Nov-2021,ATM,327.10,00.00,327.10
07-Nov-2021,Interest,00.00,36.34,290.76
07-Nov-2021,Bill,"17,432.00",00.00,"17,722.76"
07-Nov-2021,Cash,00.00,"3,544.55","14,178.21"
07-Nov-2021,Purchase,07.63,00.00,"14,185.84"
07-Nov-2021,Debit Card,"141,764.20",00.00,"155,950.04"
07-Nov-2021,IMPS,"200,027.00",00.00,"355,977.04"
07-Nov-2021,Bill,00.00,"59,329.51","296,647.53"
07-Nov-2021,Debit Card,00.00,"42,378.22","254,269.31"
07-Nov-2021,Reversal,00.00,"28,252.15","226,017.16"
07-Nov-2021,Commission,"1,383,014.00",00.00,"1,609,031.16"
07-Nov-2021,Cheque,00.00,"321,806.23","1,287,224.93"
07-Nov-2021,Cash,00.00,"257,444.99","1,029,779.94"
07-Nov-2021,NEFT,00.00,"343,259.98","686,519.96"
07-Nov-2021,RTGS,00.00,"686,519.96",00.00
07-Nov-2021,Tax,"80,002.59",00.00,"80,002.59"
07-Nov-2021,Cheque,06.00,00.00,"80,008.59"
07-Nov-2021,Cheque,"1,579,914.25",00.00,"1,659,922.84"
07-Nov-2021,Reversal,00.00,"207,490.36","1,452,432.48"
07-Nov-2021,IMPS,00.00,"242,072.08","1,210,360.40"
07-Nov-2021,Cheque,113.00,00.00,"1,210,473.40"
08-Nov-2021,Interest,"2,320.00",00.00,"1,212,793.40"
08-Nov-2021,RTGS,"3,470.00",00.00,"1,216,263.40"
08-Nov-2021,Bill,"712,667.00",00.00,"1,928,930.40"
08-Nov-2021,Tax,53.66,00.00,"1,928,984.06"
08-Nov-2021,ATM,00.00,"482,246.02","1,446,738.04"
08-Nov-2021,Interest,00.00,"723,369.02","723,369.02"
08-Nov-2021,Transfer,"93,909.70",00.00,"817,278.72"
08-Nov-2021,Transfer,00.00,"81,727.87","735,550.85"
08-Nov-2021,Debit Card,00.00,"735,550.85",00.00
08-Nov-2021,Miscellaneous,"12,751.95",00.00,"12,751.95"
08-Nov-2021,Commission,00.00,"1,275.20","11,476.76"
08-Nov-2021,Commission,"4,056.00",00.00,"15,532.76"
08-Nov-2021,Purchase,"3,786.42",00.00,"19,319.18"
08-Nov-2021,Bill,"20,987.10",00.00,"40,306.28"
08-Nov-2021,Debit Card,00.00,"4,030.63","36,275.65"
08-Nov-2021,Tax,"168,513.20",00.00,"204,788.85"
08-Nov-2021,ATM,00.00,"40,957.77","163,831.08"
08-Nov-2021,Reversal,00.00,"163,831.08",00.00
08-Nov-2021,Reversal,06.00,00.00,06.00
08-Nov-2021,Tax,"86,980.50",00.00,"86,986.50"
08-Nov-2021,RTGS,00.00,"10,873.31","76,113.19"
08-Nov-2021,Cheque,00.00,"76,113.19",00.00
08-Nov-2021,Miscellaneous,"938,042.00",00.00,"938,042.00"
08-Nov-2021,Commission,00.00,"156,340.33","781,701.67"
08-Nov-2021,Debit Card,"209,963.90",00.00,"991,665.57"
08-Nov-2021,NEFT,"567,529.00",00.00,"1,559,194.57"
08-Nov-2021,Interest,00.00,"222,742.08","1,336,452.49"
08-Nov-2021,Tax,00.00,"668,226.25","668,226.24"
08-Nov-2021,Tax,00.00,"133,645.25","534,580.99"
08-Nov-2021,Interest,00.00,"89,096.83","445,484.16"
08-Nov-2021,Reversal,00.00,"111,371.04","334,113.12"
08-Nov-2021,Bill,00.00,"334,113.12",00.00
08-Nov-2021,ATM,"1,344.80",00.00,"1,344.80"
08-Nov-2021,RTGS,00.00,134.48,"1,210.32"
08-Nov-2021,RTGS,"2,083.97",00.00,"3,294.29"
08-Nov-2021,RTGS,00.00,823.57,"2,470.72"
08-Nov-2021,ATM,00.00,274.52,"2,196.20"
08-Nov-2021,Tax,00.00,313.74,"1,882.46"
08-Nov-2021,Commission,00.00,470.62,"1,411.84"
08-Nov-2021,ATM,00.00,"1,411.84",00.00
08-Nov-2021,Transfer,"2,286.08",00.00,"2,286.08"
08-Nov-2021,Debit Card,43.49,00.00,"2,329.57"
08-Nov-2021,Purchase,00.00,258.84,"2,070.73"
08-Nov-2021,Cheque,509.39,00.00,"2,580.12"
08-Nov-2021,ATM,00.00,645.03,"1,935.09"
08-Nov-2021,Cheque,"1,990,560.00",00.00,"1,992,495.09"
08-Nov-2021,Tax,00.00,"498,123.77","1,494,371.32"
08-Nov-2021,ATM,168.00,00.00,"1,494,539.32"
08-Nov-2021,NEFT,"8,261.00",00.00,"1,502,800.32"
08-Nov-2021,Debit Card,00.00,"150,280.03","1,352,520.29"
08-Nov-2021,Purchase,"2,476.00",00.00,"1,354,996.29"
08-Nov-2021,RTGS,00.00,"169,374.54","1,185,621.75"
08-Nov-2021,Cheque,00.00,"1,185,621.75",00.00
08-Nov-2021,Cash,02.79,00.00,02.79
08-Nov-2021,Interest,00.00,00.47,02.33
08-Nov-2021,RTGS,00.00,00.78,01.55
08-Nov-2021,ATM,00.00,00.31,01.24
08-Nov-2021,Purchase,00.00,00.62,00.62
08-Nov-2021,IMPS,00.00,00.31,00.31
08-Nov-2021,NEFT,31.00,00.00,31.31
08-Nov-2021,Bill,00.00,03.91,27.40
08-Nov-2021,Cash,"1,244.20",00.00,"1,271.60"
08-Nov-2021,Bill,"1,018,840.00",00.00,"1,020,111.60"
08-Nov-2021,Miscellaneous,17.92,00.00,"1,020,129.52"
08-Nov-2021,Transfer,00.00,"255,032.38","765,097.14"
08-Nov-2021,Tax,"121,566.90",00.00,"886,664.04"
08-Nov-2021,Debit Card,05.69,00.00,"886,669.73"
08-Nov-2021,Transfer,00.00,"295,556.58","591,113.15"
08-Nov-2021,Tax,"7,649.00",00.00,"598,762.15"
08-Nov-2021,Cheque,"1,782.25",00.00,"600,544.40"
08-Nov-2021,Reversal,00.00,"75,068.05","525,476.35"
08-Nov-2021,Miscellaneous,00.96,00.00,"525,477.31"
08-Nov-2021,IMPS,00.00,"105,095.46","420,381.85"
08-Nov-2021,ATM,00.00,"46,709.09","373,672.76"
08-Nov-2021,NEFT,00.00,"124,557.59","249,115.17"
08-Nov-2021,Tax,00.00,"49,823.03","199,292.14"
08-Nov-2021,RTGS,00.00,"24,911.52","174,380.62"
08-Nov-2021,Tax,13.30,00.00,"174,393.92"
08-Nov-2021,Interest,00.00,"34,878.78","139,515.14"
08-Nov-2021,Cheque,00.00,"17,439.39","122,075.75"
08-Nov-2021,Cheque,00.00,"17,439.39","104,636.36"
08-Nov-2021,Miscellaneous,00.00,"13,079.55","91,556.82"
08-Nov-2021,IMPS,72.90,00.00,"91,629.72"
08-Nov-2021,Cash,36.97,00.00,"91,666.69"
08-Nov-2021,Purchase,00.00,"15,277.78","76,388.91"
08-Nov-2021,Bill,"72,029.75",00.00,"148,418.66"
08-Nov-2021,IMPS,04.50,00.00,"148,423.16"
08-Nov-2021,Transfer,00.00,"29,684.63","118,738.53"
08-Nov-2021,Debit Card,06.76,00.00,"118,745.29"
09-Nov-2021,Transfer,"2,304.30",00.00,"121,049.59"
09-Nov-2021,IMPS,"2,667.00",00.00,"123,716.59"
09-Nov-2021,Bill,"2,529.40",00.00,"126,245.99"
09-Nov-2021,RTGS,00.00,"25,249.20","100,996.79"
09-Nov-2021,Tax,"26,319.56",00.00,"127,316.35"
09-Nov-2021,ATM,00.00,"18,188.05","109,128.30"
09-Nov-2021,Reversal,00.00,"15,589.76","93,538.54"
09-Nov-2021,Miscellaneous,"670,901.20",00.00,"764,439.74"
09-Nov-2021,Interest,616.00,00.00,"765,055.74"
09-Nov-2021,IMPS,00.00,"85,006.19","680,049.55"
09-Nov-2021,Transfer,"2,571.81",00.00,"682,621.36"
09-Nov-2021,NEFT,"315,064.25",00.00,"997,685.61"
09-Nov-2021,Interest,13.53,00.00,"997,699.14"
09-Nov-2021,Debit Card,00.00,"166,283.19","831,415.95"
09-Nov-2021,Transfer,00.00,"831,415.95",00.00
09-Nov-2021,Cheque,04.73,00.00,04.73
09-Nov-2021,Commission,"17,886.08",00.00,"17,890.81"
09-Nov-2021,Tax,00.00,"17,890.81",00.00
09-Nov-2021,RTGS,493.69,00.00,493.69
09-Nov-2021,Debit Card,00.00,49.37,444.32
09-Nov-2021,ATM,00.00,222.16,222.16
09-Nov-2021,Cheque,"3,840.00",00.00,"4,062.16"
09-Nov-2021,Commission,"181,378.20",00.00,"185,440.36"
09-Nov-2021,NEFT,00.00,"37,088.07","148,352.29"
09-Nov-2021,Transfer,"1,363.00",00.00,"149,715.29"
09-Nov-2021,Cheque,00.00,"18,714.41","131,000.88"
09-Nov-2021,Debit Card,00.00,"43,666.96","87,333.92"
09-Nov-2021,Purchase,253.00,00.00,"87,586.92"
09-Nov-2021,Cash,00.00,"14,597.82","72,989.10"
09-Nov-2021,Cash,"408,450.00",00.00,"481,439.10"
09-Nov-2021,ATM,00.00,"60,179.89","421,259.21"
09-Nov-2021,Interest,"3,356.10",00.00,"424,615.31"
09-Nov-2021,RTGS,00.00,"212,307.66","212,307.66"
09-Nov-2021,Cash,"3,606.00",00.00,"215,913.66"
09-Nov-2021,RTGS,"601,378.50",00.00,"817,292.16"
09-Nov-2021,Cheque,02.00,00.00,"817,294.16"
09-Nov-2021,ATM,41.00,00.00,"817,335.16"
09-Nov-2021,Purchase,00.00,"102,166.90","715,168.26"
09-Nov-2021,ATM,00.00,"79,463.14","635,705.12"
09-Nov-2021,Tax,"104,013.00",00.00,"739,718.12"
09-Nov-2021,Purchase,"24,778.60",00.00,"764,496.72"
09-Nov-2021,Interest,00.00,"152,899.34","611,597.38"
09-Nov-2021,Debit Card,120.00,00.00,"611,717.38"
09-Nov-2021,Reversal,"104,874.03",00.00,"716,591.41"
09-Nov-2021,RTGS,00.00,"89,573.93","627,017.48"
09-Nov-2021,ATM,"7,532.21",00.00,"634,549.69"
09-Nov-2021,Cheque,"1,103,571.50",00.00,"1,738,121.19"
09-Nov-2021,Interest,05.00,00.00,"1,738,126.19"
09-Nov-2021,Commission,00.00,"193,125.13","1,545,001.06"
09-Nov-2021,Purchase,448.00,00.00,"1,545,449.06"
09-Nov-2021,Cheque,03.00,00.00,"1,545,452.06"
09-Nov-2021,Miscellaneous,00.00,"220,778.87","1,324,673.19"
09-Nov-2021,RTGS,"151,109.00",00.00,"1,475,782.19"
09-Nov-2021,Purchase,"1,375,891.80",00.00,"2,851,673.99"
09-Nov-2021,IMPS,00.00,"316,852.67","2,534,821.32"
09-Nov-2021,Interest,"9,864.39",00.00,"2,544,685.71"
09-Nov-2021,Debit Card,00.00,"363,526.53","2,181,159.18"
09-Nov-2021,Cash,00.00,"311,594.17","1,869,565.01"
09-Nov-2021,RTGS,00.00,"373,913.00","1,495,652.01"
09-Nov-2021,Commission,00.00,"498,550.67","997,101.34"
09-Nov-2021,Tax,00.00,"997,101.34",00.00
09-Nov-2021,Tax,104.00,00.00,104.00
09-Nov-2021,Reversal,00.00,104.00,00.00
09-Nov-2021,Interest,"25,079.91",00.00,"25,079.91"
09-Nov-2021,Bill,"204,553.10",00.00,"229,633.01"
09-Nov-2021,NEFT,04.70,00.00,"229,637.71"
09-Nov-2021,Bill,120.00,00.00,"229,757.71"
09-Nov-2021,NEFT,00.00,"229,757.71",00.00
09-Nov-2021,Commission,20.00,00.00,20.00
09-Nov-2021,NEFT,21.00,00.00,41.00
09-Nov-2021,Bill,"1,383,445.50",00.00,"1,383,486.50"
09-Nov-2021,Cheque,"8,800.00",00.00,"1,392,286.50"
09-Nov-2021,Tax,00.00,"1,392,286.50",00.00
09-Nov-2021,ATM,"1,669,203.00",00.00,"1,669,203.00"
09-Nov-2021,NEFT,"26,401.00",00.00,"1,695,604.00"
09-Nov-2021,Cheque,"1,537,000.20",00.00,"3,232,604.20"
09-Nov-2021,Reversal,"26,276.20",00.00,"3,258,880.40"
09-Nov-2021,Miscellaneous,00.00,"407,360.05","2,851,520.35"
09-Nov-2021,Miscellaneous,00.00,"712,880.09","2,138,640.26"
09-Nov-2021,NEFT,"86,865.40",00.00,"2,225,505.66"
09-Nov-2021,Commission,03.50,00.00,"2,225,509.16"
09-Nov-2021,Tax,38.20,00.00,"2,225,547.36"
09-Nov-2021,Cash,"17,918.60",00.00,"2,243,465.96"
09-Nov-2021,Bill,00.00,"373,910.99","1,869,554.97"
09-Nov-2021,Debit Card,"6,092.00",00.00,"1,875,646.97"
09-Nov-2021,Interest,"83,125.00",00.00,"1,958,771.97"
09-Nov-2021,IMPS,00.00,00.00,"1,958,771.97"
09-Nov-2021,ATM,00.00,"1,958,771.97",00.00
09-Nov-2021,Transfer,"1,140.20",00.00,"1,140.20"
09-Nov-2021,ATM,"2,293.69",00.00,"3,433.89"
09-Nov-2021,Cheque,"2,070.00",00.00,"5,503.89"
09-Nov-2021,ATM,00.00,550.39,"4,953.50"
09-Nov-2021,Transfer,00.00,"1,238.38","3,715.12"
09-Nov-2021,Transfer,00.00,928.78,"2,786.34"
09-Nov-2021,Tax,00.00,"2,786.34",00.00
09-Nov-2021,Reversal,"111,082.91",00.00,"111,082.91"
09-Nov-2021,NEFT,07.10,00.00,"111,090.01"
09-Nov-2021,Interest,"1,069,221.00",00.00,"1,180,311.01"
09-Nov-2021,Interest,00.00,"393,437.00","786,874.01"
09-Nov-2021,Tax,00.00,"196,718.50","590,155.51"
09-Nov-2021,ATM,282.00,00.00,"590,437.51"
09-Nov-2021,Debit Card,00.00,"196,812.50","393,625.01"
09-Nov-2021,Miscellaneous,55.30,00.00,"393,680.31"
09-Nov-2021,Interest,00.00,"49,210.04","344,470.27"
09-Nov-2021,Miscellaneous,"189,898.88",00.00,"534,369.15"
09-Nov-2021,RTGS,00.00,"89,061.53","445,307.62"
09-Nov-2021,Debit Card,01.00,00.00,"445,308.62"
09-Nov-2021,Commission,07.19,00.00,"445,315.81"
09-Nov-2021,Commission,00.00,"222,657.91","222,657.90"
10-Nov-2021,Transfer,06.00,00.00,"222,663.90"
10-Nov-2021,IMPS,00.00,"111,331.95","111,331.95"
10-Nov-2021,NEFT,00.00,"22,266.39","89,065.56"
10-Nov-2021,Interest,00.00,"44,532.78","44,532.78"
10-Nov-2021,Tax,07.00,00.00,"44,539.78"
10-Nov-2021,Cheque,00.00,"44,539.78",00.00
10-Nov-2021,Miscellaneous,"18,497.60",00.00,"18,497.60"
10-Nov-2021,Miscellaneous,00.00,"2,312.20","16,185.40"
10-Nov-2021,Purchase,00.00,"2,312.20","13,873.20"
10-Nov-2021,Bill,07.72,00.00,"13,880.92"
10-Nov-2021,IMPS,00.00,"2,776.18","11,104.74"
10-Nov-2021,Cash,05.70,00.00,"11,110.44"
10-Nov-2021,Cheque,"569,206.75",00.00,"580,317.19"
10-Nov-2021,Commission,"24,247.00",00.00,"604,564.19"
10-Nov-2021,Cash,"1,632,460.25",00.00,"2,237,024.44"
11-Nov-2021,ATM,00.00,"559,256.11","1,677,768.33"
11-Nov-2021,Transfer,00.00,"419,442.08","1,258,326.25"
11-Nov-2021,Cash,"125,222.00",00.00,"1,383,548.25"
11-Nov-2021,Transfer,35.43,00.00,"1,383,583.68"
11-Nov-2021,Cheque,00.00,"138,358.37","1,245,225.31"
11-Nov-2021,Purchase,00.00,"249,045.06","996,180.25"
11-Nov-2021,Tax,"2,022,442.00",00.00,"3,018,622.25"
11-Nov-2021,Cheque,"371,634.20",00.00,"3,390,256.45"
11-Nov-2021,ATM,59.00,00.00,"3,390,315.45"
11-Nov-2021,Transfer,00.00,"1,130,105.15","2,260,210.30"
11-Nov-2021,Commission,00.00,"1,130,105.15","1,130,105.15"
11-Nov-2021,Purchase,"45,667.00",00.00,"1,175,772.15"
11-Nov-2021,Debit Card,00.00,"195,962.03","979,810.12"
12-Nov-2021,ATM,"852,098.75",00.00,"1,831,908.87"
12-Nov-2021,Cash,54.20,00.00,"1,831,963.07"
12-Nov-2021,Interest,05.18,00.00,"1,831,968.25"
12-Nov-2021,Miscellaneous,00.00,"366,393.65","1,465,574.60"
12-Nov-2021,ATM,60.00,00.00,"1,465,634.60"
12-Nov-2021,Cheque,00.00,"162,848.29","1,302,786.31"
12-Nov-2021,Bill,"3,189.00",00.00,"1,305,975.31"
12-Nov-2021,ATM,00.00,"163,246.91","1,142,728.40"
12-Nov-2021,RTGS,"153,241.10",00.00,"1,295,969.50"
12-Nov-2021,Reversal,"1,557,590.50",00.00,"2,853,560.00"
12-Nov-2021,Bill,00.00,"713,390.00","2,140,170.00"
12-Nov-2021,Interest,00.00,"2,140,170.00",00.00
12-Nov-2021,Bill,238.70,00.00,238.70
13-Nov-2021,Commission,00.00,59.68,179.02
13-Nov-2021,Miscellaneous,00.00,89.51,89.51
13-Nov-2021,Cheque,44.20,00.00,133.71
13-Nov-2021,Reversal,33.22,00.00,166.93
13-Nov-2021,IMPS,00.00,55.64,111.29
13-Nov-2021,ATM,"19,661.57",00.00,"19,772.86"
13-Nov-2021,Transfer,00.00,"2,471.61","17,301.25"
13-Nov-2021,Purchase,40.00,00.00,"17,341.25"
13-Nov-2021,Commission,00.00,"17,341.25",00.00
13-Nov-2021,Interest,"61,648.91",00.00,"61,648.91"
13-Nov-2021,Miscellaneous,495.50,00.00,"62,144.41"
13-Nov-2021,RTGS,00.00,"62,144.41",00.00
14-Nov-2021,Cheque,"1,011.00",00.00,"1,011.00"
14-Nov-2021,ATM,00.80,00.00,"1,011.80"
14-Nov-2021,RTGS,00.00,126.48,885.32
14-Nov-2021,RTGS,00.00,885.32,00.00
14-Nov-2021,Transfer,"1,589.10",00.00,"1,589.10"
14-Nov-2021,ATM,00.00,397.28,"1,191.82"
14-Nov-2021,Transfer,00.00,297.96,893.86
14-Nov-2021,ATM,832.00,00.00,"1,725.86"
14-Nov-2021,Reversal,"1,711,448.50",00.00,"1,713,174.36"
14-Nov-2021,Purchase,00.00,"214,146.80","1,499,027.57"
14-Nov-2021,Debit Card,"1,117,586.00",00.00,"2,616,613.57"
14-Nov-2021,ATM,00.00,"1,308,306.79","1,308,306.78"
14-Nov-2021,Reversal,00.00,"1,308,306.78",00.00
14-Nov-2021,Miscellaneous,00.14,00.00,00.14
14-Nov-2021,Cheque,00.00,00.01,00.13
14-Nov-2021,Tax,22.49,00.00,22.62
14-Nov-2021,Bill,00.00,05.66,16.96
14-Nov-2021,Cash,"1,276,310.20",00.00,"1,276,327.16"
14-Nov-2021,ATM,366.35,00.00,"1,276,693.51"
14-Nov-2021,Interest,00.00,"255,338.70","1,021,354.81"
14-Nov-2021,Interest,03.00,00.00,"1,021,357.81"
14-Nov-2021,Commission,00.00,"102,135.78","919,222.03"
14-Nov-2021,Commission,00.00,"91,922.20","827,299.83"
14-Nov-2021,IMPS,03.37,00.00,"827,303.20"
14-Nov-2021,Cash,"11,994.10",00.00,"839,297.30"
14-Nov-2021,IMPS,00.00,"419,648.65","419,648.65"
14-Nov-2021,ATM,114.20,00.00,"419,762.85"
14-Nov-2021,IMPS,156.00,00.00,"419,918.85"
14-Nov-2021,Bill,00.00,"59,988.41","359,930.44"
14-Nov-2021,Reversal,111.90,00.00,"360,042.34"
14-Nov-2021,RTGS,00.00,"36,004.23","324,038.11"
14-Nov-2021,Debit Card,00.00,"162,019.06","162,019.06"
14-Nov-2021,Interest,00.00,"18,002.12","144,016.94"
14-Nov-2021,Reversal,00.00,"14,401.69","129,615.25"
14-Nov-2021,Commission,14.32,00.00,"129,629.57"
14-Nov-2021,RTGS,"12,454.00",00.00,"142,083.57"
14-Nov-2021,Cash,00.00,"47,361.19","94,722.38"
14-Nov-2021,RTGS,02.36,00.00,"94,724.74"
14-Nov-2021,NEFT,00.00,"10,524.97","84,199.77"
14-Nov-2021,NEFT,"21,666.80",00.00,"105,866.57"
14-Nov-2021,NEFT,06.00,00.00,"105,872.57"
14-Nov-2021,Cheque,00.00,"11,763.62","94,108.95"
14-Nov-2021,Cheque,69.30,00.00,"94,178.25"
14-Nov-2021,Reversal,91.78,00.00,"94,270.03"
14-Nov-2021,Cash,04.66,00.00,"94,274.69"
14-Nov-2021,Cheque,00.00,"9,427.47","84,847.22"
14-Nov-2021,Miscellaneous,00.00,"16,969.44","67,877.78"
14-Nov-2021,Cheque,"2,027,768.75",00.00,"2,095,646.53"
14-Nov-2021,Miscellaneous,00.00,"349,274.42","1,746,372.11"
14-Nov-2021,Debit Card,01.30,00.00,"1,746,373.41"
14-Nov-2021,Debit Card,00.00,"249,481.92","1,496,891.49"
14-Nov-2021,Tax,00.00,"374,222.87","1,122,668.62"
14-Nov-2021,ATM,"1,490,977.50",00.00,"2,613,646.12"
14-Nov-2021,Tax,00.00,"373,378.02","2,240,268.10"
14-Nov-2021,IMPS,00.00,"746,756.03","1,493,512.07"
14-Nov-2021,Debit Card,319.00,00.00,"1,493,831.07"
15-Nov-2021,Reversal,00.00,"165,981.23","1,327,849.84"
15-Nov-2021,RTGS,60.00,00.00,"1,327,909.84"
15-Nov-2021,Purchase,00.00,"189,701.41","1,138,208.43"
15-Nov-2021,Cheque,"412,178.00",00.00,"1,550,386.43"
15-Nov-2021,Bill,00.00,"172,265.16","1,378,121.27"
15-Nov-2021,ATM,129.90,00.00,"1,378,251.17"
16-Nov-2021,RTGS,00.00,"172,281.40","1,205,969.77"
16-Nov-2021,RTGS,"948,484.80",00.00,"2,154,454.57"
16-Nov-2021,RTGS,00.00,"538,613.64","1,615,840.93"
16-Nov-2021,Commission,00.00,"403,960.23","1,211,880.70"
16-Nov-2021,Miscellaneous,00.00,"403,960.23","807,920.47"
16-Nov-2021,Purchase,"132,248.00",00.00,"940,168.47"
16-Nov-2021,Bill,00.00,"188,033.69","752,134.78"
16-Nov-2021,Cheque,"3,900.00",00.00,"756,034.78"
16-Nov-2021,Interest,00.00,"108,004.97","648,029.81"
16-Nov-2021,Cheque,00.00,"108,004.97","540,024.84"
16-Nov-2021,Cash,00.00,"108,004.97","432,019.87"
16-Nov-2021,Cheque,00.00,"48,002.21","384,017.66"
16-Nov-2021,RTGS,00.00,00.00,"384,017.66"
16-Nov-2021,Miscellaneous,00.00,"54,859.67","329,157.99"
16-Nov-2021,RTGS,01.40,00.00,"329,159.39"
16-Nov-2021,Commission,17.60,00.00,"329,176.99"
16-Nov-2021,Interest,00.00,"164,588.50","164,588.50"
16-Nov-2021,RTGS,"47,458.09",00.00,"212,046.59"
16-Nov-2021,Tax,01.49,00.00,"212,048.08"
16-Nov-2021,RTGS,47.02,00.00,"212,095.10"
16-Nov-2021,ATM,00.00,"42,419.02","169,676.08"
16-Nov-2021,Debit Card,00.50,00.00,"169,676.58"
16-Nov-2021,Reversal,00.00,"84,838.29","84,838.29"
16-Nov-2021,ATM,00.00,"8,483.83","76,354.46"
16-Nov-2021,IMPS,00.00,"19,088.62","57,265.84"
16-Nov-2021,Debit Card,00.00,"5,726.58","51,539.26"
16-Nov-2021,IMPS,"1,455.60",00.00,"52,994.86"
16-Nov-2021,RTGS,00.00,"13,248.72","39,746.15"
16-Nov-2021,Interest,00.00,"5,678.02","34,068.13"
16-Nov-2021,Purchase,00.00,"11,356.04","22,712.09"
16-Nov-2021,RTGS,00.00,"4,542.42","18,169.67"
16-Nov-2021,Cash,00.00,"18,169.67",00.00
16-Nov-2021,Tax,"259,051.10",00.00,"259,051.10"
16-Nov-2021,Cheque,47.80,00.00,"259,098.90"
16-Nov-2021,Miscellaneous,00.00,"32,387.36","226,711.54"
16-Nov-2021,Interest,00.00,"75,570.51","151,141.03"
16-Nov-2021,Tax,"2,589.00",00.00,"153,730.03"
16-Nov-2021,Bill,52.10,00.00,"153,782.13"
16-Nov-2021,Cash,366.00,00.00,"154,148.13"
16-Nov-2021,Interest,00.00,"17,127.57","137,020.56"
16-Nov-2021,Transfer,05.80,00.00,"137,026.36"
16-Nov-2021,Cash,00.00,"22,837.73","114,188.63"
16-Nov-2021,Transfer,"2,125.19",00.00,"116,313.82"
16-Nov-2021,ATM,00.00,"23,262.76","93,051.06"
16-Nov-2021,Debit Card,00.00,"10,339.01","82,712.05"
16-Nov-2021,Cheque,03.55,00.00,"82,715.60"
16-Nov-2021,Reversal,05.00,00.00,"82,720.60"
17-Nov-2021,Interest,00.00,"10,340.08","72,380.53"
17-Nov-2021,Cheque,331.00,00.00,"72,711.53"
17-Nov-2021,Purchase,"24,372.64",00.00,"97,084.17"
17-Nov-2021,Purchase,00.00,"9,708.42","87,375.75"
17-Nov-2021,Debit Card,05.03,00.00,"87,380.78"
17-Nov-2021,ATM,00.00,"87,380.78",00.00
17-Nov-2021,Miscellaneous,"153,660.00",00.00,"153,660.00"
17-Nov-2021,RTGS,02.00,00.00,"153,662.00"
17-Nov-2021,ATM,00.00,"21,951.71","131,710.29"
17-Nov-2021,Bill,22.22,00.00,"131,732.51"
17-Nov-2021,Transfer,00.00,"14,636.95","117,095.56"
17-Nov-2021,Tax,00.00,"14,636.95","102,458.62"
17-Nov-2021,Transfer,"122,296.53",00.00,"224,755.15"
17-Nov-2021,Purchase,230.26,00.00,"224,985.41"
17-Nov-2021,Purchase,00.00,"22,498.54","202,486.87"
17-Nov-2021,Cheque,00.00,"50,621.72","151,865.15"
17-Nov-2021,IMPS,"15,700.00",00.00,"167,565.15"
17-Nov-2021,Commission,00.00,"33,513.03","134,052.12"
17-Nov-2021,Commission,00.00,"16,756.52","117,295.60"
17-Nov-2021,Reversal,"2,704.00",00.00,"119,999.60"
17-Nov-2021,Cash,02.20,00.00,"120,001.80"
17-Nov-2021,Tax,00.00,"120,001.80",00.00
17-Nov-2021,IMPS,24.40,00.00,24.40
17-Nov-2021,Purchase,00.00,02.44,21.96
17-Nov-2021,NEFT,"131,169.66",00.00,"131,191.62"
17-Nov-2021,Transfer,00.00,"18,741.66","112,449.96"
17-Nov-2021,Cheque,00.00,"18,741.66","93,708.30"
17-Nov-2021,Commission,00.00,"10,412.03","83,296.27"
17-Nov-2021,IMPS,198.13,00.00,"83,494.40"
17-Nov-2021,Interest,00.00,"13,915.73","69,578.67"
17-Nov-2021,Cheque,00.00,"23,192.89","46,385.78"
17-Nov-2021,IMPS,"1,114,516.00",00.00,"1,160,901.78"
17-Nov-2021,Interest,981.85,00.00,"1,161,883.63"
17-Nov-2021,Interest,00.00,"145,235.45","1,016,648.18"
17-Nov-2021,Cheque,00.00,"203,329.64","813,318.54"
17-Nov-2021,NEFT,"1,395,726.50",00.00,"2,209,045.04"
17-Nov-2021,Transfer,00.00,"220,904.50","1,988,140.54"
17-Nov-2021,Miscellaneous,00.00,"1,988,140.54",00.00
17-Nov-2021,Commission,21.20,00.00,21.20
17-Nov-2021,Reversal,00.00,10.60,10.60
17-Nov-2021,RTGS,"15,035.39",00.00,"15,045.99"
17-Nov-2021,Miscellaneous,63.40,00.00,"15,109.39"
17-Nov-2021,Purchase,00.00,"15,109.39",00.00
17-Nov-2021,Bill,362.00,00.00,362.00
18-Nov-2021,Reversal,21.00,00.00,383.00
18-Nov-2021,Tax,04.90,00.00,387.90
18-Nov-2021,Interest,487.00,00.00,874.90
18-Nov-2021,Transfer,"168,255.50",00.00,"169,130.40"
18-Nov-2021,Bill,01.00,00.00,"169,131.40"
18-Nov-2021,Interest,00.00,"16,913.14","152,218.26"
18-Nov-2021,Cash,00.00,"50,739.42","101,478.84"
18-Nov-2021,Debit Card,00.00,"11,275.43","90,203.41"
18-Nov-2021,Bill,735.60,00.00,"90,939.01"
18-Nov-2021,Commission,00.00,"22,734.75","68,204.26"
18-Nov-2021,RTGS,00.00,"11,367.38","56,836.88"
18-Nov-2021,Commission,00.00,"7,104.61","49,732.27"
18-Nov-2021,Cash,00.00,"7,104.61","42,627.66"
18-Nov-2021,Cash,00.00,"10,656.92","31,970.75"
18-Nov-2021,Tax,53.57,00.00,"32,024.32"
19-Nov-2021,Purchase,01.20,00.00,"32,025.52"
19-Nov-2021,Debit Card,00.00,"8,006.38","24,019.14"
19-Nov-2021,Debit Card,344.00,00.00,"24,363.14"
19-Nov-2021,Tax,00.00,"3,045.39","21,317.75"
19-Nov-2021,Purchase,00.00,"2,368.64","18,949.11"
19-Nov-2021,Purchase,185.50,00.00,"19,134.61"
19-Nov-2021,Purchase,00.00,"6,378.20","12,756.41"
19-Nov-2021,Commission,00.00,"1,275.64","11,480.77"
19-Nov-2021,Tax,00.00,"11,480.77",00.00
19-Nov-2021,Interest,04.97,00.00,04.97
19-Nov-2021,Cheque,02.20,00.00,07.17
19-Nov-2021,Cash,"139,213.47",00.00,"139,220.64"
19-Nov-2021,Interest,00.00,"34,805.16","104,415.48"
19-Nov-2021,Interest,00.00,"52,207.74","52,207.74"
19-Nov-2021,Cheque,00.00,"5,220.77","46,986.97"
19-Nov-2021,RTGS,134.76,00.00,"47,121.73"
19-Nov-2021,Reversal,01.00,00.00,"47,122.73"
19-Nov-2021,Commission,00.00,"6,731.82","40,390.91"
19-Nov-2021,Transfer,00.00,"40,390.91",00.00
19-Nov-2021,Miscellaneous,66.00,00.00,66.00
19-Nov-2021,ATM,00.00,11.00,55.00
20-Nov-2021,Cheque,00.00,05.50,49.50
20-Nov-2021,Cheque,00.00,49.50,00.00
20-Nov-2021,Purchase,"2,040,164.80",00.00,"2,040,164.80"
20-Nov-2021,IMPS,19.00,00.00,"2,040,183.80"
20-Nov-2021,Transfer,47.00,00.00,"2,040,230.80"
20-Nov-2021,Tax,00.00,"1,020,115.40","1,020,115.40"
20-Nov-2021,Commission,496.00,00.00,"1,020,611.40"
20-Nov-2021,Miscellaneous,"3,647.09",00.00,"1,024,258.49"
20-Nov-2021,Miscellaneous,00.00,"1,024,258.49",00.00
20-Nov-2021,Miscellaneous,03.00,00.00,03.00
20-Nov-2021,Cheque,00.00,01.50,01.50
20-Nov-2021,Miscellaneous,10.50,00.00,12.00
20-Nov-2021,Cash,00.00,04.00,08.00
20-Nov-2021,Cheque,00.00,08.00,00.00
20-Nov-2021,Tax,48.05,00.00,48.05
20-Nov-2021,IMPS,"269,380.00",00.00,"269,428.05"
20-Nov-2021,Reversal,00.00,"26,942.81","242,485.24"
20-Nov-2021,Debit Card,"26,759.20",00.00,"269,244.44"
20-Nov-2021,Purchase,00.00,"269,244.44",00.00
20-Nov-2021,RTGS,"1,589,438.50",00.00,"1,589,438.50"
20-Nov-2021,Cheque,00.00,"529,812.83","1,059,625.67"
20-Nov-2021,Cash,03.44,00.00,"1,059,629.11"
20-Nov-2021,Bill,00.00,"211,925.82","847,703.29"
20-Nov-2021,Commission,00.00,"282,567.76","565,135.53"
20-Nov-2021,Tax,"102,465.00",00.00,"667,600.53"
20-Nov-2021,Interest,"3,150.50",00.00,"670,751.03"
20-Nov-2021,Purchase,00.00,"223,583.68","447,167.35"
20-Nov-2021,Debit Card,"888,980.50",00.00,"1,336,147.85"
20-Nov-2021,Purchase,00.00,"668,073.93","668,073.93"
20-Nov-2021,ATM,00.00,"334,036.97","334,036.97"
20-Nov-2021,Miscellaneous,763.77,00.00,"334,800.74"
20-Nov-2021,NEFT,"111,229.94",00.00,"446,030.68"
20-Nov-2021,RTGS,"955,311.00",00.00,"1,401,341.68"
20-Nov-2021,Tax,00.00,"175,167.71","1,226,173.97"
20-Nov-2021,Transfer,00.00,"175,167.71","1,051,006.26"
21-Nov-2021,IMPS,00.00,"1,051,006.26",00.00
21-Nov-2021,RTGS,"177,678.28",00.00,"177,678.28"
22-Nov-2021,Debit Card,"92,096.50",00.00,"269,774.78"
22-Nov-2021,Cheque,00.00,"53,954.96","215,819.82"
22-Nov-2021,Tax,790.76,00.00,"216,610.58"
22-Nov-2021,Purchase,"96,250.70",00.00,"312,861.28"
22-Nov-2021,IMPS,"2,331.47",00.00,"315,192.75"
22-Nov-2021,Transfer,150.10,00.00,"315,342.85"
22-Nov-2021,Commission,41.00,00.00,"315,383.85"
22-Nov-2021,Commission,05.00,00.00,"315,388.85"
22-Nov-2021,ATM,264.30,00.00,"315,653.15"
22-Nov-2021,Commission,00.00,"315,653.15",00.00
22-Nov-2021,Cash,"69,811.40",00.00,"69,811.40"
22-Nov-2021,RTGS,"20,890.00",00.00,"90,701.40"
22-Nov-2021,Cash,"66,228.60",00.00,"156,930.00"
22-Nov-2021,Miscellaneous,00.00,"31,386.00","125,544.00"
22-Nov-2021,Cash,"2,699.50",00.00,"128,243.50"
22-Nov-2021,Commission,00.00,"64,121.75","64,121.75"
22-Nov-2021,Tax,00.00,"21,373.92","42,747.83"
22-Nov-2021,Debit Card,00.00,"5,343.48","37,404.35"
22-Nov-2021,Reversal,00.00,"5,343.48","32,060.87"
22-Nov-2021,Cheque,00.00,"32,060.87",00.00
22-Nov-2021,Bill,405.40,00.00,405.40
22-Nov-2021,RTGS,409.77,00.00,815.17
22-Nov-2021,NEFT,00.00,116.45,698.72
22-Nov-2021,Reversal,"21,664.57",00.00,"22,363.29"
22-Nov-2021,Transfer,04.80,00.00,"22,368.09"
22-Nov-2021,IMPS,447.54,00.00,"22,815.63"
22-Nov-2021,Transfer,"130,600.90",00.00,"153,416.53"
22-Nov-2021,RTGS,"18,061.11",00.00,"171,477.64"
22-Nov-2021,ATM,"2,667.00",00.00,"174,144.64"
22-Nov-2021,Purchase,00.00,"174,144.64",00.00
22-Nov-2021,Reversal,"1,104,194.00",00.00,"1,104,194.00"
22-Nov-2021,Tax,00.00,"138,024.25","966,169.75"
22-Nov-2021,Reversal,"2,433.43",00.00,"968,603.18"
22-Nov-2021,Miscellaneous,423.00,00.00,"969,026.18"
22-Nov-2021,Interest,00.00,"242,256.55","726,769.64"
22-Nov-2021,Miscellaneous,00.00,"145,353.93","581,415.71"
22-Nov-2021,Cash,360.00,00.00,"581,775.71"
22-Nov-2021,ATM,00.00,"145,443.93","436,331.78"
23-Nov-2021,Reversal,"89,091.10",00.00,"525,422.88"
23-Nov-2021,ATM,02.98,00.00,"525,425.86"
23-Nov-2021,IMPS,"23,185.30",00.00,"548,611.16"
23-Nov-2021,Interest,"82,181.72",00.00,"630,792.88"
23-Nov-2021,RTGS,493.40,00.00,"631,286.28"
23-Nov-2021,Cheque,00.00,"210,428.76","420,857.52"
23-Nov-2021,Miscellaneous,00.00,"140,285.84","280,571.68"
23-Nov-2021,Commission,00.00,"280,571.68",00.00
23-Nov-2021,ATM,03.71,00.00,03.71
23-Nov-2021,Tax,"1,269,334.00",00.00,"1,269,337.71"
23-Nov-2021,Bill,00.00,"181,333.96","1,088,003.75"
23-Nov-2021,Tax,146.00,00.00,"1,088,149.75"
23-Nov-2021,Tax,00.00,"362,716.58","725,433.17"
23-Nov-2021,Interest,00.00,"90,679.15","634,754.02"
23-Nov-2021,Bill,"23,682.80",00.00,"658,436.82"
23-Nov-2021,Debit Card,"163,341.00",00.00,"821,777.82"
23-Nov-2021,Transfer,00.00,"136,962.97","684,814.85"
23-Nov-2021,RTGS,00.00,"76,090.54","608,724.31"
23-Nov-2021,Debit Card,01.59,00.00,"608,725.90"
23-Nov-2021,Transfer,"246,839.00",00.00,"855,564.90"
23-Nov-2021,Debit Card,00.00,"142,594.15","712,970.75"
23-Nov-2021,Miscellaneous,00.00,"71,297.08","641,673.68"
23-Nov-2021,RTGS,00.00,"106,945.61","534,728.07"
23-Nov-2021,Miscellaneous,"252,021.60",00.00,"786,749.67"
23-Nov-2021,Tax,"10,286.40",00.00,"797,036.07"
24-Nov-2021,IMPS,388.10,00.00,"797,424.17"
24-Nov-2021,Interest,00.00,"113,917.74","683,506.43"
24-Nov-2021,IMPS,00.00,"85,438.30","598,068.13"
24-Nov-2021,Miscellaneous,10.50,00.00,"598,078.63"
24-Nov-2021,Transfer,00.00,"598,078.63",00.00
24-Nov-2021,Miscellaneous,258.00,00.00,258.00
24-Nov-2021,Cash,00.00,129.00,129.00
24-Nov-2021,Miscellaneous,00.00,129.00,00.00
24-Nov-2021,NEFT,103.20,00.00,103.20
24-Nov-2021,NEFT,00.00,20.64,82.56
24-Nov-2021,IMPS,"1,443.00",00.00,"1,525.56"
24-Nov-2021,Cash,00.00,152.56,"1,373.00"
24-Nov-2021,Purchase,00.00,196.14,"1,176.86"
24-Nov-2021,Bill,00.00,168.12,"1,008.74"
24-Nov-2021,Reversal,00.00,201.75,806.99
24-Nov-2021,Tax,00.00,80.70,726.29
24-Nov-2021,Cash,03.00,00.00,729.29
24-Nov-2021,Transfer,00.00,364.65,364.64
24-Nov-2021,Transfer,"197,977.47",00.00,"198,342.11"
24-Nov-2021,Miscellaneous,00.00,"19,834.21","178,507.90"
24-Nov-2021,IMPS,"830,161.20",00.00,"1,008,669.10"
24-Nov-2021,NEFT,00.00,"252,167.28","756,501.82"
24-Nov-2021,Debit Card,00.00,"151,300.36","605,201.46"
25-Nov-2021,Transfer,00.00,"86,457.35","518,744.11"
25-Nov-2021,ATM,00.00,"86,457.35","432,286.76"
25-Nov-2021,RTGS,00.00,"61,755.25","370,531.51"
25-Nov-2021,Tax,569.40,00.00,"371,100.91"
25-Nov-2021,RTGS,817.98,00.00,"371,918.89"
25-Nov-2021,Purchase,"13,033.86",00.00,"384,952.75"
25-Nov-2021,ATM,01.00,00.00,"384,953.75"
25-Nov-2021,Reversal,04.60,00.00,"384,958.35"
25-Nov-2021,RTGS,01.04,00.00,"384,959.39"
25-Nov-2021,IMPS,00.00,"96,239.85","288,719.54"
25-Nov-2021,IMPS,02.44,00.00,"288,721.98"
25-Nov-2021,Reversal,487.80,00.00,"289,209.78"
25-Nov-2021,Transfer,00.00,"72,302.45","216,907.34"
25-Nov-2021,Cash,"3,634.30",00.00,"220,541.64"
25-Nov-2021,Purchase,46.40,00.00,"220,588.04"
25-Nov-2021,IMPS,00.00,"73,529.35","147,058.69"
25-Nov-2021,Tax,"12,419.13",00.00,"159,477.82"
25-Nov-2021,Commission,"226,356.00",00.00,"385,833.82"
25-Nov-2021,Bill,193.63,00.00,"386,027.45"
25-Nov-2021,NEFT,57.33,00.00,"386,084.78"
25-Nov-2021,Commission,00.00,"386,084.78",00.00
25-Nov-2021,RTGS,"788,803.20",00.00,"788,803.20"
25-Nov-2021,Cheque,00.00,"394,401.60","394,401.60"
25-Nov-2021,Miscellaneous,00.00,"78,880.32","315,521.28"
26-Nov-2021,RTGS,400.63,00.00,"315,921.91"
26-Nov-2021,Interest,00.00,00.00,"315,921.91"
27-Nov-2021,Purchase,36.92,00.00,"315,958.83"
27-Nov-2021,Miscellaneous,"3,756.90",00.00,"319,715.73"
27-Nov-2021,RTGS,"76,487.20",00.00,"396,202.93"
27-Nov-2021,Tax,"2,564.20",00.00,"398,767.13"
27-Nov-2021,Purchase,00.00,"44,307.46","354,459.67"
27-Nov-2021,NEFT,00.00,"177,229.84","177,229.84"
27-Nov-2021,Debit Card,00.00,"17,722.98","159,506.86"
27-Nov-2021,Tax,00.00,"39,876.72","119,630.14"
27-Nov-2021,Bill,00.00,"13,292.24","106,337.90"
27-Nov-2021,Cheque,14.00,00.00,"106,351.90"
27-Nov-2021,Interest,"85,802.00",00.00,"192,153.90"
27-Nov-2021,Transfer,332.13,00.00,"192,486.03"
27-Nov-2021,Debit Card,00.00,"64,162.01","128,324.02"
27-Nov-2021,ATM,"5,087.45",00.00,"133,411.47"
27-Nov-2021,Transfer,00.00,"16,676.43","116,735.04"
27-Nov-2021,NEFT,"1,721.40",00.00,"118,456.44"
27-Nov-2021,Purchase,140.09,00.00,"118,596.53"
27-Nov-2021,IMPS,992.00,00.00,"119,588.53"
27-Nov-2021,Tax,00.00,"17,084.08","102,504.45"
27-Nov-2021,Reversal,00.00,"12,813.06","89,691.39"
27-Nov-2021,Debit Card,00.00,"44,845.70","44,845.70"
27-Nov-2021,Reversal,"1,266,083.00",00.00,"1,310,928.70"
27-Nov-2021,Commission,911.00,00.00,"1,311,839.70"
27-Nov-2021,RTGS,00.00,"655,919.85","655,919.85"
27-Nov-2021,NEFT,183.10,00.00,"656,102.95"
27-Nov-2021,IMPS,"1,455,989.80",00.00,"2,112,092.75"
27-Nov-2021,Bill,"3,741.50",00.00,"2,115,834.25"
27-Nov-2021,Interest,20.00,00.00,"2,115,854.25"
27-Nov-2021,Debit Card,00.00,"352,642.38","1,763,211.88"
27-Nov-2021,Tax,00.00,"220,401.49","1,542,810.40"
27-Nov-2021,RTGS,"26,113.85",00.00,"1,568,924.25"
27-Nov-2021,Purchase,00.00,"261,487.38","1,307,436.88"
27-Nov-2021,Cheque,00.00,"163,429.61","1,144,007.27"
27-Nov-2021,Debit Card,00.00,"190,667.88","953,339.39"
27-Nov-2021,Miscellaneous,"45,874.20",00.00,"999,213.59"
27-Nov-2021,RTGS,112.90,00.00,"999,326.49"
27-Nov-2021,Cheque,00.00,"111,036.28","888,290.21"
27-Nov-2021,NEFT,02.50,00.00,"888,292.71"
27-Nov-2021,Cheque,00.00,"888,292.71",00.00
27-Nov-2021,Commission,753.30,00.00,753.30
27-Nov-2021,Cash,00.00,188.33,564.97
27-Nov-2021,Transfer,00.00,56.50,508.47
27-Nov-2021,Tax,"1,341,095.50",00.00,"1,341,603.97"
27-Nov-2021,ATM,00.00,"268,320.79","1,073,283.18"
27-Nov-2021,Transfer,00.00,"178,880.53","894,402.65"
27-Nov-2021,Purchase,00.00,"89,440.27","804,962.38"
27-Nov-2021,Cheque,00.00,"89,440.26","715,522.12"
27-Nov-2021,Transfer,00.00,"119,253.69","596,268.43"
27-Nov-2021,Transfer,20.30,00.00,"596,288.73"
27-Nov-2021,RTGS,179.00,00.00,"596,467.73"
27-Nov-2021,Tax,00.00,"74,558.47","521,909.26"
27-Nov-2021,ATM,00.00,"173,969.75","347,939.51"
27-Nov-2021,IMPS,"1,736.10",00.00,"349,675.61"
27-Nov-2021,Tax,427.11,00.00,"350,102.72"
27-Nov-2021,ATM,00.00,"116,700.91","233,401.81"
27-Nov-2021,Debit Card,00.00,"33,343.12","200,058.69"
27-Nov-2021,Reversal,50.98,00.00,"200,109.67"
27-Nov-2021,ATM,31.85,00.00,"200,141.52"
27-Nov-2021,IMPS,"91,530.40",00.00,"291,671.92"
27-Nov-2021,Transfer,00.00,"145,835.96","145,835.96"
27-Nov-2021,Purchase,"138,779.62",00.00,"284,615.58"
27-Nov-2021,Reversal,16.00,00.00,"284,631.58"
27-Nov-2021,IMPS,"187,353.81",00.00,"471,985.39"
27-Nov-2021,Cash,305.04,00.00,"472,290.43"
27-Nov-2021,NEFT,180.00,00.00,"472,470.43"
27-Nov-2021,Cash,00.00,"118,117.61","354,352.82"
27-Nov-2021,ATM,"640,234.00",00.00,"994,586.82"
27-Nov-2021,Purchase,00.00,"99,458.68","895,128.14"
27-Nov-2021,Bill,00.00,"447,564.07","447,564.07"
27-Nov-2021,Transfer,00.00,"55,945.51","391,618.56"
27-Nov-2021,Bill,48.08,00.00,"391,666.64"
27-Nov-2021,ATM,00.00,"48,958.33","342,708.31"
27-Nov-2021,Bill,00.00,"34,270.83","308,437.48"
28-Nov-2021,Debit Card,"2,755.22",00.00,"311,192.70"
28-Nov-2021,Transfer,00.00,"34,576.97","276,615.73"
28-Nov-2021,Commission,"1,165,631.20",00.00,"1,442,246.93"
28-Nov-2021,Bill,00.00,"160,249.66","1,281,997.27"
28-Nov-2021,Commission,00.00,"427,332.42","854,664.85"
28-Nov-2021,Cash,"64,671.30",00.00,"919,336.15"
28-Nov-2021,ATM,00.00,"131,333.74","788,002.41"
28-Nov-2021,Bill,762.00,00.00,"788,764.41"
28-Nov-2021,Transfer,762.50,00.00,"789,526.91"
28-Nov-2021,Commission,"2,345.00",00.00,"791,871.91"
28-Nov-2021,Debit Card,159.09,00.00,"792,031.00"
28-Nov-2021,Miscellaneous,00.00,"158,406.20","633,624.80"
28-Nov-2021,Cash,00.00,"79,203.10","554,421.70"
28-Nov-2021,Purchase,"10,039.00",00.00,"564,460.70"
28-Nov-2021,RTGS,"11,381.63",00.00,"575,842.33"
28-Nov-2021,NEFT,00.00,"143,960.58","431,881.75"
28-Nov-2021,Interest,"117,157.75",00.00,"549,039.50"
28-Nov-2021,Miscellaneous,00.00,"549,039.50",00.00
28-Nov-2021,Debit Card,"23,120.00",00.00,"23,120.00"
28-Nov-2021,Cheque,00.00,"2,568.89","20,551.11"
28-Nov-2021,IMPS,35.00,00.00,"20,586.11"
28-Nov-2021,Commission,00.00,"6,862.04","13,724.07"
28-Nov-2021,Debit Card,"1,876,302.00",00.00,"1,890,026.07"
28-Nov-2021,Reversal,00.00,"945,013.04","945,013.04"
28-Nov-2021,Cash,236.00,00.00,"945,249.04"
28-Nov-2021,Reversal,27.69,00.00,"945,276.73"
28-Nov-2021,Purchase,00.00,"157,546.12","787,730.61"
28-Nov-2021,Transfer,00.00,"131,288.44","656,442.18"
28-Nov-2021,Cheque,00.00,"218,814.06","437,628.12"
28-Nov-2021,Cash,00.00,"54,703.52","382,924.60"
28-Nov-2021,Tax,00.00,"54,703.51","328,221.09"
28-Nov-2021,Reversal,273.10,00.00,"328,494.19"
28-Nov-2021,NEFT,15.00,00.00,"328,509.19"
28-Nov-2021,Purchase,00.00,"36,501.02","292,008.17"
28-Nov-2021,Purchase,00.00,"36,501.02","255,507.15"
28-Nov-2021,Interest,00.00,"28,389.68","227,117.47"
29-Nov-2021,Bill,"3,065.10",00.00,"230,182.57"
29-Nov-2021,Commission,345.96,00.00,"230,528.53"
29-Nov-2021,Interest,00.00,"57,632.13","172,896.40"
29-Nov-2021,Miscellaneous,00.00,"24,699.49","148,196.91"
29-Nov-2021,Interest,00.00,00.00,"148,196.91"
29-Nov-2021,Commission,"191,261.70",00.00,"339,458.61"
29-Nov-2021,Cash,00.00,"56,576.44","282,882.18"
29-Nov-2021,Tax,00.00,"35,360.27","247,521.91"
29-Nov-2021,Transfer,117.00,00.00,"247,638.91"
29-Nov-2021,Purchase,00.00,"247,638.91",00.00
29-Nov-2021,NEFT,"220,544.03",00.00,"220,544.03"
29-Nov-2021,Debit Card,"28,565.53",00.00,"249,109.56"
29-Nov-2021,Tax,"249,534.00",00.00,"498,643.56"
29-Nov-2021,Cheque,"1,885,955.50",00.00,"2,384,599.06"
29-Nov-2021,Interest,00.00,"340,657.01","2,043,942.05"
29-Nov-2021,Cash,"1,168.28",00.00,"2,045,110.33"
29-Nov-2021,Tax,00.00,"409,022.07","1,636,088.26"
29-Nov-2021,Tax,00.00,"545,362.75","1,090,725.51"
29-Nov-2021,Purchase,110.00,00.00,"1,090,835.51"
29-Nov-2021,Tax,"30,373.00",00.00,"1,121,208.51"
29-Nov-2021,Cheque,03.90,00.00,"1,121,212.41"
29-Nov-2021,Reversal,00.00,"280,303.10","840,909.31"
29-Nov-2021,NEFT,"22,587.00",00.00,"863,496.31"
29-Nov-2021,Commission,00.00,"123,356.62","740,139.69"
29-Nov-2021,NEFT,00.00,"123,356.62","616,783.07"
30-Nov-2021,IMPS,471.00,00.00,"617,254.07"
30-Nov-2021,Miscellaneous,"3,625.00",00.00,"620,879.07"
30-Nov-2021,Transfer,00.00,"77,609.88","543,269.19"
30-Nov-2021,Debit Card,00.00,"135,817.30","407,451.89"
30-Nov-2021,Miscellaneous,"48,085.94",00.00,"455,537.83"
01-Dec-2021,ATM,00.00,"65,076.83","390,461.00"
01-Dec-2021,Transfer,00.00,"78,092.20","312,368.80"
01-Dec-2021,Interest,00.00,"104,122.93","208,245.87"
01-Dec-2021,Reversal,452.10,00.00,"208,697.97"
01-Dec-2021,ATM,03.93,00.00,"208,701.90"
01-Dec-2021,Reversal,00.00,"52,175.48","156,526.42"
01-Dec-2021,Cash,00.00,"156,526.42",00.00
01-Dec-2021,Cash,"2,313.00",00.00,"2,313.00"
01-Dec-2021,Commission,00.00,257.00,"2,056.00"
01-Dec-2021,IMPS,"11,926.70",00.00,"13,982.70"
01-Dec-2021,Cheque,00.00,"2,796.54","11,186.16"
01-Dec-2021,Cheque,00.00,"3,728.72","7,457.44"
01-Dec-2021,NEFT,00.00,745.74,"6,711.70"
01-Dec-2021,NEFT,00.00,"1,342.34","5,369.36"
01-Dec-2021,Tax,00.00,"1,073.87","4,295.49"
01-Dec-2021,RTGS,32.90,00.00,"4,328.39"
01-Dec-2021,Bill,52.00,00.00,"4,380.39"
01-Dec-2021,IMPS,05.00,00.00,"4,385.39"
01-Dec-2021,Interest,00.00,626.48,"3,758.91"
01-Dec-2021,Interest,00.00,939.73,"2,819.18"
01-Dec-2021,NEFT,00.00,704.80,"2,114.38"
01-Dec-2021,Cash,"1,597.00",00.00,"3,711.38"
01-Dec-2021,Miscellaneous,00.00,927.85,"2,783.54"
01-Dec-2021,Interest,00.00,397.65,"2,385.89"
01-Dec-2021,RTGS,"63,116.16",00.00,"65,502.05"
01-Dec-2021,Transfer,"83,763.40",00.00,"149,265.45"
01-Dec-2021,Cash,00.00,"37,316.36","111,949.09"
01-Dec-2021,Cheque,00.00,"12,438.79","99,510.30"
01-Dec-2021,Commission,00.00,"99,510.30",00.00
01-Dec-2021,Commission,143.92,00.00,143.92
01-Dec-2021,RTGS,00.00,143.92,00.00
01-Dec-2021,Transfer,46.97,00.00,46.97
01-Dec-2021,Purchase,00.00,23.49,23.48
01-Dec-2021,NEFT,00.00,11.74,11.74
01-Dec-2021,Miscellaneous,00.00,02.35,09.39
02-Dec-2021,Purchase,00.00,01.34,08.05
02-Dec-2021,Cash,00.00,01.01,07.04
02-Dec-2021,Debit Card,00.00,02.35,04.69
02-Dec-2021,Interest,00.00,00.47,04.22
03-Dec-2021,IMPS,00.00,02.11,02.11
03-Dec-2021,Transfer,454.00,00.00,456.11
04-Dec-2021,Tax,434.47,00.00,890.58
04-Dec-2021,Cash,00.00,98.95,791.63
04-Dec-2021,Interest,"2,769.00",00.00,"3,560.63"
04-Dec-2021,Debit Card,00.00,890.16,"2,670.47"
04-Dec-2021,Cash,355.69,00.00,"3,026.16"
04-Dec-2021,Purchase,00.00,378.27,"2,647.89"
04-Dec-2021,Miscellaneous,352.10,00.00,"2,999.99"
04-Dec-2021,Purchase,07.01,00.00,"3,007.00"
04-Dec-2021,Tax,00.00,601.40,"2,405.60"
04-Dec-2021,IMPS,"1,153.50",00.00,"3,559.10"
04-Dec-2021,Bill,00.00,711.82,"2,847.28"
04-Dec-2021,ATM,"3,746.00",00.00,"6,593.28"
04-Dec-2021,Reversal,"635,656.00",00.00,"642,249.28"
04-Dec-2021,Miscellaneous,00.00,"128,449.86","513,799.42"
04-Dec-2021,Cash,19.02,00.00,"513,818.44"
04-Dec-2021,Miscellaneous,00.00,"51,381.84","462,436.60"
04-Dec-2021,Debit Card,"618,355.00",00.00,"1,080,791.60"
04-Dec-2021,ATM,00.00,"180,131.93","900,659.67"
04-Dec-2021,Cash,"1,854.00",00.00,"902,513.67"
04-Dec-2021,Miscellaneous,00.00,"100,279.30","802,234.37"
04-Dec-2021,Miscellaneous,00.00,"80,223.44","722,010.93"
04-Dec-2021,Cheque,645.24,00.00,"722,656.17"
04-Dec-2021,Purchase,00.00,"240,885.39","481,770.78"
04-Dec-2021,NEFT,07.93,00.00,"481,778.71"
04-Dec-2021,NEFT,00.00,"53,530.97","428,247.74"
04-Dec-2021,Transfer,426.20,00.00,"428,673.94"
04-Dec-2021,Cash,00.00,"61,239.13","367,434.81"
04-Dec-2021,ATM,"29,465.50",00.00,"396,900.31"
04-Dec-2021,Cash,467.40,00.00,"397,367.71"
04-Dec-2021,Purchase,"1,613.00",00.00,"398,980.71"
05-Dec-2021,IMPS,"30,588.00",00.00,"429,568.71"
05-Dec-2021,Reversal,"1,603.90",00.00,"431,172.61"
05-Dec-2021,IMPS,01.09,00.00,"431,173.70"
05-Dec-2021,Commission,00.00,"43,117.37","388,056.33"
06-Dec-2021,IMPS,00.00,"388,056.33",00.00
06-Dec-2021,Commission,"215,289.00",00.00,"215,289.00"
06-Dec-2021,NEFT,04.00,00.00,"215,293.00"
06-Dec-2021,Cheque,07.00,00.00,"215,300.00"
06-Dec-2021,ATM,00.00,"107,650.00","107,650.00"
06-Dec-2021,NEFT,"162,381.41",00.00,"270,031.41"
07-Dec-2021,Transfer,"2,938.00",00.00,"272,969.41"
07-Dec-2021,Cheque,937.20,00.00,"273,906.61"
07-Dec-2021,Debit Card,00.00,"136,953.31","136,953.30"
07-Dec-2021,Miscellaneous,"3,257.84",00.00,"140,211.14"
07-Dec-2021,Tax,00.00,"28,042.23","112,168.91"
07-Dec-2021,Tax,"114,801.00",00.00,"226,969.91"
07-Dec-2021,Purchase,"1,914,273.50",00.00,"2,141,243.41"
07-Dec-2021,IMPS,00.00,"428,248.68","1,712,994.73"
07-Dec-2021,Cheque,"658,763.00",00.00,"2,371,757.73"
07-Dec-2021,IMPS,00.00,"338,822.53","2,032,935.20"
07-Dec-2021,Transfer,181.80,00.00,"2,033,117.00"
07-Dec-2021,ATM,"6,824.30",00.00,"2,039,941.30"
07-Dec-2021,ATM,37.00,00.00,"2,039,978.30"
07-Dec-2021,Bill,00.00,"509,994.58","1,529,983.72"
07-Dec-2021,ATM,"814,775.50",00.00,"2,344,759.22"
07-Dec-2021,Debit Card,00.00,"260,528.80","2,084,230.42"
07-Dec-2021,Interest,00.00,"521,057.61","1,563,172.82"
07-Dec-2021,Bill,00.00,00.00,"1,563,172.82"
07-Dec-2021,NEFT,43.00,00.00,"1,563,215.82"
07-Dec-2021,Debit Card,00.00,"223,316.55","1,339,899.27"
07-Dec-2021,Purchase,00.00,"669,949.64","669,949.64"
07-Dec-2021,RTGS,00.00,"334,974.82","334,974.82"
07-Dec-2021,NEFT,00.00,"334,974.82",00.00
07-Dec-2021,Transfer,01.08,00.00,01.08
07-Dec-2021,ATM,04.60,00.00,05.68
07-Dec-2021,Miscellaneous,"735,819.00",00.00,"735,824.68"
07-Dec-2021,Tax,00.00,"367,912.34","367,912.34"
08-Dec-2021,Commission,00.00,"183,956.17","183,956.17"
08-Dec-2021,Bill,291.00,00.00,"184,247.17"
08-Dec-2021,Miscellaneous,27.00,00.00,"184,274.17"
08-Dec-2021,Transfer,"1,498,212.00",00.00,"1,682,486.17"
08-Dec-2021,Purchase,06.00,00.00,"1,682,492.17"
08-Dec-2021,ATM,00.00,"1,682,492.17",00.00
08-Dec-2021,Interest,86.30,00.00,86.30
08-Dec-2021,Debit Card,00.00,43.15,43.15
08-Dec-2021,Cash,00.00,06.16,36.99
08-Dec-2021,Interest,00.00,07.40,29.59
08-Dec-2021,Transfer,08.90,00.00,38.49
08-Dec-2021,Miscellaneous,141.10,00.00,179.59
08-Dec-2021,RTGS,37.00,00.00,216.59
08-Dec-2021,Bill,00.00,108.30,108.30
08-Dec-2021,Tax,00.00,18.05,90.25
08-Dec-2021,Interest,178.30,00.00,268.55
08-Dec-2021,NEFT,00.00,33.57,234.98
08-Dec-2021,IMPS,"1,699,630.00",00.00,"1,699,864.98"
08-Dec-2021,Miscellaneous,00.00,"283,310.83","1,416,554.15"
08-Dec-2021,Commission,"260,225.94",00.00,"1,676,780.09"
09-Dec-2021,Miscellaneous,265.90,00.00,"1,677,045.99"
09-Dec-2021,Cash,00.00,"559,015.33","1,118,030.66"
09-Dec-2021,Bill,00.00,"124,225.63","993,805.03"
09-Dec-2021,Miscellaneous,31.70,00.00,"993,836.73"
09-Dec-2021,ATM,"29,150.29",00.00,"1,022,987.02"
09-Dec-2021,ATM,46.56,00.00,"1,023,033.58"
09-Dec-2021,IMPS,503.57,00.00,"1,023,537.15"
09-Dec-2021,Commission,00.00,"255,884.29","767,652.86"
09-Dec-2021,NEFT,07.00,00.00,"767,659.86"
09-Dec-2021,Transfer,00.00,"191,914.97","575,744.90"
09-Dec-2021,Bill,61.00,00.00,"575,805.90"
09-Dec-2021,RTGS,00.00,"71,975.74","503,830.16"
09-Dec-2021,Cheque,00.00,"503,830.16",00.00
09-Dec-2021,ATM,"1,361,818.00",00.00,"1,361,818.00"
09-Dec-2021,Reversal,00.00,"453,939.33","907,878.67"
09-Dec-2021,Cheque,00.54,00.00,"907,879.21"
09-Dec-2021,Cheque,00.00,"453,939.61","453,939.60"
09-Dec-2021,Transfer,00.00,"151,313.20","302,626.40"
09-Dec-2021,Debit Card,663.30,00.00,"303,289.70"
09-Dec-2021,ATM,27.70,00.00,"303,317.40"
09-Dec-2021,Debit Card,00.00,"75,829.35","227,488.05"
09-Dec-2021,Interest,00.00,"75,829.35","151,658.70"
09-Dec-2021,Bill,"1,156.87",00.00,"152,815.57"
10-Dec-2021,NEFT,00.00,"76,407.79","76,407.78"
10-Dec-2021,Cheque,"2,923.00",00.00,"79,330.78"
10-Dec-2021,IMPS,00.00,"15,866.16","63,464.62"
10-Dec-2021,Reversal,"122,223.00",00.00,"185,687.62"
10-Dec-2021,NEFT,00.00,"92,843.81","92,843.81"
10-Dec-2021,Reversal,00.00,"30,947.94","61,895.87"
10-Dec-2021,Debit Card,"112,449.00",00.00,"174,344.87"
10-Dec-2021,Interest,131.36,00.00,"174,476.23"
10-Dec-2021,Cheque,"3,201.00",00.00,"177,677.23"
10-Dec-2021,Cash,00.00,"22,209.65","155,467.58"
10-Dec-2021,Transfer,00.00,"31,093.52","124,374.06"
10-Dec-2021,Bill,00.00,"24,874.81","99,499.25"
10-Dec-2021,Debit Card,"3,459.00",00.00,"102,958.25"
10-Dec-2021,Miscellaneous,00.00,"34,319.42","68,638.83"
11-Dec-2021,Debit Card,00.00,"17,159.71","51,479.12"
11-Dec-2021,Reversal,05.00,00.00,"51,484.12"
11-Dec-2021,Tax,249.00,00.00,"51,733.12"
11-Dec-2021,Cash,00.00,"12,933.28","38,799.84"
11-Dec-2021,Cash,00.00,"3,879.98","34,919.86"
11-Dec-2021,Purchase,00.00,"6,983.97","27,935.89"
11-Dec-2021,RTGS,"17,168.90",00.00,"45,104.79"
11-Dec-2021,NEFT,00.00,"15,034.93","30,069.86"
11-Dec-2021,Reversal,"16,154.00",00.00,"46,223.86"
11-Dec-2021,Interest,"26,281.72",00.00,"72,505.58"
11-Dec-2021,ATM,"2,053,908.00",00.00,"2,126,413.58"
11-Dec-2021,Tax,00.00,"425,282.72","1,701,130.86"
11-Dec-2021,ATM,"225,181.00",00.00,"1,926,311.86"
11-Dec-2021,Cheque,03.21,00.00,"1,926,315.07"
11-Dec-2021,Debit Card,"151,090.00",00.00,"2,077,405.07"
12-Dec-2021,Cheque,00.00,"346,234.18","1,731,170.89"
12-Dec-2021,Cash,00.00,"346,234.18","1,384,936.71"
12-Dec-2021,NEFT,316.60,00.00,"1,385,253.31"
12-Dec-2021,IMPS,992.00,00.00,"1,386,245.31"
12-Dec-2021,Miscellaneous,45.60,00.00,"1,386,290.91"
12-Dec-2021,Debit Card,"4,443.30",00.00,"1,390,734.21"
12-Dec-2021,Interest,"213,552.84",00.00,"1,604,287.05"
12-Dec-2021,Cash,38.85,00.00,"1,604,325.90"
13-Dec-2021,Commission,25.80,00.00,"1,604,351.70"
13-Dec-2021,NEFT,"6,067.00",00.00,"1,610,418.70"
13-Dec-2021,Commission,"100,315.20",00.00,"1,710,733.90"
13-Dec-2021,Commission,00.00,"285,122.32","1,425,611.58"
13-Dec-2021,NEFT,130.40,00.00,"1,425,741.98"
13-Dec-2021,IMPS,00.00,"203,677.43","1,222,064.55"
13-Dec-2021,Purchase,00.00,"203,677.43","1,018,387.12"
13-Dec-2021,Purchase,"15,454.90",00.00,"1,033,842.02"
13-Dec-2021,ATM,04.00,00.00,"1,033,846.02"
13-Dec-2021,ATM,"27,623.30",00.00,"1,061,469.32"
13-Dec-2021,Reversal,00.00,"117,941.04","943,528.28"
13-Dec-2021,Bill,"64,906.70",00.00,"1,008,434.98"
13-Dec-2021,Debit Card,00.00,"252,108.75","756,326.24"
13-Dec-2021,NEFT,00.00,"189,081.56","567,244.68"
13-Dec-2021,Purchase,00.00,"81,034.95","486,209.73"
13-Dec-2021,Cash,17.60,00.00,"486,227.33"
13-Dec-2021,Debit Card,"1,307,176.00",00.00,"1,793,403.33"
13-Dec-2021,ATM,54.40,00.00,"1,793,457.73"
13-Dec-2021,Debit Card,"1,462,885.75",00.00,"3,256,343.48"
13-Dec-2021,Debit Card,103.00,00.00,"3,256,446.48"
14-Dec-2021,Transfer,00.00,"814,111.62","2,442,334.86"
14-Dec-2021,Cash,00.00,"814,111.62","1,628,223.24"
14-Dec-2021,Debit Card,"1,026,776.75",00.00,"2,654,999.99"
14-Dec-2021,Interest,02.99,00.00,"2,655,002.98"
14-Dec-2021,Reversal,00.00,"2,655,002.98",00.00
14-Dec-2021,RTGS,06.98,00.00,06.98
14-Dec-2021,Interest,00.00,00.78,06.20
14-Dec-2021,Reversal,00.00,01.55,04.65
15-Dec-2021,Interest,00.00,02.33,02.33
15-Dec-2021,Tax,53.20,00.00,55.53
15-Dec-2021,Transfer,"1,273,247.00",00.00,"1,273,302.53"
15-Dec-2021,Commission,00.00,"318,325.63","954,976.90"
15-Dec-2021,Commission,00.00,"954,976.90",00.00
15-Dec-2021,Purchase,53.10,00.00,53.10
15-Dec-2021,Reversal,"2,615.97",00.00,"2,669.07"
15-Dec-2021,Tax,00.00,266.91,"2,402.16"
15-Dec-2021,IMPS,00.00,266.91,"2,135.25"
16-Dec-2021,ATM,"16,049.50",00.00,"18,184.75"
16-Dec-2021,Miscellaneous,"27,403.60",00.00,"45,588.35"
16-Dec-2021,Transfer,521.04,00.00,"46,109.39"
16-Dec-2021,Interest,"11,189.00",00.00,"57,298.39"
16-Dec-2021,Cheque,56.90,00.00,"57,355.29"
16-Dec-2021,Transfer,00.00,"14,338.82","43,016.47"
16-Dec-2021,RTGS,00.00,"10,754.12","32,262.35"
16-Dec-2021,ATM,00.00,"5,377.06","26,885.29"
17-Dec-2021,NEFT,00.00,"26,885.29",00.00
17-Dec-2021,ATM,"1,029.30",00.00,"1,029.30"
17-Dec-2021,Transfer,00.00,128.66,900.64
17-Dec-2021,RTGS,00.00,112.58,788.06
18-Dec-2021,Cheque,29.97,00.00,818.03
18-Dec-2021,Transfer,00.00,102.25,715.78
18-Dec-2021,Bill,03.86,00.00,719.64
18-Dec-2021,Reversal,00.00,89.96,629.68
18-Dec-2021,RTGS,"2,320.00",00.00,"2,949.68"
18-Dec-2021,Debit Card,01.41,00.00,"2,951.09"
18-Dec-2021,Interest,"150,728.00",00.00,"153,679.09"
18-Dec-2021,NEFT,"16,634.60",00.00,"170,313.69"
18-Dec-2021,Interest,00.00,"56,771.23","113,542.46"
18-Dec-2021,Interest,06.90,00.00,"113,549.36"
18-Dec-2021,Tax,00.00,"56,774.68","56,774.68"
18-Dec-2021,NEFT,00.00,"14,193.67","42,581.01"
18-Dec-2021,Commission,00.00,"10,645.25","31,935.76"
18-Dec-2021,IMPS,01.50,00.00,"31,937.26"
18-Dec-2021,IMPS,"480,788.00",00.00,"512,725.26"
18-Dec-2021,Tax,00.00,"51,272.53","461,452.73"
18-Dec-2021,Tax,00.00,"230,726.37","230,726.36"
18-Dec-2021,Bill,50.00,00.00,"230,776.36"
18-Dec-2021,Cash,"197,934.00",00.00,"428,710.36"
18-Dec-2021,NEFT,01.58,00.00,"428,711.94"
18-Dec-2021,ATM,438.76,00.00,"429,150.70"
18-Dec-2021,Interest,"3,396.00",00.00,"432,546.70"
18-Dec-2021,ATM,00.00,"72,091.12","360,455.58"
18-Dec-2021,ATM,04.90,00.00,"360,460.48"
18-Dec-2021,RTGS,00.00,"120,153.49","240,306.99"
18-Dec-2021,Cheque,00.00,"24,030.70","216,276.29"
18-Dec-2021,Reversal,05.10,00.00,"216,281.39"
18-Dec-2021,Cash,00.00,"30,897.34","185,384.05"
18-Dec-2021,Debit Card,00.00,"18,538.41","166,845.64"
18-Dec-2021,RTGS,00.00,"166,845.64",00.00
18-Dec-2021,Cheque,346.10,00.00,346.10
18-Dec-2021,Transfer,"136,939.03",00.00,"137,285.13"
18-Dec-2021,Debit Card,00.00,"137,285.13",00.00
18-Dec-2021,Reversal,10.04,00.00,10.04
19-Dec-2021,Cash,"150,371.40",00.00,"150,381.44"
19-Dec-2021,Cheque,00.00,"50,127.15","100,254.29"
19-Dec-2021,Debit Card,00.00,"12,531.79","87,722.50"
19-Dec-2021,Reversal,01.69,00.00,"87,724.19"
19-Dec-2021,Reversal,"1,948,822.50",00.00,"2,036,546.69"
19-Dec-2021,Cheque,"1,597,246.20",00.00,"3,633,792.89"
19-Dec-2021,Transfer,154.00,00.00,"3,633,946.89"
19-Dec-2021,Cheque,17.92,00.00,"3,633,964.81"
19-Dec-2021,RTGS,00.00,"605,660.80","3,028,304.01"
19-Dec-2021,NEFT,"1,605,921.25",00.00,"4,634,225.26"
19-Dec-2021,Debit Card,22.57,00.00,"4,634,247.83"
19-Dec-2021,Tax,02.00,00.00,"4,634,249.83"
19-Dec-2021,Tax,"1,943,148.50",00.00,"6,577,398.33"
19-Dec-2021,Cheque,00.00,"822,174.79","5,755,223.54"
19-Dec-2021,Cash,00.00,"719,402.94","5,035,820.60"
19-Dec-2021,Reversal,00.00,"839,303.43","4,196,517.17"
19-Dec-2021,Reversal,00.00,"524,564.65","3,671,952.52"
19-Dec-2021,Reversal,07.70,00.00,"3,671,960.22"
19-Dec-2021,ATM,04.00,00.00,"3,671,964.22"
19-Dec-2021,Tax,00.00,"3,671,964.22",00.00
19-Dec-2021,Miscellaneous,04.20,00.00,04.20
19-Dec-2021,Purchase,00.30,00.00,04.50
19-Dec-2021,Debit Card,"23,105.00",00.00,"23,109.50"
19-Dec-2021,Reversal,00.00,"5,777.38","17,332.12"
19-Dec-2021,Tax,00.00,"2,166.52","15,165.60"
19-Dec-2021,Cash,00.00,"2,166.51","12,999.09"
19-Dec-2021,Tax,"3,307.00",00.00,"16,306.09"
19-Dec-2021,Transfer,"2,737.00",00.00,"19,043.09"
19-Dec-2021,IMPS,00.00,"2,115.90","16,927.19"
19-Dec-2021,RTGS,00.00,"2,821.20","14,105.99"
19-Dec-2021,NEFT,31.60,00.00,"14,137.59"
19-Dec-2021,Tax,00.00,"2,356.27","11,781.32"
19-Dec-2021,ATM,00.00,"3,927.11","7,854.21"
19-Dec-2021,IMPS,"3,170.00",00.00,"11,024.21"
19-Dec-2021,Debit Card,00.00,"2,204.84","8,819.37"
19-Dec-2021,Cheque,00.00,"2,204.84","6,614.53"
19-Dec-2021,Reversal,01.50,00.00,"6,616.03"
19-Dec-2021,Cheque,"17,567.30",00.00,"24,183.33"
19-Dec-2021,Reversal,00.00,"2,687.04","21,496.29"
19-Dec-2021,RTGS,07.08,00.00,"21,503.37"
19-Dec-2021,Miscellaneous,00.00,"10,751.69","10,751.68"
19-Dec-2021,RTGS,00.00,"2,687.92","8,063.76"
19-Dec-2021,Purchase,43.00,00.00,"8,106.76"
19-Dec-2021,Bill,00.00,"1,013.35","7,093.42"
19-Dec-2021,Purchase,00.00,"2,364.47","4,728.95"
19-Dec-2021,Interest,00.00,"1,576.32","3,152.63"
19-Dec-2021,Purchase,00.00,525.44,"2,627.19"
19-Dec-2021,Cash,"179,815.20",00.00,"182,442.39"
19-Dec-2021,Interest,00.00,"22,805.30","159,637.09"
19-Dec-2021,Miscellaneous,22.00,00.00,"159,659.09"
19-Dec-2021,Reversal,00.00,"159,659.09",00.00
19-Dec-2021,IMPS,"146,597.60",00.00,"146,597.60"
19-Dec-2021,Miscellaneous,391.07,00.00,"146,988.67"
19-Dec-2021,NEFT,"1,446.00",00.00,"148,434.67"
19-Dec-2021,Miscellaneous,00.00,"14,843.47","133,591.20"
19-Dec-2021,Transfer,00.00,"33,397.80","100,193.40"
19-Dec-2021,Bill,00.00,"16,698.90","83,494.50"
19-Dec-2021,Transfer,"78,981.20",00.00,"162,475.70"
19-Dec-2021,Bill,00.00,"40,618.93","121,856.78"
19-Dec-2021,Purchase,00.00,"12,185.68","109,671.10"
19-Dec-2021,Bill,00.00,"10,967.11","98,703.99"
19-Dec-2021,Bill,00.00,"12,338.00","86,365.99"
19-Dec-2021,Cheque,00.00,"17,273.20","69,092.79"
19-Dec-2021,Cheque,325.00,00.00,"69,417.79"
19-Dec-2021,Commission,"6,039.20",00.00,"75,456.99"
19-Dec-2021,IMPS,00.00,"7,545.70","67,911.29"
19-Dec-2021,NEFT,"2,265.40",00.00,"70,176.69"
19-Dec-2021,Purchase,"10,765.00",00.00,"80,941.69"
19-Dec-2021,Purchase,"205,126.50",00.00,"286,068.19"
19-Dec-2021,Reversal,00.00,"47,678.03","238,390.16"
19-Dec-2021,ATM,00.00,"39,731.69","198,658.47"
19-Dec-2021,Bill,28.00,00.00,"198,686.47"
19-Dec-2021,Miscellaneous,"3,000.00",00.00,"201,686.47"
19-Dec-2021,Tax,00.00,"25,210.81","176,475.66"
19-Dec-2021,Interest,00.00,00.00,"176,475.66"
19-Dec-2021,Miscellaneous,"4,536.00",00.00,"181,011.66"
19-Dec-2021,Commission,54.00,00.00,"181,065.66"
19-Dec-2021,Purchase,00.00,"60,355.22","120,710.44"
19-Dec-2021,Commission,00.00,"40,236.81","80,473.63"
19-Dec-2021,Reversal,00.00,"8,047.36","72,426.27"
19-Dec-2021,Interest,"1,597.00",00.00,"74,023.27"
19-Dec-2021,Cheque,00.00,"10,574.75","63,448.52"
19-Dec-2021,Cheque,03.00,00.00,"63,451.52"
19-Dec-2021,Tax,"1,013.60",00.00,"64,465.12"
19-Dec-2021,Miscellaneous,00.00,"64,465.12",00.00
19-Dec-2021,IMPS,"659,386.00",00.00,"659,386.00"
19-Dec-2021,Purchase,"215,618.00",00.00,"875,004.00"
19-Dec-2021,Cash,00.00,"125,000.57","750,003.43"
19-Dec-2021,IMPS,00.00,"107,143.35","642,860.08"
19-Dec-2021,Transfer,44.49,00.00,"642,904.57"
19-Dec-2021,Interest,"496,119.00",00.00,"1,139,023.57"
19-Dec-2021,Reversal,00.00,"142,377.95","996,645.62"
19-Dec-2021,Purchase,394.39,00.00,"997,040.01"
19-Dec-2021,ATM,05.95,00.00,"997,045.96"
19-Dec-2021,Cash,00.00,"166,174.33","830,871.63"
19-Dec-2021,Reversal,"8,431.00",00.00,"839,302.63"
19-Dec-2021,Miscellaneous,00.00,"279,767.54","559,535.09"
20-Dec-2021,Reversal,00.00,"93,255.85","466,279.24"
20-Dec-2021,ATM,00.00,"58,284.91","407,994.34"
20-Dec-2021,Reversal,"238,506.09",00.00,"646,500.43"
20-Dec-2021,Purchase,00.00,"129,300.09","517,200.34"
20-Dec-2021,NEFT,00.00,"73,885.76","443,314.58"
20-Dec-2021,Interest,802.00,00.00,"444,116.58"
20-Dec-2021,IMPS,"2,757.70",00.00,"446,874.28"
20-Dec-2021,Debit Card,00.60,00.00,"446,874.88"
20-Dec-2021,Bill,00.00,"49,652.76","397,222.12"
20-Dec-2021,Cash,00.00,"132,407.37","264,814.75"
20-Dec-2021,Cash,"11,848.40",00.00,"276,663.15"
21-Dec-2021,Debit Card,"1,181,556.00",00.00,"1,458,219.15"
22-Dec-2021,Debit Card,210.10,00.00,"1,458,429.25"
22-Dec-2021,Reversal,00.00,"208,347.04","1,250,082.21"
22-Dec-2021,Debit Card,479.00,00.00,"1,250,561.21"
22-Dec-2021,Interest,00.00,"250,112.24","1,000,448.97"
22-Dec-2021,ATM,06.00,00.00,"1,000,454.97"
22-Dec-2021,RTGS,01.12,00.00,"1,000,456.09"
22-Dec-2021,NEFT,00.00,"100,045.61","900,410.48"
22-Dec-2021,Tax,00.00,"900,410.48",00.00
22-Dec-2021,IMPS,343.77,00.00,343.77
22-Dec-2021,Tax,00.00,34.38,309.39
22-Dec-2021,Tax,"78,320.00",00.00,"78,629.39"
22-Dec-2021,Interest,451.00,00.00,"79,080.39"
22-Dec-2021,Cheque,"716,725.00",00.00,"795,805.39"
22-Dec-2021,Interest,00.00,"198,951.35","596,854.04"
22-Dec-2021,Tax,40.00,00.00,"596,894.04"
22-Dec-2021,Miscellaneous,00.00,"596,894.04",00.00
22-Dec-2021,Miscellaneous,20.26,00.00,20.26
22-Dec-2021,Transfer,00.00,02.53,17.73
22-Dec-2021,Interest,01.00,00.00,18.73
22-Dec-2021,Cash,00.00,18.73,00.00
22-Dec-2021,Tax,"1,135.20",00.00,"1,135.20"
22-Dec-2021,Interest,00.00,126.13,"1,009.07"
22-Dec-2021,Miscellaneous,"220,141.00",00.00,"221,150.07"
22-Dec-2021,Interest,07.00,00.00,"221,157.07"
22-Dec-2021,Debit Card,247.10,00.00,"221,404.17"
22-Dec-2021,ATM,04.50,00.00,"221,408.67"
22-Dec-2021,Cash,00.00,"55,352.17","166,056.50"
22-Dec-2021,IMPS,00.00,"16,605.65","149,450.85"
22-Dec-2021,Transfer,"8,862.02",00.00,"158,312.87"
22-Dec-2021,Cash,00.00,"15,831.29","142,481.58"
22-Dec-2021,Interest,00.00,"71,240.79","71,240.79"
22-Dec-2021,NEFT,00.00,"35,620.40","35,620.39"
22-Dec-2021,NEFT,"18,224.07",00.00,"53,844.46"
22-Dec-2021,Tax,00.00,"13,461.12","40,383.34"
22-Dec-2021,Reversal,"29,562.00",00.00,"69,945.34"
22-Dec-2021,IMPS,00.00,"8,743.17","61,202.17"
22-Dec-2021,Miscellaneous,00.00,"15,300.54","45,901.63"
22-Dec-2021,Commission,"43,118.00",00.00,"89,019.63"
23-Dec-2021,Transfer,00.00,"29,673.21","59,346.42"
23-Dec-2021,Miscellaneous,41.94,00.00,"59,388.36"
23-Dec-2021,Debit Card,00.00,"29,694.18","29,694.18"
23-Dec-2021,Debit Card,00.00,"9,898.06","19,796.12"
23-Dec-2021,Bill,00.00,"6,598.71","13,197.41"
23-Dec-2021,Cash,"32,670.96",00.00,"45,868.37"
23-Dec-2021,Miscellaneous,00.00,"5,733.55","40,134.82"
23-Dec-2021,IMPS,00.00,"10,033.71","30,101.12"
23-Dec-2021,Commission,00.00,"6,020.22","24,080.90"
23-Dec-2021,RTGS,00.00,"4,013.48","20,067.42"
23-Dec-2021,Tax,"58,378.00",00.00,"78,445.42"
23-Dec-2021,Bill,00.00,"11,206.49","67,238.93"
23-Dec-2021,RTGS,00.00,"67,238.93",00.00
23-Dec-2021,Reversal,"885,204.00",00.00,"885,204.00"
23-Dec-2021,Purchase,61.77,00.00,"885,265.77"
23-Dec-2021,Bill,00.00,"177,053.15","708,212.62"
23-Dec-2021,RTGS,00.00,"78,690.29","629,522.33"
23-Dec-2021,Commission,00.00,"209,840.78","419,681.55"
23-Dec-2021,Cheque,"3,437.11",00.00,"423,118.66"
23-Dec-2021,IMPS,00.00,"105,779.67","317,339.00"
23-Dec-2021,RTGS,00.00,"105,779.67","211,559.33"
23-Dec-2021,NEFT,00.00,"21,155.93","190,403.40"
23-Dec-2021,Bill,00.00,"21,155.93","169,247.47"
23-Dec-2021,Cash,"3,794.80",00.00,"173,042.27"
23-Dec-2021,Commission,"43,592.84",00.00,"216,635.11"
23-Dec-2021,Transfer,00.00,"72,211.70","144,423.41"
23-Dec-2021,Interest,"1,679.30",00.00,"146,102.71"
23-Dec-2021,Interest,00.00,"73,051.36","73,051.36"
23-Dec-2021,Commission,00.00,"73,051.36",00.00
23-Dec-2021,Cash,"1,962,367.50",00.00,"1,962,367.50"
23-Dec-2021,Debit Card,136.00,00.00,"1,962,503.50"
23-Dec-2021,Reversal,00.00,"981,251.75","981,251.75"
23-Dec-2021,Purchase,00.00,"490,625.88","490,625.88"
23-Dec-2021,RTGS,00.00,"81,770.98","408,854.90"
23-Dec-2021,RTGS,"149,936.28",00.00,"558,791.18"
23-Dec-2021,Bill,00.00,"139,697.80","419,093.38"
23-Dec-2021,Transfer,62.38,00.00,"419,155.76"
23-Dec-2021,NEFT,00.00,"52,394.47","366,761.29"
23-Dec-2021,RTGS,00.00,"52,394.47","314,366.82"
23-Dec-2021,Cash,11.47,00.00,"314,378.29"
23-Dec-2021,Reversal,00.00,"31,437.83","282,940.46"
23-Dec-2021,Transfer,"119,632.50",00.00,"402,572.96"
23-Dec-2021,Debit Card,00.00,"134,190.99","268,381.97"
23-Dec-2021,Miscellaneous,00.00,"134,190.99","134,190.98"
23-Dec-2021,Reversal,333.70,00.00,"134,524.68"
23-Dec-2021,ATM,00.00,"67,262.34","67,262.34"
23-Dec-2021,ATM,00.00,"16,815.59","50,446.76"
23-Dec-2021,Purchase,33.64,00.00,"50,480.40"
23-Dec-2021,ATM,00.00,"6,310.05","44,170.35"
23-Dec-2021,RTGS,140.70,00.00,"44,311.05"
24-Dec-2021,Miscellaneous,"977,614.00",00.00,"1,021,925.05"
25-Dec-2021,Reversal,"12,856.00",00.00,"1,034,781.05"
25-Dec-2021,IMPS,00.00,"1,034,781.05",00.00
25-Dec-2021,Tax,36.86,00.00,36.86
25-Dec-2021,ATM,00.00,12.29,24.57
25-Dec-2021,ATM,00.00,02.46,22.11
25-Dec-2021,ATM,00.00,07.37,14.74
25-Dec-2021,Transfer,00.00,01.84,12.90
25-Dec-2021,IMPS,00.00,01.61,11.29
25-Dec-2021,Transfer,479.90,00.00,491.19
25-Dec-2021,Interest,00.00,122.80,368.39
25-Dec-2021,Bill,419.93,00.00,788.32
25-Dec-2021,RTGS,16.00,00.00,804.32
25-Dec-2021,RTGS,58.09,00.00,862.41
25-Dec-2021,Tax,121.00,00.00,983.41
25-Dec-2021,Cheque,"12,819.00",00.00,"13,802.41"
25-Dec-2021,Transfer,39.40,00.00,"13,841.81"
25-Dec-2021,Miscellaneous,00.00,"1,384.18","12,457.63"
25-Dec-2021,Bill,00.00,"12,457.63",00.00
25-Dec-2021,Miscellaneous,"3,463.20",00.00,"3,463.20"
25-Dec-2021,IMPS,367.00,00.00,"3,830.20"
25-Dec-2021,Bill,00.00,"1,915.10","1,915.10"
25-Dec-2021,Commission,00.00,239.39,"1,675.71"
25-Dec-2021,NEFT,16.00,00.00,"1,691.71"
25-Dec-2021,Transfer,00.00,"1,691.71",00.00
25-Dec-2021,Interest,"229,980.00",00.00,"229,980.00"
25-Dec-2021,Bill,00.00,"28,747.50","201,232.50"
25-Dec-2021,Transfer,07.00,00.00,"201,239.50"
25-Dec-2021,Cash,00.00,"100,619.75","100,619.75"
25-Dec-2021,IMPS,"2,703.00",00.00,"103,322.75"
25-Dec-2021,Miscellaneous,907.00,00.00,"104,229.75"
25-Dec-2021,Purchase,00.00,"13,028.72","91,201.03"
25-Dec-2021,Cash,00.00,"45,600.52","45,600.52"
25-Dec-2021,Tax,"751,320.00",00.00,"796,920.52"
26-Dec-2021,Commission,"18,271.00",00.00,"815,191.52"
26-Dec-2021,IMPS,461.00,00.00,"815,652.52"
26-Dec-2021,RTGS,00.00,"271,884.17","543,768.35"
26-Dec-2021,Purchase,"1,706,307.00",00.00,"2,250,075.35"
26-Dec-2021,Interest,59.20,00.00,"2,250,134.55"
26-Dec-2021,Debit Card,180.00,00.00,"2,250,314.55"
26-Dec-2021,Tax,123.74,00.00,"2,250,438.29"
27-Dec-2021,Cheque,"672,078.00",00.00,"2,922,516.29"
27-Dec-2021,RTGS,00.00,"487,086.05","2,435,430.24"
27-Dec-2021,Interest,00.00,"1,217,715.12","1,217,715.12"
27-Dec-2021,Tax,00.00,"1,217,715.12",00.00
27-Dec-2021,ATM,64.69,00.00,64.69
27-Dec-2021,Debit Card,"1,200.87",00.00,"1,265.56"
27-Dec-2021,IMPS,00.00,"1,265.56",00.00
27-Dec-2021,Bill,"1,787.00",00.00,"1,787.00"
27-Dec-2021,Commission,00.00,178.70,"1,608.30"
27-Dec-2021,Cheque,00.00,804.15,804.15
27-Dec-2021,ATM,00.00,804.15,00.00
27-Dec-2021,NEFT,"1,721,877.20",00.00,"1,721,877.20"
27-Dec-2021,Interest,00.00,"430,469.30","1,291,407.90"
27-Dec-2021,ATM,00.00,"143,489.77","1,147,918.13"
27-Dec-2021,Miscellaneous,00.00,"114,791.81","1,033,126.32"
27-Dec-2021,Transfer,00.00,"206,625.26","826,501.06"
27-Dec-2021,Commission,00.00,"118,071.58","708,429.48"
27-Dec-2021,Cash,00.00,"354,214.74","354,214.74"
27-Dec-2021,Debit Card,228.00,00.00,"354,442.74"
27-Dec-2021,Reversal,00.00,"354,442.74",00.00
28-Dec-2021,Interest,"1,364,453.00",00.00,"1,364,453.00"
28-Dec-2021,IMPS,"1,503.00",00.00,"1,365,956.00"
28-Dec-2021,Commission,00.00,"455,318.67","910,637.33"
28-Dec-2021,ATM,"17,423.97",00.00,"928,061.30"
28-Dec-2021,IMPS,01.60,00.00,"928,062.90"
28-Dec-2021,Purchase,"16,699.40",00.00,"944,762.30"
28-Dec-2021,Miscellaneous,00.00,"314,920.77","629,841.53"
28-Dec-2021,NEFT,00.00,"89,977.36","539,864.17"
28-Dec-2021,Debit Card,"6,492.40",00.00,"546,356.57"
28-Dec-2021,ATM,00.00,"91,059.43","455,297.14"
28-Dec-2021,Cheque,00.00,"56,912.14","398,385.00"
28-Dec-2021,Bill,00.00,"49,798.13","348,586.88"
28-Dec-2021,Commission,00.00,"348,586.88",00.00
28-Dec-2021,Bill,175.18,00.00,175.18
28-Dec-2021,Purchase,00.00,25.03,150.15
28-Dec-2021,Bill,00.00,37.54,112.61
28-Dec-2021,Miscellaneous,00.00,18.77,93.84
28-Dec-2021,Tax,00.00,93.84,00.00
28-Dec-2021,ATM,"63,024.31",00.00,"63,024.31"
28-Dec-2021,Reversal,00.00,"9,003.47","54,020.84"
28-Dec-2021,Transfer,00.00,"5,402.08","48,618.76"
28-Dec-2021,NEFT,00.00,"24,309.38","24,309.38"
28-Dec-2021,Reversal,00.00,"12,154.69","12,154.69"
28-Dec-2021,Cheque,"2,719.84",00.00,"14,874.53"
28-Dec-2021,RTGS,"18,964.10",00.00,"33,838.63"
28-Dec-2021,Reversal,00.00,"4,229.83","29,608.80"
28-Dec-2021,Commission,00.00,"3,701.10","25,907.70"
28-Dec-2021,Transfer,"46,422.00",00.00,"72,329.70"
28-Dec-2021,Miscellaneous,01.00,00.00,"72,330.70"
29-Dec-2021,Debit Card,"2,417.21",00.00,"74,747.91"
29-Dec-2021,NEFT,00.00,"12,457.99","62,289.92"
29-Dec-2021,Cash,00.00,"6,228.99","56,060.93"
29-Dec-2021,RTGS,00.00,"18,686.98","37,373.95"
29-Dec-2021,ATM,00.00,"3,737.40","33,636.56"
29-Dec-2021,Reversal,06.00,00.00,"33,642.56"
29-Dec-2021,ATM,241.00,00.00,"33,883.56"
29-Dec-2021,Interest,"36,881.00",00.00,"70,764.56"
29-Dec-2021,IMPS,00.00,"10,109.22","60,655.34"
29-Dec-2021,IMPS,"3,259.89",00.00,"63,915.23"
29-Dec-2021,NEFT,00.00,"63,915.23",00.00
29-Dec-2021,Interest,"3,590.47",00.00,"3,590.47"
29-Dec-2021,NEFT,00.00,"1,196.82","2,393.65"
29-Dec-2021,Bill,"3,232.76",00.00,"5,626.41"
29-Dec-2021,Reversal,"1,898,748.20",00.00,"1,904,374.61"
29-Dec-2021,Miscellaneous,00.00,"190,437.46","1,713,937.15"
29-Dec-2021,Cheque,"17,263.90",00.00,"1,731,201.05"
29-Dec-2021,Interest,00.00,"1,731,201.05",00.00
29-Dec-2021,Reversal,"28,959.20",00.00,"28,959.20"
29-Dec-2021,IMPS,00.10,00.00,"28,959.30"
29-Dec-2021,Cheque,"85,693.59",00.00,"114,652.89"
29-Dec-2021,NEFT,00.00,"14,331.61","100,321.28"
29-Dec-2021,Interest,00.00,"50,160.64","50,160.64"
29-Dec-2021,NEFT,"1,786,868.00",00.00,"1,837,028.64"
29-Dec-2021,Reversal,"172,431.97",00.00,"2,009,460.61"
29-Dec-2021,Bill,465.00,00.00,"2,009,925.61"
29-Dec-2021,RTGS,"2,089,285.00",00.00,"4,099,210.61"
30-Dec-2021,Tax,222.93,00.00,"4,099,433.54"
30-Dec-2021,Bill,00.00,"1,024,858.39","3,074,575.16"
30-Dec-2021,Tax,00.00,"439,225.02","2,635,350.14"
30-Dec-2021,Interest,"4,088.64",00.00,"2,639,438.78"
30-Dec-2021,Interest,00.00,"1,319,719.39","1,319,719.39"
30-Dec-2021,RTGS,05.97,00.00,"1,319,725.36"
31-Dec-2021,NEFT,01.00,00.00,"1,319,726.36"
31-Dec-2021,Tax,"2,278.00",00.00,"1,322,004.36"
31-Dec-2021,IMPS,00.00,"440,668.12","881,336.24"
31-Dec-2021,NEFT,00.00,"110,167.03","771,169.21"
31-Dec-2021,Tax,00.00,"77,116.92","694,052.29"
01-Jan-2022,Cheque,00.00,"99,150.33","594,901.96"
01-Jan-2022,Purchase,00.00,"118,980.39","475,921.57"
01-Jan-2022,Miscellaneous,00.00,"59,490.20","416,431.37"
01-Jan-2022,Debit Card,00.00,"104,107.84","312,323.53"
01-Jan-2022,NEFT,"1,864.50",00.00,"314,188.03"
01-Jan-2022,Debit Card,00.00,"52,364.67","261,823.36"
01-Jan-2022,Commission,00.00,"26,182.34","235,641.02"
01-Jan-2022,Cash,00.00,"117,820.51","117,820.51"
01-Jan-2022,ATM,00.00,"19,636.75","98,183.76"
01-Jan-2022,Debit Card,51.00,00.00,"98,234.76"
01-Jan-2022,RTGS,430.80,00.00,"98,665.56"
01-Jan-2022,Debit Card,13.00,00.00,"98,678.56"
01-Jan-2022,IMPS,"1,478,839.25",00.00,"1,577,517.81"
02-Jan-2022,NEFT,00.00,"788,758.91","788,758.90"
02-Jan-2022,Transfer,412.00,00.00,"789,170.90"
02-Jan-2022,Cash,00.00,"263,056.97","526,113.93"
02-Jan-2022,Commission,125.28,00.00,"526,239.21"
02-Jan-2022,IMPS,00.00,"175,413.07","350,826.14"
02-Jan-2022,Bill,254.50,00.00,"351,080.64"
02-Jan-2022,ATM,"1,914.00",00.00,"352,994.64"
02-Jan-2022,NEFT,"1,190,621.25",00.00,"1,543,615.89"
02-Jan-2022,Transfer,"186,391.00",00.00,"1,730,006.89"
03-Jan-2022,Cheque,27.00,00.00,"1,730,033.89"
03-Jan-2022,ATM,00.00,"865,016.95","865,016.94"
03-Jan-2022,Reversal,00.00,"123,573.85","741,443.09"
03-Jan-2022,Cheque,00.00,"185,360.77","556,082.32"
03-Jan-2022,Debit Card,00.00,"111,216.46","444,865.86"
03-Jan-2022,Interest,00.00,"74,144.31","370,721.55"
03-Jan-2022,Purchase,04.00,00.00,"370,725.55"
03-Jan-2022,Transfer,"68,526.00",00.00,"439,251.55"
03-Jan-2022,IMPS,00.00,"219,625.78","219,625.78"
03-Jan-2022,Commission,"934,494.50",00.00,"1,154,120.28"
03-Jan-2022,Purchase,00.00,"115,412.03","1,038,708.25"
03-Jan-2022,Purchase,00.00,"129,838.53","908,869.72"
03-Jan-2022,Cheque,266.00,00.00,"909,135.72"
03-Jan-2022,ATM,"178,383.19",00.00,"1,087,518.91"
03-Jan-2022,Transfer,00.00,"217,503.78","870,015.13"
03-Jan-2022,Cheque,00.00,"435,007.57","435,007.56"
03-Jan-2022,Cash,04.00,00.00,"435,011.56"
03-Jan-2022,IMPS,00.00,"72,501.93","362,509.63"
03-Jan-2022,IMPS,00.00,"72,501.93","290,007.70"
03-Jan-2022,NEFT,15.00,00.00,"290,022.70"
03-Jan-2022,Bill,00.00,"290,022.70",00.00
03-Jan-2022,Cash,"1,595,792.00",00.00,"1,595,792.00"
03-Jan-2022,Interest,12.70,00.00,"1,595,804.70"
03-Jan-2022,IMPS,"3,341.17",00.00,"1,599,145.87"
04-Jan-2022,NEFT,00.00,"533,048.62","1,066,097.25"
04-Jan-2022,NEFT,03.81,00.00,"1,066,101.06"
04-Jan-2022,Reversal,"25,092.29",00.00,"1,091,193.35"
04-Jan-2022,Miscellaneous,00.00,"1,091,193.35",00.00
04-Jan-2022,IMPS,"846,511.80",00.00,"846,511.80"
04-Jan-2022,RTGS,00.00,"282,170.60","564,341.20"
04-Jan-2022,Debit Card,00.00,"282,170.60","282,170.60"
04-Jan-2022,ATM,"326,287.00",00.00,"608,457.60"
04-Jan-2022,Cheque,"19,919.54",00.00,"628,377.14"
04-Jan-2022,ATM,"54,444.00",00.00,"682,821.14"
04-Jan-2022,ATM,"29,146.00",00.00,"711,967.14"
04-Jan-2022,Bill,00.00,"101,709.59","610,257.55"
04-Jan-2022,Miscellaneous,00.00,"152,564.39","457,693.16"
04-Jan-2022,Purchase,00.00,"50,854.80","406,838.36"
04-Jan-2022,Tax,05.80,00.00,"406,844.16"
04-Jan-2022,NEFT,"46,632.60",00.00,"453,476.76"
04-Jan-2022,Cheque,00.00,"50,386.31","403,090.45"
04-Jan-2022,Cheque,"36,631.00",00.00,"439,721.45"
04-Jan-2022,Cash,"238,283.78",00.00,"678,005.23"
04-Jan-2022,RTGS,"2,829.53",00.00,"680,834.76"
04-Jan-2022,RTGS,00.00,"85,104.35","595,730.42"
04-Jan-2022,NEFT,"16,167.27",00.00,"611,897.69"
04-Jan-2022,ATM,06.00,00.00,"611,903.69"
04-Jan-2022,NEFT,00.00,"305,951.85","305,951.84"
04-Jan-2022,Miscellaneous,"2,031.00",00.00,"307,982.84"
04-Jan-2022,Cheque,00.00,"34,220.32","273,762.52"
04-Jan-2022,Transfer,00.00,"91,254.17","182,508.35"
04-Jan-2022,Miscellaneous,00.00,"182,508.35",00.00
04-Jan-2022,NEFT,"3,524.00",00.00,"3,524.00"
04-Jan-2022,Cash,00.00,587.33,"2,936.67"
04-Jan-2022,Commission,00.00,978.89,"1,957.78"
04-Jan-2022,RTGS,"181,318.12",00.00,"183,275.90"
04-Jan-2022,Tax,00.00,"36,655.18","146,620.72"
05-Jan-2022,Bill,"584,418.50",00.00,"731,039.22"
05-Jan-2022,Interest,00.00,"146,207.84","584,831.38"
05-Jan-2022,Reversal,"3,773.00",00.00,"588,604.38"
05-Jan-2022,Tax,00.00,"294,302.19","294,302.19"
05-Jan-2022,Transfer,00.00,"73,575.55","220,726.64"
05-Jan-2022,Commission,00.00,"44,145.33","176,581.31"
05-Jan-2022,Cheque,00.00,"29,430.22","147,151.09"
05-Jan-2022,IMPS,"1,479,675.00",00.00,"1,626,826.09"
05-Jan-2022,IMPS,"1,828.90",00.00,"1,628,654.99"
05-Jan-2022,RTGS,00.00,"325,731.00","1,302,923.99"
05-Jan-2022,ATM,00.00,"162,865.50","1,140,058.49"
05-Jan-2022,Bill,00.00,"380,019.50","760,038.99"
05-Jan-2022,Cash,05.40,00.00,"760,044.39"
05-Jan-2022,Commission,"1,744,563.00",00.00,"2,504,607.39"
05-Jan-2022,Reversal,00.00,"313,075.92","2,191,531.47"
05-Jan-2022,NEFT,00.00,"313,075.92","1,878,455.55"
05-Jan-2022,ATM,00.00,"234,806.94","1,643,648.61"
05-Jan-2022,Cash,"900,854.00",00.00,"2,544,502.61"
05-Jan-2022,Cheque,00.00,"1,272,251.31","1,272,251.30"
06-Jan-2022,Transfer,"326,227.75",00.00,"1,598,479.05"
06-Jan-2022,Cheque,00.00,"266,413.18","1,332,065.88"
06-Jan-2022,Bill,00.00,"444,021.96","888,043.92"
06-Jan-2022,Purchase,00.00,"148,007.32","740,036.60"
06-Jan-2022,Debit Card,425.20,00.00,"740,461.80"
06-Jan-2022,Cash,00.00,"92,557.73","647,904.08"
06-Jan-2022,Transfer,373.00,00.00,"648,277.08"
06-Jan-2022,Cheque,00.00,"648,277.08",00.00
06-Jan-2022,Debit Card,264.00,00.00,264.00
06-Jan-2022,Commission,11.50,00.00,275.50
06-Jan-2022,NEFT,00.00,45.92,229.58
07-Jan-2022,NEFT,00.00,38.26,191.32
07-Jan-2022,Reversal,00.00,191.32,00.00
07-Jan-2022,NEFT,"1,470.60",00.00,"1,470.60"
07-Jan-2022,Cheque,"2,085,442.20",00.00,"2,086,912.80"
07-Jan-2022,Reversal,38.10,00.00,"2,086,950.90"
07-Jan-2022,RTGS,00.00,"417,390.18","1,669,560.72"
07-Jan-2022,Tax,00.00,"1,669,560.72",00.00
07-Jan-2022,Debit Card,"456,613.25",00.00,"456,613.25"
07-Jan-2022,Cash,00.00,"76,102.21","380,511.04"
07-Jan-2022,Bill,00.00,"76,102.21","304,408.83"
07-Jan-2022,RTGS,"21,336.30",00.00,"325,745.13"
07-Jan-2022,Cash,01.00,00.00,"325,746.13"
07-Jan-2022,RTGS,00.00,"108,582.04","217,164.09"
07-Jan-2022,Reversal,"3,762.00",00.00,"220,926.09"
07-Jan-2022,Transfer,"3,491.00",00.00,"224,417.09"
07-Jan-2022,Interest,00.00,"32,059.58","192,357.51"
07-Jan-2022,Purchase,"1,216,757.00",00.00,"1,409,114.51"
07-Jan-2022,Tax,00.00,"352,278.63","1,056,835.88"
07-Jan-2022,Transfer,00.00,"105,683.59","951,152.29"
07-Jan-2022,NEFT,00.00,"317,050.76","634,101.53"
07-Jan-2022,Debit Card,46.40,00.00,"634,147.93"
07-Jan-2022,NEFT,"134,189.00",00.00,"768,336.93"
07-Jan-2022,NEFT,05.00,00.00,"768,341.93"
07-Jan-2022,Miscellaneous,"17,373.77",00.00,"785,715.70"
07-Jan-2022,Purchase,00.00,"78,571.57","707,144.13"
07-Jan-2022,Interest,"6,588.48",00.00,"713,732.61"
07-Jan-2022,Transfer,00.00,"71,373.26","642,359.35"
07-Jan-2022,Debit Card,"184,767.00",00.00,"827,126.35"
07-Jan-2022,NEFT,439.00,00.00,"827,565.35"
07-Jan-2022,Transfer,"835,954.00",00.00,"1,663,519.35"
08-Jan-2022,IMPS,04.30,00.00,"1,663,523.65"
08-Jan-2022,Reversal,00.00,"166,352.37","1,497,171.28"
08-Jan-2022,Purchase,00.00,"748,585.64","748,585.64"
08-Jan-2022,Tax,"31,121.57",00.00,"779,707.21"
08-Jan-2022,Miscellaneous,"980,882.50",00.00,"1,760,589.71"
08-Jan-2022,Tax,00.00,"586,863.24","1,173,726.47"
08-Jan-2022,Tax,"1,768,492.00",00.00,"2,942,218.47"
09-Jan-2022,RTGS,"58,360.00",00.00,"3,000,578.47"
09-Jan-2022,ATM,01.00,00.00,"3,000,579.47"
09-Jan-2022,Interest,"516,413.20",00.00,"3,516,992.67"
09-Jan-2022,Commission,00.00,"3,516,992.67",00.00
09-Jan-2022,Tax,325.00,00.00,325.00
09-Jan-2022,IMPS,"149,837.06",00.00,"150,162.06"
09-Jan-2022,Commission,"2,453.13",00.00,"152,615.19"
09-Jan-2022,NEFT,404.82,00.00,"153,020.01"
09-Jan-2022,Purchase,51.00,00.00,"153,071.01"
09-Jan-2022,ATM,44.45,00.00,"153,115.46"
09-Jan-2022,ATM,00.00,"17,012.83","136,102.63"
09-Jan-2022,Cheque,"18,547.00",00.00,"154,649.63"
09-Jan-2022,Transfer,00.00,"25,774.94","128,874.69"
09-Jan-2022,ATM,"1,346,494.50",00.00,"1,475,369.19"
09-Jan-2022,Commission,"8,452.78",00.00,"1,483,821.97"
09-Jan-2022,IMPS,00.00,"494,607.32","989,214.65"
09-Jan-2022,Debit Card,"146,960.50",00.00,"1,136,175.15"
09-Jan-2022,Commission,03.00,00.00,"1,136,178.15"
09-Jan-2022,Cheque,"15,060.10",00.00,"1,151,238.25"
09-Jan-2022,Cheque,00.00,"575,619.13","575,619.12"
09-Jan-2022,RTGS,03.00,00.00,"575,622.12"
09-Jan-2022,Interest,00.00,"191,874.04","383,748.08"
09-Jan-2022,Transfer,00.00,"42,638.68","341,109.40"
09-Jan-2022,IMPS,"11,232.22",00.00,"352,341.62"
09-Jan-2022,Bill,00.00,"50,334.52","302,007.10"
09-Jan-2022,Reversal,00.00,"75,501.78","226,505.32"
09-Jan-2022,Cash,00.00,"113,252.66","113,252.66"
10-Jan-2022,Transfer,107.00,00.00,"113,359.66"
10-Jan-2022,Commission,00.00,"14,169.96","99,189.70"
11-Jan-2022,IMPS,"11,623.70",00.00,"110,813.40"
11-Jan-2022,NEFT,00.00,"12,312.60","98,500.80"
12-Jan-2022,Transfer,00.00,"19,700.16","78,800.64"
12-Jan-2022,Cash,00.00,"9,850.08","68,950.56"
12-Jan-2022,IMPS,00.00,"17,237.64","51,712.92"
12-Jan-2022,RTGS,02.00,00.00,"51,714.92"
12-Jan-2022,Debit Card,"2,552.97",00.00,"54,267.89"
12-Jan-2022,ATM,00.00,"5,426.79","48,841.10"
12-Jan-2022,Bill,"31,387.00",00.00,"80,228.10"
12-Jan-2022,Cash,"21,891.00",00.00,"102,119.10"
12-Jan-2022,IMPS,60.00,00.00,"102,179.10"
12-Jan-2022,NEFT,04.00,00.00,"102,183.10"
12-Jan-2022,Tax,00.00,"51,091.55","51,091.55"
12-Jan-2022,Transfer,101.59,00.00,"51,193.14"
12-Jan-2022,ATM,209.00,00.00,"51,402.14"
12-Jan-2022,Cheque,00.00,"25,701.07","25,701.07"
12-Jan-2022,Purchase,"1,841.00",00.00,"27,542.07"
12-Jan-2022,Tax,00.00,"3,934.58","23,607.49"
12-Jan-2022,Purchase,04.48,00.00,"23,611.97"
12-Jan-2022,NEFT,00.00,"23,611.97",00.00
12-Jan-2022,NEFT,"23,452.77",00.00,"23,452.77"
12-Jan-2022,Tax,"1,579,681.20",00.00,"1,603,133.97"
13-Jan-2022,Miscellaneous,00.00,"178,126.00","1,425,007.97"
13-Jan-2022,Cheque,03.20,00.00,"1,425,011.17"
13-Jan-2022,NEFT,"1,782.00",00.00,"1,426,793.17"
13-Jan-2022,RTGS,00.00,"1,426,793.17",00.00
13-Jan-2022,Cheque,13.77,00.00,13.77
13-Jan-2022,Tax,233.73,00.00,247.50
13-Jan-2022,Transfer,00.00,61.88,185.62
13-Jan-2022,Bill,"1,971,783.20",00.00,"1,971,968.82"
13-Jan-2022,RTGS,00.00,"328,661.47","1,643,307.35"
14-Jan-2022,Transfer,00.00,"410,826.84","1,232,480.51"
15-Jan-2022,NEFT,00.00,"154,060.06","1,078,420.45"
15-Jan-2022,Bill,"2,268.00",00.00,"1,080,688.45"
15-Jan-2022,Tax,00.53,00.00,"1,080,688.98"
15-Jan-2022,Miscellaneous,00.00,"540,344.49","540,344.49"
15-Jan-2022,Reversal,00.00,"108,068.90","432,275.59"
15-Jan-2022,Cheque,00.00,"432,275.59",00.00
15-Jan-2022,Debit Card,"340,935.00",00.00,"340,935.00"
15-Jan-2022,Cheque,"6,801.42",00.00,"347,736.42"
15-Jan-2022,Cheque,36.00,00.00,"347,772.42"
15-Jan-2022,Miscellaneous,288.00,00.00,"348,060.42"
15-Jan-2022,Cash,00.00,"58,010.07","290,050.35"
15-Jan-2022,Reversal,"31,916.71",00.00,"321,967.06"
15-Jan-2022,ATM,00.00,"40,245.88","281,721.18"
15-Jan-2022,Commission,"1,064,211.20",00.00,"1,345,932.38"
15-Jan-2022,Tax,"1,797,245.00",00.00,"3,143,177.38"
15-Jan-2022,Bill,00.00,"314,317.74","2,828,859.64"
15-Jan-2022,Interest,10.25,00.00,"2,828,869.89"
15-Jan-2022,Tax,00.00,"353,608.74","2,475,261.15"
15-Jan-2022,Cash,"72,937.00",00.00,"2,548,198.15"
15-Jan-2022,RTGS,06.00,00.00,"2,548,204.15"
15-Jan-2022,RTGS,00.00,"849,401.38","1,698,802.77"
15-Jan-2022,RTGS,00.00,"849,401.39","849,401.38"
15-Jan-2022,Interest,"1,858,483.00",00.00,"2,707,884.38"
15-Jan-2022,IMPS,00.00,"2,707,884.38",00.00
15-Jan-2022,Cash,"5,777.00",00.00,"5,777.00"
15-Jan-2022,NEFT,00.00,641.89,"5,135.11"
15-Jan-2022,Debit Card,00.00,"1,711.70","3,423.41"
15-Jan-2022,Transfer,00.00,489.06,"2,934.35"
15-Jan-2022,Purchase,00.00,978.12,"1,956.23"
15-Jan-2022,ATM,00.00,195.62,"1,760.61"
15-Jan-2022,Bill,"1,663,337.00",00.00,"1,665,097.61"
15-Jan-2022,Cheque,26.10,00.00,"1,665,123.71"
15-Jan-2022,Cash,30.00,00.00,"1,665,153.71"
15-Jan-2022,RTGS,"51,860.30",00.00,"1,717,014.01"
15-Jan-2022,Cash,00.00,"286,169.00","1,430,845.01"
15-Jan-2022,Transfer,00.00,"476,948.34","953,896.67"
15-Jan-2022,RTGS,"241,461.50",00.00,"1,195,358.17"
15-Jan-2022,NEFT,"1,095.01",00.00,"1,196,453.18"
15-Jan-2022,Purchase,189.90,00.00,"1,196,643.08"
15-Jan-2022,Miscellaneous,00.00,"598,321.54","598,321.54"
15-Jan-2022,Purchase,08.18,00.00,"598,329.72"
15-Jan-2022,Debit Card,"18,200.00",00.00,"616,529.72"
15-Jan-2022,ATM,"21,016.70",00.00,"637,546.42"
15-Jan-2022,Debit Card,692.00,00.00,"638,238.42"
15-Jan-2022,RTGS,00.00,"91,176.92","547,061.50"
15-Jan-2022,IMPS,00.00,"109,412.30","437,649.20"
15-Jan-2022,ATM,05.30,00.00,"437,654.50"
15-Jan-2022,IMPS,00.00,"87,530.90","350,123.60"
15-Jan-2022,Bill,"2,147.40",00.00,"352,271.00"
16-Jan-2022,Purchase,00.00,"352,271.00",00.00
16-Jan-2022,Tax,"411,680.00",00.00,"411,680.00"
16-Jan-2022,RTGS,00.00,"102,920.00","308,760.00"
16-Jan-2022,Debit Card,06.00,00.00,"308,766.00"
16-Jan-2022,ATM,28.00,00.00,"308,794.00"
16-Jan-2022,Cash,00.00,"30,879.40","277,914.60"
16-Jan-2022,Transfer,"94,078.75",00.00,"371,993.35"
16-Jan-2022,Reversal,00.00,"123,997.78","247,995.57"
16-Jan-2022,Debit Card,12.10,00.00,"248,007.67"
17-Jan-2022,IMPS,00.00,"124,003.84","124,003.84"
17-Jan-2022,IMPS,00.00,"124,003.84",00.00
17-Jan-2022,NEFT,"1,740,535.50",00.00,"1,740,535.50"
17-Jan-2022,Miscellaneous,50.80,00.00,"1,740,586.30"
17-Jan-2022,ATM,00.00,"193,398.48","1,547,187.82"
17-Jan-2022,Tax,"1,412,292.80",00.00,"2,959,480.62"
17-Jan-2022,Bill,"48,670.00",00.00,"3,008,150.62"
17-Jan-2022,Bill,31.00,00.00,"3,008,181.62"
17-Jan-2022,Miscellaneous,00.00,"501,363.60","2,506,818.02"
17-Jan-2022,Debit Card,00.00,"358,116.86","2,148,701.16"
17-Jan-2022,Miscellaneous,00.00,"1,074,350.58","1,074,350.58"
17-Jan-2022,Commission,48.20,00.00,"1,074,398.78"
17-Jan-2022,Cheque,00.00,"107,439.88","966,958.90"
17-Jan-2022,Bill,00.00,"193,391.78","773,567.12"
17-Jan-2022,Tax,00.00,"154,713.42","618,853.70"
17-Jan-2022,Commission,"229,012.00",00.00,"847,865.70"
17-Jan-2022,RTGS,"3,744.00",00.00,"851,609.70"
17-Jan-2022,Interest,00.00,"94,623.30","756,986.40"
17-Jan-2022,IMPS,318.00,00.00,"757,304.40"
17-Jan-2022,RTGS,00.00,"75,730.44","681,573.96"
17-Jan-2022,Bill,293.80,00.00,"681,867.76"
17-Jan-2022,Cheque,00.00,"97,409.68","584,458.08"
17-Jan-2022,Reversal,"1,195.00",00.00,"585,653.08"
17-Jan-2022,Cheque,247.66,00.00,"585,900.74"
17-Jan-2022,Debit Card,00.00,"585,900.74",00.00
17-Jan-2022,Cheque,"178,076.50",00.00,"178,076.50"
17-Jan-2022,Cheque,00.00,"89,038.25","89,038.25"
17-Jan-2022,Interest,"1,309.70",00.00,"90,347.95"
17-Jan-2022,Purchase,07.00,00.00,"90,354.95"
17-Jan-2022,Commission,06.77,00.00,"90,361.72"
17-Jan-2022,IMPS,03.00,00.00,"90,364.72"
17-Jan-2022,Commission,00.00,"11,295.59","79,069.13"
17-Jan-2022,Cash,00.00,"11,295.59","67,773.54"
17-Jan-2022,Cash,00.00,"22,591.18","45,182.36"
17-Jan-2022,Miscellaneous,00.00,"5,020.26","40,162.10"
17-Jan-2022,Bill,"13,583.25",00.00,"53,745.35"
17-Jan-2022,Cheque,00.00,"13,436.34","40,309.01"
17-Jan-2022,Bill,"29,931.40",00.00,"70,240.41"
17-Jan-2022,Bill,00.00,"10,034.34","60,206.07"
17-Jan-2022,Tax,00.00,"30,103.04","30,103.04"
17-Jan-2022,Cheque,494.00,00.00,"30,597.04"
17-Jan-2022,NEFT,00.00,"30,597.04",00.00
17-Jan-2022,Transfer,198.40,00.00,198.40
17-Jan-2022,RTGS,15.00,00.00,213.40
17-Jan-2022,Purchase,00.00,26.68,186.72
17-Jan-2022,Interest,"236,180.30",00.00,"236,367.02"
17-Jan-2022,NEFT,01.29,00.00,"236,368.31"
17-Jan-2022,Tax,00.00,"29,546.04","206,822.27"
17-Jan-2022,Transfer,25.59,00.00,"206,847.86"
17-Jan-2022,RTGS,"3,373.20",00.00,"210,221.06"
17-Jan-2022,RTGS,"845,308.00",00.00,"1,055,529.06"
17-Jan-2022,Reversal,04.00,00.00,"1,055,533.06"
17-Jan-2022,Purchase,00.00,"263,883.27","791,649.80"
17-Jan-2022,RTGS,00.00,"395,824.90","395,824.90"
17-Jan-2022,ATM,"55,662.80",00.00,"451,487.70"
17-Jan-2022,Transfer,00.00,"64,498.24","386,989.46"
17-Jan-2022,Purchase,00.00,"55,284.21","331,705.25"
17-Jan-2022,Miscellaneous,00.00,"66,341.05","265,364.20"
17-Jan-2022,Transfer,00.00,"29,484.91","235,879.29"
17-Jan-2022,Tax,37.00,00.00,"235,916.29"
17-Jan-2022,Transfer,00.00,"78,638.76","157,277.53"
17-Jan-2022,RTGS,00.00,"78,638.77","78,638.76"
17-Jan-2022,Tax,04.00,00.00,"78,642.76"
17-Jan-2022,Cheque,01.43,00.00,"78,644.19"
17-Jan-2022,Debit Card,00.00,"13,107.37","65,536.82"
17-Jan-2022,Miscellaneous,"274,433.75",00.00,"339,970.57"
17-Jan-2022,NEFT,00.00,"339,970.57",00.00
17-Jan-2022,Miscellaneous,"1,906.00",00.00,"1,906.00"
17-Jan-2022,Reversal,00.00,"1,906.00",00.00
17-Jan-2022,Tax,56.00,00.00,56.00
17-Jan-2022,Cheque,"23,414.54",00.00,"23,470.54"
17-Jan-2022,Bill,00.00,"23,470.54",00.00
17-Jan-2022,RTGS,"108,584.00",00.00,"108,584.00"
17-Jan-2022,Cheque,00.00,"27,146.00","81,438.00"
17-Jan-2022,Cash,00.00,"16,287.60","65,150.40"
17-Jan-2022,Miscellaneous,226.00,00.00,"65,376.40"
17-Jan-2022,Tax,00.00,"10,896.07","54,480.33"
17-Jan-2022,Debit Card,"1,178.40",00.00,"55,658.73"
17-Jan-2022,Cheque,00.00,"27,829.37","27,829.36"
17-Jan-2022,RTGS,00.00,"27,829.36",00.00
17-Jan-2022,Purchase,"143,702.20",00.00,"143,702.20"
17-Jan-2022,Transfer,06.27,00.00,"143,708.47"
17-Jan-2022,Tax,00.00,"17,963.56","125,744.91"
17-Jan-2022,IMPS,00.70,00.00,"125,745.61"
17-Jan-2022,Reversal,05.70,00.00,"125,751.31"
17-Jan-2022,IMPS,00.00,"15,718.91","110,032.40"
17-Jan-2022,RTGS,"76,238.00",00.00,"186,270.40"
17-Jan-2022,Transfer,00.00,"46,567.60","139,702.80"
17-Jan-2022,Bill,00.00,"19,957.54","119,745.26"
17-Jan-2022,Commission,00.00,"29,936.32","89,808.94"
17-Jan-2022,Bill,"30,399.60",00.00,"120,208.54"
17-Jan-2022,Reversal,"245,203.16",00.00,"365,411.70"
17-Jan-2022,RTGS,00.00,"36,541.17","328,870.53"
17-Jan-2022,Commission,"26,447.00",00.00,"355,317.53"
17-Jan-2022,Bill,00.00,"355,317.53",00.00
17-Jan-2022,Bill,"94,467.53",00.00,"94,467.53"
17-Jan-2022,ATM,05.10,00.00,"94,472.63"
17-Jan-2022,Interest,00.00,"23,618.16","70,854.47"
17-Jan-2022,Transfer,120.40,00.00,"70,974.87"
18-Jan-2022,Tax,00.00,"23,658.29","47,316.58"
18-Jan-2022,Cash,00.00,"5,914.57","41,402.01"
18-Jan-2022,Purchase,00.00,"10,350.50","31,051.51"
18-Jan-2022,Commission,88.00,00.00,"31,139.51"
18-Jan-2022,Miscellaneous,00.00,"3,892.44","27,247.07"
18-Jan-2022,Miscellaneous,00.00,"3,892.44","23,354.63"
18-Jan-2022,NEFT,00.00,"11,677.32","11,677.32"
18-Jan-2022,Miscellaneous,09.47,00.00,"11,686.79"
18-Jan-2022,Cheque,00.00,"5,843.40","5,843.40"
18-Jan-2022,Debit Card,"29,268.00",00.00,"35,111.40"
18-Jan-2022,Bill,00.00,"8,777.85","26,333.55"
18-Jan-2022,Commission,00.00,"26,333.55",00.00
18-Jan-2022,Transfer,"684,136.00",00.00,"684,136.00"
18-Jan-2022,Reversal,00.00,"228,045.33","456,090.67"
18-Jan-2022,ATM,03.98,00.00,"456,094.65"
18-Jan-2022,Tax,00.00,"114,023.66","342,070.99"
18-Jan-2022,Bill,00.00,"114,023.66","228,047.33"
18-Jan-2022,IMPS,00.00,"45,609.47","182,437.86"
18-Jan-2022,Cash,00.00,"91,218.93","91,218.93"
18-Jan-2022,Cash,04.10,00.00,"91,223.03"
18-Jan-2022,Miscellaneous,147.00,00.00,"91,370.03"
18-Jan-2022,Debit Card,"1,825,664.00",00.00,"1,917,034.03"
18-Jan-2022,Purchase,"9,448.68",00.00,"1,926,482.71"
18-Jan-2022,Interest,"2,016,066.00",00.00,"3,942,548.71"
18-Jan-2022,Cheque,01.00,00.00,"3,942,549.71"
18-Jan-2022,Tax,00.00,"563,221.39","3,379,328.32"
18-Jan-2022,Purchase,00.00,"675,865.66","2,703,462.66"
18-Jan-2022,Reversal,00.00,"270,346.27","2,433,116.39"
18-Jan-2022,NEFT,10.80,00.00,"2,433,127.19"
18-Jan-2022,IMPS,00.00,"405,521.20","2,027,605.99"
18-Jan-2022,Purchase,00.00,"253,450.75","1,774,155.24"
18-Jan-2022,Miscellaneous,"19,082.90",00.00,"1,793,238.14"
18-Jan-2022,Bill,02.50,00.00,"1,793,240.64"
18-Jan-2022,Cash,00.00,"896,620.32","896,620.32"
18-Jan-2022,Transfer,499.00,00.00,"897,119.32"
18-Jan-2022,Bill,02.90,00.00,"897,122.22"
18-Jan-2022,Bill,00.00,"448,561.11","448,561.11"
18-Jan-2022,ATM,00.00,"74,760.19","373,800.92"
18-Jan-2022,Tax,00.00,"93,450.23","280,350.69"
18-Jan-2022,IMPS,"6,927.71",00.00,"287,278.40"
18-Jan-2022,RTGS,00.00,"287,278.40",00.00
18-Jan-2022,Commission,"1,459,927.00",00.00,"1,459,927.00"
18-Jan-2022,Commission,51.00,00.00,"1,459,978.00"
18-Jan-2022,ATM,45.10,00.00,"1,460,023.10"
18-Jan-2022,Miscellaneous,"124,896.00",00.00,"1,584,919.10"
18-Jan-2022,Bill,08.50,00.00,"1,584,927.60"
19-Jan-2022,Interest,45.89,00.00,"1,584,973.49"
19-Jan-2022,ATM,441.00,00.00,"1,585,414.49"
19-Jan-2022,IMPS,"3,373.00",00.00,"1,588,787.49"
19-Jan-2022,Purchase,"74,609.62",00.00,"1,663,397.11"
19-Jan-2022,Cash,00.00,"554,465.70","1,108,931.41"
19-Jan-2022,Tax,"12,922.00",00.00,"1,121,853.41"
19-Jan-2022,RTGS,00.00,"373,951.14","747,902.27"
19-Jan-2022,Reversal,162.20,00.00,"748,064.47"
19-Jan-2022,Commission,00.00,"83,118.27","664,946.20"
19-Jan-2022,Cheque,00.00,"83,118.28","581,827.92"
19-Jan-2022,Miscellaneous,"2,105.16",00.00,"583,933.08"
19-Jan-2022,RTGS,122.42,00.00,"584,055.50"
19-Jan-2022,RTGS,00.00,"58,405.55","525,649.95"
19-Jan-2022,ATM,00.00,"525,649.95",00.00
19-Jan-2022,Tax,"3,474.60",00.00,"3,474.60"
19-Jan-2022,Cash,727.40,00.00,"4,202.00"
19-Jan-2022,Cheque,13.00,00.00,"4,215.00"
19-Jan-2022,Interest,177.00,00.00,"4,392.00"
19-Jan-2022,Cash,00.00,627.43,"3,764.57"
19-Jan-2022,Bill,420.20,00.00,"4,184.77"
19-Jan-2022,Commission,00.00,597.82,"3,586.95"
19-Jan-2022,Cheque,03.80,00.00,"3,590.75"
19-Jan-2022,ATM,55.56,00.00,"3,646.31"
19-Jan-2022,Transfer,00.00,455.79,"3,190.52"
19-Jan-2022,Transfer,"141,305.97",00.00,"144,496.49"
19-Jan-2022,IMPS,00.00,"36,124.12","108,372.37"
19-Jan-2022,Transfer,"5,107.00",00.00,"113,479.37"
19-Jan-2022,Cash,"175,125.88",00.00,"288,605.25"
19-Jan-2022,Purchase,00.00,"57,721.05","230,884.20"
19-Jan-2022,Cheque,"1,714,560.50",00.00,"1,945,444.70"
19-Jan-2022,Cheque,00.00,"648,481.57","1,296,963.13"
19-Jan-2022,Tax,00.00,"1,296,963.13",00.00
19-Jan-2022,RTGS,98.00,00.00,98.00
19-Jan-2022,Transfer,"164,715.00",00.00,"164,813.00"
19-Jan-2022,Cash,40.00,00.00,"164,853.00"
19-Jan-2022,Cash,"2,051,941.00",00.00,"2,216,794.00"
19-Jan-2022,Debit Card,00.00,"316,684.86","1,900,109.14"
19-Jan-2022,Debit Card,00.00,"380,021.83","1,520,087.31"
19-Jan-2022,Cash,00.00,"1,520,087.31",00.00
19-Jan-2022,Purchase,"1,905,968.00",00.00,"1,905,968.00"
19-Jan-2022,IMPS,00.00,"190,596.80","1,715,371.20"
19-Jan-2022,Cash,10.00,00.00,"1,715,381.20"
19-Jan-2022,IMPS,"56,556.16",00.00,"1,771,937.36"
19-Jan-2022,Purchase,00.00,"442,984.34","1,328,953.02"
19-Jan-2022,ATM,00.00,"147,661.45","1,181,291.57"
19-Jan-2022,IMPS,00.00,"118,129.16","1,063,162.41"
19-Jan-2022,Tax,00.00,"151,880.34","911,282.07"
19-Jan-2022,Debit Card,"4,966.60",00.00,"916,248.67"
19-Jan-2022,Cheque,07.10,00.00,"916,255.77"
19-Jan-2022,NEFT,"210,144.90",00.00,"1,126,400.67"
19-Jan-2022,Reversal,"26,828.11",00.00,"1,153,228.78"
19-Jan-2022,Commission,00.00,"384,409.59","768,819.19"
19-Jan-2022,Tax,00.00,"76,881.92","691,937.27"
19-Jan-2022,Debit Card,07.18,00.00,"691,944.45"
19-Jan-2022,Bill,00.00,"86,493.06","605,451.39"
19-Jan-2022,ATM,00.00,"60,545.14","544,906.25"
19-Jan-2022,Transfer,00.00,"90,817.71","454,088.54"
19-Jan-2022,Tax,00.00,"90,817.71","363,270.83"
19-Jan-2022,Cash,"181,029.70",00.00,"544,300.53"
19-Jan-2022,Bill,00.00,"90,716.76","453,583.78"
19-Jan-2022,Bill,00.00,"45,358.38","408,225.40"
19-Jan-2022,ATM,74.87,00.00,"408,300.27"
19-Jan-2022,Debit Card,"72,326.00",00.00,"480,626.27"
19-Jan-2022,Tax,00.00,"60,078.28","420,547.99"
19-Jan-2022,Transfer,43.00,00.00,"420,590.99"
19-Jan-2022,Reversal,00.00,"52,573.87","368,017.12"
19-Jan-2022,RTGS,00.00,"92,004.28","276,012.84"
19-Jan-2022,Bill,"584,509.00",00.00,"860,521.84"
19-Jan-2022,IMPS,09.78,00.00,"860,531.62"
19-Jan-2022,Cash,00.00,"215,132.91","645,398.72"
19-Jan-2022,RTGS,00.00,"215,132.91","430,265.81"
19-Jan-2022,Reversal,"478,728.00",00.00,"908,993.81"
19-Jan-2022,Transfer,00.00,"454,496.91","454,496.90"
19-Jan-2022,RTGS,04.00,00.00,"454,500.90"
19-Jan-2022,Miscellaneous,00.00,"75,750.15","378,750.75"
19-Jan-2022,Bill,363.00,00.00,"379,113.75"
19-Jan-2022,Tax,00.00,"189,556.88","189,556.88"
19-Jan-2022,Transfer,"98,528.56",00.00,"288,085.44"
19-Jan-2022,Transfer,00.00,"144,042.72","144,042.72"
19-Jan-2022,Debit Card,00.00,"48,014.24","96,028.48"
19-Jan-2022,NEFT,00.00,"48,014.24","48,014.24"
19-Jan-2022,ATM,01.54,00.00,"48,015.78"
19-Jan-2022,Commission,18.00,00.00,"48,033.78"
19-Jan-2022,Tax,"102,405.00",00.00,"150,438.78"
19-Jan-2022,IMPS,51.18,00.00,"150,489.96"
19-Jan-2022,Cash,00.00,"150,489.96",00.00
19-Jan-2022,Purchase,301.60,00.00,301.60
19-Jan-2022,Cash,00.00,301.60,00.00
19-Jan-2022,Cash,11.00,00.00,11.00
19-Jan-2022,Debit Card,549.00,00.00,560.00
19-Jan-2022,Cash,00.00,62.22,497.78
19-Jan-2022,NEFT,486.19,00.00,983.97
19-Jan-2022,Bill,00.00,491.99,491.98
19-Jan-2022,ATM,00.00,98.40,393.58
19-Jan-2022,Miscellaneous,00.00,78.72,314.86
19-Jan-2022,RTGS,62.73,00.00,377.59
19-Jan-2022,Debit Card,463.10,00.00,840.69
19-Jan-2022,Purchase,00.00,840.69,00.00
19-Jan-2022,IMPS,380.00,00.00,380.00
20-Jan-2022,Reversal,00.00,38.00,342.00
20-Jan-2022,Interest,00.00,57.00,285.00
20-Jan-2022,Cash,"2,005,382.50",00.00,"2,005,667.50"
20-Jan-2022,Cash,52.10,00.00,"2,005,719.60"
20-Jan-2022,Bill,47.90,00.00,"2,005,767.50"
20-Jan-2022,Cash,02.40,00.00,"2,005,769.90"
20-Jan-2022,Transfer,"17,428.20",00.00,"2,023,198.10"
20-Jan-2022,RTGS,00.00,"252,899.76","1,770,298.34"
20-Jan-2022,RTGS,00.00,"885,149.17","885,149.17"
20-Jan-2022,RTGS,00.00,"177,029.83","708,119.34"
20-Jan-2022,Cheque,"48,363.56",00.00,"756,482.90"
20-Jan-2022,Cash,"294,164.00",00.00,"1,050,646.90"
20-Jan-2022,IMPS,"1,076.00",00.00,"1,051,722.90"
20-Jan-2022,Purchase,276.00,00.00,"1,051,998.90"
20-Jan-2022,NEFT,00.00,"350,666.30","701,332.60"
20-Jan-2022,Commission,"3,301.11",00.00,"704,633.71"
20-Jan-2022,Transfer,"8,416.00",00.00,"713,049.71"
20-Jan-2022,Tax,06.84,00.00,"713,056.55"
20-Jan-2022,Interest,07.85,00.00,"713,064.40"
20-Jan-2022,Tax,00.00,"713,064.40",00.00
20-Jan-2022,Cash,"22,681.19",00.00,"22,681.19"
20-Jan-2022,Transfer,365.00,00.00,"23,046.19"
20-Jan-2022,Cash,"389,453.50",00.00,"412,499.69"
20-Jan-2022,Interest,00.00,"137,499.90","274,999.79"
20-Jan-2022,Transfer,"25,543.00",00.00,"300,542.79"
20-Jan-2022,Cash,"194,473.00",00.00,"495,015.79"
20-Jan-2022,Miscellaneous,"118,225.10",00.00,"613,240.89"
20-Jan-2022,Debit Card,"854,368.20",00.00,"1,467,609.09"
20-Jan-2022,Interest,04.00,00.00,"1,467,613.09"
20-Jan-2022,Bill,"168,643.70",00.00,"1,636,256.79"
20-Jan-2022,Interest,"17,949.60",00.00,"1,654,206.39"
20-Jan-2022,Commission,00.00,"275,701.07","1,378,505.32"
20-Jan-2022,Transfer,00.00,"196,929.33","1,181,575.99"
20-Jan-2022,Debit Card,00.00,"236,315.20","945,260.79"
20-Jan-2022,Interest,60.81,00.00,"945,321.60"
20-Jan-2022,Miscellaneous,"778,054.00",00.00,"1,723,375.60"
20-Jan-2022,Purchase,00.00,"574,458.53","1,148,917.07"
20-Jan-2022,Cash,"39,604.47",00.00,"1,188,521.54"
20-Jan-2022,Interest,171.75,00.00,"1,188,693.29"
20-Jan-2022,Interest,00.00,"198,115.55","990,577.74"
20-Jan-2022,Commission,180.90,00.00,"990,758.64"
20-Jan-2022,RTGS,00.00,"165,126.44","825,632.20"
20-Jan-2022,ATM,"22,006.60",00.00,"847,638.80"
21-Jan-2022,Bill,00.00,"211,909.70","635,729.10"
21-Jan-2022,Cash,00.00,"70,636.57","565,092.53"
21-Jan-2022,Purchase,"212,725.00",00.00,"777,817.53"
21-Jan-2022,NEFT,"3,191.53",00.00,"781,009.06"
22-Jan-2022,Commission,08.14,00.00,"781,017.20"
22-Jan-2022,Bill,"158,459.12",00.00,"939,476.32"
22-Jan-2022,NEFT,"231,795.59",00.00,"1,171,271.91"
22-Jan-2022,Commission,45.30,00.00,"1,171,317.21"
22-Jan-2022,Commission,00.00,"130,146.36","1,041,170.85"
22-Jan-2022,Miscellaneous,"2,737.60",00.00,"1,043,908.45"
22-Jan-2022,Purchase,"2,416.70",00.00,"1,046,325.15"
23-Jan-2022,IMPS,00.00,"261,581.29","784,743.86"
23-Jan-2022,Debit Card,00.00,"112,106.27","672,637.59"
23-Jan-2022,Tax,"8,032.00",00.00,"680,669.59"
23-Jan-2022,Interest,259.34,00.00,"680,928.93"
23-Jan-2022,Debit Card,474.68,00.00,"681,403.61"
23-Jan-2022,Purchase,00.00,"68,140.36","613,263.25"
23-Jan-2022,ATM,00.00,"61,326.33","551,936.93"
23-Jan-2022,NEFT,"1,336,118.00",00.00,"1,888,054.93"
23-Jan-2022,NEFT,"211,479.00",00.00,"2,099,533.93"
23-Jan-2022,RTGS,00.00,"349,922.32","1,749,611.61"
23-Jan-2022,Interest,"667,333.00",00.00,"2,416,944.61"
23-Jan-2022,ATM,00.00,"302,118.08","2,114,826.53"
23-Jan-2022,ATM,00.00,"2,114,826.53",00.00
23-Jan-2022,Reversal,"2,864.00",00.00,"2,864.00"
23-Jan-2022,RTGS,00.00,716.00,"2,148.00"
23-Jan-2022,Tax,231.00,00.00,"2,379.00"
23-Jan-2022,Purchase,52.00,00.00,"2,431.00"
23-Jan-2022,Purchase,"180,664.00",00.00,"183,095.00"
23-Jan-2022,RTGS,00.00,"91,547.50","91,547.50"
23-Jan-2022,IMPS,12.00,00.00,"91,559.50"
23-Jan-2022,Debit Card,"3,376.02",00.00,"94,935.52"
23-Jan-2022,Cash,00.00,"18,987.10","75,948.42"
23-Jan-2022,Cheque,00.00,"7,594.84","68,353.58"
23-Jan-2022,Transfer,"1,497,281.80",00.00,"1,565,635.38"
23-Jan-2022,Miscellaneous,00.00,"313,127.08","1,252,508.30"
24-Jan-2022,Cash,00.00,00.00,"1,252,508.30"
24-Jan-2022,Debit Card,00.00,"626,254.15","626,254.15"
25-Jan-2022,Transfer,00.00,"89,464.88","536,789.27"
25-Jan-2022,IMPS,00.00,"53,678.93","483,110.34"
25-Jan-2022,Interest,00.00,"53,678.93","429,431.41"
25-Jan-2022,Reversal,05.76,00.00,"429,437.17"
25-Jan-2022,Interest,00.00,"47,715.24","381,721.93"
25-Jan-2022,Bill,00.00,"76,344.39","305,377.54"
25-Jan-2022,RTGS,"25,150.21",00.00,"330,527.75"
25-Jan-2022,Transfer,00.00,"82,631.94","247,895.81"
25-Jan-2022,IMPS,00.00,"123,947.91","123,947.90"
25-Jan-2022,Purchase,"20,285.00",00.00,"144,232.90"
25-Jan-2022,Reversal,56.00,00.00,"144,288.90"
25-Jan-2022,Interest,00.00,"72,144.45","72,144.45"
25-Jan-2022,Interest,"1,333,325.75",00.00,"1,405,470.20"
25-Jan-2022,Commission,00.00,"200,781.46","1,204,688.74"
25-Jan-2022,ATM,04.02,00.00,"1,204,692.76"
25-Jan-2022,Interest,00.00,"200,782.13","1,003,910.63"
26-Jan-2022,Interest,"37,752.09",00.00,"1,041,662.72"
26-Jan-2022,Bill,09.47,00.00,"1,041,672.19"
26-Jan-2022,Miscellaneous,00.00,"173,612.03","868,060.16"
26-Jan-2022,Transfer,"16,744.00",00.00,"884,804.16"
27-Jan-2022,Miscellaneous,"30,895.30",00.00,"915,699.46"
27-Jan-2022,Transfer,469.33,00.00,"916,168.79"
27-Jan-2022,Purchase,00.00,"91,616.88","824,551.91"
27-Jan-2022,ATM,00.00,"412,275.96","412,275.96"
27-Jan-2022,Commission,49.30,00.00,"412,325.26"
27-Jan-2022,Tax,00.00,"206,162.63","206,162.63"
27-Jan-2022,RTGS,00.00,"51,540.66","154,621.97"
27-Jan-2022,Debit Card,"2,847.47",00.00,"157,469.44"
27-Jan-2022,Tax,"4,080.93",00.00,"161,550.37"
27-Jan-2022,Cheque,"3,398.99",00.00,"164,949.36"
27-Jan-2022,RTGS,"45,855.90",00.00,"210,805.26"
27-Jan-2022,Cash,00.00,"26,350.66","184,454.60"
27-Jan-2022,Purchase,"3,535.90",00.00,"187,990.50"
27-Jan-2022,ATM,00.00,"37,598.10","150,392.40"
27-Jan-2022,Debit Card,00.00,"18,799.05","131,593.35"
27-Jan-2022,Commission,00.00,"21,932.23","109,661.12"
27-Jan-2022,Cash,"514,655.80",00.00,"624,316.92"
27-Jan-2022,Transfer,"19,178.70",00.00,"643,495.62"
27-Jan-2022,IMPS,00.00,"160,873.91","482,621.72"
27-Jan-2022,Interest,00.00,"482,621.72",00.00
27-Jan-2022,Miscellaneous,"2,126.79",00.00,"2,126.79"
27-Jan-2022,Reversal,17.72,00.00,"2,144.51"
28-Jan-2022,Miscellaneous,"3,490.60",00.00,"5,635.11"
28-Jan-2022,Transfer,00.00,563.51,"5,071.60"
28-Jan-2022,Reversal,00.00,"1,267.90","3,803.70"
28-Jan-2022,Debit Card,00.00,475.46,"3,328.24"
28-Jan-2022,Interest,00.88,00.00,"3,329.12"
28-Jan-2022,Reversal,00.00,"1,664.56","1,664.56"
28-Jan-2022,RTGS,00.00,416.14,"1,248.42"
28-Jan-2022,Bill,"3,489.00",00.00,"4,737.42"
28-Jan-2022,Miscellaneous,00.00,676.77,"4,060.65"
28-Jan-2022,Transfer,"27,145.00",00.00,"31,205.65"
28-Jan-2022,Cheque,00.00,"7,801.41","23,404.24"
28-Jan-2022,Miscellaneous,00.00,"11,702.12","11,702.12"
28-Jan-2022,RTGS,00.00,"5,851.06","5,851.06"
28-Jan-2022,Tax,00.00,"1,950.35","3,900.71"
28-Jan-2022,Interest,"11,795.80",00.00,"15,696.51"
28-Jan-2022,RTGS,06.60,00.00,"15,703.11"
28-Jan-2022,Tax,00.00,"2,243.30","13,459.81"
28-Jan-2022,NEFT,00.00,"6,729.91","6,729.90"
28-Jan-2022,Cash,"1,673.50",00.00,"8,403.40"
28-Jan-2022,IMPS,"1,712.00",00.00,"10,115.40"
28-Jan-2022,Tax,03.20,00.00,"10,118.60"
28-Jan-2022,Debit Card,00.00,"10,118.60",00.00
28-Jan-2022,Bill,"82,109.00",00.00,"82,109.00"
28-Jan-2022,Cheque,238.54,00.00,"82,347.54"
28-Jan-2022,Commission,160.00,00.00,"82,507.54"
28-Jan-2022,Purchase,00.40,00.00,"82,507.94"
28-Jan-2022,ATM,"30,549.90",00.00,"113,057.84"
28-Jan-2022,NEFT,00.00,"56,528.92","56,528.92"
28-Jan-2022,Purchase,989.40,00.00,"57,518.32"
28-Jan-2022,Tax,826.80,00.00,"58,345.12"
28-Jan-2022,IMPS,00.00,"19,448.37","38,896.75"
29-Jan-2022,Reversal,"170,493.06",00.00,"209,389.81"
29-Jan-2022,Cash,00.00,"29,912.83","179,476.98"
29-Jan-2022,Interest,00.00,"17,947.70","161,529.28"
29-Jan-2022,IMPS,00.00,"23,075.61","138,453.67"
29-Jan-2022,Transfer,"246,680.44",00.00,"385,134.11"
29-Jan-2022,Commission,"37,612.40",00.00,"422,746.51"
29-Jan-2022,Reversal,06.50,00.00,"422,753.01"
30-Jan-2022,Debit Card,00.00,"140,917.67","281,835.34"
30-Jan-2022,Miscellaneous,00.00,"28,183.53","253,651.81"
30-Jan-2022,RTGS,52.00,00.00,"253,703.81"
30-Jan-2022,ATM,"2,453.50",00.00,"256,157.31"
30-Jan-2022,Commission,00.00,"42,692.89","213,464.42"
30-Jan-2022,Debit Card,00.00,"23,718.27","189,746.15"
30-Jan-2022,Debit Card,"3,559.00",00.00,"193,305.15"
30-Jan-2022,Tax,00.00,"96,652.58","96,652.58"
30-Jan-2022,Commission,00.00,"12,081.57","84,571.01"
30-Jan-2022,Cash,00.00,"14,095.17","70,475.84"
30-Jan-2022,Tax,61.63,00.00,"70,537.47"
30-Jan-2022,IMPS,422.00,00.00,"70,959.47"
30-Jan-2022,Commission,"2,870.00",00.00,"73,829.47"
30-Jan-2022,Purchase,"5,457.74",00.00,"79,287.21"
30-Jan-2022,Interest,"901,167.25",00.00,"980,454.46"
30-Jan-2022,Cheque,00.00,"108,939.38","871,515.08"
30-Jan-2022,Cheque,00.00,"108,939.39","762,575.70"
30-Jan-2022,Tax,00.00,"190,643.93","571,931.77"
30-Jan-2022,Purchase,998.47,00.00,"572,930.24"
30-Jan-2022,Reversal,00.00,"63,658.92","509,271.32"
30-Jan-2022,Miscellaneous,00.00,"72,753.05","436,518.27"
30-Jan-2022,Cheque,18.00,00.00,"436,536.27"
30-Jan-2022,Reversal,01.00,00.00,"436,537.27"
30-Jan-2022,RTGS,00.00,"72,756.21","363,781.06"
30-Jan-2022,ATM,00.00,"181,890.53","181,890.53"
30-Jan-2022,Cash,00.00,"36,378.11","145,512.42"
30-Jan-2022,Cheque,"133,720.00",00.00,"279,232.42"
30-Jan-2022,Commission,"36,346.00",00.00,"315,578.42"
31-Jan-2022,Miscellaneous,00.00,"157,789.21","157,789.21"
31-Jan-2022,ATM,"30,744.40",00.00,"188,533.61"
31-Jan-2022,Debit Card,00.00,"47,133.40","141,400.21"
31-Jan-2022,RTGS,"1,479.07",00.00,"142,879.28"
31-Jan-2022,Purchase,00.00,"28,575.86","114,303.42"
01-Feb-2022,RTGS,00.00,"38,101.14","76,202.28"
01-Feb-2022,RTGS,45.90,00.00,"76,248.18"
01-Feb-2022,IMPS,00.00,"76,248.18",00.00
01-Feb-2022,Interest,37.57,00.00,37.57
01-Feb-2022,IMPS,00.00,18.79,18.78
01-Feb-2022,IMPS,00.00,01.88,16.90
01-Feb-2022,Miscellaneous,00.00,02.41,14.49
01-Feb-2022,Interest,208.40,00.00,222.89
01-Feb-2022,Debit Card,793.00,00.00,"1,015.89"
01-Feb-2022,ATM,00.00,169.32,846.58
01-Feb-2022,Transfer,00.00,84.66,761.92
01-Feb-2022,Interest,318.82,00.00,"1,080.74"
01-Feb-2022,IMPS,"3,271.10",00.00,"4,351.84"
01-Feb-2022,Purchase,00.00,"4,351.84",00.00
01-Feb-2022,Miscellaneous,"1,707,793.00",00.00,"1,707,793.00"
01-Feb-2022,Bill,57.00,00.00,"1,707,850.00"
01-Feb-2022,Commission,00.00,"569,283.33","1,138,566.67"
01-Feb-2022,Miscellaneous,164.00,00.00,"1,138,730.67"
01-Feb-2022,RTGS,00.00,"162,675.81","976,054.86"
01-Feb-2022,IMPS,00.00,"325,351.62","650,703.24"
01-Feb-2022,NEFT,"10,133.50",00.00,"660,836.74"
01-Feb-2022,Cheque,"176,317.70",00.00,"837,154.44"
01-Feb-2022,Reversal,00.00,"104,644.31","732,510.14"
01-Feb-2022,Cash,08.00,00.00,"732,518.14"
01-Feb-2022,Cheque,"2,232.30",00.00,"734,750.44"
01-Feb-2022,Tax,"3,252.47",00.00,"738,002.91"
01-Feb-2022,Commission,06.54,00.00,"738,009.45"
01-Feb-2022,IMPS,347.79,00.00,"738,357.24"
01-Feb-2022,Cash,00.00,"147,671.45","590,685.79"
01-Feb-2022,RTGS,"2,011.29",00.00,"592,697.08"
01-Feb-2022,IMPS,00.00,"98,782.85","493,914.23"
01-Feb-2022,Cash,"2,922.10",00.00,"496,836.33"
01-Feb-2022,Miscellaneous,"1,570.97",00.00,"498,407.30"
01-Feb-2022,Purchase,"38,746.78",00.00,"537,154.08"
01-Feb-2022,Debit Card,07.90,00.00,"537,161.98"
01-Feb-2022,Commission,427.51,00.00,"537,589.49"
01-Feb-2022,NEFT,"1,337,354.00",00.00,"1,874,943.49"
01-Feb-2022,Tax,"59,447.20",00.00,"1,934,390.69"
01-Feb-2022,ATM,"719,155.00",00.00,"2,653,545.69"
01-Feb-2022,IMPS,311.30,00.00,"2,653,856.99"
01-Feb-2022,RTGS,"813,508.50",00.00,"3,467,365.49"
01-Feb-2022,Cheque,"25,180.90",00.00,"3,492,546.39"
01-Feb-2022,Transfer,00.00,"1,746,273.20","1,746,273.20"
01-Feb-2022,Reversal,"30,296.90",00.00,"1,776,570.10"
01-Feb-2022,Bill,495.45,00.00,"1,777,065.55"
01-Feb-2022,Tax,"29,213.49",00.00,"1,806,279.04"
01-Feb-2022,Purchase,"209,885.00",00.00,"2,016,164.04"
01-Feb-2022,Transfer,00.00,"336,027.34","1,680,136.70"
01-Feb-2022,ATM,00.00,"336,027.34","1,344,109.36"
01-Feb-2022,Reversal,"1,199.00",00.00,"1,345,308.36"
01-Feb-2022,Debit Card,"11,617.00",00.00,"1,356,925.36"
01-Feb-2022,ATM,00.00,"339,231.34","1,017,694.02"
01-Feb-2022,Bill,07.72,00.00,"1,017,701.74"
01-Feb-2022,Commission,382.50,00.00,"1,018,084.24"
01-Feb-2022,Interest,00.00,"145,440.61","872,643.63"
01-Feb-2022,Bill,00.00,"174,528.73","698,114.90"
01-Feb-2022,Interest,00.00,"116,352.48","581,762.42"
01-Feb-2022,Transfer,"2,487.80",00.00,"584,250.22"
01-Feb-2022,Purchase,00.00,"292,125.11","292,125.11"
01-Feb-2022,Cash,"249,656.72",00.00,"541,781.83"
01-Feb-2022,Cash,00.00,"135,445.46","406,336.37"
01-Feb-2022,Tax,19.50,00.00,"406,355.87"
01-Feb-2022,Cash,695.00,00.00,"407,050.87"
01-Feb-2022,RTGS,"223,431.10",00.00,"630,481.97"
01-Feb-2022,Miscellaneous,822.14,00.00,"631,304.11"
01-Feb-2022,Purchase,"3,478.00",00.00,"634,782.11"
01-Feb-2022,IMPS,00.00,"317,391.06","317,391.06"
01-Feb-2022,Bill,00.00,"52,898.51","264,492.55"
01-Feb-2022,Tax,00.00,"132,246.28","132,246.28"
01-Feb-2022,Cheque,00.00,"33,061.57","99,184.71"
01-Feb-2022,NEFT,00.00,"49,592.36","49,592.36"
01-Feb-2022,NEFT,00.00,"16,530.79","33,061.57"
01-Feb-2022,Debit Card,00.00,"3,306.16","29,755.41"
01-Feb-2022,Transfer,00.00,"5,951.08","23,804.33"
01-Feb-2022,Debit Card,00.00,"7,934.78","15,869.55"
02-Feb-2022,Cheque,00.00,"3,967.39","11,902.16"
02-Feb-2022,Cheque,00.00,"1,983.69","9,918.47"
02-Feb-2022,Transfer,07.00,00.00,"9,925.47"
02-Feb-2022,Tax,"1,087,169.00",00.00,"1,097,094.47"
02-Feb-2022,Miscellaneous,00.00,"274,273.62","822,820.85"
02-Feb-2022,Bill,00.00,"137,136.81","685,684.04"
03-Feb-2022,Cheque,"238,679.30",00.00,"924,363.34"
03-Feb-2022,Bill,"159,138.00",00.00,"1,083,501.34"
03-Feb-2022,ATM,00.00,"120,389.04","963,112.30"
03-Feb-2022,Interest,00.00,"96,311.23","866,801.07"
03-Feb-2022,Miscellaneous,00.00,"866,801.07",00.00
03-Feb-2022,Interest,"19,703.00",00.00,"19,703.00"
03-Feb-2022,Purchase,00.00,"4,925.75","14,777.25"
03-Feb-2022,Cheque,155.00,00.00,"14,932.25"
03-Feb-2022,Interest,00.00,"4,977.42","9,954.83"
04-Feb-2022,Commission,00.00,"1,244.35","8,710.48"
04-Feb-2022,Reversal,00.00,"1,088.81","7,621.67"
04-Feb-2022,Miscellaneous,"602,659.50",00.00,"610,281.17"
04-Feb-2022,IMPS,279.00,00.00,"610,560.17"
04-Feb-2022,ATM,"166,710.00",00.00,"777,270.17"
04-Feb-2022,RTGS,00.00,"129,545.03","647,725.14"
04-Feb-2022,Cash,00.00,"129,545.03","518,180.11"
04-Feb-2022,Debit Card,00.00,"86,363.35","431,816.76"
04-Feb-2022,Commission,00.00,"215,908.38","215,908.38"
04-Feb-2022,Transfer,00.00,"21,590.84","194,317.54"
04-Feb-2022,NEFT,24.00,00.00,"194,341.54"
04-Feb-2022,Debit Card,"87,273.00",00.00,"281,614.54"
04-Feb-2022,Miscellaneous,00.00,"40,230.65","241,383.89"
04-Feb-2022,Cash,00.00,"40,230.65","201,153.24"
04-Feb-2022,Reversal,"2,249.20",00.00,"203,402.44"
04-Feb-2022,Interest,00.00,"67,800.81","135,601.63"
04-Feb-2022,ATM,61.00,00.00,"135,662.63"
04-Feb-2022,Miscellaneous,"1,400,938.00",00.00,"1,536,600.63"
04-Feb-2022,Cash,"132,921.94",00.00,"1,669,522.57"
04-Feb-2022,NEFT,04.48,00.00,"1,669,527.05"
04-Feb-2022,Miscellaneous,"2,939.30",00.00,"1,672,466.35"
04-Feb-2022,ATM,686.18,00.00,"1,673,152.53"
04-Feb-2022,Interest,00.00,"278,858.76","1,394,293.78"
04-Feb-2022,NEFT,"1,937,234.25",00.00,"3,331,528.03"
04-Feb-2022,Tax,00.00,"1,665,764.02","1,665,764.02"
04-Feb-2022,Debit Card,193.00,00.00,"1,665,957.02"
04-Feb-2022,Purchase,590.00,00.00,"1,666,547.02"
04-Feb-2022,Debit Card,"95,319.00",00.00,"1,761,866.02"
04-Feb-2022,Tax,"16,667.20",00.00,"1,778,533.22"
04-Feb-2022,Transfer,00.00,"355,706.64","1,422,826.58"
04-Feb-2022,Reversal,"132,532.00",00.00,"1,555,358.58"
04-Feb-2022,Tax,00.00,"311,071.72","1,244,286.86"
04-Feb-2022,NEFT,02.37,00.00,"1,244,289.23"
04-Feb-2022,Cash,00.00,"155,536.15","1,088,753.08"
04-Feb-2022,Commission,00.00,"1,088,753.08",00.00
04-Feb-2022,IMPS,"2,019,675.00",00.00,"2,019,675.00"
04-Feb-2022,Tax,01.00,00.00,"2,019,676.00"
04-Feb-2022,ATM,00.00,"288,525.14","1,731,150.86"
04-Feb-2022,Transfer,00.00,"216,393.86","1,514,757.00"
04-Feb-2022,Debit Card,00.00,"1,514,757.00",00.00
04-Feb-2022,Debit Card,"2,002,768.00",00.00,"2,002,768.00"
04-Feb-2022,Tax,"202,927.47",00.00,"2,205,695.47"
04-Feb-2022,Reversal,00.00,"1,102,847.74","1,102,847.74"
04-Feb-2022,Tax,"252,545.25",00.00,"1,355,392.99"
04-Feb-2022,Commission,00.00,"150,599.22","1,204,793.77"
04-Feb-2022,RTGS,"1,040,686.75",00.00,"2,245,480.52"
04-Feb-2022,Cash,00.00,"2,245,480.52",00.00
04-Feb-2022,Cheque,"13,280.53",00.00,"13,280.53"
04-Feb-2022,Reversal,05.00,00.00,"13,285.53"
05-Feb-2022,IMPS,312.09,00.00,"13,597.62"
06-Feb-2022,RTGS,00.00,"1,942.52","11,655.10"
06-Feb-2022,ATM,00.00,"1,295.01","10,360.09"
06-Feb-2022,ATM,"38,862.00",00.00,"49,222.09"
06-Feb-2022,Bill,45.40,00.00,"49,267.49"
06-Feb-2022,RTGS,00.00,"49,267.49",00.00
06-Feb-2022,ATM,"2,704.00",00.00,"2,704.00"
06-Feb-2022,Cheque,"3,431.40",00.00,"6,135.40"
06-Feb-2022,Interest,00.00,766.93,"5,368.48"
06-Feb-2022,Tax,00.00,"2,684.24","2,684.24"
06-Feb-2022,ATM,207.80,00.00,"2,892.04"
06-Feb-2022,ATM,00.00,289.20,"2,602.84"
06-Feb-2022,Commission,"1,595.11",00.00,"4,197.95"
06-Feb-2022,Commission,00.00,419.80,"3,778.16"
06-Feb-2022,Purchase,00.00,"3,778.16",00.00
06-Feb-2022,Interest,"1,357,874.00",00.00,"1,357,874.00"
06-Feb-2022,Commission,410.10,00.00,"1,358,284.10"
06-Feb-2022,Interest,"666,836.00",00.00,"2,025,120.10"
06-Feb-2022,Cash,157.31,00.00,"2,025,277.41"
06-Feb-2022,Cash,01.00,00.00,"2,025,278.41"
06-Feb-2022,Cash,440.80,00.00,"2,025,719.21"
06-Feb-2022,RTGS,00.00,"2,025,719.21",00.00
06-Feb-2022,ATM,"19,878.78",00.00,"19,878.78"
06-Feb-2022,ATM,00.00,"9,939.39","9,939.39"
06-Feb-2022,Cash,"211,090.00",00.00,"221,029.39"
06-Feb-2022,ATM,466.71,00.00,"221,496.10"
06-Feb-2022,RTGS,00.00,"55,374.03","166,122.08"
06-Feb-2022,Interest,00.00,"55,374.03","110,748.05"
06-Feb-2022,Debit Card,00.00,"15,821.15","94,926.90"
06-Feb-2022,Purchase,00.00,"94,926.90",00.00
06-Feb-2022,Interest,287.10,00.00,287.10
06-Feb-2022,Reversal,00.00,71.78,215.32
07-Feb-2022,Miscellaneous,00.00,21.53,193.79
07-Feb-2022,Miscellaneous,06.00,00.00,199.79
07-Feb-2022,Purchase,00.00,39.96,159.83
07-Feb-2022,ATM,"146,889.00",00.00,"147,048.83"
07-Feb-2022,Commission,371.03,00.00,"147,419.86"
07-Feb-2022,Cash,"205,487.30",00.00,"352,907.16"
07-Feb-2022,Tax,00.00,"176,453.58","176,453.58"
07-Feb-2022,RTGS,00.00,"44,113.40","132,340.18"
07-Feb-2022,Commission,321.20,00.00,"132,661.38"
07-Feb-2022,Reversal,"3,321.00",00.00,"135,982.38"
07-Feb-2022,Reversal,00.00,"13,598.24","122,384.14"
08-Feb-2022,ATM,00.10,00.00,"122,384.24"
08-Feb-2022,Purchase,00.00,"122,384.24",00.00
08-Feb-2022,Interest,02.47,00.00,02.47
08-Feb-2022,Debit Card,"2,829.00",00.00,"2,831.47"
09-Feb-2022,Transfer,00.00,471.91,"2,359.56"
09-Feb-2022,Commission,00.00,393.26,"1,966.30"
09-Feb-2022,Cash,"1,934,891.50",00.00,"1,936,857.80"
09-Feb-2022,ATM,"10,754.20",00.00,"1,947,612.00"
09-Feb-2022,NEFT,"2,535.00",00.00,"1,950,147.00"
09-Feb-2022,Commission,"29,306.40",00.00,"1,979,453.40"
09-Feb-2022,Purchase,00.00,00.00,"1,979,453.40"
09-Feb-2022,ATM,00.00,"494,863.35","1,484,590.05"
09-Feb-2022,Tax,"2,452.50",00.00,"1,487,042.55"
09-Feb-2022,Miscellaneous,49.84,00.00,"1,487,092.39"
09-Feb-2022,Transfer,"3,299.00",00.00,"1,490,391.39"
09-Feb-2022,ATM,"12,151.00",00.00,"1,502,542.39"
09-Feb-2022,Cash,42.74,00.00,"1,502,585.13"
09-Feb-2022,ATM,00.00,"150,258.51","1,352,326.62"
10-Feb-2022,Miscellaneous,03.80,00.00,"1,352,330.42"
10-Feb-2022,Cash,00.00,"225,388.40","1,126,942.02"
10-Feb-2022,Transfer,00.00,"225,388.40","901,553.62"
10-Feb-2022,Purchase,00.00,"225,388.41","676,165.22"
10-Feb-2022,Purchase,00.00,"112,694.20","563,471.02"
10-Feb-2022,Transfer,315.00,00.00,"563,786.02"
10-Feb-2022,Bill,00.00,"70,473.25","493,312.77"
10-Feb-2022,Bill,00.00,"49,331.28","443,981.49"
10-Feb-2022,IMPS,00.00,"73,996.92","369,984.58"
10-Feb-2022,Cash,06.70,00.00,"369,991.28"
10-Feb-2022,Tax,00.00,"92,497.82","277,493.46"
10-Feb-2022,Transfer,00.00,"30,832.61","246,660.85"
10-Feb-2022,Miscellaneous,00.00,"27,406.76","219,254.09"
10-Feb-2022,Miscellaneous,00.00,"27,406.76","191,847.33"
10-Feb-2022,NEFT,04.00,00.00,"191,851.33"
10-Feb-2022,Debit Card,26.90,00.00,"191,878.23"
10-Feb-2022,Cash,"1,673.30",00.00,"193,551.53"
10-Feb-2022,Debit Card,00.00,"96,775.77","96,775.76"
10-Feb-2022,Interest,00.00,"13,825.11","82,950.65"
10-Feb-2022,ATM,"1,868,605.80",00.00,"1,951,556.45"
10-Feb-2022,Bill,00.00,"325,259.41","1,626,297.04"
10-Feb-2022,Purchase,00.00,"203,287.13","1,423,009.91"
10-Feb-2022,Transfer,00.00,"711,504.96","711,504.96"
10-Feb-2022,ATM,00.00,"118,584.16","592,920.80"
10-Feb-2022,Cheque,00.00,"148,230.20","444,690.60"
10-Feb-2022,Commission,00.00,"63,527.23","381,163.37"
10-Feb-2022,IMPS,497.12,00.00,"381,660.49"
10-Feb-2022,Cheque,00.00,"76,332.10","305,328.39"
10-Feb-2022,Cheque,"27,344.40",00.00,"332,672.79"
10-Feb-2022,Tax,"11,113.00",00.00,"343,785.79"
10-Feb-2022,Tax,"1,918,019.00",00.00,"2,261,804.79"
10-Feb-2022,Cash,00.00,"226,180.48","2,035,624.31"
10-Feb-2022,RTGS,00.00,"203,562.43","1,832,061.88"
10-Feb-2022,Miscellaneous,00.00,"229,007.74","1,603,054.14"
10-Feb-2022,Transfer,00.00,"534,351.38","1,068,702.76"
10-Feb-2022,Reversal,00.00,"133,587.85","935,114.92"
10-Feb-2022,Cheque,"1,679,151.50",00.00,"2,614,266.42"
10-Feb-2022,Cash,00.00,"435,711.07","2,178,555.35"
10-Feb-2022,NEFT,00.00,"544,638.84","1,633,916.51"
10-Feb-2022,Tax,01.41,00.00,"1,633,917.92"
10-Feb-2022,Cheque,00.00,"816,958.96","816,958.96"
11-Feb-2022,Debit Card,00.00,"81,695.90","735,263.06"
11-Feb-2022,RTGS,00.00,"91,907.88","643,355.18"
11-Feb-2022,ATM,00.00,"321,677.59","321,677.59"
11-Feb-2022,Tax,00.00,"32,167.76","289,509.83"
12-Feb-2022,Transfer,00.00,"57,901.97","231,607.86"
12-Feb-2022,IMPS,"51,141.88",00.00,"282,749.74"
12-Feb-2022,ATM,"525,955.00",00.00,"808,704.74"
12-Feb-2022,RTGS,00.00,"80,870.47","727,834.27"
12-Feb-2022,IMPS,"60,387.00",00.00,"788,221.27"
12-Feb-2022,Interest,"3,186.40",00.00,"791,407.67"
12-Feb-2022,Tax,"14,529.00",00.00,"805,936.67"
12-Feb-2022,Debit Card,248.00,00.00,"806,184.67"
12-Feb-2022,Debit Card,"13,118.93",00.00,"819,303.60"
12-Feb-2022,IMPS,35.60,00.00,"819,339.20"
12-Feb-2022,NEFT,00.00,"136,556.53","682,782.67"
12-Feb-2022,Tax,00.00,"75,864.74","606,917.93"
12-Feb-2022,Reversal,00.00,"75,864.74","531,053.19"
12-Feb-2022,Miscellaneous,00.00,"531,053.19",00.00
12-Feb-2022,RTGS,"1,159,643.80",00.00,"1,159,643.80"
12-Feb-2022,Cheque,00.00,"1,159,643.80",00.00
12-Feb-2022,Bill,05.00,00.00,05.00
12-Feb-2022,Debit Card,00.00,00.63,04.38
12-Feb-2022,Purchase,"2,129.00",00.00,"2,133.38"
12-Feb-2022,Commission,00.00,711.13,"1,422.25"
12-Feb-2022,Transfer,00.00,158.03,"1,264.22"
12-Feb-2022,Tax,"15,133.00",00.00,"16,397.22"
12-Feb-2022,Interest,00.00,"2,342.46","14,054.76"
12-Feb-2022,NEFT,862.30,00.00,"14,917.06"
12-Feb-2022,RTGS,00.00,"2,486.18","12,430.88"
12-Feb-2022,Miscellaneous,759.00,00.00,"13,189.88"
13-Feb-2022,Reversal,57.68,00.00,"13,247.56"
13-Feb-2022,NEFT,00.00,"4,415.85","8,831.71"
13-Feb-2022,Bill,00.00,"4,415.86","4,415.85"
13-Feb-2022,Bill,825.10,00.00,"5,240.95"
13-Feb-2022,Transfer,00.00,"1,746.98","3,493.97"
13-Feb-2022,Interest,500.00,00.00,"3,993.97"
13-Feb-2022,Transfer,00.00,399.40,"3,594.57"
13-Feb-2022,Transfer,"1,654,791.00",00.00,"1,658,385.57"
13-Feb-2022,Purchase,03.00,00.00,"1,658,388.57"
13-Feb-2022,Commission,"24,781.00",00.00,"1,683,169.57"
13-Feb-2022,Purchase,"1,310,128.25",00.00,"2,993,297.82"
13-Feb-2022,Tax,44.00,00.00,"2,993,341.82"
13-Feb-2022,Cheque,00.00,00.00,"2,993,341.82"
13-Feb-2022,Interest,00.00,"2,993,341.82",00.00
13-Feb-2022,Commission,"31,181.00",00.00,"31,181.00"
13-Feb-2022,Miscellaneous,00.00,"5,196.83","25,984.17"
13-Feb-2022,Interest,300.00,00.00,"26,284.17"
13-Feb-2022,ATM,00.00,"8,761.39","17,522.78"
13-Feb-2022,Miscellaneous,"10,878.35",00.00,"28,401.13"
13-Feb-2022,ATM,00.00,"4,733.52","23,667.61"
13-Feb-2022,Reversal,"1,790,196.00",00.00,"1,813,863.61"
13-Feb-2022,Reversal,00.00,"302,310.60","1,511,553.01"
13-Feb-2022,Commission,00.00,"503,851.00","1,007,702.01"
13-Feb-2022,Tax,00.00,"125,962.75","881,739.26"
13-Feb-2022,NEFT,"767,398.75",00.00,"1,649,138.01"
13-Feb-2022,Interest,108.78,00.00,"1,649,246.79"
13-Feb-2022,Cash,00.00,"235,606.68","1,413,640.11"
13-Feb-2022,Tax,00.00,"176,705.01","1,236,935.10"
13-Feb-2022,Commission,00.00,"1,236,935.10",00.00
13-Feb-2022,Reversal,"18,183.00",00.00,"18,183.00"
13-Feb-2022,Miscellaneous,"26,512.00",00.00,"44,695.00"
13-Feb-2022,NEFT,"6,069.10",00.00,"50,764.10"
13-Feb-2022,Miscellaneous,00.00,"8,460.68","42,303.42"
14-Feb-2022,Commission,"19,899.00",00.00,"62,202.42"
14-Feb-2022,Purchase,00.00,"15,550.61","46,651.82"
14-Feb-2022,Interest,"15,739.80",00.00,"62,391.62"
14-Feb-2022,NEFT,"1,961,855.80",00.00,"2,024,247.42"
14-Feb-2022,Reversal,00.00,"289,178.20","1,735,069.22"
14-Feb-2022,Purchase,"3,914.10",00.00,"1,738,983.32"
14-Feb-2022,Cheque,00.42,00.00,"1,738,983.74"
14-Feb-2022,Reversal,"4,282.80",00.00,"1,743,266.54"
14-Feb-2022,Transfer,"132,086.00",00.00,"1,875,352.54"
14-Feb-2022,IMPS,00.00,"937,676.27","937,676.27"
14-Feb-2022,Cash,"3,113.70",00.00,"940,789.97"
14-Feb-2022,Transfer,00.00,"235,197.49","705,592.48"
14-Feb-2022,Cheque,00.00,"141,118.50","564,473.98"
14-Feb-2022,NEFT,00.00,"282,236.99","282,236.99"
14-Feb-2022,Tax,07.00,00.00,"282,243.99"
14-Feb-2022,RTGS,00.00,"47,040.67","235,203.32"
14-Feb-2022,IMPS,02.00,00.00,"235,205.32"
14-Feb-2022,Transfer,00.00,"117,602.66","117,602.66"
14-Feb-2022,Miscellaneous,00.00,"39,200.89","78,401.77"
14-Feb-2022,Debit Card,06.00,00.00,"78,407.77"
14-Feb-2022,Cheque,00.00,"78,407.77",00.00
14-Feb-2022,Miscellaneous,994.03,00.00,994.03
14-Feb-2022,Transfer,00.00,99.40,894.63
14-Feb-2022,Cash,"65,080.00",00.00,"65,974.63"
14-Feb-2022,Transfer,"124,315.56",00.00,"190,290.19"
15-Feb-2022,Reversal,00.00,"19,029.02","171,261.17"
15-Feb-2022,Commission,00.00,"17,126.12","154,135.05"
15-Feb-2022,Reversal,"127,490.22",00.00,"281,625.27"
15-Feb-2022,Tax,299.00,00.00,"281,924.27"
15-Feb-2022,Purchase,80.00,00.00,"282,004.27"
15-Feb-2022,Cheque,00.00,"47,000.71","235,003.56"
15-Feb-2022,Purchase,00.00,"117,501.78","117,501.78"
15-Feb-2022,NEFT,"2,342.31",00.00,"119,844.09"
15-Feb-2022,Commission,46.50,00.00,"119,890.59"
15-Feb-2022,Tax,"701,388.00",00.00,"821,278.59"
15-Feb-2022,Tax,00.00,"82,127.86","739,150.73"
15-Feb-2022,Reversal,00.00,"105,592.96","633,557.77"
15-Feb-2022,RTGS,00.00,"316,778.89","316,778.88"
15-Feb-2022,NEFT,00.00,"39,597.36","277,181.52"
15-Feb-2022,Transfer,00.00,"69,295.38","207,886.14"
15-Feb-2022,Miscellaneous,00.00,"20,788.61","187,097.53"
15-Feb-2022,Tax,00.00,"37,419.51","149,678.02"
15-Feb-2022,Tax,"202,536.20",00.00,"352,214.22"
15-Feb-2022,IMPS,"272,285.75",00.00,"624,499.97"
15-Feb-2022,Transfer,429.81,00.00,"624,929.78"
15-Feb-2022,NEFT,"1,749,635.25",00.00,"2,374,565.03"
15-Feb-2022,NEFT,00.00,"593,641.26","1,780,923.77"
15-Feb-2022,ATM,00.00,"1,780,923.77",00.00
15-Feb-2022,Miscellaneous,"184,747.80",00.00,"184,747.80"
15-Feb-2022,Bill,00.00,"184,747.80",00.00
15-Feb-2022,Reversal,61.54,00.00,61.54
15-Feb-2022,Miscellaneous,00.00,61.54,00.00
15-Feb-2022,Bill,15.39,00.00,15.39
15-Feb-2022,Commission,00.00,01.71,13.68
15-Feb-2022,Commission,00.00,01.52,12.16
15-Feb-2022,Interest,00.00,01.22,10.94
15-Feb-2022,IMPS,423.30,00.00,434.24
15-Feb-2022,ATM,"1,026,348.00",00.00,"1,026,782.24"
15-Feb-2022,Commission,"26,846.72",00.00,"1,053,628.96"
15-Feb-2022,Tax,"219,429.00",00.00,"1,273,057.96"
15-Feb-2022,Cash,00.00,"1,273,057.96",00.00
15-Feb-2022,Cheque,156.70,00.00,156.70
15-Feb-2022,Cheque,00.00,22.39,134.31
15-Feb-2022,RTGS,00.00,16.79,117.52
15-Feb-2022,Purchase,00.00,58.76,58.76
15-Feb-2022,Transfer,"1,098.00",00.00,"1,156.76"
15-Feb-2022,ATM,04.10,00.00,"1,160.86"
15-Feb-2022,Transfer,00.00,116.09,"1,044.77"
15-Feb-2022,Purchase,00.00,130.60,914.17
15-Feb-2022,RTGS,"1,640.00",00.00,"2,554.17"
15-Feb-2022,Cash,00.00,425.70,"2,128.48"
15-Feb-2022,Tax,00.00,304.07,"1,824.41"
15-Feb-2022,IMPS,57.40,00.00,"1,881.81"
15-Feb-2022,Debit Card,02.40,00.00,"1,884.21"
15-Feb-2022,Debit Card,00.00,376.84,"1,507.37"
15-Feb-2022,Commission,00.00,502.46,"1,004.91"
15-Feb-2022,ATM,00.00,"1,004.91",00.00
15-Feb-2022,Purchase,"21,816.40",00.00,"21,816.40"
15-Feb-2022,Cash,00.00,"2,727.05","19,089.35"
15-Feb-2022,Bill,00.00,"1,908.94","17,180.41"
15-Feb-2022,Bill,"79,990.81",00.00,"97,171.22"
15-Feb-2022,Tax,00.00,"12,146.40","85,024.82"
15-Feb-2022,Tax,00.00,"21,256.21","63,768.62"
15-Feb-2022,Cheque,"107,463.50",00.00,"171,232.12"
15-Feb-2022,Transfer,00.00,"17,123.21","154,108.91"
15-Feb-2022,Debit Card,00.00,"17,123.21","136,985.70"
15-Feb-2022,Miscellaneous,"10,086.00",00.00,"147,071.70"
15-Feb-2022,Miscellaneous,00.00,"73,535.85","73,535.85"
15-Feb-2022,RTGS,82.80,00.00,"73,618.65"
15-Feb-2022,Cheque,"3,913.88",00.00,"77,532.53"
15-Feb-2022,Cash,00.00,"77,532.53",00.00
15-Feb-2022,Miscellaneous,"3,349.00",00.00,"3,349.00"
15-Feb-2022,Commission,"1,458,663.50",00.00,"1,462,012.50"
15-Feb-2022,NEFT,00.00,"1,462,012.50",00.00
15-Feb-2022,Cheque,"1,940,785.00",00.00,"1,940,785.00"
15-Feb-2022,Purchase,385.60,00.00,"1,941,170.60"
15-Feb-2022,IMPS,00.00,"215,685.62","1,725,484.98"
15-Feb-2022,Transfer,00.00,"287,580.83","1,437,904.15"
15-Feb-2022,Cheque,"1,611,132.00",00.00,"3,049,036.15"
15-Feb-2022,Cheque,55.94,00.00,"3,049,092.09"
15-Feb-2022,RTGS,00.00,"381,136.51","2,667,955.58"
15-Feb-2022,IMPS,00.00,"666,988.90","2,000,966.68"
15-Feb-2022,ATM,00.00,"500,241.67","1,500,725.01"
15-Feb-2022,Bill,"238,303.30",00.00,"1,739,028.31"
15-Feb-2022,Miscellaneous,00.00,"1,739,028.31",00.00
15-Feb-2022,Purchase,"1,116,176.00",00.00,"1,116,176.00"
15-Feb-2022,Bill,"30,011.80",00.00,"1,146,187.80"
15-Feb-2022,Debit Card,143.00,00.00,"1,146,330.80"
15-Feb-2022,RTGS,421.47,00.00,"1,146,752.27"
15-Feb-2022,Reversal,217.10,00.00,"1,146,969.37"
15-Feb-2022,Miscellaneous,00.00,"163,852.77","983,116.60"
15-Feb-2022,Cash,"3,646.63",00.00,"986,763.23"
15-Feb-2022,Debit Card,"212,034.00",00.00,"1,198,797.23"
15-Feb-2022,Commission,"3,753.00",00.00,"1,202,550.23"
15-Feb-2022,ATM,80.93,00.00,"1,202,631.16"
15-Feb-2022,ATM,00.00,"120,263.12","1,082,368.04"
15-Feb-2022,ATM,474.01,00.00,"1,082,842.05"
15-Feb-2022,Tax,00.00,"108,284.21","974,557.85"
15-Feb-2022,Cheque,00.00,"974,557.85",00.00
15-Feb-2022,Interest,"2,507.01",00.00,"2,507.01"
15-Feb-2022,ATM,00.00,278.56,"2,228.45"
15-Feb-2022,ATM,00.00,"1,114.23","1,114.22"
15-Feb-2022,Cash,00.00,222.84,891.38
15-Feb-2022,RTGS,00.00,445.69,445.69
15-Feb-2022,Bill,142.00,00.00,587.69
15-Feb-2022,Reversal,00.00,587.69,00.00
15-Feb-2022,Commission,96.80,00.00,96.80
15-Feb-2022,Cash,00.00,10.76,86.04
15-Feb-2022,Cash,00.00,09.56,76.48
15-Feb-2022,Purchase,51.80,00.00,128.28
15-Feb-2022,Miscellaneous,06.78,00.00,135.06
15-Feb-2022,Purchase,20.60,00.00,155.66
15-Feb-2022,Purchase,23.10,00.00,178.76
15-Feb-2022,Commission,00.00,19.86,158.90
15-Feb-2022,Cash,"207,911.90",00.00,"208,070.80"
15-Feb-2022,Purchase,"27,004.29",00.00,"235,075.09"
15-Feb-2022,RTGS,00.00,"117,537.55","117,537.54"
15-Feb-2022,Tax,07.00,00.00,"117,544.54"
15-Feb-2022,Commission,"1,848,778.00",00.00,"1,966,322.54"
15-Feb-2022,Cheque,56.43,00.00,"1,966,378.97"
15-Feb-2022,RTGS,"237,085.00",00.00,"2,203,463.97"
15-Feb-2022,Miscellaneous,00.00,"244,829.33","1,958,634.64"
15-Feb-2022,Purchase,00.00,"195,863.46","1,762,771.18"
15-Feb-2022,RTGS,00.00,"220,346.40","1,542,424.78"
15-Feb-2022,IMPS,"31,650.00",00.00,"1,574,074.78"
15-Feb-2022,Commission,"11,914.20",00.00,"1,585,988.98"
15-Feb-2022,Debit Card,00.00,"792,994.49","792,994.49"
15-Feb-2022,Debit Card,00.00,"158,598.90","634,395.59"
15-Feb-2022,Reversal,00.00,"70,488.40","563,907.19"
15-Feb-2022,ATM,00.00,"56,390.72","507,516.47"
15-Feb-2022,Transfer,55.85,00.00,"507,572.32"
15-Feb-2022,Transfer,00.00,"253,786.16","253,786.16"
16-Feb-2022,ATM,00.00,"25,378.62","228,407.54"
16-Feb-2022,RTGS,"199,710.53",00.00,"428,118.07"
16-Feb-2022,Purchase,00.00,"61,159.72","366,958.35"
16-Feb-2022,Transfer,00.00,"52,422.62","314,535.73"
16-Feb-2022,Purchase,279.29,00.00,"314,815.02"
16-Feb-2022,Tax,00.00,"314,815.02",00.00
16-Feb-2022,Miscellaneous,12.00,00.00,12.00
16-Feb-2022,Reversal,59.00,00.00,71.00
16-Feb-2022,RTGS,00.00,07.89,63.11
16-Feb-2022,NEFT,"2,756.93",00.00,"2,820.04"
16-Feb-2022,Tax,00.00,470.01,"2,350.03"
16-Feb-2022,Debit Card,00.00,"2,350.03",00.00
16-Feb-2022,Purchase,"11,600.70",00.00,"11,600.70"
16-Feb-2022,Bill,249.26,00.00,"11,849.96"
16-Feb-2022,Interest,00.00,"1,692.85","10,157.11"
16-Feb-2022,ATM,"39,397.00",00.00,"49,554.11"
16-Feb-2022,Interest,00.00,"4,955.41","44,598.70"
16-Feb-2022,ATM,503.80,00.00,"45,102.50"
16-Feb-2022,RTGS,"28,820.20",00.00,"73,922.70"
16-Feb-2022,Cash,00.00,"14,784.54","59,138.16"
16-Feb-2022,Cheque,00.00,"59,138.16",00.00
16-Feb-2022,Bill,"188,956.41",00.00,"188,956.41"
16-Feb-2022,Miscellaneous,00.00,"47,239.10","141,717.31"
16-Feb-2022,Purchase,00.00,"70,858.66","70,858.66"
16-Feb-2022,Miscellaneous,"1,103,550.50",00.00,"1,174,409.16"
16-Feb-2022,RTGS,"217,956.78",00.00,"1,392,365.94"
16-Feb-2022,NEFT,80.00,00.00,"1,392,445.94"
16-Feb-2022,Tax,06.00,00.00,"1,392,451.94"
16-Feb-2022,Commission,00.00,"232,075.32","1,160,376.62"
16-Feb-2022,RTGS,00.00,"193,396.10","966,980.52"
16-Feb-2022,RTGS,00.00,"193,396.10","773,584.42"
16-Feb-2022,IMPS,"14,809.00",00.00,"788,393.42"
16-Feb-2022,IMPS,"304,788.50",00.00,"1,093,181.92"
16-Feb-2022,Purchase,00.00,"156,168.85","937,013.07"
16-Feb-2022,Purchase,36.00,00.00,"937,049.07"
16-Feb-2022,NEFT,00.00,"937,049.07",00.00
16-Feb-2022,Cash,126.62,00.00,126.62
16-Feb-2022,IMPS,"241,461.91",00.00,"241,588.53"
16-Feb-2022,IMPS,00.00,"34,512.65","207,075.88"
16-Feb-2022,Bill,"30,421.90",00.00,"237,497.78"
16-Feb-2022,NEFT,00.00,"33,928.25","203,569.53"
16-Feb-2022,Transfer,00.00,"20,356.95","183,212.58"
16-Feb-2022,Miscellaneous,"15,824.10",00.00,"199,036.68"
16-Feb-2022,Interest,"240,961.97",00.00,"439,998.65"
16-Feb-2022,Cheque,00.00,"87,999.73","351,998.92"
16-Feb-2022,RTGS,00.00,"175,999.46","175,999.46"
16-Feb-2022,Transfer,346.81,00.00,"176,346.27"
16-Feb-2022,RTGS,"1,337,155.00",00.00,"1,513,501.27"
16-Feb-2022,Cash,17.00,00.00,"1,513,518.27"
16-Feb-2022,Miscellaneous,00.00,"189,189.78","1,324,328.49"
16-Feb-2022,RTGS,03.00,00.00,"1,324,331.49"
16-Feb-2022,Commission,"1,252.30",00.00,"1,325,583.79"
16-Feb-2022,Miscellaneous,"4,078.00",00.00,"1,329,661.79"
16-Feb-2022,Purchase,00.00,"166,207.72","1,163,454.07"
16-Feb-2022,Transfer,"1,182,629.00",00.00,"2,346,083.07"
16-Feb-2022,NEFT,00.00,"234,608.31","2,111,474.76"
16-Feb-2022,Tax,00.00,"703,824.92","1,407,649.84"
16-Feb-2022,Purchase,"18,295.78",00.00,"1,425,945.62"
16-Feb-2022,Cash,53.10,00.00,"1,425,998.72"
16-Feb-2022,RTGS,00.00,"356,499.68","1,069,499.04"
16-Feb-2022,Tax,52.00,00.00,"1,069,551.04"
16-Feb-2022,ATM,"15,670.50",00.00,"1,085,221.54"
16-Feb-2022,ATM,"160,795.38",00.00,"1,246,016.92"
16-Feb-2022,Bill,00.00,"311,504.23","934,512.69"
16-Feb-2022,NEFT,00.00,"311,504.23","623,008.46"
16-Feb-2022,Debit Card,"13,113.00",00.00,"636,121.46"
16-Feb-2022,Debit Card,00.00,"70,680.16","565,441.30"
16-Feb-2022,Transfer,00.00,"565,441.30",00.00
16-Feb-2022,Transfer,68.45,00.00,68.45
16-Feb-2022,Tax,02.60,00.00,71.05
16-Feb-2022,Tax,00.00,17.76,53.29
16-Feb-2022,RTGS,00.00,07.61,45.68
16-Feb-2022,Bill,00.00,00.00,45.68
16-Feb-2022,Purchase,00.00,11.42,34.26
16-Feb-2022,RTGS,"2,204.43",00.00,"2,238.69"
16-Feb-2022,Miscellaneous,"149,157.00",00.00,"151,395.69"
16-Feb-2022,Miscellaneous,03.70,00.00,"151,399.39"
16-Feb-2022,NEFT,00.00,"25,233.23","126,166.16"
16-Feb-2022,Reversal,00.00,"18,023.74","108,142.42"
16-Feb-2022,Miscellaneous,00.00,"108,142.42",00.00
16-Feb-2022,IMPS,"204,483.06",00.00,"204,483.06"
16-Feb-2022,Tax,00.00,"25,560.38","178,922.68"
16-Feb-2022,Cash,181.60,00.00,"179,104.28"
16-Feb-2022,Cheque,325.00,00.00,"179,429.28"
16-Feb-2022,Reversal,00.00,"29,904.88","149,524.40"
16-Feb-2022,RTGS,371.00,00.00,"149,895.40"
16-Feb-2022,IMPS,00.00,"29,979.08","119,916.32"
16-Feb-2022,Cash,00.00,"14,989.54","104,926.78"
16-Feb-2022,IMPS,00.00,"11,658.53","93,268.25"
16-Feb-2022,Tax,00.00,"10,363.14","82,905.11"
16-Feb-2022,Debit Card,"31,241.10",00.00,"114,146.21"
16-Feb-2022,IMPS,"387,507.80",00.00,"501,654.01"
17-Feb-2022,NEFT,00.00,"167,218.00","334,436.01"
17-Feb-2022,ATM,00.00,"55,739.34","278,696.68"
17-Feb-2022,Miscellaneous,00.00,"278,696.68",00.00
17-Feb-2022,Purchase,03.50,00.00,03.50
17-Feb-2022,Commission,"27,837.10",00.00,"27,840.60"
17-Feb-2022,Cheque,00.00,"2,784.06","25,056.54"
17-Feb-2022,Debit Card,129.00,00.00,"25,185.54"
17-Feb-2022,Transfer,00.00,"5,037.11","20,148.43"
17-Feb-2022,Miscellaneous,00.00,"2,014.84","18,133.59"
17-Feb-2022,RTGS,02.50,00.00,"18,136.09"
17-Feb-2022,Interest,"15,245.12",00.00,"33,381.21"
17-Feb-2022,ATM,"27,942.70",00.00,"61,323.91"
17-Feb-2022,ATM,00.00,"8,760.56","52,563.35"
17-Feb-2022,Purchase,326.00,00.00,"52,889.35"
17-Feb-2022,Debit Card,"109,750.50",00.00,"162,639.85"
17-Feb-2022,Bill,50.00,00.00,"162,689.85"
17-Feb-2022,Miscellaneous,00.00,"162,689.85",00.00
17-Feb-2022,Bill,244.00,00.00,244.00
17-Feb-2022,ATM,00.00,81.33,162.67
17-Feb-2022,RTGS,"200,563.00",00.00,"200,725.67"
17-Feb-2022,Debit Card,"66,638.00",00.00,"267,363.67"
17-Feb-2022,Cheque,"238,369.00",00.00,"505,732.67"
17-Feb-2022,Debit Card,00.00,"56,192.52","449,540.15"
17-Feb-2022,Miscellaneous,"4,037.60",00.00,"453,577.75"
17-Feb-2022,Bill,00.00,"113,394.44","340,183.31"
17-Feb-2022,ATM,00.00,"85,045.83","255,137.48"
17-Feb-2022,Commission,00.00,"36,448.21","218,689.27"
18-Feb-2022,Commission,00.00,"43,737.85","174,951.42"
18-Feb-2022,Bill,00.00,"87,475.71","87,475.71"
18-Feb-2022,Interest,00.00,"9,719.52","77,756.19"
18-Feb-2022,IMPS,00.00,"25,918.73","51,837.46"
18-Feb-2022,Transfer,00.00,"5,183.75","46,653.71"
18-Feb-2022,IMPS,"23,363.50",00.00,"70,017.21"
18-Feb-2022,Debit Card,00.00,"14,003.44","56,013.77"
18-Feb-2022,RTGS,271.30,00.00,"56,285.07"
18-Feb-2022,Reversal,"2,489.20",00.00,"58,774.27"
18-Feb-2022,Tax,00.00,"6,530.47","52,243.80"
18-Feb-2022,Debit Card,00.00,"5,804.87","46,438.93"
18-Feb-2022,ATM,04.45,00.00,"46,443.38"
18-Feb-2022,Transfer,"243,482.20",00.00,"289,925.58"
18-Feb-2022,Cheque,235.62,00.00,"290,161.20"
18-Feb-2022,IMPS,06.00,00.00,"290,167.20"
18-Feb-2022,NEFT,00.00,"58,033.44","232,133.76"
18-Feb-2022,RTGS,"9,023.10",00.00,"241,156.86"
18-Feb-2022,Commission,00.00,"80,385.62","160,771.24"
18-Feb-2022,Commission,00.00,"26,795.21","133,976.03"
18-Feb-2022,Purchase,56.00,00.00,"134,032.03"
18-Feb-2022,RTGS,"672,599.80",00.00,"806,631.83"
18-Feb-2022,Commission,"98,702.00",00.00,"905,333.83"
18-Feb-2022,NEFT,"162,131.70",00.00,"1,067,465.53"
18-Feb-2022,Tax,00.00,"355,821.84","711,643.69"
18-Feb-2022,Commission,36.25,00.00,"711,679.94"
18-Feb-2022,Tax,00.00,"142,335.99","569,343.95"
18-Feb-2022,Reversal,00.00,"63,260.44","506,083.51"
18-Feb-2022,IMPS,41.60,00.00,"506,125.11"
18-Feb-2022,ATM,00.00,"56,236.12","449,888.99"
18-Feb-2022,Reversal,"53,492.00",00.00,"503,380.99"
18-Feb-2022,RTGS,03.00,00.00,"503,383.99"
18-Feb-2022,Cheque,"3,883.59",00.00,"507,267.58"
18-Feb-2022,ATM,00.00,"56,363.06","450,904.52"
18-Feb-2022,ATM,00.00,"50,100.50","400,804.02"
18-Feb-2022,Cash,00.00,"40,080.40","360,723.62"
18-Feb-2022,Tax,00.00,"60,120.60","300,603.02"
18-Feb-2022,ATM,28.20,00.00,"300,631.22"
18-Feb-2022,Tax,58.00,00.00,"300,689.22"
18-Feb-2022,Interest,00.00,"300,689.22",00.00
18-Feb-2022,Purchase,411.65,00.00,411.65
18-Feb-2022,IMPS,"148,178.80",00.00,"148,590.45"
18-Feb-2022,Bill,00.00,"14,859.05","133,731.40"
19-Feb-2022,Miscellaneous,00.00,"133,731.40",00.00
19-Feb-2022,ATM,31.90,00.00,31.90
19-Feb-2022,Interest,03.00,00.00,34.90
19-Feb-2022,Debit Card,00.00,06.98,27.92
19-Feb-2022,ATM,00.00,06.98,20.94
19-Feb-2022,Cheque,03.05,00.00,23.99
20-Feb-2022,Cheque,"22,007.00",00.00,"22,030.99"
20-Feb-2022,ATM,41.00,00.00,"22,071.99"
20-Feb-2022,Debit Card,00.00,"2,207.20","19,864.79"
20-Feb-2022,Bill,00.00,"2,837.83","17,026.96"
20-Feb-2022,NEFT,"3,779.00",00.00,"20,805.96"
20-Feb-2022,NEFT,00.00,"10,402.98","10,402.98"
20-Feb-2022,Cheque,00.00,"1,300.37","9,102.61"
20-Feb-2022,Transfer,00.00,"1,820.52","7,282.09"
20-Feb-2022,Bill,"6,495.00",00.00,"13,777.09"
20-Feb-2022,Tax,00.00,"13,777.09",00.00
20-Feb-2022,Reversal,225.89,00.00,225.89
20-Feb-2022,Interest,00.00,45.18,180.71
20-Feb-2022,Bill,07.60,00.00,188.31
20-Feb-2022,Cash,00.00,20.92,167.39
20-Feb-2022,Cheque,"1,428,187.20",00.00,"1,428,354.59"
20-Feb-2022,Transfer,501.51,00.00,"1,428,856.10"
20-Feb-2022,NEFT,00.00,"285,771.22","1,143,084.88"
20-Feb-2022,Transfer,"1,316,470.50",00.00,"2,459,555.38"
20-Feb-2022,RTGS,00.00,"307,444.42","2,152,110.96"
20-Feb-2022,Transfer,00.00,"358,685.16","1,793,425.80"
20-Feb-2022,Interest,22.93,00.00,"1,793,448.73"
20-Feb-2022,Transfer,00.00,"256,206.96","1,537,241.77"
20-Feb-2022,Reversal,00.00,"153,724.18","1,383,517.59"
20-Feb-2022,Reversal,"1,304,635.00",00.00,"2,688,152.59"
20-Feb-2022,Tax,00.00,"2,688,152.59",00.00
20-Feb-2022,IMPS,53.60,00.00,53.60
20-Feb-2022,IMPS,00.00,26.80,26.80
20-Feb-2022,Commission,"3,388.64",00.00,"3,415.44"
20-Feb-2022,Miscellaneous,00.00,853.86,"2,561.58"
21-Feb-2022,Reversal,"1,100,968.00",00.00,"1,103,529.58"
21-Feb-2022,Tax,"125,684.90",00.00,"1,229,214.48"
21-Feb-2022,Interest,33.00,00.00,"1,229,247.48"
21-Feb-2022,Commission,00.00,"153,655.94","1,075,591.54"
21-Feb-2022,Cheque,00.00,"179,265.26","896,326.28"
21-Feb-2022,Debit Card,26.00,00.00,"896,352.28"
21-Feb-2022,Reversal,00.00,"149,392.05","746,960.23"
21-Feb-2022,Tax,"717,191.75",00.00,"1,464,151.98"
21-Feb-2022,Debit Card,516.12,00.00,"1,464,668.10"
21-Feb-2022,Interest,"20,311.21",00.00,"1,484,979.31"
22-Feb-2022,Transfer,"155,845.00",00.00,"1,640,824.31"
22-Feb-2022,Tax,00.00,"205,103.04","1,435,721.27"
22-Feb-2022,Reversal,62.18,00.00,"1,435,783.45"
22-Feb-2022,Reversal,"10,867.30",00.00,"1,446,650.75"
22-Feb-2022,ATM,510.00,00.00,"1,447,160.75"
22-Feb-2022,Commission,"144,013.80",00.00,"1,591,174.55"
22-Feb-2022,Transfer,"36,938.40",00.00,"1,628,112.95"
22-Feb-2022,Tax,00.00,"180,901.44","1,447,211.51"
22-Feb-2022,ATM,00.00,"144,721.15","1,302,490.36"
22-Feb-2022,Interest,00.00,"434,163.45","868,326.91"
22-Feb-2022,Tax,00.00,"217,081.73","651,245.18"
22-Feb-2022,Tax,"18,134.78",00.00,"669,379.96"
22-Feb-2022,Transfer,00.00,"66,938.00","602,441.96"
22-Feb-2022,NEFT,00.00,"120,488.39","481,953.57"
22-Feb-2022,Transfer,"2,253.00",00.00,"484,206.57"
22-Feb-2022,NEFT,00.00,"48,420.66","435,785.91"
23-Feb-2022,NEFT,00.00,"54,473.24","381,312.67"
23-Feb-2022,Tax,"1,758,918.80",00.00,"2,140,231.47"
23-Feb-2022,Tax,00.00,"535,057.87","1,605,173.60"
23-Feb-2022,Cheque,00.00,"1,605,173.60",00.00
23-Feb-2022,Commission,"77,187.80",00.00,"77,187.80"
23-Feb-2022,IMPS,"193,411.20",00.00,"270,599.00"
23-Feb-2022,Cheque,"1,225,215.50",00.00,"1,495,814.50"
23-Feb-2022,Bill,07.17,00.00,"1,495,821.67"
23-Feb-2022,ATM,00.00,"213,688.81","1,282,132.86"
23-Feb-2022,NEFT,00.00,"320,533.22","961,599.64"
23-Feb-2022,ATM,00.00,"120,199.96","841,399.68"
23-Feb-2022,Tax,50.80,00.00,"841,450.48"
23-Feb-2022,NEFT,"6,308.30",00.00,"847,758.78"
23-Feb-2022,Purchase,"86,164.00",00.00,"933,922.78"
23-Feb-2022,Cheque,"1,517,461.50",00.00,"2,451,384.28"
23-Feb-2022,Transfer,00.00,"245,138.43","2,206,245.85"
23-Feb-2022,Cash,"100,863.88",00.00,"2,307,109.73"
23-Feb-2022,Commission,00.00,"230,710.97","2,076,398.76"
23-Feb-2022,Transfer,00.00,"230,710.97","1,845,687.79"
23-Feb-2022,Purchase,19.50,00.00,"1,845,707.29"
23-Feb-2022,Cash,04.10,00.00,"1,845,711.39"
23-Feb-2022,Tax,60.10,00.00,"1,845,771.49"
23-Feb-2022,Cash,"183,157.00",00.00,"2,028,928.49"
23-Feb-2022,Cheque,00.00,"253,616.06","1,775,312.43"
23-Feb-2022,Purchase,165.00,00.00,"1,775,477.43"
23-Feb-2022,RTGS,00.00,"197,275.27","1,578,202.16"
23-Feb-2022,Transfer,00.00,"197,275.27","1,380,926.89"
23-Feb-2022,Interest,"178,410.00",00.00,"1,559,336.89"
23-Feb-2022,RTGS,00.00,"259,889.48","1,299,447.41"
23-Feb-2022,Tax,"1,088,811.75",00.00,"2,388,259.16"
23-Feb-2022,Purchase,"16,057.00",00.00,"2,404,316.16"
23-Feb-2022,Purchase,"3,387.60",00.00,"2,407,703.76"
23-Feb-2022,Cash,455.70,00.00,"2,408,159.46"
23-Feb-2022,Cheque,00.00,"344,022.78","2,064,136.68"
23-Feb-2022,NEFT,00.00,"1,032,068.34","1,032,068.34"
23-Feb-2022,Commission,00.00,"258,017.09","774,051.26"
23-Feb-2022,Reversal,00.00,"110,578.75","663,472.51"
23-Feb-2022,Commission,"70,054.20",00.00,"733,526.71"
23-Feb-2022,IMPS,168.00,00.00,"733,694.71"
23-Feb-2022,Tax,02.92,00.00,"733,697.63"
23-Feb-2022,Cheque,30.50,00.00,"733,728.13"
23-Feb-2022,Cash,103.50,00.00,"733,831.63"
23-Feb-2022,IMPS,"79,186.50",00.00,"813,018.13"
23-Feb-2022,RTGS,421.00,00.00,"813,439.13"
23-Feb-2022,Cash,28.70,00.00,"813,467.83"
23-Feb-2022,Bill,"165,879.00",00.00,"979,346.83"
23-Feb-2022,Reversal,00.00,"139,906.69","839,440.14"
23-Feb-2022,Bill,00.00,"139,906.69","699,533.45"
23-Feb-2022,Transfer,00.00,"116,588.91","582,944.54"
23-Feb-2022,Tax,00.00,"97,157.42","485,787.12"
23-Feb-2022,Reversal,00.00,"121,446.78","364,340.34"
23-Feb-2022,Bill,00.00,"182,170.17","182,170.17"
23-Feb-2022,Cheque,"103,276.25",00.00,"285,446.42"
23-Feb-2022,Reversal,"10,323.00",00.00,"295,769.42"
23-Feb-2022,IMPS,02.50,00.00,"295,771.92"
23-Feb-2022,Miscellaneous,00.00,"29,577.19","266,194.73"
23-Feb-2022,Interest,02.27,00.00,"266,197.00"
23-Feb-2022,ATM,00.00,"266,197.00",00.00
23-Feb-2022,Tax,"138,544.00",00.00,"138,544.00"
23-Feb-2022,RTGS,"655,334.25",00.00,"793,878.25"
23-Feb-2022,Cheque,00.00,"396,939.13","396,939.12"
23-Feb-2022,Purchase,00.00,"132,313.04","264,626.08"
23-Feb-2022,IMPS,"46,387.20",00.00,"311,013.28"
23-Feb-2022,Bill,00.00,"77,753.32","233,259.96"
23-Feb-2022,Cheque,00.00,"25,917.77","207,342.19"
23-Feb-2022,Bill,16.43,00.00,"207,358.62"
23-Feb-2022,Transfer,00.00,"103,679.31","103,679.31"
23-Feb-2022,Cash,"3,324.15",00.00,"107,003.46"
23-Feb-2022,Reversal,328.61,00.00,"107,332.07"
23-Feb-2022,Miscellaneous,00.00,"15,333.15","91,998.92"
23-Feb-2022,Bill,"1,062,063.50",00.00,"1,154,062.42"
23-Feb-2022,Bill,"2,603.22",00.00,"1,156,665.64"
23-Feb-2022,ATM,00.00,"128,518.40","1,028,147.24"
23-Feb-2022,Reversal,00.00,"102,814.72","925,332.52"
23-Feb-2022,NEFT,"120,746.00",00.00,"1,046,078.52"
23-Feb-2022,NEFT,00.00,"348,692.84","697,385.68"
23-Feb-2022,ATM,00.00,"697,385.68",00.00
23-Feb-2022,Bill,"8,911.75",00.00,"8,911.75"
23-Feb-2022,NEFT,00.00,"1,113.97","7,797.78"
23-Feb-2022,NEFT,85.00,00.00,"7,882.78"
23-Feb-2022,RTGS,08.00,00.00,"7,890.78"
23-Feb-2022,Cheque,00.00,"1,972.70","5,918.08"
23-Feb-2022,Debit Card,"99,984.10",00.00,"105,902.18"
23-Feb-2022,Reversal,00.00,"17,650.36","88,251.82"
23-Feb-2022,Transfer,"24,137.00",00.00,"112,388.82"
23-Feb-2022,ATM,07.60,00.00,"112,396.42"
23-Feb-2022,Purchase,00.00,"14,049.55","98,346.87"
23-Feb-2022,ATM,27.57,00.00,"98,374.44"
23-Feb-2022,RTGS,00.00,"24,593.61","73,780.83"
23-Feb-2022,Purchase,00.00,"10,540.12","63,240.71"
23-Feb-2022,Purchase,00.00,"12,648.14","50,592.57"
23-Feb-2022,Purchase,00.00,"6,324.07","44,268.50"
23-Feb-2022,Bill,"1,752.10",00.00,"46,020.60"
23-Feb-2022,Commission,00.00,"9,204.12","36,816.48"
23-Feb-2022,Cheque,00.00,"9,204.12","27,612.36"
23-Feb-2022,Debit Card,00.00,"13,806.18","13,806.18"
23-Feb-2022,Transfer,00.00,"3,451.55","10,354.64"
23-Feb-2022,Cheque,00.00,"2,588.66","7,765.98"
23-Feb-2022,Purchase,59.20,00.00,"7,825.18"
23-Feb-2022,Bill,"8,971.60",00.00,"16,796.78"
23-Feb-2022,RTGS,00.00,"16,796.78",00.00
23-Feb-2022,Bill,"2,931.70",00.00,"2,931.70"
23-Feb-2022,Purchase,445.10,00.00,"3,376.80"
23-Feb-2022,NEFT,"960,007.25",00.00,"963,384.05"
23-Feb-2022,NEFT,00.00,"240,846.01","722,538.04"
23-Feb-2022,Cash,32.00,00.00,"722,570.04"
23-Feb-2022,Interest,05.00,00.00,"722,575.04"
24-Feb-2022,Commission,06.50,00.00,"722,581.54"
24-Feb-2022,ATM,"2,815.80",00.00,"725,397.34"
24-Feb-2022,NEFT,"6,327.60",00.00,"731,724.94"
24-Feb-2022,Transfer,"196,275.69",00.00,"928,000.63"
24-Feb-2022,Commission,00.00,"185,600.13","742,400.50"
24-Feb-2022,Bill,"564,615.00",00.00,"1,307,015.50"
24-Feb-2022,Interest,00.00,"1,307,015.50",00.00
24-Feb-2022,Tax,04.93,00.00,04.93
24-Feb-2022,Debit Card,00.00,01.64,03.29
24-Feb-2022,Miscellaneous,"3,448.50",00.00,"3,451.79"
24-Feb-2022,Cash,37.20,00.00,"3,488.99"
24-Feb-2022,Commission,"23,903.00",00.00,"27,391.99"
24-Feb-2022,Cash,"212,378.00",00.00,"239,769.99"
24-Feb-2022,Purchase,00.00,"239,769.99",00.00
24-Feb-2022,Cash,"70,860.09",00.00,"70,860.09"
24-Feb-2022,NEFT,"10,232.73",00.00,"81,092.82"
24-Feb-2022,Interest,40.80,00.00,"81,133.62"
24-Feb-2022,Reversal,00.00,"40,566.81","40,566.81"
24-Feb-2022,Cheque,00.00,"4,507.42","36,059.39"
24-Feb-2022,RTGS,00.00,"4,507.42","31,551.97"
24-Feb-2022,Reversal,692.00,00.00,"32,243.97"
24-Feb-2022,Transfer,"31,918.38",00.00,"64,162.35"
24-Feb-2022,Debit Card,00.00,"7,129.15","57,033.20"
24-Feb-2022,Tax,00.00,"19,011.07","38,022.13"
24-Feb-2022,Cheque,227.34,00.00,"38,249.47"
24-Feb-2022,Cash,"17,694.00",00.00,"55,943.47"
24-Feb-2022,Purchase,"35,343.22",00.00,"91,286.69"
24-Feb-2022,Reversal,00.00,"45,643.35","45,643.34"
25-Feb-2022,NEFT,297.90,00.00,"45,941.24"
25-Feb-2022,Cheque,"1,899,305.00",00.00,"1,945,246.24"
25-Feb-2022,Interest,00.00,"389,049.25","1,556,196.99"
25-Feb-2022,Cash,27.66,00.00,"1,556,224.65"
25-Feb-2022,Reversal,00.00,"518,741.55","1,037,483.10"
25-Feb-2022,IMPS,"355,444.00",00.00,"1,392,927.10"
25-Feb-2022,IMPS,"1,990,911.75",00.00,"3,383,838.85"
25-Feb-2022,Reversal,00.00,"845,959.71","2,537,879.14"
25-Feb-2022,Miscellaneous,"81,336.66",00.00,"2,619,215.80"
25-Feb-2022,Debit Card,00.00,"873,071.93","1,746,143.87"
25-Feb-2022,Cash,00.00,"436,535.97","1,309,607.90"
25-Feb-2022,Cheque,00.00,"145,511.99","1,164,095.91"
25-Feb-2022,Cheque,00.00,"1,164,095.91",00.00
25-Feb-2022,Bill,235.00,00.00,235.00
25-Feb-2022,ATM,"31,824.09",00.00,"32,059.09"
25-Feb-2022,Reversal,13.07,00.00,"32,072.16"
25-Feb-2022,RTGS,00.00,"3,563.57","28,508.59"
25-Feb-2022,Interest,00.00,"14,254.30","14,254.30"
25-Feb-2022,RTGS,00.00,"1,781.79","12,472.51"
25-Feb-2022,Bill,414.00,00.00,"12,886.51"
25-Feb-2022,Commission,"217,909.78",00.00,"230,796.29"
25-Feb-2022,Purchase,00.00,"230,796.29",00.00
25-Feb-2022,Debit Card,612.77,00.00,612.77
25-Feb-2022,RTGS,"57,716.00",00.00,"58,328.77"
25-Feb-2022,Bill,00.00,"58,328.77",00.00
25-Feb-2022,Commission,"1,999,691.00",00.00,"1,999,691.00"
25-Feb-2022,Bill,00.00,"666,563.67","1,333,127.33"
25-Feb-2022,Debit Card,00.00,"1,333,127.33",00.00
25-Feb-2022,Bill,04.63,00.00,04.63
25-Feb-2022,RTGS,"1,983,062.00",00.00,"1,983,066.63"
25-Feb-2022,Cash,00.00,"283,295.23","1,699,771.40"
25-Feb-2022,IMPS,00.00,"849,885.70","849,885.70"
25-Feb-2022,RTGS,"3,102.61",00.00,"852,988.31"
25-Feb-2022,IMPS,91.00,00.00,"853,079.31"
25-Feb-2022,Tax,00.00,"106,634.91","746,444.40"
25-Feb-2022,Debit Card,"601,778.00",00.00,"1,348,222.40"
25-Feb-2022,ATM,00.00,"337,055.60","1,011,166.80"
25-Feb-2022,NEFT,928.60,00.00,"1,012,095.40"
25-Feb-2022,Bill,94.05,00.00,"1,012,189.45"
25-Feb-2022,Bill,"76,681.69",00.00,"1,088,871.14"
25-Feb-2022,RTGS,"767,837.00",00.00,"1,856,708.14"
25-Feb-2022,Commission,"20,325.00",00.00,"1,877,033.14"
25-Feb-2022,Reversal,544.00,00.00,"1,877,577.14"
26-Feb-2022,ATM,00.00,"234,697.14","1,642,880.00"
26-Feb-2022,Cash,00.00,"234,697.14","1,408,182.86"
26-Feb-2022,Commission,"11,163.03",00.00,"1,419,345.89"
26-Feb-2022,IMPS,00.00,"157,705.10","1,261,640.79"
26-Feb-2022,RTGS,00.00,"315,410.20","946,230.59"
26-Feb-2022,Transfer,"91,520.00",00.00,"1,037,750.59"
26-Feb-2022,Interest,"1,322.96",00.00,"1,039,073.55"
26-Feb-2022,RTGS,00.00,"115,452.62","923,620.93"
26-Feb-2022,IMPS,00.00,"115,452.62","808,168.31"
26-Feb-2022,Purchase,23.00,00.00,"808,191.31"
26-Feb-2022,Cash,489.20,00.00,"808,680.51"
26-Feb-2022,Interest,00.00,"404,340.26","404,340.26"
26-Feb-2022,Bill,25.30,00.00,"404,365.56"
26-Feb-2022,Cheque,"122,725.16",00.00,"527,090.72"
26-Feb-2022,Cheque,00.00,"87,848.45","439,242.27"
26-Feb-2022,ATM,00.00,"73,207.05","366,035.22"
26-Feb-2022,Tax,06.60,00.00,"366,041.82"
26-Feb-2022,Transfer,07.30,00.00,"366,049.12"
26-Feb-2022,RTGS,00.00,"36,604.91","329,444.21"
26-Feb-2022,Cheque,"236,201.75",00.00,"565,645.96"
26-Feb-2022,Interest,36.20,00.00,"565,682.16"
27-Feb-2022,Bill,"1,541,327.00",00.00,"2,107,009.16"
27-Feb-2022,Commission,00.00,"210,700.92","1,896,308.24"
27-Feb-2022,Transfer,00.00,"210,700.92","1,685,607.32"
27-Feb-2022,Bill,07.36,00.00,"1,685,614.68"
27-Feb-2022,RTGS,57.00,00.00,"1,685,671.68"
27-Feb-2022,Interest,"1,277,476.00",00.00,"2,963,147.68"
27-Feb-2022,Interest,00.00,"1,481,573.84","1,481,573.84"
27-Feb-2022,Miscellaneous,"97,652.70",00.00,"1,579,226.54"
27-Feb-2022,Transfer,00.00,"315,845.31","1,263,381.23"
27-Feb-2022,Cash,00.00,"631,690.62","631,690.62"
27-Feb-2022,Commission,220.19,00.00,"631,910.81"
27-Feb-2022,Commission,59.40,00.00,"631,970.21"
27-Feb-2022,Transfer,00.00,"70,218.91","561,751.30"
27-Feb-2022,ATM,00.00,"187,250.43","374,500.87"
27-Feb-2022,Tax,"4,294.70",00.00,"378,795.57"
27-Feb-2022,Cash,"2,238.00",00.00,"381,033.57"
27-Feb-2022,Reversal,"18,331.00",00.00,"399,364.57"
27-Feb-2022,Cash,00.00,"99,841.14","299,523.43"
27-Feb-2022,ATM,171.30,00.00,"299,694.73"
27-Feb-2022,ATM,00.00,"37,461.84","262,232.89"
27-Feb-2022,Bill,00.00,"262,232.89",00.00
27-Feb-2022,Debit Card,"1,115,024.00",00.00,"1,115,024.00"
27-Feb-2022,Tax,00.00,"159,289.14","955,734.86"
27-Feb-2022,Commission,00.00,"955,734.86",00.00
27-Feb-2022,Transfer,"606,401.25",00.00,"606,401.25"
27-Feb-2022,Bill,00.00,"75,800.16","530,601.09"
27-Feb-2022,Interest,00.00,"132,650.27","397,950.82"
27-Feb-2022,Transfer,00.00,"79,590.16","318,360.66"
27-Feb-2022,Miscellaneous,00.00,"39,795.08","278,565.58"
27-Feb-2022,Transfer,"110,080.75",00.00,"388,646.33"
28-Feb-2022,ATM,00.00,"194,323.17","194,323.16"
28-Feb-2022,Commission,00.00,"97,161.58","97,161.58"
28-Feb-2022,Cash,00.00,"32,387.19","64,774.39"
28-Feb-2022,NEFT,00.00,"6,477.44","58,296.95"
28-Feb-2022,IMPS,"1,680,564.80",00.00,"1,738,861.75"
28-Feb-2022,Bill,00.00,"1,738,861.75",00.00
28-Feb-2022,Purchase,"142,917.00",00.00,"142,917.00"
28-Feb-2022,Purchase,00.00,"142,917.00",00.00
28-Feb-2022,Bill,00.98,00.00,00.98
28-Feb-2022,Bill,21.00,00.00,21.98
28-Feb-2022,RTGS,01.56,00.00,23.54
28-Feb-2022,Bill,"169,628.88",00.00,"169,652.42"
28-Feb-2022,Cheque,00.00,"18,850.27","150,802.15"
28-Feb-2022,Bill,00.00,"18,850.27","131,951.88"
28-Feb-2022,RTGS,00.00,"26,390.38","105,561.50"
28-Feb-2022,Tax,00.00,"11,729.06","93,832.44"
28-Feb-2022,Commission,00.00,"46,916.22","46,916.22"
01-Mar-2022,IMPS,138.82,00.00,"47,055.04"
01-Mar-2022,Interest,00.00,"7,842.51","39,212.53"
02-Mar-2022,IMPS,"2,057,629.00",00.00,"2,096,841.53"
02-Mar-2022,Cash,00.00,"232,982.39","1,863,859.14"
02-Mar-2022,Transfer,"23,582.20",00.00,"1,887,441.34"
02-Mar-2022,Reversal,"2,190.00",00.00,"1,889,631.34"
02-Mar-2022,Tax,00.00,"314,938.56","1,574,692.78"
02-Mar-2022,Tax,00.00,"524,897.59","1,049,795.19"
02-Mar-2022,Tax,00.00,"104,979.52","944,815.67"
02-Mar-2022,Debit Card,00.00,"314,938.56","629,877.11"
02-Mar-2022,ATM,00.00,"209,959.04","419,918.07"
02-Mar-2022,Miscellaneous,00.00,"104,979.52","314,938.55"
03-Mar-2022,Miscellaneous,05.60,00.00,"314,944.15"
03-Mar-2022,ATM,840.00,00.00,"315,784.15"
03-Mar-2022,Miscellaneous,00.00,"31,578.42","284,205.74"
03-Mar-2022,Purchase,00.00,"40,600.82","243,604.92"
03-Mar-2022,IMPS,00.00,"30,450.62","213,154.31"
03-Mar-2022,Bill,00.80,00.00,"213,155.11"
03-Mar-2022,Cash,"28,970.00",00.00,"242,125.11"
03-Mar-2022,Purchase,94.20,00.00,"242,219.31"
04-Mar-2022,Commission,"17,078.90",00.00,"259,298.21"
04-Mar-2022,Debit Card,"24,024.00",00.00,"283,322.21"
04-Mar-2022,IMPS,00.00,"70,830.55","212,491.66"
04-Mar-2022,Miscellaneous,"169,899.97",00.00,"382,391.63"
04-Mar-2022,Cash,00.00,"42,487.96","339,903.67"
04-Mar-2022,RTGS,00.00,"67,980.73","271,922.94"
04-Mar-2022,NEFT,"25,851.00",00.00,"297,773.94"
04-Mar-2022,IMPS,00.00,"74,443.49","223,330.46"
04-Mar-2022,IMPS,00.00,"74,443.49","148,886.97"
04-Mar-2022,Tax,01.00,00.00,"148,887.97"
04-Mar-2022,Commission,00.00,"148,887.97",00.00
04-Mar-2022,Purchase,"2,657.59",00.00,"2,657.59"
04-Mar-2022,Cheque,"80,077.40",00.00,"82,734.99"
04-Mar-2022,RTGS,"224,985.00",00.00,"307,719.99"
04-Mar-2022,Cash,00.00,"30,772.00","276,947.99"
05-Mar-2022,Commission,00.00,"92,316.00","184,631.99"
05-Mar-2022,Cash,00.00,"46,158.00","138,473.99"
05-Mar-2022,Transfer,"10,160.20",00.00,"148,634.19"
05-Mar-2022,Purchase,402.00,00.00,"149,036.19"
05-Mar-2022,RTGS,"28,119.70",00.00,"177,155.89"
05-Mar-2022,Cheque,"236,832.20",00.00,"413,988.09"
05-Mar-2022,ATM,00.00,"413,988.09",00.00
05-Mar-2022,Bill,"2,949.00",00.00,"2,949.00"
05-Mar-2022,RTGS,"1,978.00",00.00,"4,927.00"
05-Mar-2022,ATM,00.00,"1,642.33","3,284.67"
05-Mar-2022,Purchase,677.00,00.00,"3,961.67"
05-Mar-2022,Cheque,227.90,00.00,"4,189.57"
05-Mar-2022,Reversal,730.97,00.00,"4,920.54"
05-Mar-2022,Transfer,00.00,492.05,"4,428.49"
05-Mar-2022,Miscellaneous,00.00,442.85,"3,985.64"
05-Mar-2022,Cheque,37.27,00.00,"4,022.91"
06-Mar-2022,NEFT,00.00,502.86,"3,520.05"
06-Mar-2022,Cheque,00.00,352.01,"3,168.04"
06-Mar-2022,Miscellaneous,"594,778.00",00.00,"597,946.04"
06-Mar-2022,Transfer,"435,372.00",00.00,"1,033,318.04"
06-Mar-2022,Cash,"16,097.87",00.00,"1,049,415.91"
06-Mar-2022,Transfer,00.00,"116,601.77","932,814.14"
06-Mar-2022,Reversal,00.00,"93,281.41","839,532.73"
06-Mar-2022,Cheque,179.00,00.00,"839,711.73"
06-Mar-2022,Cash,00.00,"279,903.91","559,807.82"
06-Mar-2022,Commission,"146,269.06",00.00,"706,076.88"
06-Mar-2022,NEFT,04.00,00.00,"706,080.88"
06-Mar-2022,RTGS,00.00,"141,216.18","564,864.70"
06-Mar-2022,Tax,"2,031.00",00.00,"566,895.70"
06-Mar-2022,Cash,00.00,"141,723.93","425,171.78"
06-Mar-2022,Tax,35.00,00.00,"425,206.78"
06-Mar-2022,NEFT,"2,133.20",00.00,"427,339.98"
06-Mar-2022,Debit Card,"9,388.00",00.00,"436,727.98"
06-Mar-2022,ATM,"89,991.81",00.00,"526,719.79"
06-Mar-2022,Interest,00.00,"263,359.90","263,359.90"
06-Mar-2022,Tax,"31,512.00",00.00,"294,871.90"
06-Mar-2022,Commission,579.00,00.00,"295,450.90"
06-Mar-2022,Tax,00.00,"49,241.82","246,209.08"
06-Mar-2022,Cheque,"917,897.00",00.00,"1,164,106.08"
06-Mar-2022,Purchase,"5,648.00",00.00,"1,169,754.08"
06-Mar-2022,ATM,00.00,"292,438.52","877,315.56"
06-Mar-2022,Purchase,00.00,"87,731.56","789,584.00"
06-Mar-2022,Tax,"10,932.20",00.00,"800,516.20"
06-Mar-2022,Transfer,00.00,"133,419.37","667,096.83"
06-Mar-2022,Transfer,00.00,"95,299.55","571,797.28"
06-Mar-2022,Bill,"2,368.00",00.00,"574,165.28"
06-Mar-2022,ATM,"173,669.90",00.00,"747,835.18"
06-Mar-2022,Reversal,00.00,"93,479.40","654,355.78"
06-Mar-2022,Cash,"1,515.50",00.00,"655,871.28"
06-Mar-2022,Debit Card,00.00,"218,623.76","437,247.52"
06-Mar-2022,Commission,00.00,"48,583.06","388,664.46"
06-Mar-2022,NEFT,"1,601.00",00.00,"390,265.46"
06-Mar-2022,Commission,"13,166.00",00.00,"403,431.46"
06-Mar-2022,NEFT,00.00,"40,343.15","363,088.31"
06-Mar-2022,IMPS,"1,015,637.20",00.00,"1,378,725.51"
06-Mar-2022,Interest,"20,813.88",00.00,"1,399,539.39"
06-Mar-2022,Miscellaneous,"11,427.00",00.00,"1,410,966.39"
06-Mar-2022,Tax,155.50,00.00,"1,411,121.89"
06-Mar-2022,Debit Card,"1,269,080.20",00.00,"2,680,202.09"
06-Mar-2022,Cash,00.00,"268,020.21","2,412,181.88"
06-Mar-2022,Miscellaneous,10.60,00.00,"2,412,192.48"
06-Mar-2022,Miscellaneous,"1,241.00",00.00,"2,413,433.48"
06-Mar-2022,Debit Card,"869,883.00",00.00,"3,283,316.48"
06-Mar-2022,Interest,549.00,00.00,"3,283,865.48"
06-Mar-2022,ATM,41.00,00.00,"3,283,906.48"
06-Mar-2022,Debit Card,"1,069,718.50",00.00,"4,353,624.98"
06-Mar-2022,Commission,00.00,"621,946.43","3,731,678.55"
06-Mar-2022,Tax,"219,870.00",00.00,"3,951,548.55"
06-Mar-2022,Cash,443.80,00.00,"3,951,992.35"
06-Mar-2022,ATM,372.00,00.00,"3,952,364.35"
06-Mar-2022,Cash,00.00,"1,317,454.78","2,634,909.57"
06-Mar-2022,Tax,00.00,"292,767.73","2,342,141.84"
06-Mar-2022,Commission,"1,680,334.75",00.00,"4,022,476.59"
06-Mar-2022,Tax,"965,740.50",00.00,"4,988,217.09"
06-Mar-2022,IMPS,00.00,"997,643.42","3,990,573.67"
06-Mar-2022,Purchase,"5,484.75",00.00,"3,996,058.42"
06-Mar-2022,Purchase,"1,478,690.00",00.00,"5,474,748.42"
06-Mar-2022,Reversal,"1,710.40",00.00,"5,476,458.82"
07-Mar-2022,Debit Card,"3,681.00",00.00,"5,480,139.82"
07-Mar-2022,Tax,"5,672.00",00.00,"5,485,811.82"
07-Mar-2022,Bill,"1,412,372.80",00.00,"6,898,184.62"
07-Mar-2022,Tax,00.00,"6,898,184.62",00.00
07-Mar-2022,Cash,"2,474.27",00.00,"2,474.27"
07-Mar-2022,Interest,"21,273.00",00.00,"23,747.27"
07-Mar-2022,Reversal,00.00,"11,873.64","11,873.64"
07-Mar-2022,Reversal,00.00,"1,319.29","10,554.35"
07-Mar-2022,Tax,00.00,"1,319.29","9,235.06"
07-Mar-2022,Debit Card,00.00,"1,154.38","8,080.68"
07-Mar-2022,Commission,00.00,"2,020.17","6,060.51"
07-Mar-2022,Commission,"1,086.00",00.00,"7,146.51"
07-Mar-2022,Reversal,00.00,714.65,"6,431.86"
07-Mar-2022,NEFT,"296,914.00",00.00,"303,345.86"
07-Mar-2022,Transfer,"3,439.80",00.00,"306,785.66"
07-Mar-2022,Bill,49.02,00.00,"306,834.68"
07-Mar-2022,Tax,00.00,"102,278.23","204,556.45"
07-Mar-2022,Bill,00.00,"34,092.74","170,463.71"
07-Mar-2022,Interest,00.00,"170,463.71",00.00
07-Mar-2022,Transfer,05.00,00.00,05.00
07-Mar-2022,Cheque,00.00,00.63,04.38
07-Mar-2022,Cash,84.99,00.00,89.37
07-Mar-2022,Debit Card,00.00,11.17,78.20
07-Mar-2022,Purchase,00.00,39.10,39.10
07-Mar-2022,Miscellaneous,00.00,19.55,19.55
07-Mar-2022,Reversal,00.00,19.55,00.00
07-Mar-2022,Transfer,04.12,00.00,04.12
07-Mar-2022,Cash,"2,298.40",00.00,"2,302.52"
07-Mar-2022,Cash,00.00,767.51,"1,535.01"
08-Mar-2022,RTGS,00.00,219.29,"1,315.72"
08-Mar-2022,Cash,668.61,00.00,"1,984.33"
08-Mar-2022,Purchase,00.00,992.17,992.16
08-Mar-2022,RTGS,03.50,00.00,995.66
08-Mar-2022,ATM,00.00,165.94,829.72
08-Mar-2022,Bill,"118,118.00",00.00,"118,947.72"
09-Mar-2022,RTGS,259.55,00.00,"119,207.27"
09-Mar-2022,RTGS,00.00,"39,735.76","79,471.51"
09-Mar-2022,IMPS,05.86,00.00,"79,477.37"
09-Mar-2022,IMPS,217.60,00.00,"79,694.97"
09-Mar-2022,Bill,00.00,"15,938.99","63,755.98"
09-Mar-2022,Bill,"14,954.10",00.00,"78,710.08"
09-Mar-2022,Reversal,03.00,00.00,"78,713.08"
09-Mar-2022,Bill,"2,019,570.80",00.00,"2,098,283.88"
09-Mar-2022,Commission,00.00,"1,049,141.94","1,049,141.94"
09-Mar-2022,IMPS,29.52,00.00,"1,049,171.46"
10-Mar-2022,Miscellaneous,00.00,"116,574.61","932,596.85"
10-Mar-2022,Interest,00.00,"310,865.62","621,731.23"
10-Mar-2022,Transfer,275.74,00.00,"622,006.97"
10-Mar-2022,Transfer,05.00,00.00,"622,011.97"
10-Mar-2022,RTGS,"128,283.00",00.00,"750,294.97"
10-Mar-2022,Cash,00.00,"187,573.74","562,721.23"
10-Mar-2022,Cash,02.40,00.00,"562,723.63"
10-Mar-2022,ATM,00.00,"281,361.82","281,361.82"
10-Mar-2022,Purchase,00.00,"40,194.55","241,167.27"
10-Mar-2022,Bill,"2,641.10",00.00,"243,808.37"
10-Mar-2022,IMPS,00.00,"40,634.73","203,173.64"
10-Mar-2022,Cash,"1,813,073.25",00.00,"2,016,246.89"
10-Mar-2022,Reversal,"6,216.00",00.00,"2,022,462.89"
10-Mar-2022,Tax,00.00,"674,154.30","1,348,308.59"
10-Mar-2022,RTGS,00.00,"1,348,308.59",00.00
10-Mar-2022,RTGS,"153,754.53",00.00,"153,754.53"
10-Mar-2022,Purchase,00.00,"76,877.27","76,877.26"
10-Mar-2022,ATM,00.00,"9,609.66","67,267.60"
10-Mar-2022,Cash,333.00,00.00,"67,600.60"
10-Mar-2022,Miscellaneous,00.00,"67,600.60",00.00
10-Mar-2022,ATM,"1,446,337.00",00.00,"1,446,337.00"
10-Mar-2022,ATM,"946,501.00",00.00,"2,392,838.00"
10-Mar-2022,NEFT,592.70,00.00,"2,393,430.70"
10-Mar-2022,Commission,"2,075.00",00.00,"2,395,505.70"
10-Mar-2022,Interest,"102,657.50",00.00,"2,498,163.20"
10-Mar-2022,Transfer,00.00,"2,498,163.20",00.00
10-Mar-2022,Debit Card,"11,484.00",00.00,"11,484.00"
10-Mar-2022,Reversal,"1,746.06",00.00,"13,230.06"
10-Mar-2022,Commission,00.00,"1,653.76","11,576.30"
10-Mar-2022,NEFT,49.00,00.00,"11,625.30"
10-Mar-2022,Bill,00.00,"1,291.70","10,333.60"
10-Mar-2022,NEFT,00.00,"1,291.70","9,041.90"
10-Mar-2022,Debit Card,54.00,00.00,"9,095.90"
10-Mar-2022,Commission,104.00,00.00,"9,199.90"
10-Mar-2022,Transfer,00.00,"2,299.98","6,899.92"
10-Mar-2022,Reversal,04.60,00.00,"6,904.52"
10-Mar-2022,ATM,"2,090.34",00.00,"8,994.86"
10-Mar-2022,Debit Card,"1,105.70",00.00,"10,100.56"
10-Mar-2022,NEFT,"1,762.80",00.00,"11,863.36"
10-Mar-2022,Miscellaneous,"1,038,086.00",00.00,"1,049,949.36"
10-Mar-2022,Reversal,00.00,"524,974.68","524,974.68"
10-Mar-2022,Tax,12.60,00.00,"524,987.28"
10-Mar-2022,Cash,354.11,00.00,"525,341.39"
11-Mar-2022,Tax,964.00,00.00,"526,305.39"
11-Mar-2022,Cash,00.00,"263,152.70","263,152.70"
11-Mar-2022,RTGS,06.40,00.00,"263,159.10"
11-Mar-2022,Purchase,00.00,"43,859.85","219,299.25"
11-Mar-2022,Cash,00.00,"219,299.25",00.00
11-Mar-2022,RTGS,149.75,00.00,149.75
11-Mar-2022,Interest,112.00,00.00,261.75
11-Mar-2022,Debit Card,"142,490.00",00.00,"142,751.75"
11-Mar-2022,IMPS,03.00,00.00,"142,754.75"
11-Mar-2022,Cash,"618,905.00",00.00,"761,659.75"
11-Mar-2022,ATM,03.00,00.00,"761,662.75"
11-Mar-2022,Commission,00.00,"761,662.75",00.00
11-Mar-2022,ATM,721.16,00.00,721.16
11-Mar-2022,Interest,192.31,00.00,913.47
11-Mar-2022,Bill,"1,505,264.00",00.00,"1,506,177.47"
12-Mar-2022,IMPS,"106,701.00",00.00,"1,612,878.47"
12-Mar-2022,NEFT,"101,046.66",00.00,"1,713,925.13"
12-Mar-2022,Bill,00.00,"244,846.45","1,469,078.68"
12-Mar-2022,Cash,00.00,"489,692.89","979,385.79"
12-Mar-2022,Interest,00.00,"97,938.58","881,447.21"
12-Mar-2022,IMPS,"21,278.88",00.00,"902,726.09"
12-Mar-2022,Purchase,00.00,"100,302.90","802,423.19"
12-Mar-2022,Transfer,25.00,00.00,"802,448.19"
12-Mar-2022,ATM,00.00,"802,448.19",00.00
12-Mar-2022,Transfer,332.27,00.00,332.27
12-Mar-2022,Bill,00.00,83.07,249.20
12-Mar-2022,Purchase,04.10,00.00,253.30
12-Mar-2022,NEFT,363.70,00.00,617.00
12-Mar-2022,Cheque,41.00,00.00,658.00
12-Mar-2022,Debit Card,"91,466.00",00.00,"92,124.00"
12-Mar-2022,Transfer,00.00,"46,062.00","46,062.00"
12-Mar-2022,Cash,00.00,"11,515.50","34,546.50"
12-Mar-2022,IMPS,00.00,"3,454.65","31,091.85"
12-Mar-2022,ATM,00.00,"4,441.69","26,650.16"
12-Mar-2022,Debit Card,"3,570.09",00.00,"30,220.25"
12-Mar-2022,Purchase,00.00,"3,022.03","27,198.22"
12-Mar-2022,Reversal,"1,143,300.20",00.00,"1,170,498.42"
12-Mar-2022,Cheque,"1,730,246.00",00.00,"2,900,744.42"
12-Mar-2022,Interest,02.54,00.00,"2,900,746.96"
12-Mar-2022,Bill,00.00,"414,392.42","2,486,354.54"
12-Mar-2022,Cash,"94,757.00",00.00,"2,581,111.54"
12-Mar-2022,Bill,00.00,"1,290,555.77","1,290,555.77"
12-Mar-2022,ATM,00.00,"645,277.89","645,277.88"
12-Mar-2022,Miscellaneous,00.00,"161,319.47","483,958.41"
12-Mar-2022,NEFT,00.00,"48,395.84","435,562.57"
12-Mar-2022,Transfer,"1,780.90",00.00,"437,343.47"
12-Mar-2022,Reversal,"451,335.80",00.00,"888,679.27"
12-Mar-2022,Reversal,00.00,"222,169.82","666,509.45"
12-Mar-2022,Purchase,00.00,"666,509.45",00.00
12-Mar-2022,Cheque,"1,074,087.00",00.00,"1,074,087.00"
12-Mar-2022,Commission,00.00,"268,521.75","805,565.25"
12-Mar-2022,Debit Card,"564,472.50",00.00,"1,370,037.75"
12-Mar-2022,Cash,00.00,"152,226.42","1,217,811.33"
12-Mar-2022,Miscellaneous,00.00,"202,968.56","1,014,842.78"
12-Mar-2022,Cheque,00.00,"169,140.46","845,702.32"
12-Mar-2022,Purchase,"448,467.50",00.00,"1,294,169.82"
12-Mar-2022,ATM,"21,279.80",00.00,"1,315,449.62"
12-Mar-2022,NEFT,"228,491.60",00.00,"1,543,941.22"
12-Mar-2022,IMPS,437.00,00.00,"1,544,378.22"
12-Mar-2022,Debit Card,07.15,00.00,"1,544,385.37"
12-Mar-2022,IMPS,"655,414.00",00.00,"2,199,799.37"
12-Mar-2022,Cheque,"2,048,808.00",00.00,"4,248,607.37"
12-Mar-2022,Cash,00.00,"1,062,151.84","3,186,455.53"
12-Mar-2022,Debit Card,00.00,"1,062,151.84","2,124,303.69"
12-Mar-2022,NEFT,00.00,"236,033.74","1,888,269.95"
12-Mar-2022,Transfer,32.20,00.00,"1,888,302.15"
12-Mar-2022,RTGS,00.00,"629,434.05","1,258,868.10"
12-Mar-2022,Cheque,"28,568.60",00.00,"1,287,436.70"
12-Mar-2022,Tax,364.29,00.00,"1,287,800.99"
12-Mar-2022,Miscellaneous,00.00,"257,560.20","1,030,240.79"
12-Mar-2022,Cheque,00.00,"128,780.10","901,460.69"
12-Mar-2022,Cash,00.00,"128,780.10","772,680.59"
12-Mar-2022,Reversal,00.00,"110,382.94","662,297.65"
12-Mar-2022,RTGS,00.00,"66,229.77","596,067.88"
12-Mar-2022,Cheque,00.00,"198,689.29","397,378.59"
12-Mar-2022,NEFT,"123,002.00",00.00,"520,380.59"
12-Mar-2022,Miscellaneous,00.00,"65,047.57","455,333.02"
12-Mar-2022,NEFT,00.00,"113,833.26","341,499.76"
12-Mar-2022,Bill,143.40,00.00,"341,643.16"
13-Mar-2022,RTGS,00.00,"37,960.35","303,682.81"
13-Mar-2022,IMPS,00.00,"101,227.60","202,455.21"
13-Mar-2022,Miscellaneous,182.00,00.00,"202,637.21"
13-Mar-2022,NEFT,"32,810.34",00.00,"235,447.55"
13-Mar-2022,Purchase,00.00,"39,241.26","196,206.29"
13-Mar-2022,Debit Card,86.81,00.00,"196,293.10"
13-Mar-2022,Cheque,06.90,00.00,"196,300.00"
13-Mar-2022,Interest,"17,541.00",00.00,"213,841.00"
13-Mar-2022,Bill,"1,519,916.00",00.00,"1,733,757.00"
14-Mar-2022,Debit Card,00.00,"433,439.25","1,300,317.75"
14-Mar-2022,Transfer,00.00,"162,539.72","1,137,778.03"
14-Mar-2022,Cash,"90,520.80",00.00,"1,228,298.83"
14-Mar-2022,Tax,00.00,"153,537.35","1,074,761.48"
14-Mar-2022,Purchase,00.00,"358,253.83","716,507.65"
14-Mar-2022,RTGS,412.00,00.00,"716,919.65"
14-Mar-2022,Bill,00.00,"119,486.61","597,433.04"
14-Mar-2022,IMPS,"271,298.00",00.00,"868,731.04"
14-Mar-2022,ATM,00.00,"144,788.51","723,942.53"
14-Mar-2022,Bill,"11,877.70",00.00,"735,820.23"
14-Mar-2022,ATM,"20,433.00",00.00,"756,253.23"
14-Mar-2022,Reversal,00.00,"378,126.62","378,126.62"
14-Mar-2022,RTGS,"88,038.50",00.00,"466,165.12"
14-Mar-2022,Transfer,00.00,"466,165.12",00.00
14-Mar-2022,IMPS,"843,441.75",00.00,"843,441.75"
14-Mar-2022,RTGS,00.00,"210,860.44","632,581.31"
14-Mar-2022,Purchase,00.00,"63,258.13","569,323.18"
14-Mar-2022,Commission,00.00,"94,887.20","474,435.98"
14-Mar-2022,RTGS,06.00,00.00,"474,441.98"
14-Mar-2022,Bill,06.03,00.00,"474,448.01"
14-Mar-2022,Commission,00.00,"474,448.01",00.00
14-Mar-2022,Cash,"1,633,132.00",00.00,"1,633,132.00"
14-Mar-2022,RTGS,05.30,00.00,"1,633,137.30"
14-Mar-2022,Transfer,51.80,00.00,"1,633,189.10"
14-Mar-2022,RTGS,"1,464,957.00",00.00,"3,098,146.10"
14-Mar-2022,Miscellaneous,58.74,00.00,"3,098,204.84"
14-Mar-2022,RTGS,00.00,"774,551.21","2,323,653.63"
14-Mar-2022,Purchase,"148,405.10",00.00,"2,472,058.73"
14-Mar-2022,IMPS,00.00,"618,014.68","1,854,044.05"
14-Mar-2022,Tax,"837,858.00",00.00,"2,691,902.05"
14-Mar-2022,Commission,00.00,"269,190.21","2,422,711.84"
14-Mar-2022,NEFT,18.89,00.00,"2,422,730.73"
14-Mar-2022,Tax,00.00,"484,546.15","1,938,184.58"
14-Mar-2022,Tax,42.00,00.00,"1,938,226.58"
14-Mar-2022,Cash,"27,247.00",00.00,"1,965,473.58"
14-Mar-2022,Purchase,00.00,"196,547.36","1,768,926.22"
14-Mar-2022,NEFT,00.00,"589,642.07","1,179,284.15"
14-Mar-2022,Transfer,00.00,"196,547.36","982,736.79"
14-Mar-2022,IMPS,00.00,"245,684.20","737,052.59"
14-Mar-2022,Commission,00.00,"92,131.57","644,921.02"
14-Mar-2022,Commission,"3,527.10",00.00,"648,448.12"
14-Mar-2022,Interest,"4,072.00",00.00,"652,520.12"
14-Mar-2022,Cheque,"1,685,622.75",00.00,"2,338,142.87"
14-Mar-2022,Commission,"1,199,828.50",00.00,"3,537,971.37"
14-Mar-2022,ATM,86.10,00.00,"3,538,057.47"
14-Mar-2022,Miscellaneous,00.00,"1,179,352.49","2,358,704.98"
14-Mar-2022,IMPS,"29,151.00",00.00,"2,387,855.98"
14-Mar-2022,Cash,03.70,00.00,"2,387,859.68"
14-Mar-2022,Cheque,63.74,00.00,"2,387,923.42"
14-Mar-2022,Cash,"2,176.00",00.00,"2,390,099.42"
14-Mar-2022,NEFT,00.00,"2,390,099.42",00.00
14-Mar-2022,Interest,"7,413.00",00.00,"7,413.00"
14-Mar-2022,Tax,00.00,823.67,"6,589.33"
14-Mar-2022,Debit Card,"2,308.13",00.00,"8,897.46"
14-Mar-2022,NEFT,"29,321.97",00.00,"38,219.43"
14-Mar-2022,Cheque,00.00,"4,246.60","33,972.83"
14-Mar-2022,Commission,00.00,"16,986.42","16,986.42"
14-Mar-2022,Reversal,00.00,"1,698.64","15,287.78"
14-Mar-2022,Debit Card,00.00,"2,183.97","13,103.81"
14-Mar-2022,Cheque,00.30,00.00,"13,104.11"
14-Mar-2022,Tax,01.39,00.00,"13,105.50"
14-Mar-2022,Bill,08.00,00.00,"13,113.50"
14-Mar-2022,Miscellaneous,"182,891.00",00.00,"196,004.50"
14-Mar-2022,ATM,00.00,"28,000.64","168,003.86"
14-Mar-2022,RTGS,00.00,"21,000.48","147,003.38"
14-Mar-2022,Reversal,"1,892.00",00.00,"148,895.38"
14-Mar-2022,Debit Card,61.98,00.00,"148,957.36"
14-Mar-2022,Bill,23.30,00.00,"148,980.66"
14-Mar-2022,RTGS,"247,103.80",00.00,"396,084.46"
14-Mar-2022,Purchase,00.50,00.00,"396,084.96"
14-Mar-2022,Cash,38.20,00.00,"396,123.16"
14-Mar-2022,ATM,00.00,"39,612.32","356,510.84"
14-Mar-2022,Miscellaneous,00.00,"59,418.47","297,092.37"
14-Mar-2022,Debit Card,00.00,"99,030.79","198,061.58"
14-Mar-2022,Commission,04.20,00.00,"198,065.78"
14-Mar-2022,Bill,00.00,"22,007.31","176,058.47"
14-Mar-2022,Cash,00.00,"17,605.85","158,452.62"
14-Mar-2022,RTGS,"3,409.00",00.00,"161,861.62"
14-Mar-2022,Commission,00.00,"161,861.62",00.00
14-Mar-2022,Transfer,"25,502.12",00.00,"25,502.12"
14-Mar-2022,NEFT,"2,672.00",00.00,"28,174.12"
14-Mar-2022,Miscellaneous,"26,019.27",00.00,"54,193.39"
14-Mar-2022,Debit Card,00.00,"27,096.70","27,096.70"
14-Mar-2022,Cash,00.00,"9,032.23","18,064.47"
14-Mar-2022,NEFT,"2,892.60",00.00,"20,957.07"
14-Mar-2022,Debit Card,00.00,"4,191.41","16,765.66"
14-Mar-2022,Interest,00.00,"4,191.42","12,574.24"
14-Mar-2022,Purchase,"25,260.50",00.00,"37,834.74"
14-Mar-2022,Reversal,00.00,"12,611.58","25,223.16"
14-Mar-2022,RTGS,08.00,00.00,"25,231.16"
14-Mar-2022,Debit Card,00.00,"2,523.12","22,708.04"
14-Mar-2022,Interest,00.00,"2,838.51","19,869.54"
14-Mar-2022,Transfer,00.58,00.00,"19,870.12"
14-Mar-2022,RTGS,16.24,00.00,"19,886.36"
14-Mar-2022,Miscellaneous,00.00,"3,977.27","15,909.09"
14-Mar-2022,ATM,00.00,"2,272.73","13,636.36"
14-Mar-2022,NEFT,00.00,"1,363.64","12,272.72"
14-Mar-2022,Cash,00.00,"1,363.64","10,909.08"
14-Mar-2022,IMPS,104.49,00.00,"11,013.57"
14-Mar-2022,Purchase,"21,647.00",00.00,"32,660.57"
14-Mar-2022,Interest,00.00,"16,330.29","16,330.28"
14-Mar-2022,Interest,00.00,"1,633.03","14,697.25"
14-Mar-2022,RTGS,00.00,"14,697.25",00.00
14-Mar-2022,Cash,149.00,00.00,149.00
14-Mar-2022,NEFT,"94,255.16",00.00,"94,404.16"
14-Mar-2022,Bill,"2,881.00",00.00,"97,285.16"
14-Mar-2022,NEFT,00.00,"16,214.19","81,070.97"
14-Mar-2022,Reversal,00.00,"11,581.57","69,489.40"
14-Mar-2022,Transfer,00.00,"13,897.88","55,591.52"
14-Mar-2022,Cash,00.00,"9,265.25","46,326.27"
14-Mar-2022,Purchase,00.00,"7,721.05","38,605.22"
14-Mar-2022,Transfer,00.00,"38,605.22",00.00
14-Mar-2022,Miscellaneous,309.00,00.00,309.00
14-Mar-2022,Debit Card,00.00,309.00,00.00
14-Mar-2022,Commission,46.00,00.00,46.00
14-Mar-2022,NEFT,"1,063,386.50",00.00,"1,063,432.50"
14-Mar-2022,Cash,255.00,00.00,"1,063,687.50"
14-Mar-2022,ATM,56.00,00.00,"1,063,743.50"
14-Mar-2022,Tax,00.00,"354,581.17","709,162.33"
14-Mar-2022,Debit Card,20.00,00.00,"709,182.33"
14-Mar-2022,Bill,00.00,"70,918.23","638,264.10"
15-Mar-2022,RTGS,00.00,"91,180.59","547,083.51"
15-Mar-2022,ATM,00.00,"60,787.06","486,296.45"
15-Mar-2022,Cash,03.00,00.00,"486,299.45"
15-Mar-2022,Transfer,13.18,00.00,"486,312.63"
15-Mar-2022,Cheque,04.80,00.00,"486,317.43"
15-Mar-2022,Bill,"28,822.10",00.00,"515,139.53"
15-Mar-2022,Miscellaneous,00.00,"57,237.73","457,901.80"
15-Mar-2022,Reversal,"26,311.70",00.00,"484,213.50"
15-Mar-2022,Cheque,"2,612.00",00.00,"486,825.50"
16-Mar-2022,Interest,02.31,00.00,"486,827.81"
16-Mar-2022,Cheque,"1,280,518.50",00.00,"1,767,346.31"
16-Mar-2022,Miscellaneous,"2,929.60",00.00,"1,770,275.91"
16-Mar-2022,IMPS,"31,468.00",00.00,"1,801,743.91"
16-Mar-2022,Cash,"949,003.75",00.00,"2,750,747.66"
16-Mar-2022,Cheque,05.40,00.00,"2,750,753.06"
16-Mar-2022,Purchase,124.00,00.00,"2,750,877.06"
16-Mar-2022,Commission,122.00,00.00,"2,750,999.06"
16-Mar-2022,Cheque,00.00,"458,499.84","2,292,499.22"
16-Mar-2022,Purchase,00.00,"254,722.14","2,037,777.08"
16-Mar-2022,Bill,"108,338.53",00.00,"2,146,115.61"
17-Mar-2022,Cash,01.30,00.00,"2,146,116.91"
17-Mar-2022,NEFT,00.00,"1,073,058.46","1,073,058.46"
17-Mar-2022,ATM,00.00,"107,305.85","965,752.61"
17-Mar-2022,Interest,"159,446.90",00.00,"1,125,199.51"
17-Mar-2022,Reversal,00.00,"1,125,199.51",00.00
17-Mar-2022,Cheque,260.00,00.00,260.00
17-Mar-2022,ATM,00.00,28.89,231.11
17-Mar-2022,Commission,00.00,23.11,208.00
17-Mar-2022,Cheque,23.60,00.00,231.60
18-Mar-2022,Interest,00.00,57.90,173.70
18-Mar-2022,Purchase,"7,239.20",00.00,"7,412.90"
18-Mar-2022,Tax,00.00,926.61,"6,486.29"
18-Mar-2022,Bill,387.42,00.00,"6,873.71"
18-Mar-2022,Miscellaneous,"53,305.34",00.00,"60,179.05"
18-Mar-2022,Interest,00.00,"7,522.38","52,656.67"
18-Mar-2022,Cash,00.00,"26,328.34","26,328.34"
18-Mar-2022,ATM,00.00,"13,164.17","13,164.17"
18-Mar-2022,Bill,"1,788,573.80",00.00,"1,801,737.97"
19-Mar-2022,NEFT,707.94,00.00,"1,802,445.91"
19-Mar-2022,Transfer,"29,872.00",00.00,"1,832,317.91"
19-Mar-2022,Purchase,"16,717.70",00.00,"1,849,035.61"
19-Mar-2022,Cheque,"254,594.10",00.00,"2,103,629.71"
19-Mar-2022,Transfer,"31,585.00",00.00,"2,135,214.71"
19-Mar-2022,Tax,00.00,"711,738.24","1,423,476.47"
19-Mar-2022,Debit Card,00.00,"711,738.24","711,738.24"
19-Mar-2022,Commission,00.00,"118,623.04","593,115.20"
19-Mar-2022,Miscellaneous,00.00,"65,901.69","527,213.51"
19-Mar-2022,Bill,00.00,"131,803.38","395,410.13"
19-Mar-2022,Purchase,00.00,"65,901.69","329,508.44"
19-Mar-2022,Transfer,03.09,00.00,"329,511.53"
19-Mar-2022,NEFT,00.00,"329,511.53",00.00
19-Mar-2022,Cheque,"2,366.09",00.00,"2,366.09"
19-Mar-2022,IMPS,00.00,473.22,"1,892.87"
19-Mar-2022,Interest,326.80,00.00,"2,219.67"
19-Mar-2022,IMPS,170.97,00.00,"2,390.64"
19-Mar-2022,Cash,00.00,478.13,"1,912.51"
19-Mar-2022,Commission,00.00,382.50,"1,530.01"
19-Mar-2022,Tax,00.00,510.00,"1,020.01"
19-Mar-2022,Reversal,"1,889,930.00",00.00,"1,890,950.01"
20-Mar-2022,ATM,49.30,00.00,"1,890,999.31"
20-Mar-2022,RTGS,00.00,"189,099.93","1,701,899.38"
20-Mar-2022,Interest,"2,392.00",00.00,"1,704,291.38"
21-Mar-2022,Purchase,00.00,"568,097.13","1,136,194.25"
21-Mar-2022,Reversal,"22,025.80",00.00,"1,158,220.05"
22-Mar-2022,Bill,00.00,"1,158,220.05",00.00
22-Mar-2022,NEFT,"1,472,994.80",00.00,"1,472,994.80"
22-Mar-2022,Purchase,"19,181.51",00.00,"1,492,176.31"
22-Mar-2022,Cheque,00.00,"186,522.04","1,305,654.27"
22-Mar-2022,Bill,00.00,"435,218.09","870,436.18"
22-Mar-2022,Interest,00.65,00.00,"870,436.83"
22-Mar-2022,Reversal,"9,541.00",00.00,"879,977.83"
22-Mar-2022,RTGS,00.00,"125,711.12","754,266.71"
22-Mar-2022,Bill,00.00,"251,422.24","502,844.47"
22-Mar-2022,Debit Card,00.00,"502,844.47",00.00
22-Mar-2022,Debit Card,"15,419.00",00.00,"15,419.00"
22-Mar-2022,Reversal,36.50,00.00,"15,455.50"
22-Mar-2022,Reversal,00.00,"1,545.55","13,909.95"
22-Mar-2022,Bill,05.00,00.00,"13,914.95"
22-Mar-2022,Commission,00.00,"2,782.99","11,131.96"
22-Mar-2022,Cheque,493.60,00.00,"11,625.56"
22-Mar-2022,Bill,00.00,"2,325.11","9,300.45"
22-Mar-2022,Reversal,"1,565,934.80",00.00,"1,575,235.25"
22-Mar-2022,Commission,664.27,00.00,"1,575,899.52"
22-Mar-2022,Cheque,"1,468,100.25",00.00,"3,043,999.77"
22-Mar-2022,Reversal,00.00,"3,043,999.77",00.00
22-Mar-2022,Tax,"3,175.00",00.00,"3,175.00"
22-Mar-2022,Debit Card,57.00,00.00,"3,232.00"
22-Mar-2022,Interest,00.00,404.00,"2,828.00"
22-Mar-2022,Interest,10.20,00.00,"2,838.20"
22-Mar-2022,Cash,"24,856.82",00.00,"27,695.02"
22-Mar-2022,Cheque,00.00,"4,615.84","23,079.18"
22-Mar-2022,IMPS,"196,469.00",00.00,"219,548.18"
22-Mar-2022,ATM,39.38,00.00,"219,587.56"
22-Mar-2022,RTGS,39.72,00.00,"219,627.28"
22-Mar-2022,Miscellaneous,00.00,"109,813.64","109,813.64"
22-Mar-2022,Reversal,00.00,"36,604.55","73,209.09"
22-Mar-2022,IMPS,00.00,"36,604.55","36,604.54"
22-Mar-2022,Reversal,00.00,"18,302.27","18,302.27"
22-Mar-2022,Purchase,00.00,"2,614.61","15,687.66"
23-Mar-2022,Tax,00.00,"2,241.09","13,446.57"
23-Mar-2022,Transfer,"30,014.25",00.00,"43,460.82"
23-Mar-2022,Tax,"658,637.75",00.00,"702,098.57"
23-Mar-2022,Purchase,00.00,"70,209.86","631,888.71"
23-Mar-2022,Miscellaneous,00.00,"631,888.71",00.00
23-Mar-2022,Transfer,"2,353.56",00.00,"2,353.56"
23-Mar-2022,Bill,"4,353.00",00.00,"6,706.56"
23-Mar-2022,Cheque,00.00,745.17,"5,961.39"
23-Mar-2022,ATM,00.00,"1,192.28","4,769.11"
23-Mar-2022,IMPS,"436,712.00",00.00,"441,481.11"
23-Mar-2022,Cash,00.00,"49,053.46","392,427.65"
23-Mar-2022,Cash,"625,450.00",00.00,"1,017,877.65"
23-Mar-2022,Commission,00.00,"127,234.71","890,642.94"
23-Mar-2022,Bill,"2,485.16",00.00,"893,128.10"
23-Mar-2022,IMPS,"1,612.51",00.00,"894,740.61"
23-Mar-2022,Miscellaneous,00.00,"99,415.62","795,324.99"
23-Mar-2022,Cash,00.00,"132,554.17","662,770.82"
23-Mar-2022,Commission,"3,336.00",00.00,"666,106.82"
23-Mar-2022,Reversal,02.00,00.00,"666,108.82"
24-Mar-2022,IMPS,00.00,"166,527.21","499,581.62"
24-Mar-2022,Purchase,"14,101.99",00.00,"513,683.61"
24-Mar-2022,IMPS,07.00,00.00,"513,690.61"
24-Mar-2022,Miscellaneous,05.75,00.00,"513,696.36"
24-Mar-2022,Purchase,00.00,"102,739.27","410,957.09"
24-Mar-2022,Transfer,00.00,"58,708.16","352,248.93"
24-Mar-2022,Transfer,"212,308.00",00.00,"564,556.93"
24-Mar-2022,Purchase,"7,355.50",00.00,"571,912.43"
24-Mar-2022,RTGS,"22,495.00",00.00,"594,407.43"
24-Mar-2022,RTGS,00.00,"148,601.86","445,805.57"
24-Mar-2022,Cash,00.00,"445,805.57",00.00
24-Mar-2022,RTGS,"385,554.75",00.00,"385,554.75"
24-Mar-2022,RTGS,"2,678.03",00.00,"388,232.78"
24-Mar-2022,Miscellaneous,00.00,"64,705.46","323,527.32"
24-Mar-2022,Cheque,00.00,"64,705.46","258,821.86"
24-Mar-2022,NEFT,00.00,"64,705.47","194,116.40"
24-Mar-2022,Miscellaneous,08.00,00.00,"194,124.40"
24-Mar-2022,ATM,00.90,00.00,"194,125.30"
24-Mar-2022,RTGS,00.00,"64,708.43","129,416.87"
24-Mar-2022,IMPS,57.00,00.00,"129,473.87"
24-Mar-2022,Interest,00.00,"12,947.39","116,526.48"
24-Mar-2022,Cash,"1,062,286.00",00.00,"1,178,812.48"
24-Mar-2022,ATM,00.00,"168,401.78","1,010,410.70"
24-Mar-2022,Transfer,00.00,"202,082.14","808,328.56"
24-Mar-2022,RTGS,11.00,00.00,"808,339.56"
24-Mar-2022,RTGS,"744,817.25",00.00,"1,553,156.81"
24-Mar-2022,RTGS,"1,714,219.00",00.00,"3,267,375.81"
24-Mar-2022,ATM,39.32,00.00,"3,267,415.13"
24-Mar-2022,Cash,00.00,"363,046.13","2,904,369.00"
24-Mar-2022,Commission,00.00,"322,707.67","2,581,661.33"
24-Mar-2022,Commission,"1,941.60",00.00,"2,583,602.93"
24-Mar-2022,Transfer,00.00,"258,360.29","2,325,242.64"
24-Mar-2022,Interest,"18,046.00",00.00,"2,343,288.64"
24-Mar-2022,RTGS,00.00,"1,171,644.32","1,171,644.32"
25-Mar-2022,Cash,00.00,"390,548.11","781,096.21"
25-Mar-2022,Transfer,00.00,"78,109.62","702,986.59"
25-Mar-2022,Transfer,00.00,"175,746.65","527,239.94"
25-Mar-2022,Miscellaneous,00.00,"263,619.97","263,619.97"
25-Mar-2022,Tax,"42,566.00",00.00,"306,185.97"
25-Mar-2022,Reversal,00.00,"153,092.99","153,092.98"
25-Mar-2022,Commission,04.70,00.00,"153,097.68"
26-Mar-2022,Cash,"1,525,565.00",00.00,"1,678,662.68"
26-Mar-2022,Tax,19.00,00.00,"1,678,681.68"
26-Mar-2022,Commission,00.00,"239,811.67","1,438,870.01"
26-Mar-2022,Debit Card,00.00,"359,717.50","1,079,152.51"
26-Mar-2022,Bill,02.95,00.00,"1,079,155.46"
26-Mar-2022,Interest,00.00,"539,577.73","539,577.73"
26-Mar-2022,ATM,00.00,"67,447.22","472,130.51"
26-Mar-2022,Miscellaneous,00.00,"472,130.51",00.00
26-Mar-2022,Miscellaneous,"163,964.41",00.00,"163,964.41"
26-Mar-2022,Reversal,"16,985.62",00.00,"180,950.03"
26-Mar-2022,Transfer,00.00,"25,850.00","155,100.03"
26-Mar-2022,Interest,"860,606.00",00.00,"1,015,706.03"
26-Mar-2022,ATM,00.00,"145,100.86","870,605.17"
26-Mar-2022,NEFT,00.00,"870,605.17",00.00
26-Mar-2022,Debit Card,427.40,00.00,427.40
26-Mar-2022,Interest,00.00,53.43,373.98
26-Mar-2022,Reversal,00.00,62.33,311.65
26-Mar-2022,Commission,"1,723,907.00",00.00,"1,724,218.65"
26-Mar-2022,NEFT,00.00,"287,369.78","1,436,848.88"
26-Mar-2022,Miscellaneous,00.05,00.00,"1,436,848.93"
26-Mar-2022,Transfer,"10,330.20",00.00,"1,447,179.13"
26-Mar-2022,Tax,"202,178.00",00.00,"1,649,357.13"
26-Mar-2022,Miscellaneous,"974,985.80",00.00,"2,624,342.93"
26-Mar-2022,Transfer,00.00,"1,312,171.47","1,312,171.47"
26-Mar-2022,NEFT,05.00,00.00,"1,312,176.47"
26-Mar-2022,Tax,00.91,00.00,"1,312,177.38"
26-Mar-2022,RTGS,"2,017.90",00.00,"1,314,195.28"
26-Mar-2022,ATM,960.00,00.00,"1,315,155.28"
26-Mar-2022,Commission,00.00,"1,315,155.28",00.00
26-Mar-2022,Commission,"2,248.00",00.00,"2,248.00"
26-Mar-2022,Cheque,00.00,"1,124.00","1,124.00"
26-Mar-2022,Interest,38.86,00.00,"1,162.86"
26-Mar-2022,RTGS,"1,891.30",00.00,"3,054.16"
26-Mar-2022,Commission,00.00,381.77,"2,672.39"
26-Mar-2022,Tax,"10,153.00",00.00,"12,825.39"
26-Mar-2022,ATM,"153,496.00",00.00,"166,321.39"
26-Mar-2022,Purchase,"1,574,616.00",00.00,"1,740,937.39"
26-Mar-2022,Bill,"201,423.25",00.00,"1,942,360.64"
26-Mar-2022,NEFT,04.34,00.00,"1,942,364.98"
26-Mar-2022,ATM,00.00,"215,818.33","1,726,546.65"
26-Mar-2022,Cheque,00.00,"431,636.66","1,294,909.99"
26-Mar-2022,Commission,"2,947.00",00.00,"1,297,856.99"
26-Mar-2022,Cash,00.00,"185,408.14","1,112,448.85"
27-Mar-2022,Reversal,00.00,"1,112,448.85",00.00
27-Mar-2022,Cash,"2,151.00",00.00,"2,151.00"
27-Mar-2022,ATM,402.22,00.00,"2,553.22"
27-Mar-2022,Bill,00.00,364.75,"2,188.47"
27-Mar-2022,Cheque,00.00,243.16,"1,945.31"
27-Mar-2022,Commission,00.00,648.44,"1,296.87"
27-Mar-2022,RTGS,00.00,324.22,972.65
27-Mar-2022,ATM,"1,156,431.00",00.00,"1,157,403.65"
27-Mar-2022,NEFT,"31,751.70",00.00,"1,189,155.35"
27-Mar-2022,Commission,49.26,00.00,"1,189,204.61"
27-Mar-2022,ATM,00.00,"237,840.92","951,363.69"
27-Mar-2022,IMPS,"20,359.00",00.00,"971,722.69"
27-Mar-2022,Transfer,00.00,"97,172.27","874,550.42"
27-Mar-2022,Commission,46.00,00.00,"874,596.42"
27-Mar-2022,Miscellaneous,932.00,00.00,"875,528.42"
27-Mar-2022,Miscellaneous,00.00,"87,552.84","787,975.58"
28-Mar-2022,Miscellaneous,"8,425.00",00.00,"796,400.58"
28-Mar-2022,RTGS,"253,450.25",00.00,"1,049,850.83"
28-Mar-2022,NEFT,"21,468.00",00.00,"1,071,318.83"
28-Mar-2022,Miscellaneous,"1,972,264.00",00.00,"3,043,582.83"
28-Mar-2022,Cheque,"16,407.46",00.00,"3,059,990.29"
28-Mar-2022,Cash,00.00,"1,529,995.15","1,529,995.14"
28-Mar-2022,Bill,00.00,"1,529,995.14",00.00
28-Mar-2022,Reversal,"28,329.40",00.00,"28,329.40"
28-Mar-2022,Purchase,00.00,"28,329.40",00.00
28-Mar-2022,Cash,29.79,00.00,29.79
28-Mar-2022,RTGS,"5,845.30",00.00,"5,875.09"
28-Mar-2022,ATM,00.00,"1,958.36","3,916.73"
28-Mar-2022,Purchase,"1,132.00",00.00,"5,048.73"
28-Mar-2022,Debit Card,00.00,504.87,"4,543.86"
28-Mar-2022,Cheque,00.00,454.39,"4,089.47"
28-Mar-2022,NEFT,05.12,00.00,"4,094.59"
28-Mar-2022,Reversal,00.00,682.43,"3,412.16"
28-Mar-2022,Interest,"246,506.78",00.00,"249,918.94"
28-Mar-2022,Reversal,322.00,00.00,"250,240.94"
28-Mar-2022,Debit Card,00.00,"35,748.71","214,492.23"
28-Mar-2022,Cheque,00.00,"71,497.41","142,994.82"
28-Mar-2022,Reversal,59.00,00.00,"143,053.82"
28-Mar-2022,Debit Card,00.00,"47,684.61","95,369.21"
28-Mar-2022,Interest,53.90,00.00,"95,423.11"
28-Mar-2022,ATM,"137,032.56",00.00,"232,455.67"
28-Mar-2022,Reversal,59.65,00.00,"232,515.32"
28-Mar-2022,Debit Card,00.00,"77,505.11","155,010.21"
28-Mar-2022,Transfer,"330,426.00",00.00,"485,436.21"
28-Mar-2022,IMPS,"2,779.81",00.00,"488,216.02"
29-Mar-2022,Interest,00.00,"488,216.02",00.00
29-Mar-2022,Miscellaneous,"10,590.00",00.00,"10,590.00"
29-Mar-2022,IMPS,19.10,00.00,"10,609.10"
29-Mar-2022,Miscellaneous,00.00,"1,326.14","9,282.96"
29-Mar-2022,Tax,"20,308.28",00.00,"29,591.24"
29-Mar-2022,Commission,"77,846.00",00.00,"107,437.24"
29-Mar-2022,NEFT,00.00,"26,859.31","80,577.93"
29-Mar-2022,RTGS,00.00,"80,577.93",00.00
29-Mar-2022,Reversal,43.91,00.00,43.91
29-Mar-2022,Commission,53.20,00.00,97.11
29-Mar-2022,Transfer,05.14,00.00,102.25
30-Mar-2022,Interest,00.00,25.56,76.69
30-Mar-2022,Miscellaneous,00.00,25.56,51.13
30-Mar-2022,Cheque,51.76,00.00,102.89
30-Mar-2022,Commission,00.00,11.43,91.46
30-Mar-2022,Tax,00.00,91.46,00.00
30-Mar-2022,Cheque,"62,933.40",00.00,"62,933.40"
30-Mar-2022,Cash,38.00,00.00,"62,971.40"
30-Mar-2022,NEFT,00.00,"10,495.23","52,476.17"
30-Mar-2022,Purchase,"191,384.80",00.00,"243,860.97"
30-Mar-2022,Miscellaneous,00.00,"34,837.28","209,023.69"
30-Mar-2022,Transfer,"1,471.10",00.00,"210,494.79"
30-Mar-2022,RTGS,00.00,"35,082.47","175,412.32"
30-Mar-2022,Purchase,00.00,"25,058.90","150,353.42"
30-Mar-2022,Transfer,00.00,"25,058.90","125,294.52"
30-Mar-2022,Purchase,06.00,00.00,"125,300.52"
30-Mar-2022,Interest,00.00,"62,650.26","62,650.26"
30-Mar-2022,RTGS,00.00,"12,530.05","50,120.21"
30-Mar-2022,Cheque,283.00,00.00,"50,403.21"
30-Mar-2022,Debit Card,00.00,"5,040.32","45,362.89"
30-Mar-2022,Bill,00.00,"5,040.32","40,322.57"
30-Mar-2022,Miscellaneous,"2,963.87",00.00,"43,286.44"
30-Mar-2022,Commission,"131,694.90",00.00,"174,981.34"
30-Mar-2022,IMPS,00.00,"87,490.67","87,490.67"
30-Mar-2022,NEFT,"3,593.00",00.00,"91,083.67"
30-Mar-2022,Transfer,00.00,"30,361.22","60,722.45"
30-Mar-2022,Cheque,00.00,"8,674.64","52,047.81"
30-Mar-2022,ATM,00.00,"26,023.91","26,023.90"
30-Mar-2022,Commission,00.00,"26,023.90",00.00
30-Mar-2022,Interest,"29,618.00",00.00,"29,618.00"
30-Mar-2022,Interest,00.00,"5,923.60","23,694.40"
30-Mar-2022,ATM,"142,510.90",00.00,"166,205.30"
30-Mar-2022,Transfer,"185,425.30",00.00,"351,630.60"
30-Mar-2022,Interest,"1,952.89",00.00,"353,583.49"
30-Mar-2022,Miscellaneous,00.00,"39,287.05","314,296.44"
30-Mar-2022,Debit Card,00.00,"104,765.48","209,530.96"
30-Mar-2022,Tax,00.00,"23,281.22","186,249.74"
30-Mar-2022,IMPS,50.40,00.00,"186,300.14"
30-Mar-2022,RTGS,00.00,"18,630.01","167,670.13"
30-Mar-2022,Bill,"10,569.00",00.00,"178,239.13"
30-Mar-2022,NEFT,00.00,"17,823.91","160,415.22"
30-Mar-2022,Bill,"81,252.00",00.00,"241,667.22"
30-Mar-2022,Interest,"10,882.00",00.00,"252,549.22"
30-Mar-2022,NEFT,"1,308.00",00.00,"253,857.22"
30-Mar-2022,IMPS,"6,667.60",00.00,"260,524.82"
30-Mar-2022,NEFT,"1,513,274.00",00.00,"1,773,798.82"
30-Mar-2022,Commission,00.00,"221,724.85","1,552,073.97"
30-Mar-2022,Purchase,00.00,"194,009.25","1,358,064.72"
30-Mar-2022,Reversal,"1,165.00",00.00,"1,359,229.72"
30-Mar-2022,Commission,00.00,"271,845.94","1,087,383.78"
30-Mar-2022,Cheque,00.00,"271,845.95","815,537.84"
30-Mar-2022,Transfer,00.00,"203,884.46","611,653.38"
30-Mar-2022,Transfer,00.00,"152,913.35","458,740.04"
30-Mar-2022,Cash,07.00,00.00,"458,747.04"
30-Mar-2022,Interest,"1,514,255.25",00.00,"1,973,002.29"
30-Mar-2022,Transfer,00.00,"394,600.46","1,578,401.83"
30-Mar-2022,Purchase,"112,668.00",00.00,"1,691,069.83"
30-Mar-2022,Interest,00.00,"241,581.40","1,449,488.43"
30-Mar-2022,Purchase,00.00,"207,069.78","1,242,418.65"
30-Mar-2022,Cheque,00.00,"310,604.66","931,813.99"
30-Mar-2022,ATM,00.00,"116,476.75","815,337.24"
30-Mar-2022,Bill,"239,484.70",00.00,"1,054,821.94"
30-Mar-2022,Interest,02.20,00.00,"1,054,824.14"
30-Mar-2022,RTGS,00.00,"527,412.07","527,412.07"
30-Mar-2022,RTGS,00.00,"105,482.41","421,929.66"
30-Mar-2022,Cheque,00.00,"421,929.66",00.00
30-Mar-2022,Cheque,01.00,00.00,01.00
30-Mar-2022,Purchase,00.00,00.20,00.80
30-Mar-2022,Interest,"2,690.00",00.00,"2,690.80"
30-Mar-2022,IMPS,"801,788.00",00.00,"804,478.80"
30-Mar-2022,ATM,00.00,"89,386.53","715,092.27"
30-Mar-2022,Cash,57.80,00.00,"715,150.07"
30-Mar-2022,Transfer,00.00,"79,461.12","635,688.95"
30-Mar-2022,Commission,00.00,00.00,"635,688.95"
30-Mar-2022,Transfer,00.00,"70,632.11","565,056.84"
30-Mar-2022,RTGS,00.00,"113,011.37","452,045.47"
30-Mar-2022,Purchase,"580,091.75",00.00,"1,032,137.22"
30-Mar-2022,Transfer,"678,546.00",00.00,"1,710,683.22"
30-Mar-2022,Cheque,00.00,"570,227.74","1,140,455.48"
30-Mar-2022,Commission,00.00,"1,140,455.48",00.00
30-Mar-2022,Reversal,07.00,00.00,07.00
30-Mar-2022,Miscellaneous,117.21,00.00,124.21
30-Mar-2022,Bill,86.00,00.00,210.21
30-Mar-2022,Purchase,"19,080.75",00.00,"19,290.96"
30-Mar-2022,Reversal,279.40,00.00,"19,570.36"
30-Mar-2022,Purchase,00.00,"1,957.04","17,613.32"
30-Mar-2022,Cash,03.95,00.00,"17,617.27"
30-Mar-2022,Tax,"32,731.77",00.00,"50,349.04"
30-Mar-2022,Reversal,00.00,"6,293.63","44,055.41"
30-Mar-2022,Cheque,"947,106.50",00.00,"991,161.91"
30-Mar-2022,Interest,00.00,"110,129.10","881,032.81"
30-Mar-2022,IMPS,00.00,"125,861.83","755,170.98"
30-Mar-2022,IMPS,00.00,"188,792.75","566,378.24"
30-Mar-2022,Reversal,51.00,00.00,"566,429.24"
30-Mar-2022,Purchase,"209,177.66",00.00,"775,606.90"
30-Mar-2022,IMPS,348.00,00.00,"775,954.90"
30-Mar-2022,ATM,00.00,"387,977.45","387,977.45"
30-Mar-2022,Tax,"1,712,760.00",00.00,"2,100,737.45"
30-Mar-2022,ATM,00.00,"300,105.35","1,800,632.10"
30-Mar-2022,Reversal,"116,758.25",00.00,"1,917,390.35"
30-Mar-2022,Bill,"92,849.70",00.00,"2,010,240.05"
30-Mar-2022,IMPS,00.00,"335,040.01","1,675,200.04"
30-Mar-2022,Miscellaneous,"2,848.73",00.00,"1,678,048.77"
30-Mar-2022,Purchase,368.93,00.00,"1,678,417.70"
30-Mar-2022,ATM,00.00,"209,802.21","1,468,615.49"
30-Mar-2022,Reversal,00.00,"209,802.21","1,258,813.28"
30-Mar-2022,IMPS,00.00,"139,868.14","1,118,945.14"
30-Mar-2022,Cash,"528,552.00",00.00,"1,647,497.14"
30-Mar-2022,Interest,00.00,"274,582.86","1,372,914.28"
30-Mar-2022,RTGS,11.00,00.00,"1,372,925.28"
30-Mar-2022,Bill,00.00,"137,292.53","1,235,632.75"
30-Mar-2022,Cheque,00.00,"205,938.79","1,029,693.96"
30-Mar-2022,Purchase,55.70,00.00,"1,029,749.66"
30-Mar-2022,Tax,"169,333.00",00.00,"1,199,082.66"
30-Mar-2022,RTGS,"21,688.00",00.00,"1,220,770.66"
30-Mar-2022,Cash,"3,875.56",00.00,"1,224,646.22"
30-Mar-2022,Transfer,00.00,"612,323.11","612,323.11"
30-Mar-2022,Cheque,00.00,"61,232.31","551,090.80"
30-Mar-2022,RTGS,36.27,00.00,"551,127.07"
30-Mar-2022,Transfer,"1,091,273.00",00.00,"1,642,400.07"
30-Mar-2022,Cheque,233.32,00.00,"1,642,633.39"
30-Mar-2022,Bill,00.00,"273,772.23","1,368,861.16"
30-Mar-2022,Cash,"1,801,474.25",00.00,"3,170,335.41"
30-Mar-2022,Bill,"182,402.00",00.00,"3,352,737.41"
30-Mar-2022,Reversal,00.00,"670,547.48","2,682,189.93"
30-Mar-2022,ATM,"78,418.69",00.00,"2,760,608.62"
30-Mar-2022,Miscellaneous,417.00,00.00,"2,761,025.62"
30-Mar-2022,Tax,00.00,"306,780.62","2,454,245.00"
30-Mar-2022,Miscellaneous,"18,187.29",00.00,"2,472,432.29"
30-Mar-2022,NEFT,"146,906.06",00.00,"2,619,338.35"
30-Mar-2022,Transfer,00.00,"873,112.78","1,746,225.57"
30-Mar-2022,Miscellaneous,58.80,00.00,"1,746,284.37"
30-Mar-2022,Cheque,00.00,"436,571.09","1,309,713.28"
30-Mar-2022,Debit Card,00.40,00.00,"1,309,713.68"
30-Mar-2022,Purchase,00.00,"436,571.23","873,142.45"
30-Mar-2022,Commission,00.00,"124,734.64","748,407.81"
30-Mar-2022,Bill,00.00,"149,681.56","598,726.25"
30-Mar-2022,Bill,"3,971.08",00.00,"602,697.33"
30-Mar-2022,Purchase,38.00,00.00,"602,735.33"
30-Mar-2022,Interest,"9,286.00",00.00,"612,021.33"
30-Mar-2022,Interest,00.00,"76,502.67","535,518.66"
30-Mar-2022,Cash,76.60,00.00,"535,595.26"
30-Mar-2022,Cheque,"1,026,609.25",00.00,"1,562,204.51"
30-Mar-2022,Debit Card,05.40,00.00,"1,562,209.91"
30-Mar-2022,Bill,"3,451.00",00.00,"1,565,660.91"
30-Mar-2022,Interest,00.00,"313,132.18","1,252,528.73"
30-Mar-2022,Cash,00.00,"178,932.68","1,073,596.05"
30-Mar-2022,Cash,00.00,"134,199.51","939,396.54"
30-Mar-2022,Cheque,00.00,"117,424.57","821,971.97"
30-Mar-2022,Commission,"152,906.94",00.00,"974,878.91"
30-Mar-2022,Tax,"1,450,455.25",00.00,"2,425,334.16"
30-Mar-2022,Commission,00.00,"303,166.77","2,122,167.39"
30-Mar-2022,Commission,00.00,"424,433.48","1,697,733.91"
30-Mar-2022,Debit Card,"23,553.30",00.00,"1,721,287.21"
30-Mar-2022,IMPS,"142,387.28",00.00,"1,863,674.49"
30-Mar-2022,Tax,00.00,"465,918.62","1,397,755.87"
30-Mar-2022,Purchase,00.00,"139,775.59","1,257,980.28"
30-Mar-2022,Cash,00.00,"628,990.14","628,990.14"
30-Mar-2022,Tax,282.00,00.00,"629,272.14"
30-Mar-2022,Debit Card,31.50,00.00,"629,303.64"
30-Mar-2022,RTGS,00.00,"157,325.91","471,977.73"
31-Mar-2022,RTGS,"5,221.06",00.00,"477,198.79"
31-Mar-2022,NEFT,06.00,00.00,"477,204.79"
31-Mar-2022,Purchase,335.40,00.00,"477,540.19"
31-Mar-2022,Miscellaneous,00.00,"47,754.02","429,786.17"
31-Mar-2022,RTGS,"17,184.10",00.00,"446,970.27"
31-Mar-2022,Bill,"278,691.25",00.00,"725,661.52"
31-Mar-2022,Reversal,145.10,00.00,"725,806.62"
01-Apr-2022,Miscellaneous,55.00,00.00,"725,861.62"
01-Apr-2022,Tax,00.00,"103,694.52","622,167.10"
01-Apr-2022,Cash,00.00,"155,541.78","466,625.32"
01-Apr-2022,NEFT,00.00,"155,541.77","311,083.55"
01-Apr-2022,IMPS,00.00,"44,440.51","266,643.04"
01-Apr-2022,Purchase,00.00,"38,091.86","228,551.18"
01-Apr-2022,NEFT,41.30,00.00,"228,592.48"
01-Apr-2022,Tax,28.20,00.00,"228,620.68"
01-Apr-2022,Commission,04.81,00.00,"228,625.49"
01-Apr-2022,Reversal,00.00,"76,208.50","152,416.99"
01-Apr-2022,ATM,00.00,"19,052.12","133,364.87"
01-Apr-2022,NEFT,00.80,00.00,"133,365.67"
01-Apr-2022,Reversal,"92,457.20",00.00,"225,822.87"
01-Apr-2022,RTGS,00.00,"32,260.41","193,562.46"
01-Apr-2022,Commission,04.90,00.00,"193,567.36"
01-Apr-2022,Commission,"16,633.89",00.00,"210,201.25"
01-Apr-2022,Miscellaneous,00.00,"52,550.31","157,650.94"
01-Apr-2022,RTGS,00.00,"22,521.56","135,129.38"
01-Apr-2022,NEFT,00.00,"19,304.20","115,825.18"
01-Apr-2022,IMPS,"11,351.10",00.00,"127,176.28"
01-Apr-2022,ATM,04.00,00.00,"127,180.28"
01-Apr-2022,ATM,11.07,00.00,"127,191.35"
01-Apr-2022,Purchase,00.00,"31,797.84","95,393.51"
01-Apr-2022,Purchase,00.00,"31,797.84","63,595.67"
01-Apr-2022,Purchase,00.00,"21,198.56","42,397.11"
01-Apr-2022,ATM,00.00,"4,239.71","38,157.40"
01-Apr-2022,Interest,51.00,00.00,"38,208.40"
01-Apr-2022,Cash,"13,237.00",00.00,"51,445.40"
01-Apr-2022,Miscellaneous,"183,451.00",00.00,"234,896.40"
01-Apr-2022,Cheque,00.00,"26,099.60","208,796.80"
01-Apr-2022,Miscellaneous,15.50,00.00,"208,812.30"
01-Apr-2022,Purchase,00.00,"26,101.54","182,710.76"
01-Apr-2022,Miscellaneous,"1,204,041.00",00.00,"1,386,751.76"
01-Apr-2022,Miscellaneous,04.10,00.00,"1,386,755.86"
01-Apr-2022,Bill,00.00,"277,351.17","1,109,404.69"
01-Apr-2022,Interest,"1,985,328.00",00.00,"3,094,732.69"
01-Apr-2022,ATM,00.00,"309,473.27","2,785,259.42"
01-Apr-2022,Tax,00.00,"348,157.43","2,437,101.99"
01-Apr-2022,Miscellaneous,00.00,"1,218,551.00","1,218,551.00"
01-Apr-2022,Purchase,00.00,"304,637.75","913,913.25"
01-Apr-2022,Reversal,00.00,"101,545.92","812,367.33"
01-Apr-2022,Commission,00.00,"81,236.73","731,130.60"
01-Apr-2022,RTGS,00.00,"81,236.73","649,893.87"
01-Apr-2022,Interest,456.98,00.00,"650,350.85"
01-Apr-2022,ATM,00.00,"108,391.81","541,959.04"
01-Apr-2022,Interest,00.00,"54,195.90","487,763.14"
01-Apr-2022,Bill,00.00,"487,763.14",00.00
02-Apr-2022,Commission,"1,939.16",00.00,"1,939.16"
02-Apr-2022,Debit Card,"1,533.30",00.00,"3,472.46"
02-Apr-2022,IMPS,00.00,"3,472.46",00.00
02-Apr-2022,Transfer,06.78,00.00,06.78
02-Apr-2022,NEFT,26.20,00.00,32.98
02-Apr-2022,RTGS,00.00,03.66,29.32
02-Apr-2022,IMPS,00.00,29.32,00.00
02-Apr-2022,ATM,"1,216.00",00.00,"1,216.00"
02-Apr-2022,Bill,00.00,121.60,"1,094.40"
02-Apr-2022,Reversal,00.00,547.20,547.20
02-Apr-2022,Cheque,"181,208.50",00.00,"181,755.70"
02-Apr-2022,Debit Card,01.37,00.00,"181,757.07"
02-Apr-2022,ATM,00.00,"18,175.71","163,581.36"
03-Apr-2022,Commission,31.45,00.00,"163,612.81"
03-Apr-2022,Interest,00.00,"20,451.60","143,161.21"
03-Apr-2022,IMPS,00.00,"47,720.40","95,440.81"
03-Apr-2022,Purchase,"3,696.62",00.00,"99,137.43"
04-Apr-2022,RTGS,00.00,"24,784.36","74,353.07"
04-Apr-2022,Cheque,"543,022.50",00.00,"617,375.57"
04-Apr-2022,Transfer,00.00,"61,737.56","555,638.01"
04-Apr-2022,Reversal,"164,872.00",00.00,"720,510.01"
04-Apr-2022,Debit Card,"17,301.81",00.00,"737,811.82"
04-Apr-2022,Purchase,00.00,"737,811.82",00.00
04-Apr-2022,Reversal,51.00,00.00,51.00
04-Apr-2022,RTGS,00.00,08.50,42.50
04-Apr-2022,Bill,00.00,08.50,34.00
04-Apr-2022,IMPS,114.00,00.00,148.00
04-Apr-2022,Debit Card,"1,509,500.00",00.00,"1,509,648.00"
05-Apr-2022,Bill,00.00,"167,738.67","1,341,909.33"
05-Apr-2022,Commission,63.20,00.00,"1,341,972.53"
05-Apr-2022,RTGS,09.00,00.00,"1,341,981.53"
05-Apr-2022,Commission,00.00,"149,109.06","1,192,872.47"
05-Apr-2022,RTGS,03.00,00.00,"1,192,875.47"
05-Apr-2022,Debit Card,00.00,"596,437.74","596,437.74"
05-Apr-2022,Cash,00.00,"66,270.86","530,166.88"
05-Apr-2022,ATM,"253,932.00",00.00,"784,098.88"
05-Apr-2022,NEFT,00.00,"261,366.29","522,732.59"
05-Apr-2022,ATM,"23,824.00",00.00,"546,556.59"
05-Apr-2022,Bill,00.00,"91,092.77","455,463.82"
05-Apr-2022,Purchase,"1,614,021.20",00.00,"2,069,485.02"
05-Apr-2022,Transfer,00.00,"517,371.26","1,552,113.76"
05-Apr-2022,ATM,00.00,"221,730.54","1,330,383.22"
06-Apr-2022,Miscellaneous,"6,337.00",00.00,"1,336,720.22"
06-Apr-2022,ATM,00.00,"190,960.03","1,145,760.19"
06-Apr-2022,Commission,00.00,"114,576.02","1,031,184.17"
06-Apr-2022,NEFT,00.00,"1,031,184.17",00.00
06-Apr-2022,NEFT,"1,997,835.50",00.00,"1,997,835.50"
06-Apr-2022,Purchase,00.00,"199,783.55","1,798,051.95"
06-Apr-2022,Bill,02.97,00.00,"1,798,054.92"
06-Apr-2022,ATM,00.00,"1,798,054.92",00.00
06-Apr-2022,Commission,"21,694.10",00.00,"21,694.10"
06-Apr-2022,NEFT,434.80,00.00,"22,128.90"
06-Apr-2022,Cash,00.00,"4,425.78","17,703.12"
06-Apr-2022,Reversal,00.00,"17,703.12",00.00
06-Apr-2022,Reversal,"12,251.00",00.00,"12,251.00"
06-Apr-2022,Interest,00.00,"4,083.67","8,167.33"
06-Apr-2022,Debit Card,06.00,00.00,"8,173.33"
06-Apr-2022,Interest,00.00,"8,173.33",00.00
06-Apr-2022,ATM,"3,454.70",00.00,"3,454.70"
06-Apr-2022,Reversal,00.00,"3,454.70",00.00
06-Apr-2022,Bill,322.00,00.00,322.00
06-Apr-2022,IMPS,00.00,35.78,286.22
06-Apr-2022,Cash,"61,368.00",00.00,"61,654.22"
06-Apr-2022,ATM,00.00,"7,706.78","53,947.44"
06-Apr-2022,Tax,00.00,"53,947.44",00.00
06-Apr-2022,Interest,04.47,00.00,04.47
06-Apr-2022,Purchase,"155,446.31",00.00,"155,450.78"
06-Apr-2022,Tax,"192,639.00",00.00,"348,089.78"
06-Apr-2022,Debit Card,00.00,"43,511.22","304,578.56"
06-Apr-2022,Debit Card,00.00,"30,457.86","274,120.70"
06-Apr-2022,Interest,"104,682.00",00.00,"378,802.70"
06-Apr-2022,Debit Card,"126,284.00",00.00,"505,086.70"
06-Apr-2022,Bill,73.00,00.00,"505,159.70"
06-Apr-2022,IMPS,268.21,00.00,"505,427.91"
06-Apr-2022,RTGS,66.27,00.00,"505,494.18"
06-Apr-2022,Interest,00.00,"50,549.42","454,944.76"
06-Apr-2022,Reversal,116.10,00.00,"455,060.86"
06-Apr-2022,Cheque,00.00,"455,060.86",00.00
06-Apr-2022,NEFT,01.72,00.00,01.72
06-Apr-2022,NEFT,00.00,00.86,00.86
07-Apr-2022,Purchase,"1,986,797.00",00.00,"1,986,797.86"
07-Apr-2022,Reversal,"652,688.80",00.00,"2,639,486.66"
07-Apr-2022,Miscellaneous,"982,494.50",00.00,"3,621,981.16"
08-Apr-2022,Debit Card,00.00,"452,747.65","3,169,233.52"
08-Apr-2022,ATM,"2,838.90",00.00,"3,172,072.42"
08-Apr-2022,Debit Card,00.00,"1,586,036.21","1,586,036.21"
08-Apr-2022,RTGS,00.00,"317,207.24","1,268,828.97"
08-Apr-2022,IMPS,00.00,"253,765.79","1,015,063.18"
08-Apr-2022,IMPS,412.30,00.00,"1,015,475.48"
08-Apr-2022,Transfer,00.00,"203,095.10","812,380.38"
08-Apr-2022,Debit Card,00.00,"135,396.73","676,983.65"
08-Apr-2022,IMPS,31.80,00.00,"677,015.45"
08-Apr-2022,RTGS,"2,560.72",00.00,"679,576.17"
08-Apr-2022,Bill,00.00,"135,915.23","543,660.94"
08-Apr-2022,ATM,"92,321.90",00.00,"635,982.84"
08-Apr-2022,RTGS,00.00,"158,995.71","476,987.13"
08-Apr-2022,Cheque,00.00,"158,995.71","317,991.42"
08-Apr-2022,Tax,00.00,"31,799.14","286,192.28"
08-Apr-2022,Cash,"277,514.50",00.00,"563,706.78"
09-Apr-2022,Debit Card,00.00,"62,634.09","501,072.69"
09-Apr-2022,RTGS,35.20,00.00,"501,107.89"
09-Apr-2022,Transfer,00.00,"167,035.96","334,071.93"
09-Apr-2022,RTGS,00.00,"83,517.98","250,553.95"
09-Apr-2022,Reversal,11.72,00.00,"250,565.67"
09-Apr-2022,Cheque,00.00,"125,282.84","125,282.84"
09-Apr-2022,Miscellaneous,"19,693.50",00.00,"144,976.34"
09-Apr-2022,RTGS,00.00,"36,244.09","108,732.26"
09-Apr-2022,Cash,00.00,"12,081.36","96,650.90"
09-Apr-2022,ATM,"2,156.00",00.00,"98,806.90"
09-Apr-2022,Transfer,00.00,"24,701.73","74,105.17"
09-Apr-2022,Bill,00.00,"24,701.72","49,403.45"
09-Apr-2022,NEFT,03.56,00.00,"49,407.01"
09-Apr-2022,Cheque,"99,481.00",00.00,"148,888.01"
09-Apr-2022,NEFT,"241,397.10",00.00,"390,285.11"
09-Apr-2022,NEFT,"1,754.10",00.00,"392,039.21"
09-Apr-2022,Cash,"755,166.25",00.00,"1,147,205.46"
09-Apr-2022,Reversal,"2,767.00",00.00,"1,149,972.46"
09-Apr-2022,Interest,00.00,"143,746.56","1,006,225.90"
09-Apr-2022,Cheque,00.00,"1,006,225.90",00.00
09-Apr-2022,Cash,"1,864,641.20",00.00,"1,864,641.20"
09-Apr-2022,Commission,00.00,"466,160.30","1,398,480.90"
09-Apr-2022,ATM,00.00,"279,696.18","1,118,784.72"
09-Apr-2022,Reversal,00.00,"559,392.36","559,392.36"
09-Apr-2022,RTGS,485.00,00.00,"559,877.36"
09-Apr-2022,Miscellaneous,00.00,"55,987.74","503,889.62"
09-Apr-2022,Cash,00.00,"71,984.23","431,905.39"
09-Apr-2022,Tax,"28,169.62",00.00,"460,075.01"
09-Apr-2022,Cash,04.23,00.00,"460,079.24"
09-Apr-2022,Cash,00.00,"65,725.61","394,353.63"
09-Apr-2022,Tax,00.00,"39,435.36","354,918.27"
09-Apr-2022,Commission,12.80,00.00,"354,931.07"
09-Apr-2022,Cash,"427,306.20",00.00,"782,237.27"
09-Apr-2022,ATM,00.00,"156,447.45","625,789.82"
09-Apr-2022,RTGS,"12,085.00",00.00,"637,874.82"
09-Apr-2022,Purchase,00.00,"212,624.94","425,249.88"
10-Apr-2022,RTGS,00.00,"60,749.98","364,499.90"
10-Apr-2022,ATM,00.00,"36,449.99","328,049.91"
10-Apr-2022,Reversal,00.00,"54,674.99","273,374.92"
10-Apr-2022,Tax,00.00,"30,374.99","242,999.93"
10-Apr-2022,Cheque,00.00,"242,999.93",00.00
10-Apr-2022,Purchase,"154,350.25",00.00,"154,350.25"
10-Apr-2022,Commission,00.00,"19,293.78","135,056.47"
10-Apr-2022,Miscellaneous,07.34,00.00,"135,063.81"
10-Apr-2022,IMPS,00.00,"19,294.83","115,768.98"
10-Apr-2022,Miscellaneous,00.00,"23,153.80","92,615.18"
10-Apr-2022,Cheque,40.30,00.00,"92,655.48"
10-Apr-2022,RTGS,02.00,00.00,"92,657.48"
11-Apr-2022,Interest,00.00,"15,442.91","77,214.57"
11-Apr-2022,NEFT,00.87,00.00,"77,215.44"
11-Apr-2022,Cash,00.00,"12,869.24","64,346.20"
11-Apr-2022,IMPS,"3,520.30",00.00,"67,866.50"
11-Apr-2022,Interest,"125,995.00",00.00,"193,861.50"
11-Apr-2022,NEFT,00.00,"64,620.50","129,241.00"
11-Apr-2022,Transfer,00.00,"18,463.00","110,778.00"
11-Apr-2022,ATM,00.00,"36,926.00","73,852.00"
11-Apr-2022,Reversal,01.00,00.00,"73,853.00"
11-Apr-2022,Commission,00.00,"8,205.89","65,647.11"
11-Apr-2022,Cash,00.00,"21,882.37","43,764.74"
11-Apr-2022,Bill,19.00,00.00,"43,783.74"
11-Apr-2022,Interest,07.90,00.00,"43,791.64"
11-Apr-2022,RTGS,"50,569.00",00.00,"94,360.64"
11-Apr-2022,Purchase,00.00,"15,726.77","78,633.87"
11-Apr-2022,RTGS,00.00,"13,105.65","65,528.22"
11-Apr-2022,Debit Card,00.00,"13,105.64","52,422.58"
11-Apr-2022,Miscellaneous,"26,970.50",00.00,"79,393.08"
11-Apr-2022,RTGS,00.00,"79,393.08",00.00
11-Apr-2022,Interest,"189,866.69",00.00,"189,866.69"
11-Apr-2022,Tax,"145,124.70",00.00,"334,991.39"
11-Apr-2022,Commission,04.20,00.00,"334,995.59"
12-Apr-2022,Commission,00.00,"111,665.20","223,330.39"
12-Apr-2022,Reversal,00.00,"74,443.46","148,886.93"
12-Apr-2022,Cash,"1,269.58",00.00,"150,156.51"
12-Apr-2022,Bill,00.00,"75,078.26","75,078.26"
12-Apr-2022,NEFT,06.18,00.00,"75,084.44"
12-Apr-2022,Cheque,00.00,"8,342.72","66,741.72"
12-Apr-2022,Debit Card,00.00,"9,534.53","57,207.19"
12-Apr-2022,Reversal,00.00,"6,356.35","50,850.84"
12-Apr-2022,Debit Card,"390,105.00",00.00,"440,955.84"
12-Apr-2022,NEFT,00.00,"48,995.09","391,960.75"
12-Apr-2022,Transfer,487.94,00.00,"392,448.69"
12-Apr-2022,Cheque,00.00,"49,056.09","343,392.60"
12-Apr-2022,Commission,02.70,00.00,"343,395.30"
12-Apr-2022,Debit Card,"178,816.00",00.00,"522,211.30"
12-Apr-2022,Transfer,00.00,"52,221.13","469,990.17"
12-Apr-2022,Purchase,00.00,"234,995.09","234,995.08"
12-Apr-2022,ATM,00.00,"23,499.51","211,495.57"
12-Apr-2022,Reversal,00.00,"26,436.95","185,058.62"
12-Apr-2022,IMPS,05.80,00.00,"185,064.42"
12-Apr-2022,Commission,"197,399.00",00.00,"382,463.42"
12-Apr-2022,Cash,00.00,"38,246.34","344,217.08"
12-Apr-2022,Tax,00.00,"68,843.42","275,373.66"
12-Apr-2022,ATM,284.00,00.00,"275,657.66"
12-Apr-2022,Transfer,00.00,"137,828.83","137,828.83"
12-Apr-2022,Miscellaneous,02.14,00.00,"137,830.97"
12-Apr-2022,Debit Card,00.00,"13,783.10","124,047.87"
12-Apr-2022,Cheque,"1,043.18",00.00,"125,091.05"
12-Apr-2022,Purchase,"769,964.00",00.00,"895,055.05"
12-Apr-2022,Purchase,00.00,"895,055.05",00.00
12-Apr-2022,Commission,295.30,00.00,295.30
12-Apr-2022,ATM,00.00,36.91,258.39
12-Apr-2022,RTGS,254.70,00.00,513.09
12-Apr-2022,RTGS,00.00,171.03,342.06
12-Apr-2022,Tax,00.00,68.41,273.65
12-Apr-2022,ATM,00.00,54.73,218.92
12-Apr-2022,ATM,52.50,00.00,271.42
12-Apr-2022,Transfer,22.00,00.00,293.42
13-Apr-2022,Interest,00.00,32.60,260.82
13-Apr-2022,Purchase,00.00,26.08,234.74
13-Apr-2022,Tax,00.00,58.69,176.06
13-Apr-2022,Debit Card,"716,272.75",00.00,"716,448.81"
13-Apr-2022,RTGS,00.00,"89,556.10","626,892.71"
13-Apr-2022,Miscellaneous,00.00,"125,378.54","501,514.17"
13-Apr-2022,Cheque,"85,027.00",00.00,"586,541.17"
13-Apr-2022,Commission,398.50,00.00,"586,939.67"
13-Apr-2022,Debit Card,00.00,"195,646.56","391,293.11"
13-Apr-2022,Transfer,00.00,"391,293.11",00.00
13-Apr-2022,Cash,"3,573.80",00.00,"3,573.80"
13-Apr-2022,Bill,00.00,357.38,"3,216.42"
13-Apr-2022,Bill,00.00,804.11,"2,412.32"
13-Apr-2022,Tax,00.00,402.05,"2,010.27"
13-Apr-2022,Tax,00.00,670.09,"1,340.18"
13-Apr-2022,Debit Card,00.00,223.36,"1,116.82"
13-Apr-2022,Tax,00.00,111.68,"1,005.14"
13-Apr-2022,Tax,"29,336.70",00.00,"30,341.84"
13-Apr-2022,Interest,00.00,"3,792.73","26,549.11"
13-Apr-2022,Interest,00.00,"26,549.11",00.00
13-Apr-2022,Purchase,"19,117.00",00.00,"19,117.00"
13-Apr-2022,Cheque,255.20,00.00,"19,372.20"
13-Apr-2022,Tax,"2,006,148.00",00.00,"2,025,520.20"
13-Apr-2022,Bill,"245,391.80",00.00,"2,270,912.00"
13-Apr-2022,RTGS,00.00,"378,485.33","1,892,426.67"
13-Apr-2022,Reversal,"230,986.70",00.00,"2,123,413.37"
13-Apr-2022,Cheque,00.00,"303,344.77","1,820,068.60"
13-Apr-2022,Tax,"1,092,546.75",00.00,"2,912,615.35"
13-Apr-2022,Transfer,60.14,00.00,"2,912,675.49"
13-Apr-2022,ATM,00.00,"1,456,337.75","1,456,337.74"
13-Apr-2022,Transfer,"27,919.91",00.00,"1,484,257.65"
13-Apr-2022,Miscellaneous,01.40,00.00,"1,484,259.05"
13-Apr-2022,Interest,342.00,00.00,"1,484,601.05"
13-Apr-2022,ATM,30.00,00.00,"1,484,631.05"
13-Apr-2022,Cheque,00.00,"212,090.15","1,272,540.90"
13-Apr-2022,Reversal,00.00,"141,393.43","1,131,147.47"
13-Apr-2022,Commission,00.00,"125,683.05","1,005,464.42"
13-Apr-2022,ATM,00.00,"143,637.77","861,826.65"
13-Apr-2022,Transfer,311.12,00.00,"862,137.77"
13-Apr-2022,Cheque,338.00,00.00,"862,475.77"
13-Apr-2022,Debit Card,"1,305.00",00.00,"863,780.77"
13-Apr-2022,RTGS,00.00,"172,756.15","691,024.62"
13-Apr-2022,RTGS,00.00,"345,512.31","345,512.31"
13-Apr-2022,Reversal,00.00,"57,585.39","287,926.92"
13-Apr-2022,Debit Card,"2,979.70",00.00,"290,906.62"
13-Apr-2022,RTGS,00.00,"72,726.66","218,179.96"
14-Apr-2022,Debit Card,00.00,"109,089.98","109,089.98"
14-Apr-2022,Cash,"3,225.60",00.00,"112,315.58"
14-Apr-2022,IMPS,376.49,00.00,"112,692.07"
14-Apr-2022,Interest,00.00,"14,086.51","98,605.56"
15-Apr-2022,RTGS,"2,178.50",00.00,"100,784.06"
15-Apr-2022,Bill,00.00,"20,156.81","80,627.25"
15-Apr-2022,Purchase,48.25,00.00,"80,675.50"
15-Apr-2022,Commission,"29,086.16",00.00,"109,761.66"
15-Apr-2022,Cheque,00.00,"15,680.24","94,081.42"
15-Apr-2022,IMPS,"2,471.80",00.00,"96,553.22"
15-Apr-2022,RTGS,00.00,"24,138.31","72,414.92"
15-Apr-2022,IMPS,"1,633,261.25",00.00,"1,705,676.17"
15-Apr-2022,IMPS,"2,819.60",00.00,"1,708,495.77"
15-Apr-2022,ATM,00.00,"244,070.82","1,464,424.95"
15-Apr-2022,RTGS,00.00,"146,442.50","1,317,982.46"
15-Apr-2022,Debit Card,00.00,"658,991.23","658,991.23"
15-Apr-2022,Commission,00.00,"131,798.25","527,192.98"
15-Apr-2022,Tax,00.00,"527,192.98",00.00
15-Apr-2022,Commission,00.30,00.00,00.30
15-Apr-2022,Reversal,00.00,00.03,00.27
15-Apr-2022,Commission,05.00,00.00,05.27
15-Apr-2022,Transfer,28.70,00.00,33.97
15-Apr-2022,Transfer,00.00,04.25,29.72
15-Apr-2022,Bill,00.00,07.43,22.29
15-Apr-2022,Tax,00.00,05.57,16.72
15-Apr-2022,RTGS,06.00,00.00,22.72
15-Apr-2022,Reversal,40.48,00.00,63.20
15-Apr-2022,Debit Card,00.00,06.32,56.88
15-Apr-2022,Bill,342.95,00.00,399.83
15-Apr-2022,Interest,"13,804.00",00.00,"14,203.83"
15-Apr-2022,NEFT,00.00,"1,775.48","12,428.35"
15-Apr-2022,Tax,52.50,00.00,"12,480.85"
15-Apr-2022,Transfer,00.00,"6,240.43","6,240.42"
15-Apr-2022,Reversal,00.00,"1,248.08","4,992.34"
15-Apr-2022,Cash,00.00,998.47,"3,993.87"
15-Apr-2022,ATM,"4,023.00",00.00,"8,016.87"
15-Apr-2022,Reversal,"1,354.50",00.00,"9,371.37"
15-Apr-2022,NEFT,00.00,"2,342.84","7,028.53"
15-Apr-2022,Interest,"23,368.00",00.00,"30,396.53"
15-Apr-2022,Cheque,88.30,00.00,"30,484.83"
15-Apr-2022,Purchase,00.00,"15,242.42","15,242.42"
15-Apr-2022,RTGS,29.00,00.00,"15,271.42"
15-Apr-2022,Bill,444.00,00.00,"15,715.42"
15-Apr-2022,Cash,00.00,"7,857.71","7,857.71"
15-Apr-2022,Transfer,"108,068.00",00.00,"115,925.71"
15-Apr-2022,Tax,"14,671.79",00.00,"130,597.50"
15-Apr-2022,Miscellaneous,00.00,"14,510.83","116,086.67"
15-Apr-2022,Interest,00.00,"29,021.67","87,065.00"
15-Apr-2022,Cash,"19,366.66",00.00,"106,431.66"
15-Apr-2022,Cheque,"1,228,741.75",00.00,"1,335,173.41"
16-Apr-2022,Bill,00.00,"166,896.68","1,168,276.73"
17-Apr-2022,IMPS,00.00,"1,168,276.73",00.00
17-Apr-2022,Bill,"2,008,021.00",00.00,"2,008,021.00"
17-Apr-2022,Cash,"1,887,288.80",00.00,"3,895,309.80"
17-Apr-2022,Reversal,"13,321.10",00.00,"3,908,630.90"
17-Apr-2022,Reversal,00.00,"977,157.73","2,931,473.18"
17-Apr-2022,Tax,00.00,"977,157.73","1,954,315.45"
17-Apr-2022,Bill,00.00,"244,289.43","1,710,026.02"
17-Apr-2022,Cheque,08.00,00.00,"1,710,034.02"
17-Apr-2022,Commission,"105,386.16",00.00,"1,815,420.18"
17-Apr-2022,RTGS,"544,011.00",00.00,"2,359,431.18"
17-Apr-2022,Cheque,"1,339.50",00.00,"2,360,770.68"
17-Apr-2022,Interest,"172,060.50",00.00,"2,532,831.18"
17-Apr-2022,Miscellaneous,00.00,"316,603.90","2,216,227.28"
17-Apr-2022,Miscellaneous,"2,640.34",00.00,"2,218,867.62"
17-Apr-2022,IMPS,00.00,"1,109,433.81","1,109,433.81"
18-Apr-2022,Tax,00.00,"138,679.23","970,754.58"
18-Apr-2022,Reversal,"7,476.00",00.00,"978,230.58"
18-Apr-2022,Interest,"225,688.12",00.00,"1,203,918.70"
18-Apr-2022,Purchase,00.00,"200,653.12","1,003,265.58"
18-Apr-2022,Miscellaneous,00.00,"125,408.20","877,857.38"
18-Apr-2022,Bill,06.60,00.00,"877,863.98"
18-Apr-2022,Reversal,00.00,"438,931.99","438,931.99"
18-Apr-2022,Commission,00.00,"146,310.66","292,621.33"
18-Apr-2022,Purchase,"1,483,277.50",00.00,"1,775,898.83"
18-Apr-2022,Reversal,00.00,"221,987.35","1,553,911.48"
18-Apr-2022,Commission,"1,164,023.00",00.00,"2,717,934.48"
18-Apr-2022,Miscellaneous,00.00,"388,276.35","2,329,658.13"
18-Apr-2022,Cheque,00.00,"582,414.53","1,747,243.60"
18-Apr-2022,Commission,"1,122.10",00.00,"1,748,365.70"
18-Apr-2022,RTGS,00.00,"174,836.57","1,573,529.13"
18-Apr-2022,Commission,00.00,"224,789.88","1,348,739.25"
18-Apr-2022,Transfer,00.00,"269,747.85","1,078,991.40"
18-Apr-2022,IMPS,"19,823.10",00.00,"1,098,814.50"
18-Apr-2022,NEFT,00.00,"274,703.63","824,110.88"
18-Apr-2022,Interest,00.00,"82,411.09","741,699.79"
18-Apr-2022,Debit Card,28.00,00.00,"741,727.79"
18-Apr-2022,Commission,"1,717.00",00.00,"743,444.79"
18-Apr-2022,Miscellaneous,00.00,"371,722.40","371,722.40"
18-Apr-2022,NEFT,03.68,00.00,"371,726.08"
18-Apr-2022,RTGS,50.90,00.00,"371,776.98"
18-Apr-2022,ATM,00.00,"74,355.40","297,421.58"
18-Apr-2022,Reversal,00.00,"42,488.80","254,932.78"
18-Apr-2022,RTGS,09.70,00.00,"254,942.48"
18-Apr-2022,NEFT,00.00,"42,490.41","212,452.07"
18-Apr-2022,Transfer,473.70,00.00,"212,925.77"
19-Apr-2022,Commission,"2,587.50",00.00,"215,513.27"
19-Apr-2022,Purchase,"201,933.00",00.00,"417,446.27"
19-Apr-2022,Reversal,00.00,"69,574.38","347,871.89"
19-Apr-2022,Cash,00.00,"115,957.30","231,914.59"
19-Apr-2022,Reversal,446.79,00.00,"232,361.38"
19-Apr-2022,Debit Card,00.00,"33,194.48","199,166.90"
19-Apr-2022,Miscellaneous,04.00,00.00,"199,170.90"
19-Apr-2022,Cheque,"898,386.25",00.00,"1,097,557.15"
19-Apr-2022,Interest,00.00,"182,926.19","914,630.96"
19-Apr-2022,Cheque,30.00,00.00,"914,660.96"
19-Apr-2022,Debit Card,"1,405,286.00",00.00,"2,319,946.96"
19-Apr-2022,Cash,"106,774.66",00.00,"2,426,721.62"
19-Apr-2022,Purchase,"227,226.00",00.00,"2,653,947.62"
20-Apr-2022,Interest,01.00,00.00,"2,653,948.62"
20-Apr-2022,Tax,00.00,"663,487.16","1,990,461.46"
20-Apr-2022,Cheque,"1,710,776.25",00.00,"3,701,237.71"
20-Apr-2022,Interest,00.00,"925,309.43","2,775,928.28"
20-Apr-2022,Tax,00.00,"2,775,928.28",00.00
20-Apr-2022,Tax,09.00,00.00,09.00
20-Apr-2022,Tax,00.00,02.25,06.75
20-Apr-2022,RTGS,00.00,00.96,05.79
20-Apr-2022,Commission,00.00,01.45,04.34
20-Apr-2022,Purchase,00.00,00.62,03.72
20-Apr-2022,Cheque,00.00,01.24,02.48
20-Apr-2022,Cheque,00.00,00.31,02.17
20-Apr-2022,NEFT,04.90,00.00,07.07
20-Apr-2022,Reversal,"18,240.27",00.00,"18,247.34"
20-Apr-2022,Cheque,00.00,"2,027.48","16,219.86"
20-Apr-2022,Bill,04.56,00.00,"16,224.42"
20-Apr-2022,Commission,00.00,"5,408.14","10,816.28"
20-Apr-2022,Tax,00.00,"1,352.04","9,464.25"
20-Apr-2022,Bill,00.00,00.00,"9,464.25"
20-Apr-2022,NEFT,00.00,"1,577.38","7,886.88"
20-Apr-2022,ATM,"51,073.80",00.00,"58,960.68"
20-Apr-2022,Tax,00.00,"9,826.78","49,133.90"
20-Apr-2022,Tax,00.00,"5,459.32","43,674.58"
20-Apr-2022,Miscellaneous,00.00,"21,837.29","21,837.29"
20-Apr-2022,Commission,"141,070.59",00.00,"162,907.88"
20-Apr-2022,Cash,00.00,"20,363.49","142,544.40"
20-Apr-2022,IMPS,460.62,00.00,"143,005.02"
20-Apr-2022,Reversal,00.00,"143,005.02",00.00
20-Apr-2022,Transfer,"23,320.00",00.00,"23,320.00"
20-Apr-2022,Cheque,259.00,00.00,"23,579.00"
20-Apr-2022,Commission,00.00,"2,947.38","20,631.62"
20-Apr-2022,Miscellaneous,"204,455.00",00.00,"225,086.62"
20-Apr-2022,Commission,00.00,"75,028.87","150,057.75"
20-Apr-2022,RTGS,00.00,"21,436.82","128,620.93"
20-Apr-2022,NEFT,00.00,"18,374.42","110,246.51"
20-Apr-2022,Cheque,00.00,"18,374.42","91,872.09"
20-Apr-2022,IMPS,03.00,00.00,"91,875.09"
20-Apr-2022,IMPS,"230,099.50",00.00,"321,974.59"
20-Apr-2022,Transfer,"259,934.41",00.00,"581,909.00"
20-Apr-2022,Cheque,"2,287.70",00.00,"584,196.70"
20-Apr-2022,NEFT,00.00,"64,910.74","519,285.96"
20-Apr-2022,Commission,00.00,"64,910.75","454,375.22"
20-Apr-2022,Purchase,35.00,00.00,"454,410.22"
20-Apr-2022,Miscellaneous,398.00,00.00,"454,808.22"
20-Apr-2022,IMPS,"31,274.31",00.00,"486,082.53"
20-Apr-2022,Cheque,"752,489.50",00.00,"1,238,572.03"
20-Apr-2022,Debit Card,20.90,00.00,"1,238,592.93"
20-Apr-2022,IMPS,00.00,"154,824.12","1,083,768.81"
20-Apr-2022,Commission,48.70,00.00,"1,083,817.51"
20-Apr-2022,Bill,43.00,00.00,"1,083,860.51"
20-Apr-2022,Bill,00.00,"120,428.95","963,431.56"
20-Apr-2022,Cheque,00.00,"137,633.08","825,798.48"
20-Apr-2022,Debit Card,00.00,"117,971.21","707,827.27"
20-Apr-2022,Miscellaneous,00.00,"141,565.45","566,261.82"
20-Apr-2022,NEFT,00.00,"70,782.73","495,479.09"
20-Apr-2022,Interest,"89,225.12",00.00,"584,704.21"
20-Apr-2022,IMPS,"3,547.27",00.00,"588,251.48"
20-Apr-2022,Debit Card,00.00,"147,062.87","441,188.61"
20-Apr-2022,Debit Card,02.00,00.00,"441,190.61"
20-Apr-2022,Debit Card,00.00,"110,297.65","330,892.96"
20-Apr-2022,IMPS,"3,821.00",00.00,"334,713.96"
20-Apr-2022,Debit Card,"2,017,302.00",00.00,"2,352,015.96"
20-Apr-2022,Interest,00.00,"336,002.28","2,016,013.68"
20-Apr-2022,Tax,510.53,00.00,"2,016,524.21"
20-Apr-2022,Miscellaneous,00.00,"672,174.74","1,344,349.47"
20-Apr-2022,NEFT,00.00,"149,372.16","1,194,977.31"
20-Apr-2022,Debit Card,00.00,"170,711.04","1,024,266.27"
20-Apr-2022,Debit Card,"7,252.16",00.00,"1,031,518.43"
20-Apr-2022,Tax,00.00,"206,303.69","825,214.74"
20-Apr-2022,Reversal,00.00,"137,535.79","687,678.95"
21-Apr-2022,Debit Card,"10,650.00",00.00,"698,328.95"
21-Apr-2022,Commission,00.00,"77,592.11","620,736.84"
21-Apr-2022,Transfer,00.00,"310,368.42","310,368.42"
21-Apr-2022,Interest,00.00,"62,073.68","248,294.74"
21-Apr-2022,Commission,"304,078.20",00.00,"552,372.94"
21-Apr-2022,NEFT,01.00,00.00,"552,373.94"
21-Apr-2022,ATM,"7,879.00",00.00,"560,252.94"
21-Apr-2022,Tax,00.00,"280,126.47","280,126.47"
21-Apr-2022,ATM,00.00,"40,018.07","240,108.40"
21-Apr-2022,Reversal,00.00,"240,108.40",00.00
21-Apr-2022,ATM,"10,205.48",00.00,"10,205.48"
21-Apr-2022,Commission,"3,609.00",00.00,"13,814.48"
21-Apr-2022,Bill,585.00,00.00,"14,399.48"
21-Apr-2022,Transfer,"20,030.00",00.00,"34,429.48"
21-Apr-2022,Cheque,00.00,"6,885.90","27,543.58"
21-Apr-2022,Cash,352.00,00.00,"27,895.58"
22-Apr-2022,Cheque,46.70,00.00,"27,942.28"
22-Apr-2022,Transfer,00.00,"9,314.09","18,628.19"
22-Apr-2022,Cash,00.00,"3,725.64","14,902.55"
22-Apr-2022,Miscellaneous,00.00,"1,490.26","13,412.30"
22-Apr-2022,Debit Card,00.00,"4,470.77","8,941.53"
22-Apr-2022,Debit Card,01.51,00.00,"8,943.04"
22-Apr-2022,Reversal,"1,930.10",00.00,"10,873.14"
22-Apr-2022,Transfer,"3,239.70",00.00,"14,112.84"
22-Apr-2022,Cheque,00.00,"2,016.12","12,096.72"
22-Apr-2022,Bill,00.00,"3,024.18","9,072.54"
22-Apr-2022,Commission,"153,229.00",00.00,"162,301.54"
22-Apr-2022,Tax,"1,517,736.50",00.00,"1,680,038.04"
22-Apr-2022,RTGS,00.00,"336,007.61","1,344,030.43"
22-Apr-2022,Tax,"336,866.00",00.00,"1,680,896.43"
22-Apr-2022,Cash,"22,823.72",00.00,"1,703,720.15"
22-Apr-2022,Reversal,00.00,"1,703,720.15",00.00
22-Apr-2022,Commission,"178,723.20",00.00,"178,723.20"
22-Apr-2022,NEFT,00.00,"89,361.60","89,361.60"
22-Apr-2022,Tax,00.00,"44,680.80","44,680.80"
22-Apr-2022,Cheque,00.00,"6,382.97","38,297.83"
22-Apr-2022,Interest,00.00,"4,787.23","33,510.60"
22-Apr-2022,Interest,12.56,00.00,"33,523.16"
22-Apr-2022,Bill,"7,171.10",00.00,"40,694.26"
22-Apr-2022,Purchase,00.00,"5,086.78","35,607.48"
22-Apr-2022,Transfer,43.50,00.00,"35,650.98"
22-Apr-2022,Reversal,00.00,"17,825.49","17,825.49"
22-Apr-2022,Interest,00.00,"2,546.50","15,278.99"
22-Apr-2022,Debit Card,"5,991.32",00.00,"21,270.31"
22-Apr-2022,Cash,"165,529.50",00.00,"186,799.81"
22-Apr-2022,Reversal,"447,054.00",00.00,"633,853.81"
22-Apr-2022,Interest,04.21,00.00,"633,858.02"
22-Apr-2022,Interest,00.00,"316,929.01","316,929.01"
22-Apr-2022,Commission,"127,070.00",00.00,"443,999.01"
22-Apr-2022,RTGS,05.90,00.00,"444,004.91"
22-Apr-2022,Reversal,"3,861.40",00.00,"447,866.31"
22-Apr-2022,RTGS,00.00,"111,966.58","335,899.73"
22-Apr-2022,ATM,"22,494.79",00.00,"358,394.52"
22-Apr-2022,Interest,00.00,"89,598.63","268,795.89"
22-Apr-2022,IMPS,315.70,00.00,"269,111.59"
22-Apr-2022,Purchase,00.00,"33,638.95","235,472.64"
22-Apr-2022,Purchase,00.00,"29,434.08","206,038.56"
22-Apr-2022,RTGS,00.00,"22,893.17","183,145.39"
22-Apr-2022,Debit Card,00.00,"183,145.39",00.00
22-Apr-2022,Bill,52.00,00.00,52.00
22-Apr-2022,Transfer,00.00,05.78,46.22
22-Apr-2022,RTGS,00.00,23.11,23.11
22-Apr-2022,ATM,00.00,02.31,20.80
22-Apr-2022,ATM,00.00,06.93,13.87
22-Apr-2022,Interest,726.90,00.00,740.77
22-Apr-2022,Cash,00.00,185.19,555.58
22-Apr-2022,Cheque,"901,320.75",00.00,"901,876.33"
22-Apr-2022,RTGS,00.00,"90,187.63","811,688.70"
22-Apr-2022,Cheque,00.00,"405,844.35","405,844.35"
22-Apr-2022,Debit Card,00.00,"405,844.35",00.00
22-Apr-2022,NEFT,"2,619.90",00.00,"2,619.90"
22-Apr-2022,Cash,00.00,327.49,"2,292.41"
22-Apr-2022,NEFT,00.23,00.00,"2,292.64"
22-Apr-2022,ATM,"1,509,403.00",00.00,"1,511,695.64"
22-Apr-2022,Debit Card,00.00,"251,949.27","1,259,746.37"
22-Apr-2022,IMPS,00.00,"314,936.59","944,809.78"
22-Apr-2022,Commission,"2,558.00",00.00,"947,367.78"
22-Apr-2022,NEFT,103.80,00.00,"947,471.58"
22-Apr-2022,Reversal,00.00,"236,867.90","710,603.68"
22-Apr-2022,Interest,"11,338.00",00.00,"721,941.68"
22-Apr-2022,Debit Card,"3,241.26",00.00,"725,182.94"
22-Apr-2022,Miscellaneous,00.00,"145,036.59","580,146.35"
22-Apr-2022,IMPS,00.00,"290,073.18","290,073.18"
22-Apr-2022,RTGS,00.00,"96,691.06","193,382.12"
22-Apr-2022,Transfer,00.00,"64,460.71","128,921.41"
22-Apr-2022,Tax,00.00,"18,417.34","110,504.07"
22-Apr-2022,RTGS,32.00,00.00,"110,536.07"
22-Apr-2022,Cash,04.52,00.00,"110,540.59"
22-Apr-2022,Commission,05.00,00.00,"110,545.59"
22-Apr-2022,Miscellaneous,107.38,00.00,"110,652.97"
22-Apr-2022,Commission,"16,946.00",00.00,"127,598.97"
22-Apr-2022,Tax,44.57,00.00,"127,643.54"
22-Apr-2022,RTGS,33.28,00.00,"127,676.82"
22-Apr-2022,NEFT,423.60,00.00,"128,100.42"
22-Apr-2022,Reversal,06.60,00.00,"128,107.02"
22-Apr-2022,Bill,00.00,"64,053.51","64,053.51"
22-Apr-2022,Interest,00.00,"7,117.06","56,936.45"
22-Apr-2022,Reversal,00.00,"28,468.23","28,468.22"
22-Apr-2022,Reversal,00.00,"3,163.14","25,305.08"
22-Apr-2022,Commission,00.00,"12,652.54","12,652.54"
22-Apr-2022,Purchase,00.00,"12,652.54",00.00
22-Apr-2022,ATM,27.00,00.00,27.00
22-Apr-2022,Cheque,"530,163.75",00.00,"530,190.75"
22-Apr-2022,Miscellaneous,"1,251.15",00.00,"531,441.90"
22-Apr-2022,Interest,"1,029,241.25",00.00,"1,560,683.15"
22-Apr-2022,Purchase,00.00,"222,954.74","1,337,728.41"
22-Apr-2022,ATM,"178,036.84",00.00,"1,515,765.25"
22-Apr-2022,Cheque,00.00,"1,515,765.25",00.00
22-Apr-2022,Purchase,01.86,00.00,01.86
22-Apr-2022,Debit Card,"86,527.75",00.00,"86,529.61"
22-Apr-2022,NEFT,00.00,"8,652.96","77,876.65"
22-Apr-2022,ATM,00.00,"12,979.44","64,897.21"
22-Apr-2022,Miscellaneous,00.00,"16,224.30","48,672.91"
22-Apr-2022,Cheque,"111,529.00",00.00,"160,201.91"
22-Apr-2022,Tax,468.00,00.00,"160,669.91"
22-Apr-2022,Commission,26.04,00.00,"160,695.95"
22-Apr-2022,NEFT,"2,820.40",00.00,"163,516.35"
22-Apr-2022,Tax,47.00,00.00,"163,563.35"
22-Apr-2022,Cheque,00.00,"32,712.67","130,850.68"
22-Apr-2022,IMPS,342.00,00.00,"131,192.68"
22-Apr-2022,Tax,00.00,"14,576.96","116,615.72"
22-Apr-2022,Commission,00.00,"38,871.91","77,743.81"
22-Apr-2022,RTGS,"157,334.00",00.00,"235,077.81"
22-Apr-2022,Interest,00.00,"78,359.27","156,718.54"
22-Apr-2022,Bill,00.00,"39,179.64","117,538.90"
22-Apr-2022,Commission,00.00,"117,538.90",00.00
22-Apr-2022,Debit Card,228.50,00.00,228.50
23-Apr-2022,Commission,00.00,76.17,152.33
23-Apr-2022,RTGS,"111,773.41",00.00,"111,925.74"
23-Apr-2022,Cash,00.00,"27,981.44","83,944.30"
23-Apr-2022,Miscellaneous,00.00,"83,944.30",00.00
23-Apr-2022,Commission,"252,576.80",00.00,"252,576.80"
23-Apr-2022,Commission,00.00,"84,192.27","168,384.53"
23-Apr-2022,Interest,"249,420.00",00.00,"417,804.53"
23-Apr-2022,Bill,00.00,"46,422.73","371,381.80"
23-Apr-2022,Transfer,00.00,"92,845.45","278,536.35"
23-Apr-2022,ATM,00.00,"30,948.48","247,587.87"
23-Apr-2022,Tax,"1,170,379.00",00.00,"1,417,966.87"
23-Apr-2022,Tax,06.99,00.00,"1,417,973.86"
23-Apr-2022,Debit Card,00.00,"708,986.93","708,986.93"
23-Apr-2022,IMPS,"27,698.32",00.00,"736,685.25"
23-Apr-2022,Cheque,00.00,"184,171.31","552,513.94"
23-Apr-2022,Tax,00.00,"69,064.24","483,449.70"
23-Apr-2022,Commission,00.00,"120,862.43","362,587.28"
23-Apr-2022,Reversal,00.00,"362,587.28",00.00
23-Apr-2022,Tax,"14,254.02",00.00,"14,254.02"
23-Apr-2022,Bill,"1,803,524.75",00.00,"1,817,778.77"
23-Apr-2022,Debit Card,"2,543.60",00.00,"1,820,322.37"
23-Apr-2022,Commission,401.00,00.00,"1,820,723.37"
23-Apr-2022,Cash,00.00,"364,144.67","1,456,578.70"
23-Apr-2022,Commission,00.00,"182,072.34","1,274,506.36"
23-Apr-2022,ATM,00.00,"141,611.82","1,132,894.54"
23-Apr-2022,Reversal,26.53,00.00,"1,132,921.07"
24-Apr-2022,Reversal,00.00,"141,615.13","991,305.94"
24-Apr-2022,Miscellaneous,00.00,"991,305.94",00.00
24-Apr-2022,RTGS,"139,585.06",00.00,"139,585.06"
24-Apr-2022,ATM,00.00,"13,958.51","125,626.55"
24-Apr-2022,Commission,04.40,00.00,"125,630.95"
24-Apr-2022,Commission,00.00,"20,938.49","104,692.46"
24-Apr-2022,Purchase,00.00,"17,448.74","87,243.72"
24-Apr-2022,Commission,00.00,"21,810.93","65,432.79"
24-Apr-2022,Commission,"2,599.20",00.00,"68,031.99"
24-Apr-2022,Miscellaneous,"3,692.00",00.00,"71,723.99"
24-Apr-2022,Debit Card,914.00,00.00,"72,637.99"
24-Apr-2022,Commission,00.00,"14,527.60","58,110.39"
24-Apr-2022,RTGS,223.70,00.00,"58,334.09"
24-Apr-2022,Interest,"14,756.50",00.00,"73,090.59"
24-Apr-2022,NEFT,02.88,00.00,"73,093.47"
24-Apr-2022,IMPS,00.00,"9,136.68","63,956.79"
24-Apr-2022,IMPS,02.30,00.00,"63,959.09"
24-Apr-2022,NEFT,"3,502.00",00.00,"67,461.09"
24-Apr-2022,NEFT,02.40,00.00,"67,463.49"
24-Apr-2022,Miscellaneous,00.00,"9,637.64","57,825.85"
24-Apr-2022,Reversal,00.00,"5,782.59","52,043.26"
24-Apr-2022,Interest,00.00,"10,408.65","41,634.61"
24-Apr-2022,IMPS,00.00,"5,947.80","35,686.81"
24-Apr-2022,Interest,"1,093,967.25",00.00,"1,129,654.06"
24-Apr-2022,Purchase,00.00,"376,551.35","753,102.71"
24-Apr-2022,Reversal,"3,193.56",00.00,"756,296.27"
24-Apr-2022,ATM,39.26,00.00,"756,335.53"
24-Apr-2022,IMPS,02.20,00.00,"756,337.73"
24-Apr-2022,Interest,"12,954.56",00.00,"769,292.29"
24-Apr-2022,RTGS,11.00,00.00,"769,303.29"
24-Apr-2022,Bill,49.10,00.00,"769,352.39"
24-Apr-2022,ATM,00.00,"76,935.24","692,417.15"
24-Apr-2022,Commission,226.70,00.00,"692,643.85"
24-Apr-2022,Reversal,00.00,"86,580.48","606,063.37"
24-Apr-2022,Tax,00.00,"202,021.12","404,042.25"
24-Apr-2022,Transfer,01.11,00.00,"404,043.36"
24-Apr-2022,Cheque,195.05,00.00,"404,238.41"
24-Apr-2022,Bill,"3,933.40",00.00,"408,171.81"
24-Apr-2022,Purchase,00.00,"68,028.64","340,143.18"
24-Apr-2022,IMPS,"1,127,451.00",00.00,"1,467,594.18"
24-Apr-2022,Interest,00.00,"183,449.27","1,284,144.91"
24-Apr-2022,Bill,45.57,00.00,"1,284,190.48"
24-Apr-2022,Tax,00.00,"183,455.78","1,100,734.70"
24-Apr-2022,Debit Card,"839,518.20",00.00,"1,940,252.90"
24-Apr-2022,Debit Card,"20,400.00",00.00,"1,960,652.90"
24-Apr-2022,Debit Card,00.00,"245,081.61","1,715,571.29"
24-Apr-2022,Purchase,00.00,"190,619.03","1,524,952.26"
24-Apr-2022,Transfer,00.00,"1,524,952.26",00.00
24-Apr-2022,ATM,"149,999.00",00.00,"149,999.00"
24-Apr-2022,Commission,"97,533.80",00.00,"247,532.80"
24-Apr-2022,ATM,155.72,00.00,"247,688.52"
24-Apr-2022,Cheque,00.00,"49,537.70","198,150.82"
24-Apr-2022,IMPS,00.00,"198,150.82",00.00
24-Apr-2022,Cash,"3,000.10",00.00,"3,000.10"
24-Apr-2022,Purchase,00.00,"3,000.10",00.00
24-Apr-2022,NEFT,"140,316.91",00.00,"140,316.91"
24-Apr-2022,IMPS,00.00,"35,079.23","105,237.68"
24-Apr-2022,ATM,"13,861.00",00.00,"119,098.68"
24-Apr-2022,Commission,00.00,"59,549.34","59,549.34"
24-Apr-2022,Tax,00.00,"5,954.93","53,594.41"
24-Apr-2022,Cash,00.00,"10,718.88","42,875.53"
24-Apr-2022,Commission,00.00,"10,718.88","32,156.65"
24-Apr-2022,Cash,00.00,"5,359.44","26,797.21"
24-Apr-2022,Cash,"6,972.21",00.00,"33,769.42"
24-Apr-2022,Cash,00.00,"33,769.42",00.00
24-Apr-2022,Debit Card,"1,294.49",00.00,"1,294.49"
24-Apr-2022,Debit Card,"60,759.10",00.00,"62,053.59"
24-Apr-2022,Interest,00.00,"8,864.80","53,188.79"
24-Apr-2022,Cash,03.00,00.00,"53,191.79"
24-Apr-2022,ATM,00.00,"13,297.95","39,893.84"
24-Apr-2022,Bill,00.00,"19,946.92","19,946.92"
24-Apr-2022,Transfer,00.00,"2,849.56","17,097.36"
24-Apr-2022,Cheque,"2,095.10",00.00,"19,192.46"
24-Apr-2022,Commission,"787,264.75",00.00,"806,457.21"
24-Apr-2022,Transfer,"31,200.20",00.00,"837,657.41"
24-Apr-2022,Bill,00.00,"93,073.05","744,584.36"
24-Apr-2022,RTGS,"1,058.50",00.00,"745,642.86"
24-Apr-2022,Bill,"1,319,763.80",00.00,"2,065,406.66"
24-Apr-2022,Purchase,343.00,00.00,"2,065,749.66"
24-Apr-2022,Reversal,00.00,"413,149.93","1,652,599.73"
25-Apr-2022,ATM,00.00,"826,299.87","826,299.86"
25-Apr-2022,Miscellaneous,718.01,00.00,"827,017.87"
25-Apr-2022,Interest,00.00,"82,701.79","744,316.08"
25-Apr-2022,Bill,"244,107.50",00.00,"988,423.58"
25-Apr-2022,Debit Card,00.00,"329,474.53","658,949.05"
25-Apr-2022,ATM,00.00,"131,789.81","527,159.24"
25-Apr-2022,Debit Card,00.00,"105,431.85","421,727.39"
25-Apr-2022,Debit Card,00.00,"46,858.60","374,868.79"
25-Apr-2022,Reversal,00.00,"74,973.76","299,895.03"
26-Apr-2022,Cash,"2,212.00",00.00,"302,107.03"
26-Apr-2022,Tax,00.00,"30,210.70","271,896.33"
26-Apr-2022,RTGS,00.00,"54,379.27","217,517.06"
26-Apr-2022,Debit Card,"92,938.50",00.00,"310,455.56"
26-Apr-2022,Bill,00.00,"155,227.78","155,227.78"
26-Apr-2022,IMPS,00.00,"155,227.78",00.00
26-Apr-2022,Debit Card,497.00,00.00,497.00
26-Apr-2022,Cash,"9,053.00",00.00,"9,550.00"
26-Apr-2022,IMPS,04.35,00.00,"9,554.35"
26-Apr-2022,RTGS,00.00,"4,777.18","4,777.18"
26-Apr-2022,ATM,19.20,00.00,"4,796.38"
27-Apr-2022,Cash,46.70,00.00,"4,843.08"
27-Apr-2022,RTGS,00.00,968.62,"3,874.46"
27-Apr-2022,RTGS,04.00,00.00,"3,878.46"
27-Apr-2022,Cash,23.00,00.00,"3,901.46"
27-Apr-2022,RTGS,"2,497.00",00.00,"6,398.46"
27-Apr-2022,ATM,"133,803.10",00.00,"140,201.56"
27-Apr-2022,Cheque,"3,775.20",00.00,"143,976.76"
28-Apr-2022,Miscellaneous,00.00,"20,568.11","123,408.65"
28-Apr-2022,ATM,"3,095.00",00.00,"126,503.65"
28-Apr-2022,Reversal,"14,889.68",00.00,"141,393.33"
28-Apr-2022,Transfer,"117,040.00",00.00,"258,433.33"
28-Apr-2022,Interest,00.00,"32,304.17","226,129.16"
28-Apr-2022,Miscellaneous,"3,121.58",00.00,"229,250.74"
28-Apr-2022,RTGS,00.00,"229,250.74",00.00
28-Apr-2022,Bill,06.71,00.00,06.71
28-Apr-2022,Debit Card,"28,699.80",00.00,"28,706.51"
28-Apr-2022,Cheque,"1,155.10",00.00,"29,861.61"
28-Apr-2022,Cheque,853.22,00.00,"30,714.83"
28-Apr-2022,Reversal,00.00,"5,119.14","25,595.69"
28-Apr-2022,NEFT,00.00,"8,531.90","17,063.79"
28-Apr-2022,Commission,00.00,"5,687.93","11,375.86"
28-Apr-2022,ATM,00.00,"1,263.98","10,111.88"
28-Apr-2022,Purchase,389.50,00.00,"10,501.38"
29-Apr-2022,Purchase,"161,275.28",00.00,"171,776.66"
29-Apr-2022,Bill,52.60,00.00,"171,829.26"
29-Apr-2022,Purchase,"53,662.97",00.00,"225,492.23"
29-Apr-2022,Cheque,00.00,"25,054.69","200,437.54"
29-Apr-2022,NEFT,"3,965.10",00.00,"204,402.64"
29-Apr-2022,Purchase,00.00,"20,440.26","183,962.38"
29-Apr-2022,Cash,"47,781.00",00.00,"231,743.38"
29-Apr-2022,Purchase,50.84,00.00,"231,794.22"
29-Apr-2022,Cheque,"1,581,888.20",00.00,"1,813,682.42"
29-Apr-2022,Miscellaneous,00.00,"906,841.21","906,841.21"
29-Apr-2022,Cheque,00.00,"453,420.61","453,420.60"
29-Apr-2022,Commission,61.56,00.00,"453,482.16"
29-Apr-2022,IMPS,00.00,"75,580.36","377,901.80"
29-Apr-2022,Interest,"213,433.60",00.00,"591,335.40"
29-Apr-2022,Purchase,00.00,"197,111.80","394,223.60"
29-Apr-2022,RTGS,00.00,"131,407.87","262,815.73"
29-Apr-2022,Reversal,00.00,"52,563.15","210,252.58"
29-Apr-2022,ATM,00.00,"23,361.40","186,891.18"
29-Apr-2022,Tax,00.00,"18,689.12","168,202.06"
29-Apr-2022,Interest,"254,107.00",00.00,"422,309.06"
29-Apr-2022,IMPS,00.00,"60,329.87","361,979.19"
29-Apr-2022,ATM,11.07,00.00,"361,990.26"
29-Apr-2022,ATM,"167,814.84",00.00,"529,805.10"
29-Apr-2022,Purchase,00.00,"58,867.23","470,937.87"
30-Apr-2022,Purchase,14.60,00.00,"470,952.47"
30-Apr-2022,Reversal,504.60,00.00,"471,457.07"
30-Apr-2022,Bill,00.00,"52,384.12","419,072.95"
30-Apr-2022,Bill,00.56,00.00,"419,073.51"
01-May-2022,NEFT,00.00,"104,768.38","314,305.13"
01-May-2022,Transfer,"148,311.10",00.00,"462,616.23"
01-May-2022,NEFT,797.74,00.00,"463,413.97"
01-May-2022,Debit Card,00.00,"115,853.49","347,560.48"
01-May-2022,Bill,00.00,"173,780.24","173,780.24"
01-May-2022,Interest,00.00,"24,825.75","148,954.49"
01-May-2022,Cash,"1,432.00",00.00,"150,386.49"
01-May-2022,Cash,"195,376.70",00.00,"345,763.19"
01-May-2022,RTGS,00.00,"34,576.32","311,186.87"
01-May-2022,Bill,00.00,"38,898.36","272,288.51"
01-May-2022,Miscellaneous,00.00,"27,228.85","245,059.66"
01-May-2022,Transfer,58.00,00.00,"245,117.66"
01-May-2022,Debit Card,"3,245.00",00.00,"248,362.66"
01-May-2022,Tax,"6,085.91",00.00,"254,448.57"
01-May-2022,Commission,00.00,"254,448.57",00.00
01-May-2022,Purchase,05.80,00.00,05.80
01-May-2022,Bill,"28,873.90",00.00,"28,879.70"
01-May-2022,Bill,07.00,00.00,"28,886.70"
01-May-2022,Purchase,00.00,"7,221.68","21,665.02"
01-May-2022,Transfer,00.00,"2,407.22","19,257.80"
01-May-2022,NEFT,00.00,"1,925.78","17,332.02"
01-May-2022,Cheque,00.00,"4,333.01","12,999.02"
02-May-2022,Commission,59.60,00.00,"13,058.62"
02-May-2022,RTGS,00.00,"1,305.86","11,752.76"
02-May-2022,IMPS,07.00,00.00,"11,759.76"
02-May-2022,Interest,00.00,"5,879.88","5,879.88"
02-May-2022,Interest,"210,186.00",00.00,"216,065.88"
02-May-2022,NEFT,"24,115.70",00.00,"240,181.58"
02-May-2022,RTGS,00.00,"120,090.79","120,090.79"
02-May-2022,NEFT,314.00,00.00,"120,404.79"
02-May-2022,Tax,00.00,"40,134.93","80,269.86"
02-May-2022,Miscellaneous,06.00,00.00,"80,275.86"
03-May-2022,Miscellaneous,00.00,"40,137.93","40,137.93"
03-May-2022,ATM,00.00,"40,137.93",00.00
03-May-2022,RTGS,119.10,00.00,119.10
03-May-2022,IMPS,00.00,19.85,99.25
03-May-2022,Cash,00.00,09.93,89.32
03-May-2022,Cheque,246.93,00.00,336.25
03-May-2022,Miscellaneous,00.00,84.06,252.19
03-May-2022,Debit Card,34.90,00.00,287.09
03-May-2022,Purchase,00.00,41.01,246.08
03-May-2022,IMPS,00.00,41.01,205.07
03-May-2022,Interest,"22,709.00",00.00,"22,914.07"
03-May-2022,Interest,00.00,"7,638.02","15,276.05"
03-May-2022,Debit Card,00.00,"7,638.03","7,638.02"
03-May-2022,RTGS,00.00,"7,638.02",00.00
03-May-2022,Cash,"250,501.70",00.00,"250,501.70"
03-May-2022,NEFT,"12,382.40",00.00,"262,884.10"
03-May-2022,Reversal,651.00,00.00,"263,535.10"
03-May-2022,Interest,34.73,00.00,"263,569.83"
03-May-2022,Cheque,"2,077.81",00.00,"265,647.64"
03-May-2022,Cash,128.00,00.00,"265,775.64"
03-May-2022,Interest,00.00,"265,775.64",00.00
03-May-2022,Tax,02.40,00.00,02.40
03-May-2022,Transfer,00.00,02.40,00.00
03-May-2022,Reversal,16.00,00.00,16.00
03-May-2022,Bill,"9,988.90",00.00,"10,004.90"
03-May-2022,NEFT,00.00,"2,501.23","7,503.67"
03-May-2022,Transfer,00.00,"2,501.22","5,002.45"
03-May-2022,Bill,"51,368.60",00.00,"56,371.05"
03-May-2022,Interest,"3,923.37",00.00,"60,294.42"
03-May-2022,Cheque,"1,251.00",00.00,"61,545.42"
03-May-2022,Transfer,00.00,"6,838.38","54,707.04"
03-May-2022,Interest,"844,448.00",00.00,"899,155.04"
03-May-2022,Transfer,08.30,00.00,"899,163.34"
03-May-2022,Cheque,"2,409.00",00.00,"901,572.34"
03-May-2022,RTGS,"24,382.70",00.00,"925,955.04"
03-May-2022,Interest,00.00,"92,595.50","833,359.54"
03-May-2022,Interest,33.10,00.00,"833,392.64"
04-May-2022,Purchase,00.00,"416,696.32","416,696.32"
04-May-2022,Miscellaneous,06.70,00.00,"416,703.02"
04-May-2022,Miscellaneous,00.00,"41,670.30","375,032.72"
04-May-2022,ATM,00.00,"41,670.30","333,362.42"
04-May-2022,RTGS,00.00,"33,336.24","300,026.18"
04-May-2022,Bill,00.00,"300,026.18",00.00
04-May-2022,Cash,"1,063,024.50",00.00,"1,063,024.50"
04-May-2022,Commission,00.00,"151,860.64","911,163.86"
04-May-2022,Transfer,00.00,"227,790.97","683,372.90"
04-May-2022,Bill,00.00,"97,624.70","585,748.20"
04-May-2022,Commission,00.00,"83,678.31","502,069.89"
04-May-2022,Reversal,07.26,00.00,"502,077.15"
04-May-2022,Transfer,00.00,"83,679.53","418,397.62"
04-May-2022,Interest,00.00,"69,732.94","348,664.68"
05-May-2022,Purchase,00.00,"87,166.17","261,498.51"
05-May-2022,Cheque,00.00,"65,374.63","196,123.88"
05-May-2022,Tax,"115,492.00",00.00,"311,615.88"
05-May-2022,Miscellaneous,00.00,"155,807.94","155,807.94"
05-May-2022,Commission,00.00,"25,967.99","129,839.95"
05-May-2022,Reversal,"1,144,529.20",00.00,"1,274,369.15"
06-May-2022,Tax,"1,403,531.00",00.00,"2,677,900.15"
06-May-2022,Bill,00.00,"334,737.52","2,343,162.63"
06-May-2022,NEFT,08.00,00.00,"2,343,170.63"
06-May-2022,Transfer,00.00,"781,056.88","1,562,113.75"
07-May-2022,Transfer,00.00,"312,422.75","1,249,691.00"
07-May-2022,NEFT,05.75,00.00,"1,249,696.75"
07-May-2022,Interest,05.77,00.00,"1,249,702.52"
07-May-2022,ATM,00.00,"416,567.51","833,135.01"
07-May-2022,Cash,"26,921.00",00.00,"860,056.01"
08-May-2022,Cheque,31.00,00.00,"860,087.01"
08-May-2022,Debit Card,00.00,"215,021.75","645,065.26"
08-May-2022,IMPS,06.00,00.00,"645,071.26"
08-May-2022,Commission,28.38,00.00,"645,099.64"
08-May-2022,Cheque,352.60,00.00,"645,452.24"
08-May-2022,Tax,00.00,"80,681.53","564,770.71"
08-May-2022,ATM,00.00,"141,192.68","423,578.03"
08-May-2022,Interest,418.03,00.00,"423,996.06"
08-May-2022,ATM,434.00,00.00,"424,430.06"
09-May-2022,Interest,00.00,"70,738.34","353,691.72"
09-May-2022,Miscellaneous,"29,622.50",00.00,"383,314.22"
10-May-2022,Transfer,00.00,"38,331.42","344,982.80"
10-May-2022,Debit Card,00.00,"43,122.85","301,859.95"
10-May-2022,Reversal,00.00,"75,464.99","226,394.96"
10-May-2022,RTGS,253.30,00.00,"226,648.26"
10-May-2022,Debit Card,00.00,"32,378.32","194,269.94"
10-May-2022,Cash,00.00,"97,134.97","97,134.97"
10-May-2022,Miscellaneous,"1,717,790.00",00.00,"1,814,924.97"
10-May-2022,Cheque,00.00,"226,865.62","1,588,059.35"
10-May-2022,Reversal,00.00,"264,676.56","1,323,382.79"
10-May-2022,RTGS,"2,024,931.80",00.00,"3,348,314.59"
10-May-2022,Miscellaneous,00.00,"558,052.43","2,790,262.16"
10-May-2022,Reversal,"105,101.16",00.00,"2,895,363.32"
10-May-2022,Purchase,"1,585,251.00",00.00,"4,480,614.32"
10-May-2022,Cash,00.00,"4,480,614.32",00.00
10-May-2022,Transfer,"3,639.00",00.00,"3,639.00"
10-May-2022,ATM,00.00,454.88,"3,184.12"
10-May-2022,Commission,00.00,"1,592.06","1,592.06"
10-May-2022,IMPS,"882,666.00",00.00,"884,258.06"
10-May-2022,Bill,"1,938.66",00.00,"886,196.72"
10-May-2022,IMPS,40.88,00.00,"886,237.60"
11-May-2022,Transfer,"1,124,889.00",00.00,"2,011,126.60"
11-May-2022,Transfer,"49,275.59",00.00,"2,060,402.19"
11-May-2022,IMPS,"2,346.15",00.00,"2,062,748.34"
11-May-2022,Miscellaneous,"14,075.00",00.00,"2,076,823.34"
11-May-2022,Bill,00.00,"2,076,823.34",00.00
11-May-2022,ATM,"2,470.00",00.00,"2,470.00"
11-May-2022,Miscellaneous,00.00,352.86,"2,117.14"
11-May-2022,IMPS,00.00,264.64,"1,852.50"
11-May-2022,Reversal,00.00,205.83,"1,646.67"
11-May-2022,IMPS,00.00,205.83,"1,440.84"
11-May-2022,Purchase,00.00,144.08,"1,296.76"
11-May-2022,NEFT,00.00,162.10,"1,134.66"
11-May-2022,NEFT,00.00,189.11,945.55
11-May-2022,Reversal,14.00,00.00,959.55
11-May-2022,ATM,00.00,106.62,852.93
11-May-2022,IMPS,00.00,852.93,00.00
11-May-2022,Commission,"1,433,861.00",00.00,"1,433,861.00"
11-May-2022,Commission,00.00,"716,930.50","716,930.50"
11-May-2022,Purchase,29.35,00.00,"716,959.85"
11-May-2022,RTGS,00.00,"79,662.21","637,297.64"
11-May-2022,Miscellaneous,00.00,"159,324.41","477,973.23"
11-May-2022,NEFT,798.49,00.00,"478,771.72"
11-May-2022,Transfer,00.00,"478,771.72",00.00
11-May-2022,NEFT,"20,328.02",00.00,"20,328.02"
11-May-2022,Tax,00.00,"5,082.01","15,246.02"
11-May-2022,Cheque,06.50,00.00,"15,252.52"
11-May-2022,Bill,00.00,"2,178.93","13,073.59"
11-May-2022,Reversal,00.00,"6,536.80","6,536.80"
11-May-2022,ATM,00.00,"1,634.20","4,902.60"
11-May-2022,Commission,00.00,612.83,"4,289.78"
11-May-2022,Debit Card,"860,839.50",00.00,"865,129.28"
11-May-2022,Debit Card,00.00,"144,188.21","720,941.07"
11-May-2022,Purchase,00.00,"144,188.21","576,752.86"
11-May-2022,Transfer,00.00,"82,393.27","494,359.59"
11-May-2022,Transfer,00.00,"123,589.90","370,769.69"
11-May-2022,NEFT,00.00,"123,589.90","247,179.79"
11-May-2022,Interest,00.00,"30,897.47","216,282.32"
11-May-2022,Miscellaneous,"1,371.80",00.00,"217,654.12"
11-May-2022,Purchase,00.00,"43,530.82","174,123.30"
11-May-2022,NEFT,07.80,00.00,"174,131.10"
11-May-2022,Interest,00.00,"21,766.39","152,364.71"
11-May-2022,Interest,"1,359,290.80",00.00,"1,511,655.51"
11-May-2022,Purchase,"21,685.90",00.00,"1,533,341.41"
11-May-2022,Purchase,00.00,"153,334.14","1,380,007.27"
11-May-2022,Purchase,00.00,"153,334.14","1,226,673.13"
11-May-2022,Cash,"20,962.00",00.00,"1,247,635.13"
11-May-2022,Bill,00.00,"124,763.51","1,122,871.62"
11-May-2022,NEFT,00.00,"187,145.27","935,726.35"
11-May-2022,Reversal,00.00,"311,908.78","623,817.57"
11-May-2022,Bill,00.00,"207,939.19","415,878.38"
11-May-2022,Cheque,00.00,"415,878.38",00.00
11-May-2022,Miscellaneous,35.00,00.00,35.00
11-May-2022,Commission,"144,757.00",00.00,"144,792.00"
11-May-2022,ATM,00.00,"20,684.57","124,107.43"
11-May-2022,Reversal,00.00,"15,513.43","108,594.00"
11-May-2022,Miscellaneous,"31,262.40",00.00,"139,856.40"
11-May-2022,Reversal,00.00,"34,964.10","104,892.30"
11-May-2022,IMPS,00.00,"10,489.23","94,403.07"
11-May-2022,Interest,"1,980,068.00",00.00,"2,074,471.07"
11-May-2022,Miscellaneous,02.50,00.00,"2,074,473.57"
11-May-2022,Transfer,00.00,"345,745.60","1,728,727.98"
11-May-2022,Bill,"121,923.22",00.00,"1,850,651.20"
11-May-2022,Cheque,"591,872.00",00.00,"2,442,523.20"
11-May-2022,IMPS,00.00,"814,174.40","1,628,348.80"
11-May-2022,Interest,"860,617.00",00.00,"2,488,965.80"
11-May-2022,Commission,"1,103,884.80",00.00,"3,592,850.60"
11-May-2022,Transfer,"11,332.00",00.00,"3,604,182.60"
11-May-2022,Debit Card,00.00,"360,418.26","3,243,764.34"
11-May-2022,Miscellaneous,00.00,"1,621,882.17","1,621,882.17"
11-May-2022,Debit Card,"1,329,823.75",00.00,"2,951,705.92"
11-May-2022,IMPS,"3,582.80",00.00,"2,955,288.72"
12-May-2022,Reversal,00.00,"422,184.10","2,533,104.62"
12-May-2022,Miscellaneous,"771,583.00",00.00,"3,304,687.62"
12-May-2022,Debit Card,01.00,00.00,"3,304,688.62"
12-May-2022,RTGS,00.00,"826,172.16","2,478,516.46"
12-May-2022,Purchase,00.00,"826,172.15","1,652,344.31"
12-May-2022,Purchase,00.00,"206,543.04","1,445,801.27"
12-May-2022,Purchase,00.00,"160,644.59","1,285,156.68"
12-May-2022,Reversal,"79,413.44",00.00,"1,364,570.12"
12-May-2022,Transfer,00.00,"194,938.59","1,169,631.53"
12-May-2022,Transfer,00.00,"389,877.18","779,754.35"
12-May-2022,Tax,00.00,"389,877.18","389,877.18"
13-May-2022,Debit Card,"6,468.60",00.00,"396,345.78"
13-May-2022,IMPS,"122,281.78",00.00,"518,627.56"
13-May-2022,Transfer,00.00,"51,862.76","466,764.80"
13-May-2022,Reversal,00.00,"46,676.48","420,088.32"
13-May-2022,ATM,00.00,"70,014.72","350,073.60"
13-May-2022,Bill,00.00,"175,036.80","175,036.80"
13-May-2022,Commission,00.00,"58,345.60","116,691.20"
14-May-2022,Cheque,00.20,00.00,"116,691.40"
14-May-2022,ATM,00.00,"16,670.20","100,021.20"
14-May-2022,Transfer,58.97,00.00,"100,080.17"
15-May-2022,Miscellaneous,392.00,00.00,"100,472.17"
15-May-2022,IMPS,19.65,00.00,"100,491.82"
16-May-2022,ATM,429.30,00.00,"100,921.12"
16-May-2022,Interest,00.00,"100,921.12",00.00
16-May-2022,RTGS,04.50,00.00,04.50
16-May-2022,NEFT,00.00,00.64,03.86
16-May-2022,Miscellaneous,205.00,00.00,208.86
16-May-2022,ATM,00.00,69.62,139.24
16-May-2022,Miscellaneous,"1,098.00",00.00,"1,237.24"
16-May-2022,RTGS,00.00,412.41,824.83
16-May-2022,Miscellaneous,"1,377,517.50",00.00,"1,378,342.33"
17-May-2022,Interest,286.00,00.00,"1,378,628.33"
17-May-2022,IMPS,"817,111.00",00.00,"2,195,739.33"
17-May-2022,IMPS,00.00,"2,195,739.33",00.00
17-May-2022,Debit Card,"2,775.10",00.00,"2,775.10"
17-May-2022,Miscellaneous,03.05,00.00,"2,778.15"
17-May-2022,Transfer,"1,921,378.00",00.00,"1,924,156.15"
17-May-2022,Cheque,00.00,"320,692.69","1,603,463.46"
17-May-2022,Bill,46.90,00.00,"1,603,510.36"
17-May-2022,ATM,00.00,"534,503.45","1,069,006.91"
17-May-2022,Transfer,"74,129.62",00.00,"1,143,136.53"
17-May-2022,Tax,42.50,00.00,"1,143,179.03"
17-May-2022,Tax,408.00,00.00,"1,143,587.03"
17-May-2022,IMPS,"1,682.90",00.00,"1,145,269.93"
17-May-2022,RTGS,00.00,"286,317.48","858,952.45"
17-May-2022,Cheque,00.00,"858,952.45",00.00
17-May-2022,Commission,24.00,00.00,24.00
17-May-2022,Miscellaneous,00.00,02.40,21.60
17-May-2022,IMPS,00.00,21.60,00.00
17-May-2022,Miscellaneous,"1,981,687.00",00.00,"1,981,687.00"
17-May-2022,Interest,186.00,00.00,"1,981,873.00"
17-May-2022,Miscellaneous,00.00,"247,734.13","1,734,138.88"
17-May-2022,Tax,"1,195,982.00",00.00,"2,930,120.88"
17-May-2022,Commission,"7,561.20",00.00,"2,937,682.08"
17-May-2022,NEFT,00.00,"326,409.12","2,611,272.96"
17-May-2022,Transfer,00.00,"373,038.99","2,238,233.97"
17-May-2022,Cash,"6,885.89",00.00,"2,245,119.86"
17-May-2022,Transfer,48.60,00.00,"2,245,168.46"
17-May-2022,Tax,00.00,"748,389.49","1,496,778.97"
17-May-2022,IMPS,38.28,00.00,"1,496,817.25"
17-May-2022,RTGS,"1,388,740.00",00.00,"2,885,557.25"
17-May-2022,Commission,60.00,00.00,"2,885,617.25"
17-May-2022,Debit Card,00.00,"480,936.21","2,404,681.04"
17-May-2022,Interest,"1,884.00",00.00,"2,406,565.04"
17-May-2022,Bill,00.00,"401,094.17","2,005,470.87"
17-May-2022,Transfer,00.00,"1,002,735.44","1,002,735.44"
17-May-2022,NEFT,00.00,"167,122.57","835,612.87"
17-May-2022,Purchase,01.00,00.00,"835,613.87"
17-May-2022,Interest,00.00,"835,613.87",00.00
17-May-2022,Interest,"1,859.92",00.00,"1,859.92"
17-May-2022,Bill,"31,857.43",00.00,"33,717.35"
17-May-2022,Interest,00.00,"33,717.35",00.00
17-May-2022,Purchase,100.00,00.00,100.00
17-May-2022,IMPS,34.30,00.00,134.30
17-May-2022,IMPS,35.17,00.00,169.47
17-May-2022,Interest,"263,806.25",00.00,"263,975.72"
17-May-2022,Commission,00.00,"52,795.14","211,180.58"
17-May-2022,Bill,"2,196.70",00.00,"213,377.28"
17-May-2022,IMPS,"90,865.50",00.00,"304,242.78"
17-May-2022,Commission,00.00,"152,121.39","152,121.39"
17-May-2022,Cheque,"11,414.00",00.00,"163,535.39"
17-May-2022,Tax,"1,620.53",00.00,"165,155.92"
17-May-2022,Cheque,"251,381.60",00.00,"416,537.52"
17-May-2022,Cash,00.00,"69,422.92","347,114.60"
17-May-2022,Cheque,00.00,"43,389.33","303,725.27"
17-May-2022,Commission,03.00,00.00,"303,728.27"
17-May-2022,Transfer,160.10,00.00,"303,888.37"
17-May-2022,Miscellaneous,00.00,"37,986.05","265,902.32"
17-May-2022,NEFT,04.66,00.00,"265,906.98"
17-May-2022,Reversal,04.69,00.00,"265,911.67"
17-May-2022,Miscellaneous,"19,424.00",00.00,"285,335.67"
17-May-2022,ATM,"1,848,778.00",00.00,"2,134,113.67"
17-May-2022,IMPS,"275,868.00",00.00,"2,409,981.67"
17-May-2022,Interest,00.00,"481,996.33","1,927,985.34"
17-May-2022,Tax,00.00,"481,996.34","1,445,989.00"
17-May-2022,Bill,"26,181.70",00.00,"1,472,170.70"
17-May-2022,Purchase,353.00,00.00,"1,472,523.70"
17-May-2022,Transfer,00.00,"736,261.85","736,261.85"
17-May-2022,Purchase,"145,883.10",00.00,"882,144.95"
17-May-2022,Cheque,00.00,"441,072.48","441,072.48"
17-May-2022,Purchase,"259,298.25",00.00,"700,370.73"
17-May-2022,ATM,03.20,00.00,"700,373.93"
17-May-2022,Interest,"202,166.40",00.00,"902,540.33"
17-May-2022,NEFT,381.18,00.00,"902,921.51"
17-May-2022,RTGS,00.00,"112,865.19","790,056.32"
17-May-2022,Purchase,"1,059,936.80",00.00,"1,849,993.12"
17-May-2022,Reversal,13.16,00.00,"1,850,006.28"
17-May-2022,NEFT,00.00,"462,501.57","1,387,504.71"
17-May-2022,Reversal,00.00,"1,387,504.71",00.00
17-May-2022,ATM,"7,457.80",00.00,"7,457.80"
17-May-2022,Bill,"75,209.20",00.00,"82,667.00"
17-May-2022,Reversal,"904,697.25",00.00,"987,364.25"
17-May-2022,Reversal,00.00,"98,736.43","888,627.82"
17-May-2022,Cheque,00.00,"444,313.91","444,313.91"
17-May-2022,Transfer,00.00,"222,156.96","222,156.96"
17-May-2022,ATM,00.00,"22,215.70","199,941.26"
17-May-2022,Reversal,00.00,"199,941.26",00.00
17-May-2022,Transfer,"235,129.80",00.00,"235,129.80"
17-May-2022,Debit Card,00.00,"117,564.90","117,564.90"
17-May-2022,IMPS,00.00,"58,782.45","58,782.45"
17-May-2022,Reversal,00.00,"5,878.25","52,904.20"
17-May-2022,Purchase,454.00,00.00,"53,358.20"
17-May-2022,RTGS,00.00,"17,786.07","35,572.13"
17-May-2022,Purchase,00.00,"5,081.73","30,490.40"
17-May-2022,NEFT,218.20,00.00,"30,708.60"
17-May-2022,Debit Card,00.00,"5,118.10","25,590.50"
17-May-2022,IMPS,00.00,"3,198.81","22,391.69"
17-May-2022,Cheque,00.00,"7,463.90","14,927.79"
17-May-2022,Reversal,239.84,00.00,"15,167.63"
17-May-2022,Transfer,00.00,"1,685.29","13,482.34"
17-May-2022,Commission,"2,333.60",00.00,"15,815.94"
17-May-2022,IMPS,00.00,"5,271.98","10,543.96"
17-May-2022,Transfer,00.00,"2,108.79","8,435.17"
17-May-2022,IMPS,00.00,"4,217.59","4,217.58"
17-May-2022,Bill,00.00,468.62,"3,748.96"
17-May-2022,Tax,00.00,"1,874.48","1,874.48"
17-May-2022,RTGS,"1,237,013.00",00.00,"1,238,887.48"
17-May-2022,Reversal,"679,545.00",00.00,"1,918,432.48"
17-May-2022,Transfer,00.00,"319,738.75","1,598,693.73"
18-May-2022,Tax,07.00,00.00,"1,598,700.73"
18-May-2022,IMPS,"24,320.00",00.00,"1,623,020.73"
18-May-2022,Bill,00.00,"180,335.64","1,442,685.09"
18-May-2022,IMPS,"2,160.82",00.00,"1,444,845.91"
18-May-2022,Reversal,00.00,"240,807.65","1,204,038.26"
19-May-2022,RTGS,00.00,"200,673.04","1,003,365.22"
19-May-2022,Reversal,00.00,"100,336.52","903,028.70"
19-May-2022,NEFT,00.00,"129,004.10","774,024.60"
19-May-2022,Cheque,"1,963,540.20",00.00,"2,737,564.80"
20-May-2022,Interest,"81,675.00",00.00,"2,819,239.80"
20-May-2022,ATM,07.80,00.00,"2,819,247.60"
20-May-2022,RTGS,"29,802.90",00.00,"2,849,050.50"
20-May-2022,Reversal,338.00,00.00,"2,849,388.50"
20-May-2022,Transfer,676.00,00.00,"2,850,064.50"
20-May-2022,Commission,03.00,00.00,"2,850,067.50"
20-May-2022,Miscellaneous,00.00,"316,674.17","2,533,393.33"
20-May-2022,ATM,05.00,00.00,"2,533,398.33"
20-May-2022,Transfer,00.00,"844,466.11","1,688,932.22"
20-May-2022,Interest,456.10,00.00,"1,689,388.32"
20-May-2022,Reversal,"16,585.00",00.00,"1,705,973.32"
20-May-2022,Reversal,00.00,"284,328.89","1,421,644.43"
20-May-2022,Cash,42.62,00.00,"1,421,687.05"
20-May-2022,Interest,58.55,00.00,"1,421,745.60"
20-May-2022,Interest,00.00,"473,915.20","947,830.40"
20-May-2022,Transfer,769.20,00.00,"948,599.60"
20-May-2022,Transfer,00.00,"474,299.80","474,299.80"
20-May-2022,Commission,00.00,"118,574.95","355,724.85"
20-May-2022,Transfer,00.00,"355,724.85",00.00
20-May-2022,Purchase,"3,721.00",00.00,"3,721.00"
20-May-2022,NEFT,293.00,00.00,"4,014.00"
20-May-2022,ATM,00.00,501.75,"3,512.25"
20-May-2022,Bill,00.00,"1,170.75","2,341.50"
20-May-2022,Tax,25.19,00.00,"2,366.69"
20-May-2022,Transfer,"1,764.40",00.00,"4,131.09"
20-May-2022,Purchase,00.00,"2,065.55","2,065.54"
20-May-2022,IMPS,00.00,344.26,"1,721.28"
20-May-2022,Bill,182.10,00.00,"1,903.38"
20-May-2022,Purchase,"65,315.00",00.00,"67,218.38"
20-May-2022,Commission,00.00,"13,443.68","53,774.70"
20-May-2022,Bill,00.00,"17,924.90","35,849.80"
20-May-2022,Interest,00.00,"35,849.80",00.00
20-May-2022,Purchase,"5,484.72",00.00,"5,484.72"
20-May-2022,Debit Card,00.00,685.59,"4,799.13"
20-May-2022,Tax,568.00,00.00,"5,367.13"
20-May-2022,NEFT,00.00,536.71,"4,830.42"
20-May-2022,NEFT,38.00,00.00,"4,868.42"
20-May-2022,IMPS,"29,778.45",00.00,"34,646.87"
20-May-2022,NEFT,"90,337.00",00.00,"124,983.87"
20-May-2022,Commission,00.00,"13,887.10","111,096.77"
20-May-2022,NEFT,"2,010.10",00.00,"113,106.87"
20-May-2022,ATM,"1,410.59",00.00,"114,517.46"
20-May-2022,Transfer,00.00,"28,629.37","85,888.10"
20-May-2022,Interest,"250,335.00",00.00,"336,223.10"
20-May-2022,Commission,"1,060.00",00.00,"337,283.10"
20-May-2022,Cheque,00.00,"168,641.55","168,641.55"
20-May-2022,Debit Card,04.00,00.00,"168,645.55"
20-May-2022,Reversal,00.00,"21,080.69","147,564.86"
20-May-2022,ATM,00.00,"16,396.10","131,168.76"
20-May-2022,Cash,00.00,"16,396.10","114,772.66"
20-May-2022,Interest,00.00,"114,772.66",00.00
20-May-2022,Tax,56.00,00.00,56.00
20-May-2022,Interest,"107,513.00",00.00,"107,569.00"
20-May-2022,NEFT,00.00,"17,928.17","89,640.83"
20-May-2022,NEFT,"196,406.50",00.00,"286,047.33"
20-May-2022,Debit Card,06.00,00.00,"286,053.33"
20-May-2022,Bill,00.00,"31,783.70","254,269.63"
20-May-2022,Commission,07.60,00.00,"254,277.23"
20-May-2022,IMPS,00.00,00.00,"254,277.23"
20-May-2022,Reversal,03.90,00.00,"254,281.13"
20-May-2022,Miscellaneous,00.00,"254,281.13",00.00
20-May-2022,Bill,"1,173,871.00",00.00,"1,173,871.00"
20-May-2022,Commission,"24,580.20",00.00,"1,198,451.20"
20-May-2022,Transfer,98.20,00.00,"1,198,549.40"
20-May-2022,Miscellaneous,"13,464.10",00.00,"1,212,013.50"
20-May-2022,Bill,44.10,00.00,"1,212,057.60"
20-May-2022,Purchase,282.80,00.00,"1,212,340.40"
20-May-2022,IMPS,00.00,"151,542.55","1,060,797.85"
20-May-2022,Purchase,00.00,"265,199.46","795,598.39"
20-May-2022,Cheque,00.00,"397,799.20","397,799.20"
20-May-2022,Cheque,00.00,"99,449.80","298,349.40"
20-May-2022,ATM,"1,808,426.20",00.00,"2,106,775.60"
20-May-2022,Reversal,"24,932.00",00.00,"2,131,707.60"
20-May-2022,Cash,39.38,00.00,"2,131,746.98"
20-May-2022,Purchase,10.45,00.00,"2,131,757.43"
20-May-2022,Purchase,00.41,00.00,"2,131,757.84"
20-May-2022,Reversal,"1,301.00",00.00,"2,133,058.84"
20-May-2022,Bill,00.00,"711,019.61","1,422,039.23"
20-May-2022,Commission,00.00,"142,203.92","1,279,835.31"
20-May-2022,Tax,"2,411.78",00.00,"1,282,247.09"
20-May-2022,RTGS,00.00,"427,415.70","854,831.39"
20-May-2022,Reversal,16.00,00.00,"854,847.39"
20-May-2022,RTGS,00.00,"142,474.57","712,372.82"
20-May-2022,Reversal,"204,326.00",00.00,"916,698.82"
20-May-2022,RTGS,00.00,"101,855.42","814,843.40"
20-May-2022,Interest,"779,456.80",00.00,"1,594,300.20"
20-May-2022,Reversal,"3,534.78",00.00,"1,597,834.98"
20-May-2022,Tax,00.00,"266,305.83","1,331,529.15"
20-May-2022,Reversal,00.00,"190,218.45","1,141,310.70"
20-May-2022,Cheque,58.66,00.00,"1,141,369.36"
20-May-2022,Transfer,"2,997.80",00.00,"1,144,367.16"
20-May-2022,IMPS,00.00,"143,045.90","1,001,321.26"
20-May-2022,IMPS,02.32,00.00,"1,001,323.58"
20-May-2022,Debit Card,00.00,"100,132.36","901,191.22"
20-May-2022,Purchase,"1,677,668.00",00.00,"2,578,859.22"
20-May-2022,Purchase,00.00,"2,578,859.22",00.00
20-May-2022,Tax,"25,955.00",00.00,"25,955.00"
20-May-2022,NEFT,00.00,"2,883.89","23,071.11"
20-May-2022,Reversal,00.00,"2,307.11","20,764.00"
20-May-2022,Reversal,00.00,"2,076.40","18,687.60"
20-May-2022,RTGS,00.00,"9,343.80","9,343.80"
20-May-2022,Purchase,07.00,00.00,"9,350.80"
20-May-2022,Debit Card,"2,337.90",00.00,"11,688.70"
20-May-2022,Cheque,"2,954.00",00.00,"14,642.70"
20-May-2022,Purchase,00.00,"1,626.97","13,015.73"
20-May-2022,Transfer,00.00,"2,603.15","10,412.58"
20-May-2022,Debit Card,"144,138.69",00.00,"154,551.27"
20-May-2022,Reversal,05.10,00.00,"154,556.37"
20-May-2022,NEFT,139.30,00.00,"154,695.67"
20-May-2022,ATM,403.30,00.00,"155,098.97"
20-May-2022,IMPS,00.00,"51,699.66","103,399.31"
20-May-2022,ATM,04.30,00.00,"103,403.61"
20-May-2022,RTGS,00.00,"34,467.87","68,935.74"
20-May-2022,Miscellaneous,"1,903.20",00.00,"70,838.94"
20-May-2022,Cheque,209.80,00.00,"71,048.74"
20-May-2022,Reversal,00.00,"17,762.19","53,286.56"
20-May-2022,IMPS,"21,501.83",00.00,"74,788.39"
20-May-2022,RTGS,00.00,"74,788.39",00.00
20-May-2022,Cheque,"599,014.00",00.00,"599,014.00"
20-May-2022,Cheque,05.00,00.00,"599,019.00"
20-May-2022,Bill,00.00,"85,574.14","513,444.86"
20-May-2022,Debit Card,00.00,"57,049.43","456,395.43"
20-May-2022,ATM,"966,401.50",00.00,"1,422,796.93"
20-May-2022,Interest,06.79,00.00,"1,422,803.72"
20-May-2022,Purchase,"159,765.00",00.00,"1,582,568.72"
20-May-2022,Transfer,00.00,"395,642.18","1,186,926.54"
20-May-2022,Bill,780.90,00.00,"1,187,707.44"
20-May-2022,ATM,"1,144.23",00.00,"1,188,851.67"
21-May-2022,Purchase,31.23,00.00,"1,188,882.90"
21-May-2022,Miscellaneous,00.00,"148,610.36","1,040,272.54"
21-May-2022,IMPS,"1,957,911.50",00.00,"2,998,184.04"
21-May-2022,Purchase,00.00,"1,499,092.02","1,499,092.02"
21-May-2022,Miscellaneous,"176,908.10",00.00,"1,676,000.12"
21-May-2022,Bill,00.00,"209,500.02","1,466,500.10"
21-May-2022,ATM,436.00,00.00,"1,466,936.10"
21-May-2022,ATM,14.45,00.00,"1,466,950.55"
21-May-2022,Transfer,"138,070.00",00.00,"1,605,020.55"
21-May-2022,Interest,00.00,"229,288.65","1,375,731.90"
21-May-2022,Bill,00.00,"343,932.98","1,031,798.92"
21-May-2022,Purchase,"15,182.96",00.00,"1,046,981.88"
21-May-2022,Reversal,41.30,00.00,"1,047,023.18"
21-May-2022,Purchase,161.40,00.00,"1,047,184.58"
22-May-2022,Bill,00.00,"261,796.15","785,388.44"
22-May-2022,Debit Card,"84,376.00",00.00,"869,764.44"
22-May-2022,Miscellaneous,262.51,00.00,"870,026.95"
22-May-2022,Cash,00.00,"435,013.48","435,013.48"
22-May-2022,Debit Card,20.20,00.00,"435,033.68"
22-May-2022,Cash,00.00,"108,758.42","326,275.26"
22-May-2022,Cheque,00.00,"54,379.21","271,896.05"
22-May-2022,Debit Card,00.00,"67,974.01","203,922.04"
22-May-2022,Interest,00.00,"101,961.02","101,961.02"
22-May-2022,Debit Card,"184,661.00",00.00,"286,622.02"
22-May-2022,Purchase,"1,440,792.00",00.00,"1,727,414.02"
22-May-2022,Commission,00.00,"345,482.80","1,381,931.22"
22-May-2022,Bill,"1,964,633.50",00.00,"3,346,564.72"
22-May-2022,Reversal,"150,769.00",00.00,"3,497,333.72"
22-May-2022,NEFT,00.00,"437,166.72","3,060,167.01"
22-May-2022,Transfer,"2,303.00",00.00,"3,062,470.01"
22-May-2022,Interest,00.00,"437,495.72","2,624,974.29"
22-May-2022,Tax,06.08,00.00,"2,624,980.37"
22-May-2022,IMPS,"3,963.30",00.00,"2,628,943.67"
22-May-2022,IMPS,00.00,"525,788.73","2,103,154.94"
22-May-2022,Interest,00.00,"420,630.99","1,682,523.95"
22-May-2022,Cheque,525.00,00.00,"1,683,048.95"
22-May-2022,Bill,"21,856.90",00.00,"1,704,905.85"
22-May-2022,Cheque,325.81,00.00,"1,705,231.66"
22-May-2022,Transfer,00.00,"170,523.17","1,534,708.49"
22-May-2022,Cash,00.00,"767,354.25","767,354.24"
22-May-2022,Transfer,00.00,"127,892.37","639,461.87"
22-May-2022,RTGS,426.10,00.00,"639,887.97"
22-May-2022,Tax,775.50,00.00,"640,663.47"
22-May-2022,IMPS,"9,109.33",00.00,"649,772.80"
22-May-2022,Cash,"6,146.00",00.00,"655,918.80"
22-May-2022,Cash,06.00,00.00,"655,924.80"
22-May-2022,NEFT,00.00,"65,592.48","590,332.32"
22-May-2022,NEFT,00.00,"84,333.19","505,999.13"
22-May-2022,Tax,00.00,"63,249.89","442,749.24"
22-May-2022,Miscellaneous,00.00,"221,374.62","221,374.62"
22-May-2022,Purchase,02.00,00.00,"221,376.62"
22-May-2022,ATM,00.00,"36,896.10","184,480.52"
22-May-2022,IMPS,"85,989.00",00.00,"270,469.52"
22-May-2022,RTGS,04.00,00.00,"270,473.52"
22-May-2022,RTGS,00.73,00.00,"270,474.25"
22-May-2022,Purchase,04.70,00.00,"270,478.95"
22-May-2022,IMPS,00.00,"67,619.74","202,859.21"
22-May-2022,Interest,00.00,"40,571.84","162,287.37"
22-May-2022,Transfer,00.00,"16,228.74","146,058.63"
22-May-2022,Purchase,"174,500.20",00.00,"320,558.83"
22-May-2022,NEFT,00.00,"80,139.71","240,419.12"
22-May-2022,Miscellaneous,00.00,"60,104.78","180,314.34"
22-May-2022,Tax,00.00,"18,031.43","162,282.91"
22-May-2022,Tax,102.00,00.00,"162,384.91"
22-May-2022,Tax,00.00,"54,128.30","108,256.61"
22-May-2022,ATM,06.96,00.00,"108,263.57"
22-May-2022,Commission,03.40,00.00,"108,266.97"
22-May-2022,IMPS,"177,432.90",00.00,"285,699.87"
22-May-2022,ATM,00.00,"31,744.43","253,955.44"
22-May-2022,Purchase,129.19,00.00,"254,084.63"
22-May-2022,IMPS,31.80,00.00,"254,116.43"
22-May-2022,NEFT,"359,050.20",00.00,"613,166.63"
22-May-2022,Cash,"2,430.00",00.00,"615,596.63"
22-May-2022,Commission,"3,574.33",00.00,"619,170.96"
22-May-2022,Cheque,"1,975,901.50",00.00,"2,595,072.46"
22-May-2022,Transfer,"27,259.70",00.00,"2,622,332.16"
22-May-2022,Bill,00.00,"374,618.88","2,247,713.28"
22-May-2022,Purchase,"4,023.40",00.00,"2,251,736.68"
22-May-2022,ATM,00.00,"281,467.09","1,970,269.60"
22-May-2022,IMPS,25.00,00.00,"1,970,294.60"
22-May-2022,IMPS,00.00,"246,286.83","1,724,007.78"
22-May-2022,IMPS,01.00,00.00,"1,724,008.78"
22-May-2022,Transfer,00.00,"431,002.20","1,293,006.58"
23-May-2022,Cheque,00.00,"184,715.23","1,108,291.35"
23-May-2022,Transfer,"22,891.95",00.00,"1,131,183.30"
23-May-2022,IMPS,00.00,"125,687.03","1,005,496.27"
23-May-2022,Cheque,62.30,00.00,"1,005,558.57"
23-May-2022,Debit Card,00.00,"100,555.86","905,002.71"
23-May-2022,Reversal,"135,353.00",00.00,"1,040,355.71"
23-May-2022,Interest,00.00,"148,622.24","891,733.47"
23-May-2022,Debit Card,00.00,"445,866.74","445,866.74"
23-May-2022,IMPS,"228,183.16",00.00,"674,049.90"
23-May-2022,NEFT,02.70,00.00,"674,052.60"
23-May-2022,RTGS,00.00,"168,513.15","505,539.45"
23-May-2022,ATM,"29,739.10",00.00,"535,278.55"
23-May-2022,Transfer,00.00,"133,819.64","401,458.91"
23-May-2022,RTGS,00.00,"57,351.27","344,107.64"
23-May-2022,IMPS,00.00,"49,158.23","294,949.41"
23-May-2022,IMPS,"1,341,472.00",00.00,"1,636,421.41"
23-May-2022,Transfer,"1,106,015.25",00.00,"2,742,436.66"
23-May-2022,Purchase,"25,085.00",00.00,"2,767,521.66"
23-May-2022,Reversal,"89,638.00",00.00,"2,857,159.66"
23-May-2022,Transfer,00.00,"714,289.92","2,142,869.74"
23-May-2022,Tax,00.00,"1,071,434.87","1,071,434.87"
23-May-2022,Commission,00.00,"214,286.97","857,147.90"
24-May-2022,Tax,30.75,00.00,"857,178.65"
24-May-2022,Bill,"1,298.85",00.00,"858,477.50"
24-May-2022,ATM,00.00,"95,386.39","763,091.11"
24-May-2022,Debit Card,50.00,00.00,"763,141.11"
24-May-2022,Interest,00.00,"76,314.11","686,827.00"
25-May-2022,Cheque,00.00,"137,365.40","549,461.60"
25-May-2022,Debit Card,00.00,"274,730.80","274,730.80"
25-May-2022,Commission,02.60,00.00,"274,733.40"
25-May-2022,Cash,00.00,"27,473.34","247,260.06"
25-May-2022,ATM,57.00,00.00,"247,317.06"
25-May-2022,Tax,"13,933.00",00.00,"261,250.06"
25-May-2022,Interest,03.40,00.00,"261,253.46"
25-May-2022,IMPS,00.00,"52,250.69","209,002.77"
25-May-2022,IMPS,00.00,"34,833.80","174,168.97"
25-May-2022,Purchase,05.20,00.00,"174,174.17"
25-May-2022,Reversal,"224,468.00",00.00,"398,642.17"
25-May-2022,Purchase,"28,065.20",00.00,"426,707.37"
25-May-2022,Interest,22.20,00.00,"426,729.57"
25-May-2022,ATM,00.00,"42,672.96","384,056.61"
25-May-2022,Cheque,00.00,"96,014.15","288,042.46"
25-May-2022,Cash,199.62,00.00,"288,242.08"
25-May-2022,Cheque,00.00,"144,121.04","144,121.04"
25-May-2022,Cash,00.00,"14,412.10","129,708.94"
25-May-2022,IMPS,01.00,00.00,"129,709.94"
25-May-2022,RTGS,00.00,"21,618.32","108,091.62"
25-May-2022,Transfer,58.00,00.00,"108,149.62"
25-May-2022,Commission,00.00,"21,629.92","86,519.70"
25-May-2022,IMPS,"1,055.00",00.00,"87,574.70"
25-May-2022,Commission,"2,683.63",00.00,"90,258.33"
25-May-2022,Bill,"67,310.31",00.00,"157,568.64"
25-May-2022,IMPS,06.00,00.00,"157,574.64"
25-May-2022,Transfer,00.00,"15,757.46","141,817.18"
25-May-2022,Bill,00.00,"28,363.44","113,453.74"
25-May-2022,Miscellaneous,00.51,00.00,"113,454.25"
25-May-2022,Commission,"330,269.20",00.00,"443,723.45"
25-May-2022,Reversal,03.00,00.00,"443,726.45"
25-May-2022,Tax,00.00,"147,908.82","295,817.63"
25-May-2022,Bill,00.00,"29,581.76","266,235.87"
25-May-2022,IMPS,"1,644,320.00",00.00,"1,910,555.87"
25-May-2022,Commission,01.00,00.00,"1,910,556.87"
25-May-2022,Interest,"313,310.00",00.00,"2,223,866.87"
25-May-2022,Transfer,"140,900.44",00.00,"2,364,767.31"
25-May-2022,Reversal,40.62,00.00,"2,364,807.93"
25-May-2022,NEFT,"67,925.62",00.00,"2,432,733.55"
25-May-2022,IMPS,323.00,00.00,"2,433,056.55"
25-May-2022,Transfer,00.00,"486,611.31","1,946,445.24"
25-May-2022,Bill,21.98,00.00,"1,946,467.22"
25-May-2022,Transfer,"4,797.90",00.00,"1,951,265.12"
25-May-2022,Miscellaneous,00.00,"243,908.14","1,707,356.98"
25-May-2022,Bill,"81,655.20",00.00,"1,789,012.18"
25-May-2022,Interest,00.00,"255,573.17","1,533,439.01"
25-May-2022,Cash,00.95,00.00,"1,533,439.96"
25-May-2022,Purchase,00.00,"511,146.65","1,022,293.31"
25-May-2022,Transfer,259.00,00.00,"1,022,552.31"
25-May-2022,Bill,00.00,"127,819.04","894,733.27"
25-May-2022,Cheque,"254,525.75",00.00,"1,149,259.02"
25-May-2022,IMPS,21.00,00.00,"1,149,280.02"
25-May-2022,Purchase,00.00,"164,182.86","985,097.16"
25-May-2022,Purchase,00.00,"492,548.58","492,548.58"
26-May-2022,IMPS,00.00,"98,509.72","394,038.86"
26-May-2022,Cheque,60.30,00.00,"394,099.16"
26-May-2022,Transfer,59.45,00.00,"394,158.61"
26-May-2022,Transfer,00.00,"56,308.37","337,850.24"
26-May-2022,Interest,00.00,"42,231.28","295,618.96"
26-May-2022,Purchase,"835,056.00",00.00,"1,130,674.96"
26-May-2022,Miscellaneous,60.00,00.00,"1,130,734.96"
26-May-2022,Purchase,"14,062.80",00.00,"1,144,797.76"
26-May-2022,RTGS,00.00,"1,144,797.76",00.00
26-May-2022,Debit Card,"26,749.00",00.00,"26,749.00"
26-May-2022,Bill,53.00,00.00,"26,802.00"
26-May-2022,Interest,00.00,"2,680.20","24,121.80"
26-May-2022,Transfer,"3,781.18",00.00,"27,902.98"
26-May-2022,NEFT,333.00,00.00,"28,235.98"
26-May-2022,Cheque,"4,062.20",00.00,"32,298.18"
26-May-2022,IMPS,00.00,00.00,"32,298.18"
26-May-2022,Cash,"31,098.00",00.00,"63,396.18"
26-May-2022,Cheque,757.70,00.00,"64,153.88"
26-May-2022,Commission,"17,736.00",00.00,"81,889.88"
26-May-2022,Cheque,00.00,"9,098.88","72,791.00"
26-May-2022,Cheque,70.00,00.00,"72,861.00"
26-May-2022,Bill,00.00,"72,861.00",00.00
26-May-2022,Cash,"1,620,753.50",00.00,"1,620,753.50"
26-May-2022,Interest,05.36,00.00,"1,620,758.86"
26-May-2022,Transfer,232.00,00.00,"1,620,990.86"
26-May-2022,Purchase,"2,549.10",00.00,"1,623,539.96"
26-May-2022,Commission,00.00,"231,934.28","1,391,605.68"
26-May-2022,Cash,34.19,00.00,"1,391,639.87"
26-May-2022,RTGS,00.00,"347,909.97","1,043,729.90"
26-May-2022,Tax,"23,978.00",00.00,"1,067,707.90"
26-May-2022,Commission,00.00,"177,951.32","889,756.58"
26-May-2022,Reversal,00.00,"222,439.15","667,317.43"
26-May-2022,IMPS,"3,261.77",00.00,"670,579.20"
26-May-2022,Cash,00.00,"67,057.92","603,521.28"
26-May-2022,Reversal,00.00,"301,760.64","301,760.64"
26-May-2022,Cash,"26,484.00",00.00,"328,244.64"
26-May-2022,Commission,"164,855.50",00.00,"493,100.14"
26-May-2022,Debit Card,853.00,00.00,"493,953.14"
26-May-2022,NEFT,"22,094.96",00.00,"516,048.10"
26-May-2022,Cheque,"1,803.00",00.00,"517,851.10"
26-May-2022,Interest,05.50,00.00,"517,856.60"
26-May-2022,Reversal,127.95,00.00,"517,984.55"
26-May-2022,Commission,491.19,00.00,"518,475.74"
26-May-2022,Debit Card,"134,538.00",00.00,"653,013.74"
26-May-2022,ATM,"1,034,546.00",00.00,"1,687,559.74"
26-May-2022,Tax,00.00,"843,779.87","843,779.87"
26-May-2022,Debit Card,"11,731.50",00.00,"855,511.37"
26-May-2022,Commission,"699,891.25",00.00,"1,555,402.62"
26-May-2022,Miscellaneous,15.71,00.00,"1,555,418.33"
26-May-2022,ATM,53.67,00.00,"1,555,472.00"
26-May-2022,Purchase,00.00,"259,245.33","1,296,226.67"
26-May-2022,Tax,402.00,00.00,"1,296,628.67"
26-May-2022,Reversal,00.00,"216,104.78","1,080,523.89"
26-May-2022,NEFT,00.00,"180,087.32","900,436.58"
26-May-2022,Miscellaneous,00.00,"180,087.32","720,349.26"
26-May-2022,Transfer,426.07,00.00,"720,775.33"
26-May-2022,Tax,"168,339.00",00.00,"889,114.33"
26-May-2022,Debit Card,00.00,"296,371.44","592,742.89"
26-May-2022,Debit Card,00.00,"118,548.58","474,194.31"
26-May-2022,Purchase,00.00,"474,194.31",00.00
26-May-2022,ATM,06.40,00.00,06.40
26-May-2022,NEFT,00.00,01.07,05.33
26-May-2022,RTGS,00.00,01.33,04.00
26-May-2022,Tax,"31,035.00",00.00,"31,039.00"
26-May-2022,Transfer,00.00,"3,879.88","27,159.12"
26-May-2022,Bill,"14,310.00",00.00,"41,469.12"
26-May-2022,Cheque,00.00,"5,924.16","35,544.96"
26-May-2022,IMPS,53.20,00.00,"35,598.16"
26-May-2022,Miscellaneous,167.00,00.00,"35,765.16"
26-May-2022,Debit Card,"2,398.06",00.00,"38,163.22"
26-May-2022,Interest,00.00,"38,163.22",00.00
26-May-2022,ATM,60.00,00.00,60.00
26-May-2022,RTGS,"2,073,471.00",00.00,"2,073,531.00"
26-May-2022,Bill,"11,293.00",00.00,"2,084,824.00"
26-May-2022,Transfer,"2,045.00",00.00,"2,086,869.00"
26-May-2022,Debit Card,"266,984.20",00.00,"2,353,853.20"
26-May-2022,ATM,37.00,00.00,"2,353,890.20"
26-May-2022,Tax,"878,373.80",00.00,"3,232,264.00"
26-May-2022,Cheque,"689,963.50",00.00,"3,922,227.50"
26-May-2022,Cheque,00.00,"980,556.88","2,941,670.62"
26-May-2022,Purchase,00.00,"326,852.29","2,614,818.33"
26-May-2022,Bill,174.50,00.00,"2,614,992.83"
26-May-2022,Commission,00.00,"1,307,496.42","1,307,496.42"
26-May-2022,Debit Card,00.00,"1,307,496.42",00.00
26-May-2022,Cheque,13.95,00.00,13.95
26-May-2022,Commission,00.00,01.40,12.56
26-May-2022,Transfer,764.90,00.00,777.46
26-May-2022,ATM,439.40,00.00,"1,216.86"
26-May-2022,Cheque,00.00,152.11,"1,064.75"
26-May-2022,ATM,"261,963.80",00.00,"263,028.55"
26-May-2022,Commission,00.00,"43,838.09","219,190.46"
26-May-2022,Tax,60.80,00.00,"219,251.26"
26-May-2022,Cheque,00.00,"109,625.63","109,625.63"
26-May-2022,Reversal,"1,810.30",00.00,"111,435.93"
26-May-2022,IMPS,00.00,"12,381.77","99,054.16"
26-May-2022,Bill,"18,233.00",00.00,"117,287.16"
26-May-2022,ATM,47.45,00.00,"117,334.61"
26-May-2022,IMPS,00.00,"58,667.31","58,667.30"
26-May-2022,ATM,472.40,00.00,"59,139.70"
26-May-2022,Purchase,"131,011.00",00.00,"190,150.70"
26-May-2022,Miscellaneous,38.00,00.00,"190,188.70"
26-May-2022,IMPS,"73,447.00",00.00,"263,635.70"
26-May-2022,Cheque,00.00,"32,954.46","230,681.24"
26-May-2022,Tax,00.00,"32,954.46","197,726.78"
26-May-2022,NEFT,"23,381.40",00.00,"221,108.18"
26-May-2022,Debit Card,"1,783,658.75",00.00,"2,004,766.93"
27-May-2022,Reversal,56.40,00.00,"2,004,823.33"
27-May-2022,Tax,"1,204,608.00",00.00,"3,209,431.33"
27-May-2022,Bill,00.00,"320,943.13","2,888,488.20"
27-May-2022,Transfer,"6,065.00",00.00,"2,894,553.20"
27-May-2022,Purchase,364.53,00.00,"2,894,917.73"
27-May-2022,Miscellaneous,00.00,"361,864.72","2,533,053.01"
27-May-2022,Miscellaneous,"172,354.00",00.00,"2,705,407.01"
27-May-2022,Miscellaneous,00.00,"541,081.40","2,164,325.61"
27-May-2022,Purchase,122.30,00.00,"2,164,447.91"
27-May-2022,ATM,00.00,"541,111.98","1,623,335.93"
28-May-2022,Cash,"26,507.38",00.00,"1,649,843.31"
28-May-2022,Reversal,00.00,"824,921.66","824,921.66"
28-May-2022,NEFT,00.00,"117,845.95","707,075.71"
28-May-2022,Debit Card,"130,697.16",00.00,"837,772.87"
28-May-2022,Transfer,00.00,"279,257.62","558,515.25"
28-May-2022,Cash,"16,122.00",00.00,"574,637.25"
28-May-2022,Purchase,00.00,"71,829.66","502,807.59"
28-May-2022,Tax,00.00,"502,807.59",00.00
28-May-2022,Commission,11.40,00.00,11.40
28-May-2022,Debit Card,"63,417.20",00.00,"63,428.60"
28-May-2022,Cheque,50.25,00.00,"63,478.85"
28-May-2022,RTGS,00.00,"6,347.89","57,130.96"
28-May-2022,Bill,"30,684.00",00.00,"87,814.96"
28-May-2022,Cash,06.60,00.00,"87,821.56"
28-May-2022,Debit Card,00.00,"17,564.31","70,257.25"
28-May-2022,Interest,36.10,00.00,"70,293.35"
28-May-2022,Cash,"409,156.00",00.00,"479,449.35"
28-May-2022,RTGS,00.00,00.00,"479,449.35"
28-May-2022,Transfer,00.00,"68,492.76","410,956.59"
28-May-2022,NEFT,26.10,00.00,"410,982.69"
29-May-2022,Transfer,"1,273,647.00",00.00,"1,684,629.69"
29-May-2022,Debit Card,265.00,00.00,"1,684,894.69"
29-May-2022,Debit Card,00.00,"842,447.35","842,447.34"
29-May-2022,IMPS,"1,267,736.00",00.00,"2,110,183.34"
29-May-2022,IMPS,00.00,"703,394.45","1,406,788.89"
29-May-2022,RTGS,13.20,00.00,"1,406,802.09"
29-May-2022,NEFT,"237,115.40",00.00,"1,643,917.49"
29-May-2022,Transfer,00.00,"410,979.37","1,232,938.12"
29-May-2022,Miscellaneous,17.50,00.00,"1,232,955.62"
29-May-2022,Miscellaneous,00.00,"136,995.07","1,095,960.55"
29-May-2022,Cash,00.00,"219,192.11","876,768.44"
29-May-2022,Tax,"92,671.78",00.00,"969,440.22"
29-May-2022,Interest,"209,840.00",00.00,"1,179,280.22"
29-May-2022,ATM,"179,035.50",00.00,"1,358,315.72"
29-May-2022,Purchase,00.00,"226,385.95","1,131,929.77"
29-May-2022,Purchase,00.00,"188,654.96","943,274.81"
29-May-2022,ATM,00.00,"314,424.94","628,849.87"
29-May-2022,RTGS,266.66,00.00,"629,116.53"
29-May-2022,Cheque,431.30,00.00,"629,547.83"
29-May-2022,ATM,"414,308.20",00.00,"1,043,856.03"
29-May-2022,Debit Card,36.70,00.00,"1,043,892.73"
29-May-2022,Miscellaneous,00.00,"149,127.53","894,765.20"
29-May-2022,RTGS,00.00,"89,476.52","805,288.68"
29-May-2022,Transfer,00.00,"80,528.87","724,759.81"
29-May-2022,Miscellaneous,"3,034.10",00.00,"727,793.91"
29-May-2022,Bill,01.80,00.00,"727,795.71"
29-May-2022,Bill,00.00,"242,598.57","485,197.14"
29-May-2022,Tax,00.00,"60,649.64","424,547.50"
30-May-2022,ATM,55.52,00.00,"424,603.02"
30-May-2022,NEFT,04.97,00.00,"424,607.99"
30-May-2022,NEFT,00.00,"106,152.00","318,455.99"
30-May-2022,Tax,00.00,"35,384.00","283,071.99"
30-May-2022,Cash,"1,720.51",00.00,"284,792.50"
30-May-2022,RTGS,48.98,00.00,"284,841.48"
30-May-2022,Tax,00.00,"40,691.64","244,149.84"
30-May-2022,Miscellaneous,495.42,00.00,"244,645.26"
30-May-2022,Transfer,"1,642.30",00.00,"246,287.56"
30-May-2022,Commission,00.00,"82,095.85","164,191.71"
30-May-2022,Cheque,05.30,00.00,"164,197.01"
30-May-2022,Debit Card,00.00,"18,244.11","145,952.90"
30-May-2022,IMPS,00.00,"29,190.58","116,762.32"
30-May-2022,Cash,00.00,"23,352.46","93,409.86"
30-May-2022,Debit Card,284.00,00.00,"93,693.86"
30-May-2022,NEFT,00.00,"9,369.39","84,324.47"
30-May-2022,Interest,00.00,"9,369.39","74,955.08"
30-May-2022,Bill,"1,852.98",00.00,"76,808.06"
30-May-2022,RTGS,06.30,00.00,"76,814.36"
30-May-2022,ATM,39.81,00.00,"76,854.17"
30-May-2022,RTGS,00.00,"12,809.03","64,045.14"
30-May-2022,ATM,00.00,"7,116.13","56,929.01"
30-May-2022,ATM,00.00,"11,385.80","45,543.21"
30-May-2022,Cheque,00.10,00.00,"45,543.31"
30-May-2022,Reversal,07.00,00.00,"45,550.31"
31-May-2022,Transfer,00.00,"9,110.06","36,440.25"
31-May-2022,IMPS,00.00,"3,644.03","32,796.22"
01-Jun-2022,Miscellaneous,"51,107.91",00.00,"83,904.13"
01-Jun-2022,Transfer,00.00,"83,904.13",00.00
01-Jun-2022,Bill,"3,591.70",00.00,"3,591.70"
01-Jun-2022,IMPS,00.00,897.93,"2,693.77"
01-Jun-2022,Debit Card,"230,268.28",00.00,"232,962.05"
01-Jun-2022,Debit Card,"765,940.00",00.00,"998,902.05"
01-Jun-2022,RTGS,00.00,"124,862.76","874,039.29"
01-Jun-2022,Bill,00.00,"109,254.91","764,784.38"
01-Jun-2022,Interest,"3,415.00",00.00,"768,199.38"
02-Jun-2022,ATM,461.70,00.00,"768,661.08"
02-Jun-2022,Commission,00.00,"192,165.27","576,495.81"
02-Jun-2022,Debit Card,00.00,"288,247.91","288,247.91"
02-Jun-2022,NEFT,03.31,00.00,"288,251.22"
03-Jun-2022,RTGS,00.00,"288,251.22",00.00
04-Jun-2022,Interest,01.00,00.00,01.00
04-Jun-2022,Tax,"188,305.44",00.00,"188,306.44"
04-Jun-2022,Cheque,00.00,"188,306.44",00.00
04-Jun-2022,Interest,37.85,00.00,37.85
04-Jun-2022,Debit Card,00.00,04.21,33.64
04-Jun-2022,Purchase,00.00,08.41,25.23
04-Jun-2022,Interest,"196,901.78",00.00,"196,927.01"
04-Jun-2022,ATM,"205,228.00",00.00,"402,155.01"
04-Jun-2022,Reversal,"5,380.20",00.00,"407,535.21"
04-Jun-2022,Miscellaneous,"2,053,922.00",00.00,"2,461,457.21"
04-Jun-2022,Commission,"19,828.00",00.00,"2,481,285.21"
04-Jun-2022,RTGS,449.00,00.00,"2,481,734.21"
04-Jun-2022,IMPS,00.00,"1,240,867.11","1,240,867.10"
04-Jun-2022,Tax,236.90,00.00,"1,241,104.00"
04-Jun-2022,Cheque,00.00,"413,701.33","827,402.67"
04-Jun-2022,Interest,"138,426.80",00.00,"965,829.47"
04-Jun-2022,Cheque,00.00,"193,165.89","772,663.58"
04-Jun-2022,IMPS,"189,958.90",00.00,"962,622.48"
04-Jun-2022,Cheque,00.00,"160,437.08","802,185.40"
04-Jun-2022,Purchase,"224,464.12",00.00,"1,026,649.52"
04-Jun-2022,ATM,868.00,00.00,"1,027,517.52"
04-Jun-2022,Cheque,"895,538.50",00.00,"1,923,056.02"
04-Jun-2022,Commission,00.00,"274,722.29","1,648,333.73"
04-Jun-2022,Commission,00.00,"329,666.75","1,318,666.98"
04-Jun-2022,Reversal,14.90,00.00,"1,318,681.88"
04-Jun-2022,Reversal,00.00,"263,736.38","1,054,945.50"
04-Jun-2022,Cheque,987.50,00.00,"1,055,933.00"
04-Jun-2022,Debit Card,"1,682,615.00",00.00,"2,738,548.00"
04-Jun-2022,Reversal,"4,035.90",00.00,"2,742,583.90"
04-Jun-2022,NEFT,00.00,"685,645.98","2,056,937.92"
04-Jun-2022,Transfer,00.00,"293,848.27","1,763,089.65"
04-Jun-2022,Cash,59.60,00.00,"1,763,149.25"
04-Jun-2022,Cheque,02.00,00.00,"1,763,151.25"
04-Jun-2022,Commission,"1,760,739.50",00.00,"3,523,890.75"
04-Jun-2022,Purchase,00.00,"503,412.96","3,020,477.79"
04-Jun-2022,Cheque,00.00,"377,559.72","2,642,918.07"
04-Jun-2022,Commission,06.70,00.00,"2,642,924.77"
04-Jun-2022,NEFT,246.90,00.00,"2,643,171.67"
05-Jun-2022,Reversal,"158,776.80",00.00,"2,801,948.47"
05-Jun-2022,Commission,00.00,"400,278.35","2,401,670.12"
05-Jun-2022,Bill,00.00,"400,278.35","2,001,391.77"
05-Jun-2022,Tax,"3,769.24",00.00,"2,005,161.01"
05-Jun-2022,Debit Card,00.00,"668,387.00","1,336,774.01"
05-Jun-2022,Cheque,00.15,00.00,"1,336,774.16"
05-Jun-2022,Purchase,00.00,"334,193.54","1,002,580.62"
05-Jun-2022,ATM,00.00,"167,096.77","835,483.85"
05-Jun-2022,Commission,00.00,"104,435.48","731,048.37"
06-Jun-2022,Cash,"1,231,022.00",00.00,"1,962,070.37"
06-Jun-2022,Commission,00.00,"654,023.46","1,308,046.91"
06-Jun-2022,NEFT,"237,745.94",00.00,"1,545,792.85"
06-Jun-2022,Cheque,00.00,"220,827.55","1,324,965.30"
06-Jun-2022,NEFT,08.05,00.00,"1,324,973.35"
06-Jun-2022,Cheque,18.00,00.00,"1,324,991.35"
06-Jun-2022,Purchase,00.00,"331,247.84","993,743.51"
06-Jun-2022,Purchase,"203,170.28",00.00,"1,196,913.79"
06-Jun-2022,Transfer,00.00,"132,990.42","1,063,923.37"
06-Jun-2022,ATM,00.00,"132,990.42","930,932.95"
06-Jun-2022,Tax,"9,180.59",00.00,"940,113.54"
06-Jun-2022,Bill,00.00,"313,371.18","626,742.36"
06-Jun-2022,Transfer,55.80,00.00,"626,798.16"
06-Jun-2022,RTGS,06.00,00.00,"626,804.16"
06-Jun-2022,Reversal,00.00,"62,680.42","564,123.74"
06-Jun-2022,Transfer,00.00,"94,020.62","470,103.12"
06-Jun-2022,Bill,54.00,00.00,"470,157.12"
06-Jun-2022,RTGS,00.00,"52,239.68","417,917.44"
06-Jun-2022,ATM,06.16,00.00,"417,923.60"
06-Jun-2022,NEFT,00.00,"83,584.72","334,338.88"
06-Jun-2022,Miscellaneous,"1,230.63",00.00,"335,569.51"
06-Jun-2022,Debit Card,90.00,00.00,"335,659.51"
06-Jun-2022,ATM,"3,282.00",00.00,"338,941.51"
06-Jun-2022,IMPS,00.00,"112,980.50","225,961.01"
06-Jun-2022,IMPS,"69,858.00",00.00,"295,819.01"
06-Jun-2022,Tax,00.00,"59,163.80","236,655.21"
06-Jun-2022,IMPS,00.00,"59,163.80","177,491.41"
06-Jun-2022,Miscellaneous,672.00,00.00,"178,163.41"
06-Jun-2022,Reversal,00.00,"22,270.43","155,892.98"
06-Jun-2022,Interest,00.00,"15,589.30","140,303.68"
06-Jun-2022,Bill,00.00,"28,060.74","112,242.94"
06-Jun-2022,Debit Card,00.00,"56,121.47","56,121.47"
06-Jun-2022,Commission,00.00,"56,121.47",00.00
06-Jun-2022,Cheque,353.20,00.00,353.20
06-Jun-2022,Reversal,"8,972.00",00.00,"9,325.20"
06-Jun-2022,Interest,00.00,"3,108.40","6,216.80"
06-Jun-2022,Miscellaneous,"20,537.00",00.00,"26,753.80"
06-Jun-2022,Cheque,00.00,"26,753.80",00.00
06-Jun-2022,Purchase,"3,083.44",00.00,"3,083.44"
06-Jun-2022,Transfer,"139,690.20",00.00,"142,773.64"
06-Jun-2022,Bill,00.00,"35,693.41","107,080.23"
07-Jun-2022,ATM,00.00,"53,540.12","53,540.12"
07-Jun-2022,Reversal,00.00,"5,354.01","48,186.11"
07-Jun-2022,Reversal,"4,616.00",00.00,"52,802.11"
07-Jun-2022,Purchase,00.00,"5,866.90","46,935.21"
07-Jun-2022,Cash,00.00,"7,822.54","39,112.68"
07-Jun-2022,Tax,00.00,"4,345.85","34,766.83"
07-Jun-2022,Reversal,00.00,"4,345.85","30,420.98"
07-Jun-2022,Commission,00.00,"5,070.16","25,350.82"
07-Jun-2022,Interest,00.00,"6,337.71","19,013.11"
07-Jun-2022,Tax,00.00,"6,337.70","12,675.41"
07-Jun-2022,Cheque,"6,570.80",00.00,"19,246.21"
07-Jun-2022,Debit Card,"1,836.56",00.00,"21,082.77"
07-Jun-2022,Transfer,00.00,"3,011.82","18,070.95"
07-Jun-2022,Miscellaneous,00.00,"18,070.95",00.00
07-Jun-2022,Transfer,"98,654.80",00.00,"98,654.80"
07-Jun-2022,Bill,02.50,00.00,"98,657.30"
07-Jun-2022,Commission,"14,873.00",00.00,"113,530.30"
08-Jun-2022,Interest,"90,409.50",00.00,"203,939.80"
08-Jun-2022,Transfer,00.00,"67,979.93","135,959.87"
08-Jun-2022,Interest,00.00,"19,422.84","116,537.03"
08-Jun-2022,Purchase,00.00,"11,653.70","104,883.33"
08-Jun-2022,Purchase,00.00,"10,488.33","94,395.00"
08-Jun-2022,Commission,"696,156.25",00.00,"790,551.25"
08-Jun-2022,RTGS,00.00,"112,935.89","677,615.36"
08-Jun-2022,Bill,00.00,"112,935.89","564,679.47"
08-Jun-2022,Reversal,00.00,"94,113.25","470,566.22"
08-Jun-2022,Commission,17.34,00.00,"470,583.56"
08-Jun-2022,Cash,00.00,"235,291.78","235,291.78"
08-Jun-2022,Miscellaneous,"94,537.60",00.00,"329,829.38"
08-Jun-2022,Commission,00.00,"65,965.88","263,863.50"
08-Jun-2022,Miscellaneous,00.00,"87,954.50","175,909.00"
08-Jun-2022,ATM,00.00,"25,129.86","150,779.14"
08-Jun-2022,Bill,01.90,00.00,"150,781.04"
08-Jun-2022,ATM,00.00,"37,695.26","113,085.78"
08-Jun-2022,Commission,00.00,"18,847.63","94,238.15"
08-Jun-2022,Cash,"2,121.12",00.00,"96,359.27"
08-Jun-2022,NEFT,58.00,00.00,"96,417.27"
08-Jun-2022,RTGS,336.00,00.00,"96,753.27"
08-Jun-2022,RTGS,00.00,"96,753.27",00.00
08-Jun-2022,Interest,44.55,00.00,44.55
08-Jun-2022,Tax,00.00,06.36,38.19
08-Jun-2022,Miscellaneous,"1,992.00",00.00,"2,030.19"
08-Jun-2022,Bill,00.00,290.03,"1,740.16"
08-Jun-2022,RTGS,00.00,174.02,"1,566.14"
08-Jun-2022,Transfer,465.52,00.00,"2,031.66"
08-Jun-2022,Cash,"3,684.70",00.00,"5,716.36"
08-Jun-2022,RTGS,405.70,00.00,"6,122.06"
08-Jun-2022,NEFT,00.00,"1,020.34","5,101.72"
08-Jun-2022,Interest,"14,262.00",00.00,"19,363.72"
08-Jun-2022,Bill,00.00,"2,420.47","16,943.26"
08-Jun-2022,Transfer,00.00,"8,471.63","8,471.63"
08-Jun-2022,Cash,45.24,00.00,"8,516.87"
08-Jun-2022,Interest,00.00,851.69,"7,665.18"
08-Jun-2022,Commission,06.30,00.00,"7,671.48"
08-Jun-2022,RTGS,"3,821.00",00.00,"11,492.48"
08-Jun-2022,IMPS,00.00,"11,492.48",00.00
08-Jun-2022,Cheque,03.83,00.00,03.83
08-Jun-2022,Cheque,00.00,00.64,03.19
08-Jun-2022,Cheque,00.00,01.06,02.13
08-Jun-2022,NEFT,02.60,00.00,04.73
08-Jun-2022,IMPS,00.00,00.53,04.20
08-Jun-2022,Cheque,"50,290.00",00.00,"50,294.20"
08-Jun-2022,Debit Card,00.00,"50,294.20",00.00
08-Jun-2022,Bill,"15,776.70",00.00,"15,776.70"
08-Jun-2022,ATM,00.00,"5,258.90","10,517.80"
08-Jun-2022,IMPS,03.00,00.00,"10,520.80"
08-Jun-2022,Cheque,00.00,"3,506.93","7,013.87"
08-Jun-2022,RTGS,05.00,00.00,"7,018.87"
08-Jun-2022,Miscellaneous,00.00,"1,002.70","6,016.17"
08-Jun-2022,Miscellaneous,"6,618.00",00.00,"12,634.17"
09-Jun-2022,RTGS,00.00,"6,317.09","6,317.08"
09-Jun-2022,Debit Card,"4,694.53",00.00,"11,011.61"
09-Jun-2022,Miscellaneous,03.93,00.00,"11,015.54"
09-Jun-2022,Interest,"3,769.60",00.00,"14,785.14"
09-Jun-2022,Interest,00.00,"2,957.03","11,828.11"
09-Jun-2022,Bill,00.00,"1,971.35","9,856.76"
09-Jun-2022,Transfer,"26,186.00",00.00,"36,042.76"
10-Jun-2022,ATM,00.00,"18,021.38","18,021.38"
10-Jun-2022,Bill,"480,294.00",00.00,"498,315.38"
10-Jun-2022,Debit Card,"3,044.80",00.00,"501,360.18"
10-Jun-2022,ATM,00.00,"250,680.09","250,680.09"
10-Jun-2022,Interest,00.00,"125,340.05","125,340.04"
10-Jun-2022,Interest,376.10,00.00,"125,716.14"
10-Jun-2022,Purchase,00.00,"20,952.69","104,763.45"
10-Jun-2022,Cheque,375.95,00.00,"105,139.40"
10-Jun-2022,Debit Card,06.00,00.00,"105,145.40"
10-Jun-2022,Transfer,06.00,00.00,"105,151.40"
10-Jun-2022,Transfer,00.00,"52,575.70","52,575.70"
10-Jun-2022,NEFT,00.00,"13,143.93","39,431.77"
10-Jun-2022,ATM,502.68,00.00,"39,934.45"
10-Jun-2022,ATM,"250,543.25",00.00,"290,477.70"
10-Jun-2022,Cash,00.00,"290,477.70",00.00
10-Jun-2022,Cheque,"1,343.24",00.00,"1,343.24"
10-Jun-2022,Debit Card,"23,063.66",00.00,"24,406.90"
10-Jun-2022,Cash,00.00,"6,101.73","18,305.18"
10-Jun-2022,Bill,00.00,"2,615.03","15,690.15"
10-Jun-2022,Interest,"2,314.00",00.00,"18,004.15"
10-Jun-2022,Debit Card,00.00,"2,000.46","16,003.69"
10-Jun-2022,RTGS,435.93,00.00,"16,439.62"
10-Jun-2022,RTGS,00.00,"1,826.62","14,613.00"
10-Jun-2022,Debit Card,05.23,00.00,"14,618.23"
10-Jun-2022,Commission,"55,896.06",00.00,"70,514.29"
10-Jun-2022,Tax,00.00,"7,834.92","62,679.37"
10-Jun-2022,Commission,"2,470.20",00.00,"65,149.57"
10-Jun-2022,IMPS,00.00,"10,858.26","54,291.31"
10-Jun-2022,Commission,00.00,"9,048.55","45,242.76"
10-Jun-2022,Debit Card,"1,810.74",00.00,"47,053.50"
10-Jun-2022,Cash,"1,011.00",00.00,"48,064.50"
10-Jun-2022,Tax,00.00,"48,064.50",00.00
10-Jun-2022,Debit Card,"20,024.00",00.00,"20,024.00"
10-Jun-2022,Debit Card,00.00,"4,004.80","16,019.20"
10-Jun-2022,Miscellaneous,00.00,"2,288.46","13,730.74"
10-Jun-2022,Transfer,"58,995.47",00.00,"72,726.21"
10-Jun-2022,Commission,00.00,"72,726.21",00.00
10-Jun-2022,Miscellaneous,"171,220.00",00.00,"171,220.00"
10-Jun-2022,Transfer,"1,855,963.00",00.00,"2,027,183.00"
10-Jun-2022,IMPS,00.00,"2,027,183.00",00.00
10-Jun-2022,NEFT,"16,479.70",00.00,"16,479.70"
10-Jun-2022,Debit Card,32.56,00.00,"16,512.26"
10-Jun-2022,IMPS,"2,855.45",00.00,"19,367.71"
10-Jun-2022,Transfer,00.00,"2,420.96","16,946.75"
10-Jun-2022,Miscellaneous,"2,404.14",00.00,"19,350.89"
10-Jun-2022,Transfer,00.00,"3,870.18","15,480.71"
10-Jun-2022,RTGS,60.00,00.00,"15,540.71"
10-Jun-2022,Miscellaneous,"2,138.29",00.00,"17,679.00"
11-Jun-2022,Tax,00.00,"2,209.88","15,469.12"
11-Jun-2022,IMPS,352.00,00.00,"15,821.12"
11-Jun-2022,Reversal,"2,001,372.00",00.00,"2,017,193.12"
11-Jun-2022,Miscellaneous,43.74,00.00,"2,017,236.86"
11-Jun-2022,ATM,"1,235,934.00",00.00,"3,253,170.86"
11-Jun-2022,Tax,00.00,"1,084,390.29","2,168,780.57"
11-Jun-2022,Cheque,"1,016.90",00.00,"2,169,797.47"
11-Jun-2022,Tax,"17,089.42",00.00,"2,186,886.89"
11-Jun-2022,Miscellaneous,"1,803.55",00.00,"2,188,690.44"
11-Jun-2022,Reversal,06.90,00.00,"2,188,697.34"
12-Jun-2022,RTGS,00.00,"243,188.59","1,945,508.75"
12-Jun-2022,Purchase,00.00,"277,929.82","1,667,578.93"
12-Jun-2022,Miscellaneous,00.00,"185,286.55","1,482,292.38"
12-Jun-2022,Purchase,03.00,00.00,"1,482,295.38"
12-Jun-2022,RTGS,54.00,00.00,"1,482,349.38"
12-Jun-2022,Reversal,"98,260.09",00.00,"1,580,609.47"
12-Jun-2022,Transfer,00.00,"158,060.95","1,422,548.52"
13-Jun-2022,Interest,00.00,"711,274.26","711,274.26"
13-Jun-2022,Cash,"256,617.00",00.00,"967,891.26"
13-Jun-2022,Commission,00.00,"161,315.21","806,576.05"
13-Jun-2022,Tax,00.00,"268,858.68","537,717.37"
13-Jun-2022,IMPS,00.00,"76,816.77","460,900.60"
13-Jun-2022,RTGS,"141,558.40",00.00,"602,459.00"
13-Jun-2022,ATM,00.00,"86,065.57","516,393.43"
13-Jun-2022,Cheque,00.00,"57,377.05","459,016.38"
13-Jun-2022,Purchase,"257,847.53",00.00,"716,863.91"
13-Jun-2022,Cheque,21.26,00.00,"716,885.17"
13-Jun-2022,Transfer,"20,802.90",00.00,"737,688.07"
14-Jun-2022,Debit Card,00.00,"368,844.04","368,844.04"
14-Jun-2022,NEFT,00.00,"184,422.02","184,422.02"
14-Jun-2022,NEFT,436.80,00.00,"184,858.82"
14-Jun-2022,Bill,02.00,00.00,"184,860.82"
14-Jun-2022,RTGS,00.00,"184,860.82",00.00
14-Jun-2022,Reversal,"250,900.00",00.00,"250,900.00"
14-Jun-2022,NEFT,00.00,"250,900.00",00.00
15-Jun-2022,Bill,"1,513.00",00.00,"1,513.00"
15-Jun-2022,RTGS,00.00,151.30,"1,361.70"
15-Jun-2022,Purchase,00.84,00.00,"1,362.54"
15-Jun-2022,Cheque,428.60,00.00,"1,791.14"
15-Jun-2022,Debit Card,00.00,"1,791.14",00.00
15-Jun-2022,Transfer,"2,593.72",00.00,"2,593.72"
15-Jun-2022,Interest,62.00,00.00,"2,655.72"
15-Jun-2022,Miscellaneous,04.00,00.00,"2,659.72"
15-Jun-2022,Cash,00.00,531.94,"2,127.78"
16-Jun-2022,Reversal,"1,459.65",00.00,"3,587.43"
16-Jun-2022,Interest,"4,042.00",00.00,"7,629.43"
16-Jun-2022,Bill,"2,190.17",00.00,"9,819.60"
16-Jun-2022,ATM,00.00,"1,636.60","8,183.00"
16-Jun-2022,RTGS,"1,962,694.50",00.00,"1,970,877.50"
16-Jun-2022,NEFT,"339,438.25",00.00,"2,310,315.75"
16-Jun-2022,IMPS,00.00,"385,052.63","1,925,263.12"
17-Jun-2022,Cash,00.00,"240,657.89","1,684,605.23"
17-Jun-2022,Transfer,"13,896.00",00.00,"1,698,501.23"
17-Jun-2022,Interest,37.00,00.00,"1,698,538.23"
17-Jun-2022,Interest,"7,830.00",00.00,"1,706,368.23"
17-Jun-2022,RTGS,"77,680.00",00.00,"1,784,048.23"
17-Jun-2022,Debit Card,37.00,00.00,"1,784,085.23"
17-Jun-2022,Transfer,"3,754.00",00.00,"1,787,839.23"
17-Jun-2022,Reversal,"3,502.00",00.00,"1,791,341.23"
17-Jun-2022,Miscellaneous,"160,826.00",00.00,"1,952,167.23"
17-Jun-2022,Purchase,"1,437.48",00.00,"1,953,604.71"
17-Jun-2022,Bill,00.00,"195,360.47","1,758,244.24"
18-Jun-2022,RTGS,03.94,00.00,"1,758,248.18"
18-Jun-2022,Reversal,"170,180.75",00.00,"1,928,428.93"
18-Jun-2022,IMPS,00.00,"385,685.79","1,542,743.14"
18-Jun-2022,Bill,00.00,"171,415.90","1,371,327.24"
18-Jun-2022,Cash,00.00,"171,415.91","1,199,911.34"
19-Jun-2022,Cash,00.00,"299,977.84","899,933.51"
19-Jun-2022,Purchase,"1,294,989.50",00.00,"2,194,923.01"
19-Jun-2022,Tax,00.00,"731,641.00","1,463,282.01"
19-Jun-2022,NEFT,00.00,"1,463,282.01",00.00
19-Jun-2022,Cash,07.90,00.00,07.90
19-Jun-2022,Interest,00.00,01.32,06.58
19-Jun-2022,Transfer,"3,744.31",00.00,"3,750.89"
19-Jun-2022,Reversal,00.00,625.15,"3,125.74"
19-Jun-2022,Bill,00.00,390.72,"2,735.02"
19-Jun-2022,IMPS,00.00,273.50,"2,461.52"
19-Jun-2022,RTGS,100.10,00.00,"2,561.62"
19-Jun-2022,Tax,00.00,"2,561.62",00.00
19-Jun-2022,Purchase,176.68,00.00,176.68
19-Jun-2022,IMPS,00.00,44.17,132.51
19-Jun-2022,Cash,"378,502.25",00.00,"378,634.76"
19-Jun-2022,Cash,00.00,"378,634.76",00.00
19-Jun-2022,Bill,372.60,00.00,372.60
19-Jun-2022,Purchase,21.85,00.00,394.45
19-Jun-2022,Reversal,"24,813.00",00.00,"25,207.45"
19-Jun-2022,Purchase,00.00,"3,150.93","22,056.52"
19-Jun-2022,Miscellaneous,00.00,"2,757.07","19,299.46"
19-Jun-2022,NEFT,"12,260.00",00.00,"31,559.46"
19-Jun-2022,NEFT,00.00,"31,559.46",00.00
19-Jun-2022,Bill,01.00,00.00,01.00
19-Jun-2022,Bill,00.00,00.20,00.80
19-Jun-2022,Commission,00.00,00.80,00.00
19-Jun-2022,Miscellaneous,"917,775.25",00.00,"917,775.25"
19-Jun-2022,Miscellaneous,00.00,"131,110.75","786,664.50"
19-Jun-2022,Cash,"248,027.60",00.00,"1,034,692.10"
19-Jun-2022,Reversal,34.24,00.00,"1,034,726.34"
19-Jun-2022,IMPS,"5,959.30",00.00,"1,040,685.64"
19-Jun-2022,Debit Card,"23,841.56",00.00,"1,064,527.20"
19-Jun-2022,Debit Card,00.00,"212,905.44","851,621.76"
19-Jun-2022,ATM,03.50,00.00,"851,625.26"
19-Jun-2022,Miscellaneous,03.00,00.00,"851,628.26"
19-Jun-2022,IMPS,00.00,"141,938.04","709,690.22"
19-Jun-2022,ATM,05.80,00.00,"709,696.02"
19-Jun-2022,Miscellaneous,00.00,"70,969.60","638,726.42"
19-Jun-2022,RTGS,00.00,"127,745.28","510,981.14"
19-Jun-2022,Transfer,00.00,"85,163.52","425,817.62"
19-Jun-2022,Miscellaneous,"89,295.00",00.00,"515,112.62"
19-Jun-2022,Debit Card,00.00,"128,778.16","386,334.46"
19-Jun-2022,Purchase,00.00,"128,778.15","257,556.31"
19-Jun-2022,NEFT,"15,216.10",00.00,"272,772.41"
19-Jun-2022,Bill,"15,667.60",00.00,"288,440.01"
19-Jun-2022,IMPS,447.50,00.00,"288,887.51"
19-Jun-2022,Miscellaneous,"31,772.00",00.00,"320,659.51"
19-Jun-2022,RTGS,00.00,"106,886.50","213,773.01"
20-Jun-2022,Cheque,07.20,00.00,"213,780.21"
20-Jun-2022,Cheque,00.00,"26,722.53","187,057.68"
20-Jun-2022,RTGS,"3,975.00",00.00,"191,032.68"
20-Jun-2022,Bill,394.00,00.00,"191,426.68"
20-Jun-2022,NEFT,05.48,00.00,"191,432.16"
20-Jun-2022,ATM,421.20,00.00,"191,853.36"
20-Jun-2022,Debit Card,"5,126.07",00.00,"196,979.43"
20-Jun-2022,Miscellaneous,05.00,00.00,"196,984.43"
20-Jun-2022,Commission,"251,776.20",00.00,"448,760.63"
20-Jun-2022,Interest,00.00,"49,862.29","398,898.34"
20-Jun-2022,Reversal,00.00,"66,483.06","332,415.28"
20-Jun-2022,Cash,00.00,"33,241.53","299,173.75"
20-Jun-2022,Cheque,00.00,"49,862.29","249,311.46"
20-Jun-2022,Transfer,96.60,00.00,"249,408.06"
20-Jun-2022,Reversal,"20,889.70",00.00,"270,297.76"
20-Jun-2022,Debit Card,00.00,"30,033.08","240,264.68"
20-Jun-2022,Purchase,00.00,"60,066.17","180,198.51"
20-Jun-2022,NEFT,00.00,"90,099.26","90,099.26"
20-Jun-2022,Cheque,79.00,00.00,"90,178.26"
20-Jun-2022,Cheque,"3,484.00",00.00,"93,662.26"
20-Jun-2022,ATM,01.00,00.00,"93,663.26"
20-Jun-2022,IMPS,32.40,00.00,"93,695.66"
20-Jun-2022,Miscellaneous,19.00,00.00,"93,714.66"
20-Jun-2022,Debit Card,"89,814.00",00.00,"183,528.66"
20-Jun-2022,ATM,"3,790.00",00.00,"187,318.66"
20-Jun-2022,Miscellaneous,168.20,00.00,"187,486.86"
20-Jun-2022,Bill,00.00,"46,871.72","140,615.14"
20-Jun-2022,ATM,00.00,"28,123.03","112,492.11"
20-Jun-2022,Cheque,00.00,"14,061.51","98,430.60"
20-Jun-2022,ATM,"84,665.81",00.00,"183,096.41"
20-Jun-2022,Bill,00.00,"61,032.14","122,064.27"
20-Jun-2022,Debit Card,00.00,"13,562.70","108,501.57"
20-Jun-2022,Bill,00.00,"15,500.22","93,001.35"
20-Jun-2022,NEFT,00.00,"18,600.27","74,401.08"
20-Jun-2022,NEFT,61.50,00.00,"74,462.58"
20-Jun-2022,Tax,00.00,"74,462.58",00.00
20-Jun-2022,ATM,"30,591.10",00.00,"30,591.10"
20-Jun-2022,Interest,00.00,"10,197.03","20,394.07"
20-Jun-2022,IMPS,"3,946.10",00.00,"24,340.17"
20-Jun-2022,Bill,02.00,00.00,"24,342.17"
20-Jun-2022,ATM,424.00,00.00,"24,766.17"
20-Jun-2022,Debit Card,323.00,00.00,"25,089.17"
20-Jun-2022,NEFT,00.00,"2,508.92","22,580.25"
20-Jun-2022,Purchase,"629,961.00",00.00,"652,541.25"
20-Jun-2022,Bill,"2,445.52",00.00,"654,986.77"
20-Jun-2022,IMPS,61.70,00.00,"655,048.47"
20-Jun-2022,Reversal,00.00,"65,504.85","589,543.62"
21-Jun-2022,NEFT,05.62,00.00,"589,549.24"
21-Jun-2022,Cash,00.00,"73,693.66","515,855.58"
21-Jun-2022,RTGS,28.80,00.00,"515,884.38"
21-Jun-2022,Commission,247.00,00.00,"516,131.38"
21-Jun-2022,ATM,00.00,"57,347.93","458,783.45"
21-Jun-2022,NEFT,396.60,00.00,"459,180.05"
21-Jun-2022,Interest,00.00,"459,180.05",00.00
21-Jun-2022,Cheque,15.50,00.00,15.50
21-Jun-2022,Cheque,40.00,00.00,55.50
21-Jun-2022,Transfer,00.00,18.50,37.00
21-Jun-2022,Purchase,00.00,05.29,31.71
21-Jun-2022,RTGS,00.00,15.86,15.86
21-Jun-2022,NEFT,"214,902.62",00.00,"214,918.48"
21-Jun-2022,Interest,"1,657,112.75",00.00,"1,872,031.23"
21-Jun-2022,Interest,00.00,"374,406.25","1,497,624.98"
21-Jun-2022,Debit Card,440.02,00.00,"1,498,065.00"
21-Jun-2022,IMPS,"2,852.00",00.00,"1,500,917.00"
21-Jun-2022,Miscellaneous,00.00,"500,305.67","1,000,611.33"
21-Jun-2022,Cheque,00.00,"1,000,611.33",00.00
21-Jun-2022,Cheque,"26,688.80",00.00,"26,688.80"
21-Jun-2022,Purchase,00.00,"5,337.76","21,351.04"
21-Jun-2022,Bill,"7,151.48",00.00,"28,502.52"
21-Jun-2022,Bill,"1,704,444.50",00.00,"1,732,947.02"
21-Jun-2022,Bill,00.00,"577,649.01","1,155,298.01"
21-Jun-2022,Cash,"26,975.80",00.00,"1,182,273.81"
21-Jun-2022,Bill,00.00,"131,363.76","1,050,910.05"
21-Jun-2022,Tax,"196,696.00",00.00,"1,247,606.05"
21-Jun-2022,Commission,00.00,"311,901.51","935,704.54"
21-Jun-2022,Debit Card,"95,892.00",00.00,"1,031,596.54"
21-Jun-2022,Tax,00.00,"114,621.84","916,974.70"
21-Jun-2022,Interest,01.00,00.00,"916,975.70"
21-Jun-2022,Cheque,00.00,"91,697.57","825,278.13"
21-Jun-2022,Debit Card,01.00,00.00,"825,279.13"
21-Jun-2022,Cash,287.00,00.00,"825,566.13"
21-Jun-2022,RTGS,"36,350.00",00.00,"861,916.13"
21-Jun-2022,Reversal,00.40,00.00,"861,916.53"
21-Jun-2022,RTGS,"1,177.00",00.00,"863,093.53"
21-Jun-2022,Debit Card,00.00,"95,899.28","767,194.25"
21-Jun-2022,Commission,00.00,"191,798.56","575,395.69"
21-Jun-2022,Bill,00.00,"575,395.69",00.00
21-Jun-2022,RTGS,90.80,00.00,90.80
21-Jun-2022,Debit Card,00.00,45.40,45.40
21-Jun-2022,Interest,"246,720.40",00.00,"246,765.80"
21-Jun-2022,Reversal,"1,811.32",00.00,"248,577.12"
21-Jun-2022,Debit Card,02.26,00.00,"248,579.38"
21-Jun-2022,Cash,30.00,00.00,"248,609.38"
21-Jun-2022,Tax,00.00,"24,860.94","223,748.44"
21-Jun-2022,IMPS,00.00,"44,749.69","178,998.75"
21-Jun-2022,Tax,31.40,00.00,"179,030.15"
21-Jun-2022,Reversal,00.00,"35,806.03","143,224.12"
21-Jun-2022,Transfer,31.00,00.00,"143,255.12"
21-Jun-2022,Bill,00.00,"47,751.71","95,503.41"
21-Jun-2022,Miscellaneous,05.00,00.00,"95,508.41"
21-Jun-2022,Cheque,"75,774.80",00.00,"171,283.21"
21-Jun-2022,Purchase,"15,529.00",00.00,"186,812.21"
21-Jun-2022,Tax,00.00,"23,351.53","163,460.68"
21-Jun-2022,Debit Card,00.00,"163,460.68",00.00
21-Jun-2022,Interest,"1,478,473.80",00.00,"1,478,473.80"
21-Jun-2022,Debit Card,00.00,"147,847.38","1,330,626.42"
21-Jun-2022,ATM,00.00,"221,771.07","1,108,855.35"
21-Jun-2022,Transfer,00.00,"110,885.54","997,969.82"
21-Jun-2022,Cheque,73.00,00.00,"998,042.82"
21-Jun-2022,Reversal,52.40,00.00,"998,095.22"
21-Jun-2022,IMPS,"791,602.00",00.00,"1,789,697.22"
21-Jun-2022,Bill,07.82,00.00,"1,789,705.04"
21-Jun-2022,IMPS,00.00,"447,426.26","1,342,278.78"
21-Jun-2022,Cheque,"1,990,470.00",00.00,"3,332,748.78"
21-Jun-2022,Transfer,04.86,00.00,"3,332,753.64"
21-Jun-2022,Tax,00.00,"370,305.96","2,962,447.68"
21-Jun-2022,Purchase,425.00,00.00,"2,962,872.68"
21-Jun-2022,NEFT,00.00,"2,962,872.68",00.00
21-Jun-2022,IMPS,"786,840.20",00.00,"786,840.20"
21-Jun-2022,Debit Card,00.00,"98,355.03","688,485.18"
22-Jun-2022,RTGS,13.00,00.00,"688,498.18"
22-Jun-2022,Debit Card,05.60,00.00,"688,503.78"
22-Jun-2022,Purchase,00.00,"76,500.42","612,003.36"
22-Jun-2022,Bill,38.00,00.00,"612,041.36"
22-Jun-2022,Interest,"16,277.14",00.00,"628,318.50"
22-Jun-2022,Interest,"2,416.00",00.00,"630,734.50"
22-Jun-2022,Reversal,06.60,00.00,"630,741.10"
22-Jun-2022,Miscellaneous,00.00,"63,074.11","567,666.99"
22-Jun-2022,Cheque,40.77,00.00,"567,707.76"
22-Jun-2022,Miscellaneous,00.00,"141,926.94","425,780.82"
22-Jun-2022,Bill,00.00,"212,890.41","212,890.41"
22-Jun-2022,Bill,"1,456.30",00.00,"214,346.71"
22-Jun-2022,RTGS,"29,360.23",00.00,"243,706.94"
22-Jun-2022,IMPS,07.80,00.00,"243,714.74"
22-Jun-2022,NEFT,"277,476.00",00.00,"521,190.74"
22-Jun-2022,Cash,00.00,"74,455.82","446,734.92"
22-Jun-2022,Cash,00.00,"148,911.64","297,823.28"
22-Jun-2022,ATM,00.00,"297,823.28",00.00
22-Jun-2022,IMPS,23.99,00.00,23.99
22-Jun-2022,Commission,"22,641.00",00.00,"22,664.99"
22-Jun-2022,Bill,00.00,"11,332.50","11,332.50"
22-Jun-2022,Purchase,00.00,"11,332.50",00.00
22-Jun-2022,Cash,"1,919,178.25",00.00,"1,919,178.25"
22-Jun-2022,Cash,00.00,"213,242.03","1,705,936.22"
22-Jun-2022,Transfer,"120,551.80",00.00,"1,826,488.02"
22-Jun-2022,Cheque,323.00,00.00,"1,826,811.02"
22-Jun-2022,Transfer,57.79,00.00,"1,826,868.81"
22-Jun-2022,Purchase,00.00,"365,373.76","1,461,495.05"
22-Jun-2022,Debit Card,00.00,"487,165.02","974,330.03"
22-Jun-2022,Transfer,108.90,00.00,"974,438.93"
22-Jun-2022,Cheque,34.01,00.00,"974,472.94"
22-Jun-2022,Commission,00.00,"974,472.94",00.00
22-Jun-2022,Bill,02.50,00.00,02.50
22-Jun-2022,Tax,00.00,00.31,02.19
22-Jun-2022,ATM,00.00,00.73,01.46
22-Jun-2022,Cash,33.70,00.00,35.16
22-Jun-2022,Bill,"2,551.69",00.00,"2,586.85"
22-Jun-2022,Tax,623.59,00.00,"3,210.44"
22-Jun-2022,Purchase,"23,688.00",00.00,"26,898.44"
22-Jun-2022,Reversal,00.00,"2,689.84","24,208.60"
22-Jun-2022,NEFT,"30,381.81",00.00,"54,590.41"
22-Jun-2022,Tax,"17,509.15",00.00,"72,099.56"
22-Jun-2022,Commission,00.00,"72,099.56",00.00
22-Jun-2022,IMPS,185.40,00.00,185.40
22-Jun-2022,Purchase,00.00,23.18,162.22
22-Jun-2022,Tax,00.50,00.00,162.72
22-Jun-2022,NEFT,00.00,54.24,108.48
22-Jun-2022,Cheque,24.00,00.00,132.48
22-Jun-2022,NEFT,"3,301.90",00.00,"3,434.38"
22-Jun-2022,Commission,00.00,"3,434.38",00.00
22-Jun-2022,Reversal,"980,639.25",00.00,"980,639.25"
22-Jun-2022,IMPS,00.00,"196,127.85","784,511.40"
22-Jun-2022,Miscellaneous,37.30,00.00,"784,548.70"
22-Jun-2022,RTGS,"20,693.00",00.00,"805,241.70"
22-Jun-2022,Miscellaneous,00.00,"201,310.43","603,931.27"
22-Jun-2022,ATM,00.00,"100,655.21","503,276.06"
22-Jun-2022,Cheque,02.30,00.00,"503,278.36"
22-Jun-2022,Debit Card,00.00,"50,327.84","452,950.52"
22-Jun-2022,Bill,00.00,"64,707.22","388,243.30"
22-Jun-2022,Commission,"2,396.20",00.00,"390,639.50"
22-Jun-2022,Commission,00.00,"390,639.50",00.00
22-Jun-2022,Tax,484.00,00.00,484.00
22-Jun-2022,RTGS,00.00,53.78,430.22
22-Jun-2022,ATM,00.00,47.80,382.42
22-Jun-2022,Cash,00.00,191.21,191.21
22-Jun-2022,Miscellaneous,51.60,00.00,242.81
22-Jun-2022,Interest,00.00,80.94,161.87
22-Jun-2022,IMPS,"1,694,485.00",00.00,"1,694,646.87"
22-Jun-2022,Bill,"156,719.10",00.00,"1,851,365.97"
22-Jun-2022,NEFT,188.00,00.00,"1,851,553.97"
22-Jun-2022,Cheque,"29,002.72",00.00,"1,880,556.69"
22-Jun-2022,NEFT,00.00,"1,880,556.69",00.00
22-Jun-2022,IMPS,"2,937.27",00.00,"2,937.27"
22-Jun-2022,Commission,"2,790.32",00.00,"5,727.59"
22-Jun-2022,Transfer,00.00,636.40,"5,091.19"
22-Jun-2022,Commission,03.30,00.00,"5,094.49"
22-Jun-2022,Transfer,00.00,636.81,"4,457.68"
22-Jun-2022,IMPS,32.00,00.00,"4,489.68"
22-Jun-2022,NEFT,56.00,00.00,"4,545.68"
22-Jun-2022,Reversal,08.00,00.00,"4,553.68"
22-Jun-2022,Debit Card,00.00,"2,276.84","2,276.84"
22-Jun-2022,RTGS,00.00,284.61,"1,992.24"
22-Jun-2022,Purchase,00.00,284.61,"1,707.63"
22-Jun-2022,NEFT,00.00,170.76,"1,536.87"
22-Jun-2022,Commission,02.00,00.00,"1,538.87"
22-Jun-2022,Cash,00.00,512.96,"1,025.91"
22-Jun-2022,Tax,"111,935.30",00.00,"112,961.21"
22-Jun-2022,Reversal,"217,673.50",00.00,"330,634.71"
22-Jun-2022,NEFT,422.30,00.00,"331,057.01"
22-Jun-2022,Cheque,"20,085.20",00.00,"351,142.21"
22-Jun-2022,Bill,00.00,"43,892.78","307,249.43"
22-Jun-2022,ATM,"395,831.00",00.00,"703,080.43"
22-Jun-2022,ATM,02.40,00.00,"703,082.83"
22-Jun-2022,Transfer,37.00,00.00,"703,119.83"
22-Jun-2022,NEFT,00.00,"140,623.97","562,495.86"
22-Jun-2022,Cheque,00.00,"56,249.59","506,246.27"
22-Jun-2022,Purchase,"1,122,845.80",00.00,"1,629,092.07"
22-Jun-2022,Commission,00.00,"181,010.23","1,448,081.84"
23-Jun-2022,Commission,"1,443,075.00",00.00,"2,891,156.84"
23-Jun-2022,Cheque,"51,421.62",00.00,"2,942,578.46"
23-Jun-2022,Bill,00.00,"1,471,289.23","1,471,289.23"
23-Jun-2022,ATM,"32,335.00",00.00,"1,503,624.23"
23-Jun-2022,NEFT,"2,221.10",00.00,"1,505,845.33"
23-Jun-2022,Commission,689.86,00.00,"1,506,535.19"
23-Jun-2022,Miscellaneous,102.10,00.00,"1,506,637.29"
23-Jun-2022,ATM,04.60,00.00,"1,506,641.89"
23-Jun-2022,Miscellaneous,00.00,"502,213.96","1,004,427.93"
23-Jun-2022,Commission,00.00,"334,809.31","669,618.62"
23-Jun-2022,Bill,00.00,"133,923.72","535,694.90"
23-Jun-2022,Cheque,00.00,"535,694.90",00.00
23-Jun-2022,Debit Card,344.70,00.00,344.70
23-Jun-2022,Bill,00.00,114.90,229.80
23-Jun-2022,Interest,66.00,00.00,295.80
23-Jun-2022,Debit Card,59.00,00.00,354.80
23-Jun-2022,Cheque,00.00,59.13,295.67
23-Jun-2022,RTGS,"3,745.92",00.00,"4,041.59"
23-Jun-2022,Cheque,"1,922,972.75",00.00,"1,927,014.34"
23-Jun-2022,Cheque,00.00,"321,169.06","1,605,845.28"
23-Jun-2022,RTGS,07.00,00.00,"1,605,852.28"
23-Jun-2022,Cheque,"113,124.00",00.00,"1,718,976.28"
23-Jun-2022,Cash,"14,240.70",00.00,"1,733,216.98"
23-Jun-2022,Bill,"13,490.59",00.00,"1,746,707.57"
23-Jun-2022,Bill,00.00,"218,338.45","1,528,369.12"
23-Jun-2022,RTGS,"2,016,271.00",00.00,"3,544,640.12"
23-Jun-2022,ATM,00.00,"506,377.16","3,038,262.96"
23-Jun-2022,Reversal,"1,431,264.00",00.00,"4,469,526.96"
23-Jun-2022,IMPS,00.00,"638,503.85","3,831,023.11"
23-Jun-2022,ATM,"233,114.00",00.00,"4,064,137.11"
23-Jun-2022,Commission,78.95,00.00,"4,064,216.06"
23-Jun-2022,Reversal,00.00,"508,027.01","3,556,189.05"
23-Jun-2022,Cheque,00.00,"889,047.26","2,667,141.79"
23-Jun-2022,Cash,00.00,"533,428.36","2,133,713.43"
23-Jun-2022,NEFT,00.00,"2,133,713.43",00.00
23-Jun-2022,IMPS,388.60,00.00,388.60
23-Jun-2022,Reversal,01.30,00.00,389.90
23-Jun-2022,IMPS,00.00,38.99,350.91
23-Jun-2022,Commission,01.00,00.00,351.91
23-Jun-2022,Bill,00.00,35.19,316.72
23-Jun-2022,IMPS,06.00,00.00,322.72
23-Jun-2022,Cheque,00.00,46.10,276.62
23-Jun-2022,Cheque,00.00,39.52,237.10
23-Jun-2022,Tax,03.10,00.00,240.20
23-Jun-2022,Purchase,00.00,48.04,192.16
23-Jun-2022,Reversal,00.00,19.22,172.94
23-Jun-2022,Commission,"142,488.22",00.00,"142,661.16"
23-Jun-2022,Cash,02.00,00.00,"142,663.16"
23-Jun-2022,IMPS,00.00,"142,663.16",00.00
23-Jun-2022,Tax,485.80,00.00,485.80
23-Jun-2022,Cash,"9,655.00",00.00,"10,140.80"
23-Jun-2022,NEFT,00.00,"2,028.16","8,112.64"
23-Jun-2022,Transfer,04.20,00.00,"8,116.84"
24-Jun-2022,Purchase,00.00,"4,058.42","4,058.42"
24-Jun-2022,NEFT,00.00,450.94,"3,607.48"
24-Jun-2022,RTGS,00.00,"3,607.48",00.00
24-Jun-2022,Purchase,"1,965.78",00.00,"1,965.78"
24-Jun-2022,RTGS,00.00,280.83,"1,684.95"
24-Jun-2022,Cash,00.00,168.50,"1,516.46"
24-Jun-2022,Reversal,511.70,00.00,"2,028.16"
24-Jun-2022,NEFT,00.00,"1,014.08","1,014.08"
24-Jun-2022,IMPS,00.00,101.41,912.67
24-Jun-2022,Reversal,398.00,00.00,"1,310.67"
24-Jun-2022,Cheque,"6,840.30",00.00,"8,150.97"
24-Jun-2022,RTGS,00.00,905.66,"7,245.31"
24-Jun-2022,Cheque,149.00,00.00,"7,394.31"
24-Jun-2022,RTGS,00.00,"3,697.16","3,697.16"
24-Jun-2022,NEFT,00.00,739.43,"2,957.73"
24-Jun-2022,Purchase,"2,026.20",00.00,"4,983.93"
24-Jun-2022,Purchase,106.84,00.00,"5,090.77"
24-Jun-2022,Commission,123.49,00.00,"5,214.26"
24-Jun-2022,Tax,00.00,744.89,"4,469.37"
24-Jun-2022,Miscellaneous,"4,067.70",00.00,"8,537.07"
24-Jun-2022,Cash,"10,743.00",00.00,"19,280.07"
24-Jun-2022,ATM,00.00,"6,426.69","12,853.38"
24-Jun-2022,Commission,00.00,"3,213.35","9,640.04"
24-Jun-2022,NEFT,"3,716.43",00.00,"13,356.47"
24-Jun-2022,Purchase,"22,735.50",00.00,"36,091.97"
24-Jun-2022,Debit Card,"14,775.00",00.00,"50,866.97"
24-Jun-2022,Debit Card,00.00,"10,173.39","40,693.58"
24-Jun-2022,Transfer,00.00,"4,521.51","36,172.07"
24-Jun-2022,Purchase,00.00,"9,043.02","27,129.05"
24-Jun-2022,Purchase,"306,125.00",00.00,"333,254.05"
24-Jun-2022,Interest,00.00,"55,542.34","277,711.71"
24-Jun-2022,Cheque,00.00,"277,711.71",00.00
24-Jun-2022,Debit Card,"2,496.40",00.00,"2,496.40"
24-Jun-2022,Purchase,00.00,277.38,"2,219.02"
24-Jun-2022,RTGS,"787,285.50",00.00,"789,504.52"
24-Jun-2022,Cheque,370.00,00.00,"789,874.52"
24-Jun-2022,Commission,00.00,"789,874.52",00.00
24-Jun-2022,Bill,61.32,00.00,61.32
24-Jun-2022,Commission,00.00,20.44,40.88
24-Jun-2022,Miscellaneous,"25,157.00",00.00,"25,197.88"
24-Jun-2022,NEFT,00.00,"6,299.47","18,898.41"
24-Jun-2022,Bill,00.00,"9,449.21","9,449.20"
24-Jun-2022,Transfer,00.00,944.92,"8,504.28"
24-Jun-2022,Bill,00.00,"4,252.14","4,252.14"
25-Jun-2022,Reversal,"16,362.00",00.00,"20,614.14"
25-Jun-2022,Commission,00.00,"2,061.41","18,552.73"
25-Jun-2022,Miscellaneous,390.90,00.00,"18,943.63"
25-Jun-2022,Debit Card,00.00,"6,314.54","12,629.09"
25-Jun-2022,Debit Card,00.00,"1,804.16","10,824.93"
25-Jun-2022,Purchase,02.00,00.00,"10,826.93"
25-Jun-2022,NEFT,"502,273.50",00.00,"513,100.43"
25-Jun-2022,RTGS,"24,947.80",00.00,"538,048.23"
25-Jun-2022,RTGS,00.00,"538,048.23",00.00
25-Jun-2022,Interest,"1,670,302.75",00.00,"1,670,302.75"
25-Jun-2022,NEFT,"1,352,892.50",00.00,"3,023,195.25"
25-Jun-2022,Transfer,"1,753,972.00",00.00,"4,777,167.25"
25-Jun-2022,IMPS,"773,814.00",00.00,"5,550,981.25"
25-Jun-2022,RTGS,"15,996.00",00.00,"5,566,977.25"
25-Jun-2022,Cheque,00.00,"1,113,395.45","4,453,581.80"
25-Jun-2022,Commission,"2,898.00",00.00,"4,456,479.80"
25-Jun-2022,Reversal,00.00,"1,485,493.27","2,970,986.53"
25-Jun-2022,NEFT,00.00,"990,328.84","1,980,657.69"
25-Jun-2022,ATM,400.60,00.00,"1,981,058.29"
26-Jun-2022,IMPS,"51,595.28",00.00,"2,032,653.57"
27-Jun-2022,RTGS,00.00,"290,379.08","1,742,274.49"
27-Jun-2022,Miscellaneous,00.00,"871,137.25","871,137.24"
27-Jun-2022,IMPS,00.00,"871,137.24",00.00
27-Jun-2022,Reversal,"6,683.00",00.00,"6,683.00"
27-Jun-2022,IMPS,00.00,835.38,"5,847.62"
27-Jun-2022,Bill,169.60,00.00,"6,017.22"
27-Jun-2022,RTGS,"73,597.00",00.00,"79,614.22"
27-Jun-2022,Cheque,00.00,"26,538.07","53,076.15"
27-Jun-2022,Bill,01.52,00.00,"53,077.67"
27-Jun-2022,Interest,163.25,00.00,"53,240.92"
27-Jun-2022,Purchase,06.20,00.00,"53,247.12"
27-Jun-2022,NEFT,"24,974.00",00.00,"78,221.12"
27-Jun-2022,RTGS,52.00,00.00,"78,273.12"
27-Jun-2022,Debit Card,"1,850.00",00.00,"80,123.12"
27-Jun-2022,Miscellaneous,253.83,00.00,"80,376.95"
27-Jun-2022,IMPS,00.20,00.00,"80,377.15"
27-Jun-2022,Transfer,00.40,00.00,"80,377.55"
27-Jun-2022,Commission,"13,760.47",00.00,"94,138.02"
27-Jun-2022,Cheque,04.97,00.00,"94,142.99"
27-Jun-2022,Commission,00.00,"47,071.50","47,071.50"
27-Jun-2022,Debit Card,00.00,"7,845.25","39,226.25"
28-Jun-2022,Cash,"5,122.86",00.00,"44,349.11"
28-Jun-2022,Commission,00.00,"44,349.11",00.00
28-Jun-2022,Bill,62.30,00.00,62.30
28-Jun-2022,Transfer,00.00,08.90,53.40
28-Jun-2022,Purchase,"106,241.22",00.00,"106,294.62"
28-Jun-2022,Reversal,00.00,"11,810.51","94,484.11"
28-Jun-2022,Purchase,185.00,00.00,"94,669.11"
28-Jun-2022,Cash,"1,299,257.00",00.00,"1,393,926.11"
28-Jun-2022,Cash,"70,655.60",00.00,"1,464,581.71"
28-Jun-2022,RTGS,00.00,"183,072.71","1,281,509.00"
28-Jun-2022,Tax,48.00,00.00,"1,281,557.00"
28-Jun-2022,Cash,00.00,"1,281,557.00",00.00
28-Jun-2022,NEFT,"143,506.00",00.00,"143,506.00"
28-Jun-2022,Commission,"3,389.01",00.00,"146,895.01"
28-Jun-2022,Reversal,345.52,00.00,"147,240.53"
28-Jun-2022,Interest,00.00,"18,405.07","128,835.46"
28-Jun-2022,Debit Card,00.00,"14,315.05","114,520.41"
28-Jun-2022,Bill,381.52,00.00,"114,901.93"
28-Jun-2022,IMPS,00.00,"38,300.64","76,601.29"
28-Jun-2022,NEFT,44.00,00.00,"76,645.29"
28-Jun-2022,Miscellaneous,01.43,00.00,"76,646.72"
28-Jun-2022,IMPS,"832,027.50",00.00,"908,674.22"
28-Jun-2022,NEFT,00.00,"151,445.70","757,228.52"
28-Jun-2022,Tax,00.00,"75,722.85","681,505.67"
28-Jun-2022,Debit Card,"70,337.09",00.00,"751,842.76"
29-Jun-2022,Debit Card,00.00,"187,960.69","563,882.07"
29-Jun-2022,Miscellaneous,275.90,00.00,"564,157.97"
29-Jun-2022,Interest,"38,142.00",00.00,"602,299.97"
29-Jun-2022,Cash,126.32,00.00,"602,426.29"
29-Jun-2022,Reversal,"16,418.80",00.00,"618,845.09"
29-Jun-2022,Bill,07.13,00.00,"618,852.22"
29-Jun-2022,Transfer,00.00,"88,407.46","530,444.76"
29-Jun-2022,Transfer,00.42,00.00,"530,445.18"
29-Jun-2022,ATM,00.00,"176,815.06","353,630.12"
29-Jun-2022,Commission,35.00,00.00,"353,665.12"
29-Jun-2022,NEFT,"1,566.20",00.00,"355,231.32"
29-Jun-2022,Cheque,00.00,"35,523.13","319,708.19"
29-Jun-2022,IMPS,03.00,00.00,"319,711.19"
29-Jun-2022,Miscellaneous,00.00,"53,285.20","266,425.99"
29-Jun-2022,Miscellaneous,00.00,"88,808.66","177,617.33"
29-Jun-2022,Purchase,00.00,"177,617.33",00.00
29-Jun-2022,ATM,123.36,00.00,123.36
29-Jun-2022,Interest,04.00,00.00,127.36
29-Jun-2022,Tax,00.00,21.23,106.13
29-Jun-2022,IMPS,48.00,00.00,154.13
29-Jun-2022,Tax,00.00,30.83,123.30
29-Jun-2022,Tax,00.00,13.70,109.60
30-Jun-2022,Commission,00.00,15.66,93.94
30-Jun-2022,Miscellaneous,02.49,00.00,96.43
30-Jun-2022,Reversal,"13,938.40",00.00,"14,034.83"
30-Jun-2022,Bill,05.00,00.00,"14,039.83"
01-Jul-2022,Reversal,57.55,00.00,"14,097.38"
01-Jul-2022,Transfer,00.00,"3,524.35","10,573.04"
01-Jul-2022,ATM,00.00,"1,762.17","8,810.87"
01-Jul-2022,NEFT,"94,290.40",00.00,"103,101.27"
01-Jul-2022,ATM,00.00,"12,887.66","90,213.61"
01-Jul-2022,Bill,"48,132.10",00.00,"138,345.71"
01-Jul-2022,Debit Card,"44,606.00",00.00,"182,951.71"
02-Jul-2022,Tax,04.80,00.00,"182,956.51"
02-Jul-2022,Debit Card,00.00,"26,136.64","156,819.87"
02-Jul-2022,Cheque,"20,752.80",00.00,"177,572.67"
02-Jul-2022,Cash,"2,570.02",00.00,"180,142.69"
02-Jul-2022,Bill,00.00,"22,517.84","157,624.85"
02-Jul-2022,Miscellaneous,00.00,"15,762.49","141,862.36"
02-Jul-2022,ATM,00.00,"47,287.45","94,574.91"
02-Jul-2022,Debit Card,05.20,00.00,"94,580.11"
02-Jul-2022,NEFT,"228,455.50",00.00,"323,035.61"
02-Jul-2022,Miscellaneous,00.00,"107,678.54","215,357.07"
02-Jul-2022,Reversal,00.00,"23,928.56","191,428.51"
02-Jul-2022,ATM,"1,811,232.00",00.00,"2,002,660.51"
02-Jul-2022,Interest,297.70,00.00,"2,002,958.21"
02-Jul-2022,ATM,00.00,"222,550.91","1,780,407.30"
02-Jul-2022,Purchase,00.00,"593,469.10","1,186,938.20"
02-Jul-2022,ATM,"3,331.00",00.00,"1,190,269.20"
02-Jul-2022,NEFT,26.63,00.00,"1,190,295.83"
02-Jul-2022,Transfer,"28,432.81",00.00,"1,218,728.64"
02-Jul-2022,Commission,04.07,00.00,"1,218,732.71"
02-Jul-2022,Bill,00.00,"152,341.59","1,066,391.12"
02-Jul-2022,Cheque,00.00,"177,731.85","888,659.27"
03-Jul-2022,NEFT,"38,115.88",00.00,"926,775.15"
03-Jul-2022,Commission,00.00,"185,355.03","741,420.12"
03-Jul-2022,Debit Card,00.00,"741,420.12",00.00
04-Jul-2022,Purchase,01.50,00.00,01.50
04-Jul-2022,NEFT,26.00,00.00,27.50
05-Jul-2022,Tax,"460,230.00",00.00,"460,257.50"
05-Jul-2022,Commission,00.00,"460,257.50",00.00
05-Jul-2022,Cheque,"3,271.08",00.00,"3,271.08"
05-Jul-2022,Commission,57.00,00.00,"3,328.08"
05-Jul-2022,IMPS,61.00,00.00,"3,389.08"
05-Jul-2022,Commission,00.00,484.15,"2,904.93"
05-Jul-2022,ATM,00.00,290.49,"2,614.44"
05-Jul-2022,Transfer,"1,792.81",00.00,"4,407.25"
05-Jul-2022,Purchase,00.00,440.73,"3,966.52"
05-Jul-2022,RTGS,00.00,495.82,"3,470.70"
05-Jul-2022,Bill,00.00,694.14,"2,776.56"
05-Jul-2022,Tax,"1,633.50",00.00,"4,410.06"
05-Jul-2022,Commission,00.00,882.01,"3,528.05"
05-Jul-2022,Cash,15.40,00.00,"3,543.45"
05-Jul-2022,Reversal,00.00,"1,771.73","1,771.72"
05-Jul-2022,Interest,00.00,177.17,"1,594.55"
05-Jul-2022,Bill,00.00,159.46,"1,435.10"
05-Jul-2022,NEFT,00.33,00.00,"1,435.43"
05-Jul-2022,Interest,00.00,205.06,"1,230.37"
06-Jul-2022,Reversal,00.00,410.12,820.25
06-Jul-2022,Debit Card,00.00,102.53,717.72
06-Jul-2022,NEFT,"213,070.31",00.00,"213,788.03"
06-Jul-2022,Cheque,"77,271.28",00.00,"291,059.31"
06-Jul-2022,Cheque,00.00,"36,382.41","254,676.90"
06-Jul-2022,RTGS,00.00,"42,446.15","212,230.75"
06-Jul-2022,Cash,27.00,00.00,"212,257.75"
06-Jul-2022,Commission,00.00,"35,376.29","176,881.46"
06-Jul-2022,Miscellaneous,00.00,"88,440.73","88,440.73"
06-Jul-2022,IMPS,"30,632.00",00.00,"119,072.73"
06-Jul-2022,Debit Card,"908,616.50",00.00,"1,027,689.23"
06-Jul-2022,Reversal,00.00,"342,563.08","685,126.15"
06-Jul-2022,Debit Card,"528,002.00",00.00,"1,213,128.15"
06-Jul-2022,Interest,00.00,"173,304.02","1,039,824.13"
06-Jul-2022,Transfer,00.00,"148,546.30","891,277.83"
06-Jul-2022,IMPS,00.00,"127,325.40","763,952.43"
06-Jul-2022,NEFT,546.80,00.00,"764,499.23"
06-Jul-2022,Transfer,00.00,"191,124.81","573,374.42"
06-Jul-2022,Reversal,00.00,"114,674.88","458,699.54"
06-Jul-2022,RTGS,"70,145.00",00.00,"528,844.54"
06-Jul-2022,Cheque,"281,208.00",00.00,"810,052.54"
06-Jul-2022,Purchase,"2,062,947.75",00.00,"2,873,000.29"
06-Jul-2022,Tax,"1,303,226.00",00.00,"4,176,226.29"
06-Jul-2022,NEFT,52.30,00.00,"4,176,278.59"
06-Jul-2022,Reversal,"155,932.00",00.00,"4,332,210.59"
06-Jul-2022,Purchase,00.00,"866,442.12","3,465,768.47"
06-Jul-2022,Interest,03.90,00.00,"3,465,772.37"
06-Jul-2022,ATM,05.00,00.00,"3,465,777.37"
06-Jul-2022,IMPS,00.00,"866,444.34","2,599,333.03"
07-Jul-2022,Debit Card,"228,749.00",00.00,"2,828,082.03"
07-Jul-2022,NEFT,"2,674.90",00.00,"2,830,756.93"
07-Jul-2022,Bill,00.00,"283,075.69","2,547,681.24"
07-Jul-2022,Commission,00.00,"2,547,681.24",00.00
07-Jul-2022,Transfer,"52,491.59",00.00,"52,491.59"
07-Jul-2022,Cheque,200.00,00.00,"52,691.59"
07-Jul-2022,Miscellaneous,00.00,"5,269.16","47,422.43"
07-Jul-2022,Interest,07.60,00.00,"47,430.03"
07-Jul-2022,Transfer,"3,024.00",00.00,"50,454.03"
07-Jul-2022,Interest,100.00,00.00,"50,554.03"
07-Jul-2022,Bill,00.00,"10,110.81","40,443.22"
07-Jul-2022,RTGS,"471,759.00",00.00,"512,202.22"
07-Jul-2022,RTGS,00.00,"73,171.75","439,030.47"
07-Jul-2022,Purchase,00.00,"146,343.49","292,686.98"
07-Jul-2022,RTGS,00.00,"146,343.49","146,343.49"
07-Jul-2022,NEFT,00.00,"29,268.70","117,074.79"
07-Jul-2022,Miscellaneous,00.00,"39,024.93","78,049.86"
07-Jul-2022,RTGS,502.00,00.00,"78,551.86"
07-Jul-2022,Transfer,00.00,"9,818.98","68,732.88"
07-Jul-2022,IMPS,00.00,"22,910.96","45,821.92"
07-Jul-2022,IMPS,00.00,"45,821.92",00.00
07-Jul-2022,Cheque,233.80,00.00,233.80
07-Jul-2022,Cheque,"1,576.00",00.00,"1,809.80"
07-Jul-2022,Cheque,34.00,00.00,"1,843.80"
07-Jul-2022,Reversal,229.10,00.00,"2,072.90"
08-Jul-2022,Miscellaneous,07.91,00.00,"2,080.81"
08-Jul-2022,RTGS,00.00,346.80,"1,734.01"
08-Jul-2022,Cash,"10,970.90",00.00,"12,704.91"
08-Jul-2022,ATM,"2,092,334.80",00.00,"2,105,039.71"
08-Jul-2022,Reversal,00.00,"350,839.95","1,754,199.76"
08-Jul-2022,ATM,00.00,"1,754,199.76",00.00
08-Jul-2022,Tax,00.50,00.00,00.50
08-Jul-2022,Debit Card,224.80,00.00,225.30
09-Jul-2022,Miscellaneous,00.00,45.06,180.24
09-Jul-2022,Debit Card,57.80,00.00,238.04
09-Jul-2022,Interest,"2,729.77",00.00,"2,967.81"
09-Jul-2022,Transfer,"1,503.00",00.00,"4,470.81"
09-Jul-2022,IMPS,00.00,894.16,"3,576.65"
09-Jul-2022,RTGS,"1,503,210.20",00.00,"1,506,786.85"
09-Jul-2022,Interest,00.00,"502,262.28","1,004,524.57"
09-Jul-2022,NEFT,360.75,00.00,"1,004,885.32"
09-Jul-2022,Purchase,00.00,"111,653.92","893,231.40"
09-Jul-2022,IMPS,00.00,"446,615.70","446,615.70"
09-Jul-2022,Bill,17.16,00.00,"446,632.86"
09-Jul-2022,Reversal,00.00,"148,877.62","297,755.24"
09-Jul-2022,Debit Card,"1,247.00",00.00,"299,002.24"
09-Jul-2022,Transfer,"704,336.20",00.00,"1,003,338.44"
09-Jul-2022,IMPS,"115,846.25",00.00,"1,119,184.69"
09-Jul-2022,Miscellaneous,"247,201.72",00.00,"1,366,386.41"
09-Jul-2022,Transfer,00.00,"136,638.64","1,229,747.77"
10-Jul-2022,Bill,05.00,00.00,"1,229,752.77"
10-Jul-2022,Interest,"1,955,165.00",00.00,"3,184,917.77"
10-Jul-2022,Debit Card,00.00,"353,879.75","2,831,038.02"
10-Jul-2022,ATM,23.00,00.00,"2,831,061.02"
10-Jul-2022,Commission,741.00,00.00,"2,831,802.02"
10-Jul-2022,Interest,00.00,"707,950.51","2,123,851.52"
10-Jul-2022,ATM,424.30,00.00,"2,124,275.82"
10-Jul-2022,Reversal,00.00,"303,467.97","1,820,807.85"
10-Jul-2022,Reversal,"1,386.00",00.00,"1,822,193.85"
10-Jul-2022,Miscellaneous,00.00,"455,548.46","1,366,645.39"
10-Jul-2022,Purchase,"216,105.00",00.00,"1,582,750.39"
10-Jul-2022,Tax,00.00,"527,583.46","1,055,166.93"
10-Jul-2022,RTGS,01.00,00.00,"1,055,167.93"
10-Jul-2022,NEFT,00.00,"105,516.79","949,651.14"
10-Jul-2022,Cash,00.00,"237,412.79","712,238.36"
10-Jul-2022,Transfer,01.00,00.00,"712,239.36"
10-Jul-2022,Cheque,07.50,00.00,"712,246.86"
10-Jul-2022,IMPS,"31,561.10",00.00,"743,807.96"
10-Jul-2022,Reversal,00.00,"743,807.96",00.00
10-Jul-2022,Miscellaneous,"28,933.90",00.00,"28,933.90"
10-Jul-2022,Bill,00.00,"7,233.48","21,700.43"
10-Jul-2022,Commission,02.60,00.00,"21,703.03"
10-Jul-2022,Miscellaneous,"7,804.50",00.00,"29,507.53"
10-Jul-2022,Cash,463.04,00.00,"29,970.57"
10-Jul-2022,Bill,00.00,"9,990.19","19,980.38"
10-Jul-2022,ATM,00.00,"1,998.04","17,982.34"
10-Jul-2022,NEFT,"1,861.00",00.00,"19,843.34"
10-Jul-2022,Interest,"658,000.50",00.00,"677,843.84"
10-Jul-2022,ATM,"19,863.60",00.00,"697,707.44"
10-Jul-2022,ATM,00.00,"69,770.74","627,936.70"
10-Jul-2022,Bill,"11,816.59",00.00,"639,753.29"
10-Jul-2022,NEFT,01.00,00.00,"639,754.29"
10-Jul-2022,Cheque,"1,318.00",00.00,"641,072.29"
10-Jul-2022,NEFT,"32,484.80",00.00,"673,557.09"
10-Jul-2022,ATM,00.00,"134,711.42","538,845.67"
10-Jul-2022,Miscellaneous,00.00,"53,884.57","484,961.10"
10-Jul-2022,Cash,"1,952,206.00",00.00,"2,437,167.10"
10-Jul-2022,Commission,03.40,00.00,"2,437,170.50"
10-Jul-2022,Cash,00.00,"304,646.31","2,132,524.19"
10-Jul-2022,IMPS,00.00,"710,841.40","1,421,682.79"
10-Jul-2022,ATM,00.00,"1,421,682.79",00.00
10-Jul-2022,NEFT,"117,069.40",00.00,"117,069.40"
10-Jul-2022,ATM,"180,140.00",00.00,"297,209.40"
10-Jul-2022,Interest,"608,124.50",00.00,"905,333.90"
10-Jul-2022,Interest,"1,587,252.00",00.00,"2,492,585.90"
10-Jul-2022,Cheque,00.00,"311,573.24","2,181,012.66"
10-Jul-2022,Bill,"121,078.00",00.00,"2,302,090.66"
10-Jul-2022,NEFT,"2,443.00",00.00,"2,304,533.66"
10-Jul-2022,ATM,00.00,"576,133.42","1,728,400.24"
10-Jul-2022,Cash,455.00,00.00,"1,728,855.24"
10-Jul-2022,NEFT,56.00,00.00,"1,728,911.24"
10-Jul-2022,Purchase,00.00,"576,303.75","1,152,607.49"
10-Jul-2022,Miscellaneous,"23,620.00",00.00,"1,176,227.49"
10-Jul-2022,Tax,03.80,00.00,"1,176,231.29"
10-Jul-2022,Interest,05.70,00.00,"1,176,236.99"
11-Jul-2022,Cheque,00.00,"147,029.62","1,029,207.37"
11-Jul-2022,NEFT,"175,727.70",00.00,"1,204,935.07"
11-Jul-2022,Miscellaneous,00.00,"602,467.54","602,467.54"
12-Jul-2022,Cash,00.00,"301,233.77","301,233.77"
12-Jul-2022,Transfer,159.30,00.00,"301,393.07"
13-Jul-2022,Commission,"23,250.00",00.00,"324,643.07"
13-Jul-2022,Bill,05.50,00.00,"324,648.57"
13-Jul-2022,Bill,00.00,"108,216.19","216,432.38"
13-Jul-2022,Debit Card,00.00,"43,286.48","173,145.90"
13-Jul-2022,Transfer,00.00,"43,286.48","129,859.42"
13-Jul-2022,Bill,00.00,"64,929.71","64,929.71"
13-Jul-2022,Debit Card,47.79,00.00,"64,977.50"
13-Jul-2022,Cheque,07.00,00.00,"64,984.50"
13-Jul-2022,Tax,00.00,"7,220.50","57,764.00"
13-Jul-2022,Debit Card,00.00,"11,552.80","46,211.20"
13-Jul-2022,Debit Card,"32,539.06",00.00,"78,750.26"
13-Jul-2022,Transfer,"1,204,249.50",00.00,"1,282,999.76"
13-Jul-2022,IMPS,"1,300.00",00.00,"1,284,299.76"
13-Jul-2022,Debit Card,00.00,"321,074.94","963,224.82"
13-Jul-2022,Cheque,02.69,00.00,"963,227.51"
13-Jul-2022,Reversal,25.90,00.00,"963,253.41"
13-Jul-2022,Miscellaneous,"18,283.20",00.00,"981,536.61"
13-Jul-2022,Tax,580.20,00.00,"982,116.81"
13-Jul-2022,Bill,214.00,00.00,"982,330.81"
13-Jul-2022,Cash,28.59,00.00,"982,359.40"
13-Jul-2022,ATM,00.00,"196,471.88","785,887.52"
14-Jul-2022,Tax,08.89,00.00,"785,896.41"
14-Jul-2022,Transfer,00.00,"98,237.05","687,659.36"
14-Jul-2022,Reversal,"1,999.00",00.00,"689,658.36"
14-Jul-2022,NEFT,00.00,"137,931.67","551,726.69"
14-Jul-2022,Cheque,00.00,"551,726.69",00.00
14-Jul-2022,Purchase,"1,962.00",00.00,"1,962.00"
14-Jul-2022,Cash,00.00,327.00,"1,635.00"
14-Jul-2022,Transfer,03.54,00.00,"1,638.54"
14-Jul-2022,Bill,00.00,327.71,"1,310.83"
14-Jul-2022,Debit Card,00.00,131.08,"1,179.75"
14-Jul-2022,Tax,"60,256.06",00.00,"61,435.81"
14-Jul-2022,Tax,00.00,"15,358.95","46,076.86"
14-Jul-2022,ATM,"117,271.25",00.00,"163,348.11"
14-Jul-2022,Interest,00.00,"32,669.62","130,678.49"
14-Jul-2022,IMPS,"136,091.40",00.00,"266,769.89"
14-Jul-2022,NEFT,"21,102.93",00.00,"287,872.82"
14-Jul-2022,RTGS,732.00,00.00,"288,604.82"
14-Jul-2022,Reversal,"11,547.10",00.00,"300,151.92"
14-Jul-2022,NEFT,"32,281.00",00.00,"332,432.92"
14-Jul-2022,NEFT,00.00,"55,405.49","277,027.43"
14-Jul-2022,IMPS,"249,520.00",00.00,"526,547.43"
14-Jul-2022,Debit Card,05.80,00.00,"526,553.23"
14-Jul-2022,Tax,00.00,"105,310.65","421,242.58"
14-Jul-2022,Reversal,07.83,00.00,"421,250.41"
14-Jul-2022,NEFT,00.00,"52,656.30","368,594.11"
14-Jul-2022,Commission,00.00,"61,432.35","307,161.76"
14-Jul-2022,Commission,03.00,00.00,"307,164.76"
14-Jul-2022,Bill,20.29,00.00,"307,185.05"
14-Jul-2022,Miscellaneous,07.55,00.00,"307,192.60"
14-Jul-2022,Cheque,16.90,00.00,"307,209.50"
14-Jul-2022,ATM,00.00,"61,441.90","245,767.60"
14-Jul-2022,Reversal,00.00,"245,767.60",00.00
15-Jul-2022,Miscellaneous,"162,618.00",00.00,"162,618.00"
15-Jul-2022,Commission,02.00,00.00,"162,620.00"
15-Jul-2022,Interest,00.00,"54,206.67","108,413.33"
16-Jul-2022,IMPS,"80,457.30",00.00,"188,870.63"
16-Jul-2022,Commission,45.90,00.00,"188,916.53"
16-Jul-2022,Transfer,05.90,00.00,"188,922.43"
16-Jul-2022,Cheque,00.00,"94,461.22","94,461.22"
16-Jul-2022,Bill,00.00,"47,230.61","47,230.61"
16-Jul-2022,Reversal,"165,248.88",00.00,"212,479.49"
16-Jul-2022,Cheque,00.00,"30,354.21","182,125.28"
16-Jul-2022,Bill,"166,891.06",00.00,"349,016.34"
16-Jul-2022,Cash,"1,700.84",00.00,"350,717.18"
16-Jul-2022,Commission,00.00,"35,071.72","315,645.46"
16-Jul-2022,Tax,00.00,"45,092.21","270,553.25"
16-Jul-2022,Purchase,01.40,00.00,"270,554.65"
16-Jul-2022,Bill,00.00,"30,061.63","240,493.02"
16-Jul-2022,Interest,00.00,"26,721.45","213,771.57"
16-Jul-2022,Transfer,"1,860.00",00.00,"215,631.57"
16-Jul-2022,RTGS,00.00,"215,631.57",00.00
16-Jul-2022,Cheque,"1,633,174.20",00.00,"1,633,174.20"
17-Jul-2022,NEFT,17.10,00.00,"1,633,191.30"
17-Jul-2022,ATM,00.00,"233,313.04","1,399,878.26"
17-Jul-2022,Cheque,00.00,"233,313.04","1,166,565.22"
17-Jul-2022,Tax,"3,085.24",00.00,"1,169,650.46"
17-Jul-2022,Cash,227.20,00.00,"1,169,877.66"
17-Jul-2022,Debit Card,"32,518.61",00.00,"1,202,396.27"
17-Jul-2022,Cash,00.00,"120,239.63","1,082,156.64"
17-Jul-2022,Tax,00.00,"135,269.58","946,887.06"
17-Jul-2022,Bill,"3,619.00",00.00,"950,506.06"
17-Jul-2022,Interest,496.69,00.00,"951,002.75"
17-Jul-2022,RTGS,00.00,"190,200.55","760,802.20"
17-Jul-2022,Transfer,"4,056.06",00.00,"764,858.26"
17-Jul-2022,Reversal,00.00,"764,858.26",00.00
17-Jul-2022,RTGS,"640,236.80",00.00,"640,236.80"
17-Jul-2022,Commission,00.00,"213,412.27","426,824.53"
17-Jul-2022,Miscellaneous,00.00,"426,824.53",00.00
18-Jul-2022,Purchase,"32,555.81",00.00,"32,555.81"
18-Jul-2022,Reversal,"12,143.97",00.00,"44,699.78"
18-Jul-2022,Reversal,211.00,00.00,"44,910.78"
18-Jul-2022,Commission,06.30,00.00,"44,917.08"
18-Jul-2022,Bill,04.15,00.00,"44,921.23"
18-Jul-2022,Cheque,00.00,"44,921.23",00.00
18-Jul-2022,RTGS,00.00,00.00,00.00
18-Jul-2022,Reversal,04.00,00.00,04.00
18-Jul-2022,Debit Card,01.00,00.00,05.00
18-Jul-2022,IMPS,"1,216,134.00",00.00,"1,216,139.00"
18-Jul-2022,RTGS,"305,036.00",00.00,"1,521,175.00"
18-Jul-2022,Tax,"1,411,819.25",00.00,"2,932,994.25"
18-Jul-2022,Debit Card,"25,954.33",00.00,"2,958,948.58"
18-Jul-2022,IMPS,39.02,00.00,"2,958,987.60"
18-Jul-2022,ATM,342.69,00.00,"2,959,330.29"
18-Jul-2022,Tax,00.00,"986,443.43","1,972,886.86"
18-Jul-2022,Bill,00.00,"281,840.98","1,691,045.88"
18-Jul-2022,Cheque,"2,130.00",00.00,"1,693,175.88"
18-Jul-2022,Miscellaneous,00.00,"241,882.27","1,451,293.61"
18-Jul-2022,RTGS,00.00,"362,823.40","1,088,470.21"
18-Jul-2022,IMPS,"414,155.00",00.00,"1,502,625.21"
18-Jul-2022,Miscellaneous,"2,046.90",00.00,"1,504,672.11"
18-Jul-2022,NEFT,51.00,00.00,"1,504,723.11"
18-Jul-2022,Interest,00.00,"188,090.39","1,316,632.72"
18-Jul-2022,IMPS,00.00,"164,579.09","1,152,053.63"
18-Jul-2022,RTGS,34.00,00.00,"1,152,087.63"
18-Jul-2022,Reversal,01.00,00.00,"1,152,088.63"
18-Jul-2022,ATM,00.00,"115,208.86","1,036,879.77"
18-Jul-2022,IMPS,"582,017.00",00.00,"1,618,896.77"
18-Jul-2022,Interest,00.00,"269,816.13","1,349,080.64"
18-Jul-2022,Miscellaneous,00.00,"449,693.55","899,387.09"
18-Jul-2022,Commission,00.00,"179,877.42","719,509.67"
18-Jul-2022,Debit Card,03.80,00.00,"719,513.47"
18-Jul-2022,Miscellaneous,"174,803.00",00.00,"894,316.47"
18-Jul-2022,Purchase,"86,733.50",00.00,"981,049.97"
18-Jul-2022,IMPS,00.00,"140,150.00","840,899.97"
18-Jul-2022,RTGS,00.00,"93,433.33","747,466.64"
18-Jul-2022,Commission,00.00,"83,051.85","664,414.79"
18-Jul-2022,Cheque,400.00,00.00,"664,814.79"
18-Jul-2022,Commission,00.00,"132,962.96","531,851.83"
19-Jul-2022,Transfer,00.00,"132,962.96","398,888.87"
19-Jul-2022,NEFT,00.18,00.00,"398,889.05"
19-Jul-2022,Transfer,00.00,"199,444.53","199,444.52"
19-Jul-2022,NEFT,00.00,"19,944.45","179,500.07"
19-Jul-2022,IMPS,452.28,00.00,"179,952.35"
19-Jul-2022,Tax,00.00,"22,494.04","157,458.31"
19-Jul-2022,Cash,47.45,00.00,"157,505.76"
19-Jul-2022,Miscellaneous,"25,555.10",00.00,"183,060.86"
20-Jul-2022,Debit Card,"3,737.00",00.00,"186,797.86"
20-Jul-2022,RTGS,00.00,"186,797.86",00.00
20-Jul-2022,Transfer,"1,006,969.50",00.00,"1,006,969.50"
20-Jul-2022,Miscellaneous,00.00,"143,852.79","863,116.71"
21-Jul-2022,Commission,48.00,00.00,"863,164.71"
21-Jul-2022,Reversal,"3,248.92",00.00,"866,413.63"
21-Jul-2022,ATM,"201,766.60",00.00,"1,068,180.23"
21-Jul-2022,Tax,53.90,00.00,"1,068,234.13"
21-Jul-2022,Transfer,90.20,00.00,"1,068,324.33"
21-Jul-2022,Reversal,171.00,00.00,"1,068,495.33"
21-Jul-2022,ATM,00.00,"534,247.67","534,247.66"
21-Jul-2022,Cash,"3,020.00",00.00,"537,267.66"
21-Jul-2022,Miscellaneous,"1,999,193.00",00.00,"2,536,460.66"
21-Jul-2022,NEFT,00.00,"317,057.58","2,219,403.08"
21-Jul-2022,Reversal,00.00,00.00,"2,219,403.08"
21-Jul-2022,Tax,00.00,"739,801.03","1,479,602.05"
21-Jul-2022,IMPS,141.80,00.00,"1,479,743.85"
21-Jul-2022,Reversal,00.00,"369,935.96","1,109,807.89"
21-Jul-2022,Interest,00.00,"138,725.99","971,081.90"
21-Jul-2022,Miscellaneous,31.20,00.00,"971,113.10"
21-Jul-2022,ATM,00.00,"242,778.28","728,334.82"
21-Jul-2022,Cheque,00.00,"80,926.09","647,408.73"
21-Jul-2022,Cheque,00.00,"92,486.96","554,921.77"
21-Jul-2022,Miscellaneous,07.80,00.00,"554,929.57"
21-Jul-2022,Cheque,"1,326,106.00",00.00,"1,881,035.57"
21-Jul-2022,IMPS,00.00,"235,129.45","1,645,906.12"
21-Jul-2022,Reversal,00.00,"1,645,906.12",00.00
21-Jul-2022,ATM,26.00,00.00,26.00
21-Jul-2022,Debit Card,07.00,00.00,33.00
21-Jul-2022,Tax,00.00,11.00,22.00
21-Jul-2022,Tax,494.98,00.00,516.98
21-Jul-2022,Bill,04.00,00.00,520.98
21-Jul-2022,Bill,00.00,52.10,468.88
21-Jul-2022,ATM,43.00,00.00,511.88
21-Jul-2022,Cheque,00.00,56.88,455.00
21-Jul-2022,Miscellaneous,00.00,151.67,303.33
21-Jul-2022,Purchase,00.00,33.70,269.63
21-Jul-2022,Tax,40.00,00.00,309.63
21-Jul-2022,Miscellaneous,00.00,51.61,258.02
21-Jul-2022,Debit Card,"1,957,828.25",00.00,"1,958,086.27"
21-Jul-2022,ATM,00.00,"1,958,086.27",00.00
22-Jul-2022,Commission,331.39,00.00,331.39
22-Jul-2022,NEFT,"978,408.00",00.00,"978,739.39"
22-Jul-2022,ATM,00.00,"978,739.39",00.00
22-Jul-2022,Bill,"225,574.12",00.00,"225,574.12"
22-Jul-2022,Miscellaneous,00.00,"28,196.77","197,377.36"
22-Jul-2022,NEFT,"778,722.00",00.00,"976,099.36"
22-Jul-2022,NEFT,00.00,"325,366.45","650,732.91"
22-Jul-2022,Interest,00.00,"325,366.46","325,366.46"
22-Jul-2022,Purchase,440.00,00.00,"325,806.46"
22-Jul-2022,IMPS,00.00,"65,161.29","260,645.17"
22-Jul-2022,Cash,00.00,"260,645.17",00.00
22-Jul-2022,Bill,05.57,00.00,05.57
22-Jul-2022,Tax,370.00,00.00,375.57
22-Jul-2022,NEFT,"13,826.90",00.00,"14,202.47"
22-Jul-2022,Miscellaneous,00.00,"1,578.05","12,624.42"
22-Jul-2022,ATM,00.00,"1,578.05","11,046.37"
22-Jul-2022,NEFT,"110,265.70",00.00,"121,312.07"
22-Jul-2022,Interest,208.00,00.00,"121,520.07"
22-Jul-2022,Debit Card,06.34,00.00,"121,526.41"
22-Jul-2022,NEFT,"1,578.10",00.00,"123,104.51"
22-Jul-2022,Debit Card,00.00,"13,678.28","109,426.23"
22-Jul-2022,Reversal,391.03,00.00,"109,817.26"
23-Jul-2022,Cash,441.87,00.00,"110,259.13"
23-Jul-2022,Interest,"94,045.00",00.00,"204,304.13"
23-Jul-2022,Transfer,00.00,"68,101.38","136,202.75"
23-Jul-2022,Reversal,00.00,"27,240.55","108,962.20"
23-Jul-2022,Cheque,00.00,"10,896.22","98,065.98"
23-Jul-2022,NEFT,"465,747.00",00.00,"563,812.98"
23-Jul-2022,Debit Card,"24,200.00",00.00,"588,012.98"
23-Jul-2022,IMPS,00.00,"58,801.30","529,211.68"
23-Jul-2022,Miscellaneous,47.00,00.00,"529,258.68"
23-Jul-2022,Reversal,00.00,00.00,"529,258.68"
23-Jul-2022,Miscellaneous,"165,867.00",00.00,"695,125.68"
23-Jul-2022,Tax,00.00,"99,303.67","595,822.01"
23-Jul-2022,RTGS,00.00,"85,117.43","510,704.58"
23-Jul-2022,Miscellaneous,383.56,00.00,"511,088.14"
23-Jul-2022,Cash,00.00,"255,544.07","255,544.07"
23-Jul-2022,Miscellaneous,00.00,"25,554.41","229,989.66"
23-Jul-2022,Cash,00.00,"229,989.66",00.00
23-Jul-2022,NEFT,"3,527.16",00.00,"3,527.16"
23-Jul-2022,Tax,"3,819.90",00.00,"7,347.06"
23-Jul-2022,Cheque,42.44,00.00,"7,389.50"
23-Jul-2022,Purchase,00.00,"3,694.75","3,694.75"
24-Jul-2022,Cash,00.00,461.84,"3,232.91"
24-Jul-2022,ATM,00.00,"1,077.64","2,155.27"
24-Jul-2022,Cash,"331,024.50",00.00,"333,179.77"
24-Jul-2022,Interest,387.67,00.00,"333,567.44"
24-Jul-2022,Transfer,"631,242.00",00.00,"964,809.44"
24-Jul-2022,Reversal,"1,839,845.75",00.00,"2,804,655.19"
24-Jul-2022,Cash,"236,780.00",00.00,"3,041,435.19"
24-Jul-2022,Commission,"27,941.18",00.00,"3,069,376.37"
24-Jul-2022,RTGS,"1,212.00",00.00,"3,070,588.37"
24-Jul-2022,Reversal,00.00,"767,647.09","2,302,941.28"
24-Jul-2022,Interest,00.00,"255,882.36","2,047,058.92"
24-Jul-2022,Transfer,"30,650.00",00.00,"2,077,708.92"
24-Jul-2022,NEFT,00.00,"2,077,708.92",00.00
24-Jul-2022,Bill,"13,633.68",00.00,"13,633.68"
24-Jul-2022,ATM,"1,008.00",00.00,"14,641.68"
24-Jul-2022,NEFT,303.00,00.00,"14,944.68"
24-Jul-2022,Reversal,"170,789.40",00.00,"185,734.08"
24-Jul-2022,Transfer,56.99,00.00,"185,791.07"
24-Jul-2022,Transfer,00.00,"23,223.88","162,567.19"
24-Jul-2022,Commission,00.00,"16,256.72","146,310.47"
24-Jul-2022,Bill,"3,678.11",00.00,"149,988.58"
24-Jul-2022,Cheque,00.00,"18,748.57","131,240.01"
24-Jul-2022,NEFT,00.00,"21,873.34","109,366.68"
24-Jul-2022,Reversal,00.00,"27,341.67","82,025.01"
24-Jul-2022,Interest,189.00,00.00,"82,214.01"
24-Jul-2022,Purchase,00.00,"9,134.89","73,079.12"
24-Jul-2022,Bill,00.00,"10,439.87","62,639.25"
24-Jul-2022,Commission,04.50,00.00,"62,643.75"
24-Jul-2022,Bill,01.00,00.00,"62,644.75"
24-Jul-2022,Miscellaneous,00.00,"15,661.19","46,983.56"
24-Jul-2022,Bill,00.00,"15,661.19","31,322.37"
24-Jul-2022,Miscellaneous,00.00,"6,264.47","25,057.90"
24-Jul-2022,Cash,992.00,00.00,"26,049.90"
24-Jul-2022,Purchase,00.00,"8,683.30","17,366.60"
24-Jul-2022,NEFT,39.00,00.00,"17,405.60"
24-Jul-2022,Reversal,00.00,"2,900.93","14,504.67"
24-Jul-2022,IMPS,00.00,"7,252.34","7,252.34"
24-Jul-2022,Commission,54.00,00.00,"7,306.34"
24-Jul-2022,Bill,00.00,811.82,"6,494.52"
24-Jul-2022,Cheque,"88,988.00",00.00,"95,482.52"
24-Jul-2022,Purchase,00.00,"23,870.63","71,611.89"
24-Jul-2022,RTGS,"1,450.70",00.00,"73,062.59"
24-Jul-2022,Miscellaneous,00.00,"73,062.59",00.00
24-Jul-2022,IMPS,"59,174.00",00.00,"59,174.00"
24-Jul-2022,Cheque,00.00,"8,453.43","50,720.57"
24-Jul-2022,Interest,00.00,"16,906.86","33,813.71"
24-Jul-2022,Interest,"711,386.00",00.00,"745,199.71"
24-Jul-2022,Debit Card,411.25,00.00,"745,610.96"
24-Jul-2022,Miscellaneous,00.00,"82,845.66","662,765.30"
24-Jul-2022,Transfer,00.00,"73,640.59","589,124.71"
24-Jul-2022,Interest,00.00,"98,187.45","490,937.26"
24-Jul-2022,Purchase,"119,282.00",00.00,"610,219.26"
24-Jul-2022,ATM,00.00,"122,043.85","488,175.41"
24-Jul-2022,Transfer,380.60,00.00,"488,556.01"
24-Jul-2022,Interest,00.00,"54,284.00","434,272.01"
24-Jul-2022,Debit Card,00.00,"48,252.45","386,019.56"
24-Jul-2022,Interest,"1,928.00",00.00,"387,947.56"
24-Jul-2022,Miscellaneous,236.00,00.00,"388,183.56"
24-Jul-2022,Cheque,00.00,"388,183.56",00.00
24-Jul-2022,ATM,28.30,00.00,28.30
24-Jul-2022,Purchase,382.00,00.00,410.30
24-Jul-2022,Cheque,00.00,51.29,359.01
24-Jul-2022,Commission,"44,933.50",00.00,"45,292.51"
24-Jul-2022,RTGS,"24,519.30",00.00,"69,811.81"
24-Jul-2022,NEFT,00.00,"7,756.87","62,054.94"
24-Jul-2022,Cash,"85,608.34",00.00,"147,663.28"
24-Jul-2022,Bill,269.86,00.00,"147,933.14"
24-Jul-2022,NEFT,"229,371.03",00.00,"377,304.17"
24-Jul-2022,Miscellaneous,10.50,00.00,"377,314.67"
24-Jul-2022,Commission,00.00,"377,314.67",00.00
24-Jul-2022,Cheque,"119,027.40",00.00,"119,027.40"
25-Jul-2022,Tax,00.00,"119,027.40",00.00
25-Jul-2022,Debit Card,12.00,00.00,12.00
26-Jul-2022,Reversal,00.00,01.50,10.50
26-Jul-2022,IMPS,00.00,02.10,08.40
26-Jul-2022,Transfer,"1,869,758.25",00.00,"1,869,766.65"
26-Jul-2022,Interest,00.00,"186,976.67","1,682,789.98"
26-Jul-2022,Debit Card,265.00,00.00,"1,683,054.98"
26-Jul-2022,ATM,703.00,00.00,"1,683,757.98"
26-Jul-2022,RTGS,00.00,"420,939.50","1,262,818.48"
27-Jul-2022,NEFT,00.00,"180,402.64","1,082,415.84"
27-Jul-2022,Reversal,00.00,"270,603.96","811,811.88"
27-Jul-2022,NEFT,"70,750.00",00.00,"882,561.88"
28-Jul-2022,Interest,00.00,"98,062.43","784,499.45"
28-Jul-2022,RTGS,"10,408.00",00.00,"794,907.45"
28-Jul-2022,IMPS,"772,769.80",00.00,"1,567,677.25"
28-Jul-2022,Miscellaneous,00.00,"313,535.45","1,254,141.80"
28-Jul-2022,Debit Card,00.00,"139,349.09","1,114,792.71"
28-Jul-2022,Tax,"3,292.00",00.00,"1,118,084.71"
29-Jul-2022,Cash,"212,722.59",00.00,"1,330,807.30"
29-Jul-2022,Transfer,63.21,00.00,"1,330,870.51"
29-Jul-2022,IMPS,00.00,"266,174.10","1,064,696.41"
29-Jul-2022,Tax,218.30,00.00,"1,064,914.71"
29-Jul-2022,Miscellaneous,00.00,"1,064,914.71",00.00
29-Jul-2022,IMPS,"2,595.43",00.00,"2,595.43"
29-Jul-2022,Reversal,"1,649,517.20",00.00,"1,652,112.63"
29-Jul-2022,Commission,29.71,00.00,"1,652,142.34"
29-Jul-2022,Purchase,00.00,"413,035.59","1,239,106.76"
29-Jul-2022,Debit Card,05.00,00.00,"1,239,111.76"
29-Jul-2022,Bill,"2,287.22",00.00,"1,241,398.98"
29-Jul-2022,Purchase,"170,186.20",00.00,"1,411,585.18"
29-Jul-2022,Interest,00.00,"470,528.39","941,056.79"
29-Jul-2022,Tax,00.00,"156,842.80","784,213.99"
29-Jul-2022,ATM,00.00,"130,702.33","653,511.66"
29-Jul-2022,Debit Card,00.00,"93,358.81","560,152.85"
29-Jul-2022,Tax,01.94,00.00,"560,154.79"
29-Jul-2022,Purchase,00.00,"80,022.11","480,132.68"
29-Jul-2022,Commission,"1,128.20",00.00,"481,260.88"
29-Jul-2022,Debit Card,00.00,"68,751.55","412,509.33"
29-Jul-2022,Bill,00.00,"41,250.93","371,258.40"
29-Jul-2022,RTGS,00.00,"123,752.80","247,505.60"
29-Jul-2022,Cheque,00.00,"247,505.60",00.00
29-Jul-2022,Tax,05.63,00.00,05.63
29-Jul-2022,Cash,"16,460.80",00.00,"16,466.43"
29-Jul-2022,RTGS,00.00,"2,744.41","13,722.02"
29-Jul-2022,IMPS,00.07,00.00,"13,722.09"
29-Jul-2022,Cheque,00.00,"3,430.52","10,291.57"
29-Jul-2022,Transfer,00.00,"2,572.89","7,718.68"
29-Jul-2022,Purchase,00.00,857.63,"6,861.05"
29-Jul-2022,Purchase,02.00,00.00,"6,863.05"
29-Jul-2022,Cash,00.00,"3,431.53","3,431.52"
29-Jul-2022,Interest,"20,823.00",00.00,"24,254.52"
29-Jul-2022,NEFT,00.00,"8,084.84","16,169.68"
29-Jul-2022,Miscellaneous,00.00,"4,042.42","12,127.26"
29-Jul-2022,Miscellaneous,"244,278.50",00.00,"256,405.76"
29-Jul-2022,NEFT,"1,881,151.75",00.00,"2,137,557.51"
29-Jul-2022,Miscellaneous,06.94,00.00,"2,137,564.45"
29-Jul-2022,Commission,00.00,"534,391.11","1,603,173.34"
30-Jul-2022,Interest,00.00,"200,396.67","1,402,776.67"
30-Jul-2022,Tax,00.00,00.00,"1,402,776.67"
30-Jul-2022,Bill,06.00,00.00,"1,402,782.67"
30-Jul-2022,Bill,"1,330.52",00.00,"1,404,113.19"
30-Jul-2022,Reversal,"1,658,154.00",00.00,"3,062,267.19"
30-Jul-2022,ATM,00.00,"1,020,755.73","2,041,511.46"
30-Jul-2022,Transfer,"70,219.50",00.00,"2,111,730.96"
30-Jul-2022,Bill,"225,525.41",00.00,"2,337,256.37"
30-Jul-2022,NEFT,00.00,"389,542.73","1,947,713.64"
30-Jul-2022,Tax,00.00,"324,618.94","1,623,094.70"
30-Jul-2022,Cash,00.00,"270,515.78","1,352,578.92"
30-Jul-2022,RTGS,60.00,00.00,"1,352,638.92"
30-Jul-2022,Transfer,38.60,00.00,"1,352,677.52"
30-Jul-2022,Miscellaneous,00.00,"338,169.38","1,014,508.14"
30-Jul-2022,ATM,167.81,00.00,"1,014,675.95"
30-Jul-2022,Tax,00.00,"144,953.71","869,722.24"
30-Jul-2022,Commission,"3,312.27",00.00,"873,034.51"
30-Jul-2022,Cash,54.99,00.00,"873,089.50"
30-Jul-2022,Miscellaneous,80.00,00.00,"873,169.50"
30-Jul-2022,Miscellaneous,00.00,"145,528.25","727,641.25"
30-Jul-2022,Commission,"9,438.34",00.00,"737,079.59"
30-Jul-2022,Bill,00.00,"122,846.60","614,232.99"
30-Jul-2022,IMPS,"2,057,719.50",00.00,"2,671,952.49"
30-Jul-2022,Cheque,00.00,"381,707.50","2,290,244.99"
30-Jul-2022,Purchase,84.00,00.00,"2,290,328.99"
30-Jul-2022,Bill,"179,064.59",00.00,"2,469,393.58"
30-Jul-2022,RTGS,"122,110.30",00.00,"2,591,503.88"
30-Jul-2022,Reversal,"3,964.10",00.00,"2,595,467.98"
30-Jul-2022,Transfer,00.80,00.00,"2,595,468.78"
30-Jul-2022,Interest,"14,826.97",00.00,"2,610,295.75"
31-Jul-2022,RTGS,00.00,"522,059.15","2,088,236.60"
31-Jul-2022,Debit Card,00.00,"2,088,236.60",00.00
31-Jul-2022,Commission,"1,483.00",00.00,"1,483.00"
31-Jul-2022,Bill,00.00,741.50,741.50
31-Jul-2022,Interest,294.20,00.00,"1,035.70"
31-Jul-2022,Cheque,00.00,103.57,932.13
31-Jul-2022,Tax,"51,072.25",00.00,"52,004.38"
31-Jul-2022,Debit Card,00.00,"6,500.55","45,503.83"
31-Jul-2022,Reversal,00.00,"7,583.97","37,919.86"
31-Jul-2022,RTGS,00.00,"6,319.98","31,599.88"
31-Jul-2022,Debit Card,28.50,00.00,"31,628.38"
31-Jul-2022,Tax,00.00,"5,271.40","26,356.98"
01-Aug-2022,Interest,00.00,"2,928.55","23,428.43"
01-Aug-2022,Interest,04.80,00.00,"23,433.23"
01-Aug-2022,Transfer,04.02,00.00,"23,437.25"
01-Aug-2022,Interest,00.00,"4,687.45","18,749.80"
01-Aug-2022,Debit Card,00.00,"9,374.90","9,374.90"
01-Aug-2022,Miscellaneous,00.00,"1,171.86","8,203.04"
01-Aug-2022,Purchase,"23,193.50",00.00,"31,396.54"
01-Aug-2022,RTGS,"14,474.40",00.00,"45,870.94"
01-Aug-2022,RTGS,00.00,"5,096.77","40,774.17"
01-Aug-2022,Cash,00.00,"10,193.54","30,580.63"
01-Aug-2022,Cash,00.00,"3,397.85","27,182.78"
01-Aug-2022,Miscellaneous,00.00,"4,530.46","22,652.32"
01-Aug-2022,Transfer,00.00,"3,775.39","18,876.93"
01-Aug-2022,Purchase,407.30,00.00,"19,284.23"
01-Aug-2022,Miscellaneous,"181,251.10",00.00,"200,535.33"
01-Aug-2022,Reversal,"1,477,084.80",00.00,"1,677,620.13"
01-Aug-2022,RTGS,00.00,"335,524.03","1,342,096.10"
01-Aug-2022,Interest,"244,890.00",00.00,"1,586,986.10"
01-Aug-2022,Tax,"13,709.60",00.00,"1,600,695.70"
01-Aug-2022,Debit Card,"1,161.22",00.00,"1,601,856.92"
01-Aug-2022,Purchase,00.00,"533,952.31","1,067,904.61"
01-Aug-2022,Purchase,00.00,"118,656.07","949,248.54"
01-Aug-2022,Commission,01.52,00.00,"949,250.06"
01-Aug-2022,Transfer,03.00,00.00,"949,253.06"
01-Aug-2022,Cash,00.00,"105,472.56","843,780.50"
01-Aug-2022,Tax,54.64,00.00,"843,835.14"
01-Aug-2022,Interest,"1,282,778.00",00.00,"2,126,613.14"
01-Aug-2022,Cheque,241.00,00.00,"2,126,854.14"
01-Aug-2022,Cheque,54.00,00.00,"2,126,908.14"
01-Aug-2022,Tax,00.00,"425,381.63","1,701,526.51"
01-Aug-2022,Tax,16.00,00.00,"1,701,542.51"
01-Aug-2022,IMPS,"213,501.00",00.00,"1,915,043.51"
01-Aug-2022,Debit Card,"1,185.20",00.00,"1,916,228.71"
01-Aug-2022,Cash,205.00,00.00,"1,916,433.71"
01-Aug-2022,Miscellaneous,00.00,"958,216.86","958,216.86"
01-Aug-2022,Reversal,"66,299.80",00.00,"1,024,516.66"
01-Aug-2022,Cheque,03.78,00.00,"1,024,520.44"
01-Aug-2022,Tax,164.00,00.00,"1,024,684.44"
01-Aug-2022,RTGS,00.00,"512,342.22","512,342.22"
01-Aug-2022,Cash,00.00,"85,390.37","426,951.85"
01-Aug-2022,Reversal,00.00,"85,390.37","341,561.48"
01-Aug-2022,RTGS,00.00,"170,780.74","170,780.74"
01-Aug-2022,Bill,414.00,00.00,"171,194.74"
02-Aug-2022,Interest,00.00,"85,597.37","85,597.37"
03-Aug-2022,IMPS,"77,589.00",00.00,"163,186.37"
03-Aug-2022,Bill,00.00,"27,197.73","135,988.64"
03-Aug-2022,NEFT,03.60,00.00,"135,992.24"
03-Aug-2022,ATM,"117,758.59",00.00,"253,750.83"
03-Aug-2022,Transfer,00.00,"253,750.83",00.00
03-Aug-2022,Cash,188.70,00.00,188.70
03-Aug-2022,Bill,00.00,20.97,167.73
03-Aug-2022,ATM,03.00,00.00,170.73
03-Aug-2022,Transfer,411.27,00.00,582.00
03-Aug-2022,Reversal,"1,360.90",00.00,"1,942.90"
03-Aug-2022,Cash,07.00,00.00,"1,949.90"
03-Aug-2022,Interest,35.50,00.00,"1,985.40"
03-Aug-2022,ATM,"738,168.50",00.00,"740,153.90"
03-Aug-2022,NEFT,"163,098.00",00.00,"903,251.90"
03-Aug-2022,Commission,00.00,"112,906.49","790,345.41"
03-Aug-2022,Miscellaneous,107.91,00.00,"790,453.32"
03-Aug-2022,NEFT,00.00,"98,806.67","691,646.65"
03-Aug-2022,Miscellaneous,"7,273.80",00.00,"698,920.45"
03-Aug-2022,Purchase,42.00,00.00,"698,962.45"
03-Aug-2022,RTGS,00.00,"232,987.48","465,974.97"
03-Aug-2022,Cash,"1,351,886.00",00.00,"1,817,860.97"
03-Aug-2022,NEFT,65.00,00.00,"1,817,925.97"
03-Aug-2022,Purchase,00.00,"908,962.99","908,962.98"
03-Aug-2022,Cheque,00.00,"113,620.37","795,342.61"
03-Aug-2022,Interest,00.00,"795,342.61",00.00
03-Aug-2022,Tax,"2,026,905.00",00.00,"2,026,905.00"
03-Aug-2022,RTGS,00.00,"225,211.67","1,801,693.33"
03-Aug-2022,Cheque,00.00,"180,169.33","1,621,524.00"
03-Aug-2022,Commission,00.00,"270,254.00","1,351,270.00"
03-Aug-2022,Commission,"160,996.00",00.00,"1,512,266.00"
03-Aug-2022,ATM,00.00,"151,226.60","1,361,039.40"
03-Aug-2022,Commission,00.00,"680,519.70","680,519.70"
04-Aug-2022,Debit Card,00.00,"68,051.97","612,467.73"
04-Aug-2022,Debit Card,295.70,00.00,"612,763.43"
04-Aug-2022,IMPS,"399,305.00",00.00,"1,012,068.43"
04-Aug-2022,IMPS,42.70,00.00,"1,012,111.13"
04-Aug-2022,Interest,00.00,"112,456.79","899,654.34"
04-Aug-2022,Purchase,00.00,"899,654.34",00.00
04-Aug-2022,Bill,13.20,00.00,13.20
04-Aug-2022,Tax,07.50,00.00,20.70
04-Aug-2022,Purchase,00.00,00.00,20.70
04-Aug-2022,Interest,00.00,05.18,15.52
04-Aug-2022,RTGS,22.00,00.00,37.52
04-Aug-2022,RTGS,00.00,09.38,28.14
05-Aug-2022,Miscellaneous,"1,707,984.50",00.00,"1,708,012.64"
05-Aug-2022,Purchase,903.70,00.00,"1,708,916.34"
05-Aug-2022,Tax,247.53,00.00,"1,709,163.87"
05-Aug-2022,Cash,00.00,"213,645.48","1,495,518.39"
05-Aug-2022,NEFT,00.00,"149,551.84","1,345,966.55"
05-Aug-2022,Miscellaneous,00.00,"192,280.94","1,153,685.61"
05-Aug-2022,RTGS,00.00,"230,737.12","922,948.49"
05-Aug-2022,Reversal,"14,384.40",00.00,"937,332.89"
05-Aug-2022,IMPS,05.23,00.00,"937,338.12"
05-Aug-2022,Miscellaneous,"66,153.78",00.00,"1,003,491.90"
05-Aug-2022,Bill,00.00,"200,698.38","802,793.52"
05-Aug-2022,Cheque,00.00,"160,558.70","642,234.82"
05-Aug-2022,Reversal,00.00,"91,747.83","550,486.99"
05-Aug-2022,Bill,00.00,"110,097.40","440,389.59"
05-Aug-2022,NEFT,"1,402,859.00",00.00,"1,843,248.59"
05-Aug-2022,Cheque,00.00,"368,649.72","1,474,598.87"
05-Aug-2022,Cheque,01.10,00.00,"1,474,599.97"
05-Aug-2022,ATM,"17,542.82",00.00,"1,492,142.79"
05-Aug-2022,Miscellaneous,"1,848,054.00",00.00,"3,340,196.79"
05-Aug-2022,Reversal,00.00,"835,049.20","2,505,147.59"
05-Aug-2022,Cheque,"1,429.67",00.00,"2,506,577.26"
05-Aug-2022,Commission,"2,749.40",00.00,"2,509,326.66"
05-Aug-2022,Reversal,339.00,00.00,"2,509,665.66"
05-Aug-2022,Cheque,00.00,"1,254,832.83","1,254,832.83"
05-Aug-2022,Purchase,"199,722.00",00.00,"1,454,554.83"
05-Aug-2022,Transfer,"1,481,370.25",00.00,"2,935,925.08"
05-Aug-2022,Cash,00.00,"2,935,925.08",00.00
05-Aug-2022,IMPS,56.00,00.00,56.00
05-Aug-2022,Transfer,00.00,08.00,48.00
05-Aug-2022,Miscellaneous,"1,133,821.00",00.00,"1,133,869.00"
05-Aug-2022,Tax,11.90,00.00,"1,133,880.90"
05-Aug-2022,Transfer,"20,463.70",00.00,"1,154,344.60"
05-Aug-2022,Cash,"2,081,832.50",00.00,"3,236,177.10"
05-Aug-2022,NEFT,41.70,00.00,"3,236,218.80"
05-Aug-2022,Miscellaneous,"919,394.00",00.00,"4,155,612.80"
05-Aug-2022,NEFT,00.00,"519,451.60","3,636,161.20"
05-Aug-2022,Reversal,76.60,00.00,"3,636,237.80"
05-Aug-2022,RTGS,00.00,"606,039.63","3,030,198.17"
05-Aug-2022,NEFT,144.16,00.00,"3,030,342.33"
05-Aug-2022,Debit Card,140.39,00.00,"3,030,482.72"
05-Aug-2022,Tax,"17,072.00",00.00,"3,047,554.72"
05-Aug-2022,NEFT,04.10,00.00,"3,047,558.82"
05-Aug-2022,Commission,39.00,00.00,"3,047,597.82"
05-Aug-2022,Bill,00.00,"338,621.98","2,708,975.84"
05-Aug-2022,NEFT,"1,922,457.50",00.00,"4,631,433.34"
05-Aug-2022,NEFT,"157,721.20",00.00,"4,789,154.54"
05-Aug-2022,Purchase,00.00,"1,596,384.85","3,192,769.69"
06-Aug-2022,NEFT,"2,593.50",00.00,"3,195,363.19"
06-Aug-2022,Cash,"1,226,068.50",00.00,"4,421,431.69"
06-Aug-2022,Cash,00.00,"631,633.10","3,789,798.59"
06-Aug-2022,Purchase,00.00,"757,959.72","3,031,838.87"
06-Aug-2022,Tax,"799,305.75",00.00,"3,831,144.62"
06-Aug-2022,Miscellaneous,00.00,"1,915,572.31","1,915,572.31"
06-Aug-2022,Cash,"1,188,463.00",00.00,"3,104,035.31"
06-Aug-2022,Bill,"161,263.00",00.00,"3,265,298.31"
06-Aug-2022,Debit Card,"2,153.12",00.00,"3,267,451.43"
06-Aug-2022,Cheque,"852,906.00",00.00,"4,120,357.43"
06-Aug-2022,Cash,00.00,"515,044.68","3,605,312.75"
06-Aug-2022,Interest,18.80,00.00,"3,605,331.55"
06-Aug-2022,Miscellaneous,"3,543.00",00.00,"3,608,874.55"
06-Aug-2022,Transfer,00.00,"902,218.64","2,706,655.91"
06-Aug-2022,NEFT,00.00,"338,331.99","2,368,323.92"
06-Aug-2022,Interest,"49,397.88",00.00,"2,417,721.80"
06-Aug-2022,Transfer,13.30,00.00,"2,417,735.10"
06-Aug-2022,IMPS,"166,928.10",00.00,"2,584,663.20"
06-Aug-2022,ATM,"174,739.00",00.00,"2,759,402.20"
06-Aug-2022,Purchase,"851,514.00",00.00,"3,610,916.20"
06-Aug-2022,ATM,00.00,"361,091.62","3,249,824.58"
06-Aug-2022,Interest,00.00,"1,083,274.86","2,166,549.72"
06-Aug-2022,NEFT,00.00,"309,507.10","1,857,042.62"
06-Aug-2022,Tax,00.10,00.00,"1,857,042.72"
06-Aug-2022,Debit Card,00.00,"371,408.54","1,485,634.18"
06-Aug-2022,Debit Card,00.00,"212,233.45","1,273,400.73"
06-Aug-2022,Transfer,04.00,00.00,"1,273,404.73"
06-Aug-2022,Transfer,00.00,"212,234.12","1,061,170.61"
06-Aug-2022,RTGS,05.00,00.00,"1,061,175.61"
06-Aug-2022,Bill,"23,779.80",00.00,"1,084,955.41"
06-Aug-2022,Cash,00.00,"1,084,955.41",00.00
06-Aug-2022,Debit Card,"1,486.00",00.00,"1,486.00"
06-Aug-2022,IMPS,"12,988.00",00.00,"14,474.00"
06-Aug-2022,Bill,00.00,"1,447.40","13,026.60"
06-Aug-2022,ATM,00.00,"1,628.33","11,398.28"
06-Aug-2022,Interest,258.04,00.00,"11,656.32"
06-Aug-2022,Transfer,00.00,"11,656.32",00.00
06-Aug-2022,RTGS,"36,801.00",00.00,"36,801.00"
06-Aug-2022,Tax,00.00,"36,801.00",00.00
06-Aug-2022,NEFT,51.20,00.00,51.20
06-Aug-2022,IMPS,00.00,07.31,43.89
06-Aug-2022,Debit Card,37.11,00.00,81.00
06-Aug-2022,Bill,00.00,08.10,72.90
06-Aug-2022,Cash,00.00,12.15,60.75
06-Aug-2022,NEFT,00.00,08.68,52.07
06-Aug-2022,Cash,00.00,05.21,46.86
06-Aug-2022,Cash,"2,892.00",00.00,"2,938.86"
06-Aug-2022,Purchase,"28,977.00",00.00,"31,915.86"
06-Aug-2022,NEFT,00.00,"7,978.97","23,936.90"
07-Aug-2022,RTGS,254.00,00.00,"24,190.90"
07-Aug-2022,Cheque,"29,488.20",00.00,"53,679.10"
08-Aug-2022,Cheque,"285,970.00",00.00,"339,649.10"
08-Aug-2022,Transfer,00.00,"113,216.37","226,432.73"
08-Aug-2022,Bill,07.00,00.00,"226,439.73"
08-Aug-2022,ATM,"1,423,571.00",00.00,"1,650,010.73"
08-Aug-2022,IMPS,00.00,"412,502.68","1,237,508.05"
08-Aug-2022,Tax,06.00,00.00,"1,237,514.05"
08-Aug-2022,RTGS,"207,406.50",00.00,"1,444,920.55"
08-Aug-2022,Commission,00.00,"1,444,920.55",00.00
08-Aug-2022,Reversal,"1,791,240.00",00.00,"1,791,240.00"
08-Aug-2022,IMPS,"164,302.00",00.00,"1,955,542.00"
08-Aug-2022,Tax,00.00,"244,442.75","1,711,099.25"
08-Aug-2022,Commission,"2,841.99",00.00,"1,713,941.24"
08-Aug-2022,Interest,00.00,"214,242.66","1,499,698.58"
08-Aug-2022,Transfer,00.00,"299,939.72","1,199,758.86"
08-Aug-2022,IMPS,508.00,00.00,"1,200,266.86"
08-Aug-2022,IMPS,00.00,"200,044.48","1,000,222.38"
08-Aug-2022,IMPS,00.00,"142,888.91","857,333.47"
08-Aug-2022,RTGS,05.70,00.00,"857,339.17"
08-Aug-2022,Cash,04.03,00.00,"857,343.20"
08-Aug-2022,IMPS,49.00,00.00,"857,392.20"
09-Aug-2022,Interest,00.00,"85,739.22","771,652.98"
09-Aug-2022,NEFT,00.00,"257,217.66","514,435.32"
09-Aug-2022,RTGS,00.00,"514,435.32",00.00
09-Aug-2022,NEFT,00.31,00.00,00.31
09-Aug-2022,Debit Card,"1,431,668.00",00.00,"1,431,668.31"
09-Aug-2022,Miscellaneous,"15,776.00",00.00,"1,447,444.31"
09-Aug-2022,Reversal,"286,966.00",00.00,"1,734,410.31"
09-Aug-2022,ATM,75.61,00.00,"1,734,485.92"
09-Aug-2022,Tax,00.00,"216,810.74","1,517,675.18"
09-Aug-2022,Bill,00.00,"379,418.80","1,138,256.38"
10-Aug-2022,Purchase,00.00,"284,564.10","853,692.28"
10-Aug-2022,Bill,00.00,"170,738.46","682,953.82"
10-Aug-2022,Cash,"795,626.00",00.00,"1,478,579.82"
10-Aug-2022,RTGS,"7,808.10",00.00,"1,486,387.92"
10-Aug-2022,NEFT,00.00,"185,798.49","1,300,589.43"
10-Aug-2022,Commission,00.00,"325,147.36","975,442.07"
10-Aug-2022,ATM,00.00,"975,442.07",00.00
10-Aug-2022,IMPS,"28,561.90",00.00,"28,561.90"
10-Aug-2022,RTGS,"7,234.10",00.00,"35,796.00"
10-Aug-2022,Purchase,00.00,"3,579.60","32,216.40"
10-Aug-2022,Debit Card,"106,172.00",00.00,"138,388.40"
10-Aug-2022,Cheque,"150,193.00",00.00,"288,581.40"
10-Aug-2022,NEFT,427.50,00.00,"289,008.90"
10-Aug-2022,Debit Card,00.00,"144,504.45","144,504.45"
11-Aug-2022,Debit Card,01.90,00.00,"144,506.35"
11-Aug-2022,Debit Card,00.00,"24,084.39","120,421.96"
11-Aug-2022,Cash,"1,359.20",00.00,"121,781.16"
11-Aug-2022,RTGS,00.00,"13,531.24","108,249.92"
11-Aug-2022,Cheque,"2,775.00",00.00,"111,024.92"
11-Aug-2022,Transfer,00.00,"37,008.31","74,016.61"
11-Aug-2022,Purchase,00.00,"10,573.80","63,442.81"
11-Aug-2022,ATM,00.00,"10,573.80","52,869.01"
11-Aug-2022,Bill,"1,810,177.00",00.00,"1,863,046.01"
12-Aug-2022,Reversal,00.00,"931,523.01","931,523.00"
12-Aug-2022,Commission,00.00,"155,253.83","776,269.17"
12-Aug-2022,ATM,00.00,"97,033.65","679,235.52"
12-Aug-2022,Interest,"1,494.60",00.00,"680,730.12"
12-Aug-2022,Commission,00.00,"85,091.27","595,638.86"
12-Aug-2022,ATM,00.00,"74,454.86","521,184.00"
13-Aug-2022,NEFT,"27,149.46",00.00,"548,333.46"
13-Aug-2022,Miscellaneous,"186,534.90",00.00,"734,868.36"
13-Aug-2022,Tax,"1,461,322.80",00.00,"2,196,191.16"
13-Aug-2022,NEFT,00.00,"244,021.24","1,952,169.92"
13-Aug-2022,Bill,"1,484,896.20",00.00,"3,437,066.12"
13-Aug-2022,ATM,00.00,"381,896.24","3,055,169.88"
13-Aug-2022,NEFT,"3,106.56",00.00,"3,058,276.44"
13-Aug-2022,Purchase,00.00,"382,284.56","2,675,991.88"
13-Aug-2022,Transfer,00.00,"535,198.38","2,140,793.50"
13-Aug-2022,Commission,52.50,00.00,"2,140,846.00"
13-Aug-2022,Transfer,"2,463.28",00.00,"2,143,309.28"
13-Aug-2022,Commission,00.00,"267,913.66","1,875,395.62"
13-Aug-2022,Reversal,00.00,"234,424.45","1,640,971.17"
13-Aug-2022,Tax,"29,690.88",00.00,"1,670,662.05"
13-Aug-2022,IMPS,"443,556.00",00.00,"2,114,218.05"
13-Aug-2022,Cheque,05.00,00.00,"2,114,223.05"
13-Aug-2022,ATM,02.00,00.00,"2,114,225.05"
13-Aug-2022,Cheque,04.00,00.00,"2,114,229.05"
13-Aug-2022,IMPS,00.00,"422,845.81","1,691,383.24"
13-Aug-2022,Purchase,00.00,"211,422.91","1,479,960.34"
13-Aug-2022,RTGS,"1,071.34",00.00,"1,481,031.68"
13-Aug-2022,Bill,00.00,"370,257.92","1,110,773.76"
13-Aug-2022,NEFT,"10,394.65",00.00,"1,121,168.41"
13-Aug-2022,Bill,"1,492,496.00",00.00,"2,613,664.41"
13-Aug-2022,Miscellaneous,00.00,"1,306,832.21","1,306,832.20"
13-Aug-2022,Interest,00.00,"435,610.73","871,221.47"
13-Aug-2022,Interest,00.00,"87,122.15","784,099.32"
13-Aug-2022,Reversal,00.00,"98,012.42","686,086.90"
13-Aug-2022,Debit Card,00.00,"68,608.69","617,478.21"
13-Aug-2022,Commission,00.00,"154,369.55","463,108.66"
13-Aug-2022,Bill,00.00,"77,184.78","385,923.88"
13-Aug-2022,Debit Card,"13,918.60",00.00,"399,842.48"
13-Aug-2022,RTGS,00.00,"79,968.50","319,873.98"
13-Aug-2022,ATM,00.00,"35,541.55","284,332.43"
13-Aug-2022,NEFT,00.00,"94,777.48","189,554.95"
13-Aug-2022,Purchase,00.00,"21,061.66","168,493.29"
13-Aug-2022,Interest,00.00,"28,082.22","140,411.08"
13-Aug-2022,ATM,00.00,"28,082.22","112,328.86"
13-Aug-2022,Debit Card,34.00,00.00,"112,362.86"
13-Aug-2022,Cheque,00.00,"18,727.14","93,635.72"
13-Aug-2022,RTGS,00.00,"11,704.47","81,931.26"
13-Aug-2022,Cheque,"15,447.10",00.00,"97,378.36"
13-Aug-2022,IMPS,05.40,00.00,"97,383.76"
13-Aug-2022,IMPS,"13,909.00",00.00,"111,292.76"
13-Aug-2022,Bill,00.00,"27,823.19","83,469.57"
13-Aug-2022,Cheque,00.00,"41,734.79","41,734.79"
13-Aug-2022,Reversal,00.00,"13,911.60","27,823.19"
13-Aug-2022,Reversal,59.67,00.00,"27,882.86"
13-Aug-2022,Interest,44.10,00.00,"27,926.96"
13-Aug-2022,ATM,00.00,"9,308.99","18,617.97"
13-Aug-2022,Purchase,00.00,"2,068.66","16,549.31"
13-Aug-2022,Purchase,00.00,"16,549.31",00.00
13-Aug-2022,Cheque,05.45,00.00,05.45
13-Aug-2022,Commission,00.00,01.09,04.36
13-Aug-2022,Transfer,00.00,04.36,00.00
13-Aug-2022,NEFT,"245,868.90",00.00,"245,868.90"
13-Aug-2022,IMPS,"10,497.61",00.00,"256,366.51"
14-Aug-2022,Commission,00.00,"28,485.17","227,881.34"
14-Aug-2022,Interest,29.00,00.00,"227,910.34"
14-Aug-2022,Purchase,04.00,00.00,"227,914.34"
14-Aug-2022,Commission,01.44,00.00,"227,915.78"
14-Aug-2022,ATM,00.00,"45,583.16","182,332.62"
14-Aug-2022,Debit Card,00.00,"91,166.31","91,166.31"
14-Aug-2022,RTGS,00.12,00.00,"91,166.43"
14-Aug-2022,Purchase,00.00,"9,116.64","82,049.79"
14-Aug-2022,Cheque,63.30,00.00,"82,113.09"
14-Aug-2022,Debit Card,00.00,"11,730.44","70,382.65"
14-Aug-2022,Miscellaneous,06.00,00.00,"70,388.65"
14-Aug-2022,Reversal,06.00,00.00,"70,394.65"
14-Aug-2022,NEFT,"1,435,762.00",00.00,"1,506,156.65"
15-Aug-2022,Miscellaneous,00.00,"376,539.16","1,129,617.49"
15-Aug-2022,Bill,437.60,00.00,"1,130,055.09"
15-Aug-2022,Transfer,00.00,"113,005.51","1,017,049.58"
15-Aug-2022,Tax,00.00,"127,131.20","889,918.38"
15-Aug-2022,Debit Card,439.00,00.00,"890,357.38"
16-Aug-2022,Interest,00.00,"890,357.38",00.00
16-Aug-2022,RTGS,246.00,00.00,246.00
16-Aug-2022,Debit Card,00.00,30.75,215.25
16-Aug-2022,RTGS,00.00,35.88,179.38
16-Aug-2022,IMPS,"1,952.83",00.00,"2,132.21"
17-Aug-2022,Purchase,00.00,710.74,"1,421.47"
17-Aug-2022,RTGS,00.00,355.37,"1,066.10"
17-Aug-2022,NEFT,00.00,177.68,888.42
17-Aug-2022,Cheque,"234,988.56",00.00,"235,876.98"
17-Aug-2022,Miscellaneous,06.46,00.00,"235,883.44"
17-Aug-2022,Cash,"19,515.47",00.00,"255,398.91"
17-Aug-2022,Transfer,33.05,00.00,"255,431.96"
18-Aug-2022,Cash,404.37,00.00,"255,836.33"
18-Aug-2022,Debit Card,00.00,"31,979.54","223,856.79"
18-Aug-2022,Purchase,"14,554.10",00.00,"238,410.89"
18-Aug-2022,Purchase,00.00,"47,682.18","190,728.71"
18-Aug-2022,Cash,00.00,"27,246.96","163,481.75"
18-Aug-2022,Transfer,22.00,00.00,"163,503.75"
18-Aug-2022,Tax,"760,788.00",00.00,"924,291.75"
18-Aug-2022,Transfer,02.00,00.00,"924,293.75"
18-Aug-2022,Reversal,00.00,"308,097.92","616,195.83"
18-Aug-2022,ATM,00.00,"68,466.20","547,729.63"
18-Aug-2022,IMPS,00.00,"68,466.20","479,263.43"
18-Aug-2022,Cheque,"214,418.30",00.00,"693,681.73"
18-Aug-2022,NEFT,00.00,"231,227.24","462,454.49"
18-Aug-2022,Interest,00.00,"46,245.45","416,209.04"
18-Aug-2022,Cheque,00.00,"83,241.81","332,967.23"
18-Aug-2022,IMPS,54.28,00.00,"333,021.51"
18-Aug-2022,Transfer,"1,077,867.50",00.00,"1,410,889.01"
18-Aug-2022,IMPS,"27,915.18",00.00,"1,438,804.19"
18-Aug-2022,IMPS,"11,222.00",00.00,"1,450,026.19"
18-Aug-2022,Debit Card,"1,850,584.75",00.00,"3,300,610.94"
18-Aug-2022,Commission,"63,292.81",00.00,"3,363,903.75"
18-Aug-2022,ATM,00.00,"373,767.08","2,990,136.67"
18-Aug-2022,Tax,"1,280,320.00",00.00,"4,270,456.67"
18-Aug-2022,Reversal,"3,201.00",00.00,"4,273,657.67"
18-Aug-2022,IMPS,00.00,"4,273,657.67",00.00
18-Aug-2022,NEFT,345.00,00.00,345.00
18-Aug-2022,RTGS,03.99,00.00,348.99
18-Aug-2022,RTGS,00.00,116.33,232.66
18-Aug-2022,Miscellaneous,00.00,232.66,00.00
18-Aug-2022,Reversal,201.40,00.00,201.40
18-Aug-2022,Cheque,347.00,00.00,548.40
18-Aug-2022,Transfer,"8,455.80",00.00,"9,004.20"
18-Aug-2022,Interest,00.00,900.42,"8,103.78"
18-Aug-2022,Debit Card,00.00,"2,701.26","5,402.52"
18-Aug-2022,Commission,392.90,00.00,"5,795.42"
18-Aug-2022,Miscellaneous,"2,858.00",00.00,"8,653.42"
18-Aug-2022,NEFT,00.00,"1,081.68","7,571.74"
18-Aug-2022,RTGS,687.68,00.00,"8,259.42"
18-Aug-2022,Transfer,00.00,917.71,"7,341.71"
18-Aug-2022,Debit Card,05.80,00.00,"7,347.51"
18-Aug-2022,Debit Card,00.00,918.44,"6,429.07"
18-Aug-2022,ATM,"247,607.70",00.00,"254,036.77"
18-Aug-2022,Interest,00.00,"25,403.68","228,633.09"
18-Aug-2022,Interest,22.20,00.00,"228,655.29"
18-Aug-2022,Cash,00.00,"114,327.65","114,327.64"
18-Aug-2022,Transfer,00.00,"114,327.64",00.00
18-Aug-2022,IMPS,"1,121,826.00",00.00,"1,121,826.00"
18-Aug-2022,Cheque,56.82,00.00,"1,121,882.82"
18-Aug-2022,Miscellaneous,00.00,"373,960.94","747,921.88"
18-Aug-2022,Debit Card,10.67,00.00,"747,932.55"
18-Aug-2022,Reversal,"16,425.62",00.00,"764,358.17"
18-Aug-2022,Debit Card,00.00,"127,393.03","636,965.14"
18-Aug-2022,ATM,00.00,"70,773.90","566,191.24"
18-Aug-2022,Purchase,00.00,"141,547.81","424,643.43"
18-Aug-2022,Cash,211.00,00.00,"424,854.43"
18-Aug-2022,Reversal,"2,824.50",00.00,"427,678.93"
18-Aug-2022,Bill,02.45,00.00,"427,681.38"
18-Aug-2022,Interest,00.00,"53,460.17","374,221.21"
18-Aug-2022,Transfer,"1,742.00",00.00,"375,963.21"
18-Aug-2022,Commission,"24,591.00",00.00,"400,554.21"
18-Aug-2022,Reversal,00.00,"100,138.55","300,415.66"
18-Aug-2022,Bill,00.00,"150,207.83","150,207.83"
18-Aug-2022,Tax,"12,978.00",00.00,"163,185.83"
18-Aug-2022,Tax,03.00,00.00,"163,188.83"
18-Aug-2022,Miscellaneous,00.00,"54,396.28","108,792.55"
18-Aug-2022,Transfer,303.95,00.00,"109,096.50"
18-Aug-2022,NEFT,37.00,00.00,"109,133.50"
18-Aug-2022,Tax,00.00,"10,913.35","98,220.15"
18-Aug-2022,Miscellaneous,00.00,"16,370.03","81,850.12"
18-Aug-2022,Miscellaneous,00.00,"20,462.53","61,387.59"
18-Aug-2022,Commission,00.00,"8,769.66","52,617.93"
18-Aug-2022,Debit Card,00.00,"17,539.31","35,078.62"
18-Aug-2022,Transfer,"15,252.00",00.00,"50,330.62"
18-Aug-2022,IMPS,00.00,"50,330.62",00.00
18-Aug-2022,Cheque,"1,211.20",00.00,"1,211.20"
18-Aug-2022,Reversal,00.00,"1,211.20",00.00
18-Aug-2022,Reversal,"2,290.00",00.00,"2,290.00"
18-Aug-2022,Cash,"3,157.00",00.00,"5,447.00"
18-Aug-2022,Reversal,00.00,778.14,"4,668.86"
18-Aug-2022,Miscellaneous,00.00,"2,334.43","2,334.43"
18-Aug-2022,Debit Card,"199,587.44",00.00,"201,921.87"
18-Aug-2022,NEFT,"1,380,859.00",00.00,"1,582,780.87"
18-Aug-2022,Miscellaneous,"1,340,709.00",00.00,"2,923,489.87"
18-Aug-2022,Commission,00.00,"584,697.97","2,338,791.90"
18-Aug-2022,Interest,00.00,"334,113.13","2,004,678.77"
18-Aug-2022,NEFT,00.00,"400,935.75","1,603,743.02"
18-Aug-2022,Cheque,"3,745.50",00.00,"1,607,488.52"
18-Aug-2022,Debit Card,164.10,00.00,"1,607,652.62"
18-Aug-2022,Commission,"24,182.00",00.00,"1,631,834.62"
18-Aug-2022,Tax,07.00,00.00,"1,631,841.62"
18-Aug-2022,Commission,00.00,"181,315.74","1,450,525.88"
18-Aug-2022,Cheque,411.00,00.00,"1,450,936.88"
18-Aug-2022,Tax,00.00,"241,822.81","1,209,114.07"
18-Aug-2022,Miscellaneous,480.00,00.00,"1,209,594.07"
18-Aug-2022,Reversal,00.00,"201,599.01","1,007,995.06"
18-Aug-2022,Reversal,00.00,"1,007,995.06",00.00
18-Aug-2022,Commission,"1,444,040.00",00.00,"1,444,040.00"
18-Aug-2022,Purchase,04.00,00.00,"1,444,044.00"
18-Aug-2022,Tax,00.00,"206,292.00","1,237,752.00"
18-Aug-2022,Purchase,"27,236.32",00.00,"1,264,988.32"
18-Aug-2022,Cheque,00.00,"126,498.83","1,138,489.49"
18-Aug-2022,Debit Card,00.00,"142,311.19","996,178.30"
18-Aug-2022,Transfer,"2,201.00",00.00,"998,379.30"
18-Aug-2022,Commission,"1,290,920.00",00.00,"2,289,299.30"
18-Aug-2022,NEFT,01.97,00.00,"2,289,301.27"
18-Aug-2022,NEFT,"245,917.70",00.00,"2,535,218.97"
18-Aug-2022,Transfer,291.52,00.00,"2,535,510.49"
19-Aug-2022,IMPS,"20,947.00",00.00,"2,556,457.49"
19-Aug-2022,Bill,"4,766.40",00.00,"2,561,223.89"
19-Aug-2022,Commission,00.00,"320,152.99","2,241,070.90"
19-Aug-2022,Cash,27.90,00.00,"2,241,098.80"
19-Aug-2022,Tax,00.00,"448,219.76","1,792,879.04"
19-Aug-2022,Cash,"27,833.80",00.00,"1,820,712.84"
19-Aug-2022,RTGS,"20,146.41",00.00,"1,840,859.25"
19-Aug-2022,Cash,00.00,"204,539.92","1,636,319.33"
19-Aug-2022,Miscellaneous,00.00,"272,719.89","1,363,599.44"
19-Aug-2022,ATM,187.80,00.00,"1,363,787.24"
19-Aug-2022,Debit Card,13.20,00.00,"1,363,800.44"
20-Aug-2022,Cash,55.47,00.00,"1,363,855.91"
20-Aug-2022,Cash,"1,222,452.00",00.00,"2,586,307.91"
20-Aug-2022,Interest,00.00,"1,293,153.96","1,293,153.96"
20-Aug-2022,Commission,00.00,"184,736.28","1,108,417.68"
20-Aug-2022,Bill,00.00,"158,345.38","950,072.30"
20-Aug-2022,Miscellaneous,"4,623.61",00.00,"954,695.91"
21-Aug-2022,Transfer,00.00,"318,231.97","636,463.94"
21-Aug-2022,Bill,00.00,"159,115.99","477,347.95"
21-Aug-2022,Cash,00.00,"59,668.49","417,679.46"
21-Aug-2022,IMPS,00.00,"208,839.73","208,839.73"
21-Aug-2022,Debit Card,00.00,"208,839.73",00.00
21-Aug-2022,Purchase,"1,295,967.00",00.00,"1,295,967.00"
21-Aug-2022,Reversal,"20,503.60",00.00,"1,316,470.60"
21-Aug-2022,Debit Card,"7,645.00",00.00,"1,324,115.60"
21-Aug-2022,RTGS,00.00,"189,159.37","1,134,956.23"
21-Aug-2022,Reversal,00.00,"113,495.62","1,021,460.61"
21-Aug-2022,ATM,02.00,00.00,"1,021,462.61"
21-Aug-2022,Miscellaneous,04.00,00.00,"1,021,466.61"
21-Aug-2022,Bill,"57,206.70",00.00,"1,078,673.31"
22-Aug-2022,Reversal,00.00,"359,557.77","719,115.54"
22-Aug-2022,Cash,262.13,00.00,"719,377.67"
22-Aug-2022,Commission,07.00,00.00,"719,384.67"
22-Aug-2022,NEFT,00.00,"102,769.24","616,615.43"
22-Aug-2022,Miscellaneous,"1,838,728.25",00.00,"2,455,343.68"
22-Aug-2022,Tax,"204,629.25",00.00,"2,659,972.93"
22-Aug-2022,Transfer,00.00,"443,328.82","2,216,644.11"
22-Aug-2022,Cash,00.00,"738,881.37","1,477,762.74"
22-Aug-2022,Cash,00.00,"738,881.37","738,881.37"
22-Aug-2022,Miscellaneous,185.00,00.00,"739,066.37"
23-Aug-2022,NEFT,00.00,"147,813.27","591,253.10"
23-Aug-2022,NEFT,00.00,"73,906.64","517,346.46"
24-Aug-2022,Miscellaneous,"49,486.00",00.00,"566,832.46"
24-Aug-2022,ATM,01.00,00.00,"566,833.46"
24-Aug-2022,Purchase,00.00,"566,833.46",00.00
24-Aug-2022,Debit Card,633.20,00.00,633.20
24-Aug-2022,Miscellaneous,00.00,633.20,00.00
24-Aug-2022,NEFT,"122,817.40",00.00,"122,817.40"
24-Aug-2022,ATM,00.00,"20,469.57","102,347.83"
24-Aug-2022,Tax,00.00,"25,586.96","76,760.87"
24-Aug-2022,IMPS,00.00,"19,190.22","57,570.65"
24-Aug-2022,Cheque,00.00,"6,396.74","51,173.91"
24-Aug-2022,Commission,02.60,00.00,"51,176.51"
24-Aug-2022,Bill,00.00,"25,588.26","25,588.26"
24-Aug-2022,Bill,53.30,00.00,"25,641.56"
24-Aug-2022,RTGS,"1,535.00",00.00,"27,176.56"
24-Aug-2022,Cash,"1,801,540.80",00.00,"1,828,717.36"
24-Aug-2022,Miscellaneous,00.00,"457,179.34","1,371,538.02"
24-Aug-2022,Reversal,00.00,"152,393.11","1,219,144.91"
24-Aug-2022,ATM,00.00,"203,190.82","1,015,954.09"
24-Aug-2022,NEFT,00.00,"126,994.26","888,959.83"
24-Aug-2022,Commission,00.00,"111,119.98","777,839.85"
24-Aug-2022,Interest,57.00,00.00,"777,896.85"
24-Aug-2022,Miscellaneous,07.00,00.00,"777,903.85"
24-Aug-2022,Cheque,"150,945.30",00.00,"928,849.15"
24-Aug-2022,Tax,"2,025,544.00",00.00,"2,954,393.15"
24-Aug-2022,RTGS,00.00,"328,265.91","2,626,127.24"
24-Aug-2022,RTGS,00.00,"656,531.81","1,969,595.43"
24-Aug-2022,Interest,391.00,00.00,"1,969,986.43"
24-Aug-2022,Transfer,00.00,"246,248.30","1,723,738.13"
24-Aug-2022,Reversal,00.00,"246,248.30","1,477,489.83"
24-Aug-2022,NEFT,00.00,"1,477,489.83",00.00
24-Aug-2022,Bill,07.92,00.00,07.92
24-Aug-2022,Interest,03.74,00.00,11.66
24-Aug-2022,NEFT,00.00,05.83,05.83
24-Aug-2022,Debit Card,00.00,02.92,02.92
24-Aug-2022,ATM,00.00,00.97,01.95
24-Aug-2022,Commission,59.61,00.00,61.56
24-Aug-2022,Commission,"2,685.00",00.00,"2,746.56"
24-Aug-2022,Cash,"2,319.50",00.00,"5,066.06"
24-Aug-2022,Bill,"1,418,262.75",00.00,"1,423,328.81"
24-Aug-2022,RTGS,"15,653.82",00.00,"1,438,982.63"
24-Aug-2022,Reversal,00.00,"287,796.53","1,151,186.10"
24-Aug-2022,Tax,05.20,00.00,"1,151,191.30"
24-Aug-2022,Miscellaneous,27.00,00.00,"1,151,218.30"
24-Aug-2022,Transfer,"2,824.41",00.00,"1,154,042.71"
25-Aug-2022,Tax,06.79,00.00,"1,154,049.50"
25-Aug-2022,NEFT,00.00,"164,864.21","989,185.29"
25-Aug-2022,Miscellaneous,29.00,00.00,"989,214.29"
25-Aug-2022,Debit Card,"3,495.90",00.00,"992,710.19"
25-Aug-2022,Commission,"6,073.30",00.00,"998,783.49"
25-Aug-2022,Commission,"4,547.60",00.00,"1,003,331.09"
25-Aug-2022,RTGS,"164,848.00",00.00,"1,168,179.09"
25-Aug-2022,Bill,"1,881.20",00.00,"1,170,060.29"
26-Aug-2022,Interest,00.00,"234,012.06","936,048.23"
27-Aug-2022,Cash,00.00,"187,209.65","748,838.58"
27-Aug-2022,Reversal,00.00,"149,767.72","599,070.86"
27-Aug-2022,RTGS,"2,866.30",00.00,"601,937.16"
27-Aug-2022,Debit Card,"10,319.00",00.00,"612,256.16"
27-Aug-2022,RTGS,00.00,"612,256.16",00.00
27-Aug-2022,Purchase,"3,725.48",00.00,"3,725.48"
27-Aug-2022,Reversal,497.20,00.00,"4,222.68"
27-Aug-2022,Bill,00.00,"1,055.67","3,167.01"
27-Aug-2022,NEFT,04.10,00.00,"3,171.11"
27-Aug-2022,Bill,"224,813.10",00.00,"227,984.21"
27-Aug-2022,Cash,"780,278.50",00.00,"1,008,262.71"
27-Aug-2022,Cheque,00.00,"100,826.27","907,436.44"
27-Aug-2022,Transfer,00.00,"90,743.64","816,692.80"
27-Aug-2022,Debit Card,00.00,"90,743.64","725,949.16"
27-Aug-2022,RTGS,00.00,"241,983.05","483,966.11"
27-Aug-2022,Debit Card,00.00,"120,991.53","362,974.58"
27-Aug-2022,Commission,00.00,"120,991.53","241,983.05"
27-Aug-2022,Miscellaneous,00.00,"60,495.76","181,487.29"
27-Aug-2022,Transfer,00.00,"36,297.46","145,189.83"
28-Aug-2022,Miscellaneous,00.00,"24,198.31","120,991.52"
28-Aug-2022,Reversal,"211,545.00",00.00,"332,536.52"
28-Aug-2022,Bill,01.00,00.00,"332,537.52"
28-Aug-2022,Cheque,00.00,"83,134.38","249,403.14"
29-Aug-2022,IMPS,00.00,"49,880.63","199,522.51"
29-Aug-2022,Cheque,00.00,"199,522.51",00.00
29-Aug-2022,Bill,400.10,00.00,400.10
29-Aug-2022,Reversal,00.00,44.46,355.64
29-Aug-2022,Purchase,00.00,50.81,304.83
29-Aug-2022,Tax,"1,725,884.00",00.00,"1,726,188.83"
29-Aug-2022,Cash,01.61,00.00,"1,726,190.44"
29-Aug-2022,Interest,00.00,"1,726,190.44",00.00
29-Aug-2022,Bill,06.40,00.00,06.40
29-Aug-2022,RTGS,00.00,00.71,05.69
29-Aug-2022,Reversal,00.00,02.85,02.84
29-Aug-2022,RTGS,00.00,00.41,02.43
29-Aug-2022,Commission,00.00,01.22,01.22
29-Aug-2022,Purchase,"102,374.25",00.00,"102,375.47"
29-Aug-2022,ATM,00.00,"12,796.93","89,578.54"
29-Aug-2022,Commission,00.00,"11,197.32","78,381.22"
29-Aug-2022,RTGS,00.00,"78,381.22",00.00
29-Aug-2022,Bill,"20,289.00",00.00,"20,289.00"
29-Aug-2022,Cheque,07.00,00.00,"20,296.00"
29-Aug-2022,Reversal,00.00,"10,148.00","10,148.00"
29-Aug-2022,Miscellaneous,"67,975.00",00.00,"78,123.00"
29-Aug-2022,Bill,91.00,00.00,"78,214.00"
29-Aug-2022,ATM,00.00,"11,173.43","67,040.57"
29-Aug-2022,Commission,"23,793.65",00.00,"90,834.22"
29-Aug-2022,Tax,00.00,"10,092.69","80,741.53"
29-Aug-2022,NEFT,"21,534.30",00.00,"102,275.83"
29-Aug-2022,Reversal,"1,458.00",00.00,"103,733.83"
29-Aug-2022,ATM,33.13,00.00,"103,766.96"
29-Aug-2022,Cash,00.00,"25,941.74","77,825.22"
29-Aug-2022,Cash,418.81,00.00,"78,244.03"
29-Aug-2022,Purchase,00.00,"26,081.34","52,162.69"
29-Aug-2022,Purchase,00.20,00.00,"52,162.89"
29-Aug-2022,RTGS,00.00,"17,387.63","34,775.26"
29-Aug-2022,Bill,00.00,"5,795.88","28,979.38"
29-Aug-2022,Cheque,"151,538.00",00.00,"180,517.38"
29-Aug-2022,Commission,"41,359.00",00.00,"221,876.38"
29-Aug-2022,Commission,492.00,00.00,"222,368.38"
29-Aug-2022,Bill,"10,890.31",00.00,"233,258.69"
29-Aug-2022,Tax,"29,192.50",00.00,"262,451.19"
29-Aug-2022,Transfer,00.00,"131,225.60","131,225.60"
29-Aug-2022,Cheque,311.80,00.00,"131,537.40"
29-Aug-2022,Miscellaneous,00.00,"13,153.74","118,383.66"
29-Aug-2022,Miscellaneous,00.00,"19,730.61","98,653.05"
29-Aug-2022,RTGS,04.52,00.00,"98,657.57"
29-Aug-2022,ATM,00.00,"98,657.57",00.00
29-Aug-2022,NEFT,18.30,00.00,18.30
29-Aug-2022,Purchase,00.00,04.58,13.73
29-Aug-2022,Purchase,00.00,01.37,12.36
29-Aug-2022,Transfer,00.00,03.09,09.27
29-Aug-2022,Transfer,"22,150.62",00.00,"22,159.89"
29-Aug-2022,Interest,00.00,"3,165.70","18,994.19"
29-Aug-2022,Transfer,00.00,"2,713.46","16,280.73"
29-Aug-2022,Interest,00.00,"1,808.97","14,471.76"
29-Aug-2022,Bill,"1,323,008.00",00.00,"1,337,479.76"
29-Aug-2022,Transfer,"113,493.47",00.00,"1,450,973.23"
29-Aug-2022,Tax,02.00,00.00,"1,450,975.23"
29-Aug-2022,ATM,00.00,"725,487.62","725,487.62"
29-Aug-2022,RTGS,09.00,00.00,"725,496.62"
29-Aug-2022,ATM,00.00,"181,374.16","544,122.46"
29-Aug-2022,Tax,"32,585.95",00.00,"576,708.41"
29-Aug-2022,Reversal,00.00,"96,118.07","480,590.34"
30-Aug-2022,Cheque,"598,134.00",00.00,"1,078,724.34"
30-Aug-2022,Cash,03.85,00.00,"1,078,728.19"
30-Aug-2022,ATM,00.00,"269,682.05","809,046.14"
30-Aug-2022,Interest,00.00,"269,682.05","539,364.09"
30-Aug-2022,Bill,"2,806.60",00.00,"542,170.69"
30-Aug-2022,Debit Card,00.00,"90,361.78","451,808.91"
30-Aug-2022,Commission,04.00,00.00,"451,812.91"
30-Aug-2022,NEFT,00.00,"45,181.29","406,631.62"
30-Aug-2022,Cash,"1,708.00",00.00,"408,339.62"
30-Aug-2022,ATM,"3,678.60",00.00,"412,018.22"
30-Aug-2022,Debit Card,377.03,00.00,"412,395.25"
30-Aug-2022,Reversal,00.00,"58,913.61","353,481.64"
30-Aug-2022,Bill,00.00,"58,913.61","294,568.03"
30-Aug-2022,Interest,196.00,00.00,"294,764.03"
30-Aug-2022,Debit Card,00.00,"147,382.02","147,382.02"
30-Aug-2022,Transfer,54.10,00.00,"147,436.12"
30-Aug-2022,Purchase,00.00,"29,487.22","117,948.90"
30-Aug-2022,ATM,"1,561.00",00.00,"119,509.90"
30-Aug-2022,Commission,527.26,00.00,"120,037.16"
30-Aug-2022,Debit Card,00.00,"120,037.16",00.00
31-Aug-2022,ATM,336.00,00.00,336.00
31-Aug-2022,Cash,00.00,336.00,00.00
31-Aug-2022,Purchase,"132,959.81",00.00,"132,959.81"
31-Aug-2022,Debit Card,00.00,"26,591.96","106,367.85"
31-Aug-2022,Commission,00.00,"106,367.85",00.00
31-Aug-2022,Cash,"28,839.06",00.00,"28,839.06"
31-Aug-2022,Interest,33.00,00.00,"28,872.06"
31-Aug-2022,RTGS,00.00,"14,436.03","14,436.03"
31-Aug-2022,ATM,00.00,"2,887.21","11,548.82"
31-Aug-2022,Tax,00.00,"5,774.41","5,774.41"
31-Aug-2022,ATM,"31,444.50",00.00,"37,218.91"
31-Aug-2022,Debit Card,00.00,"37,218.91",00.00
31-Aug-2022,Bill,"27,753.80",00.00,"27,753.80"
31-Aug-2022,Transfer,"155,769.20",00.00,"183,523.00"
31-Aug-2022,Interest,00.00,"91,761.50","91,761.50"
31-Aug-2022,Miscellaneous,60.00,00.00,"91,821.50"
31-Aug-2022,Interest,"89,503.10",00.00,"181,324.60"
01-Sep-2022,Purchase,"2,426.00",00.00,"183,750.60"
01-Sep-2022,Purchase,"18,853.00",00.00,"202,603.60"
01-Sep-2022,Commission,00.00,"50,650.90","151,952.70"
01-Sep-2022,Interest,53.00,00.00,"152,005.70"
02-Sep-2022,Bill,498.00,00.00,"152,503.70"
02-Sep-2022,Reversal,00.00,"30,500.74","122,002.96"
02-Sep-2022,Interest,360.00,00.00,"122,362.96"
02-Sep-2022,Debit Card,13.80,00.00,"122,376.76"
02-Sep-2022,Debit Card,185.30,00.00,"122,562.06"
02-Sep-2022,NEFT,02.30,00.00,"122,564.36"
02-Sep-2022,Transfer,"6,136.40",00.00,"128,700.76"
02-Sep-2022,Cheque,314.70,00.00,"129,015.46"
02-Sep-2022,Transfer,00.00,"16,126.93","112,888.53"
02-Sep-2022,IMPS,00.00,"56,444.27","56,444.26"
02-Sep-2022,Purchase,00.00,"5,644.43","50,799.83"
02-Sep-2022,Cheque,00.00,"50,799.83",00.00
02-Sep-2022,Interest,416.60,00.00,416.60
02-Sep-2022,ATM,00.00,69.43,347.17
02-Sep-2022,Miscellaneous,"1,603,070.20",00.00,"1,603,417.37"
02-Sep-2022,Miscellaneous,00.00,"801,708.69","801,708.68"
02-Sep-2022,Cheque,00.00,"100,213.59","701,495.10"
02-Sep-2022,Commission,"568,946.00",00.00,"1,270,441.10"
02-Sep-2022,ATM,"1,855.90",00.00,"1,272,297.00"
02-Sep-2022,NEFT,123.60,00.00,"1,272,420.60"
02-Sep-2022,Cheque,"17,090.23",00.00,"1,289,510.83"
02-Sep-2022,Bill,"1,837,868.50",00.00,"3,127,379.33"
02-Sep-2022,Transfer,00.00,"625,475.87","2,501,903.46"
02-Sep-2022,Commission,00.00,"625,475.87","1,876,427.60"
02-Sep-2022,Debit Card,172.31,00.00,"1,876,599.91"
03-Sep-2022,Transfer,00.00,"1,876,599.91",00.00
03-Sep-2022,Interest,13.00,00.00,13.00
03-Sep-2022,Miscellaneous,00.00,04.33,08.67
03-Sep-2022,Cheque,00.00,02.17,06.50
03-Sep-2022,Commission,00.00,02.17,04.33
03-Sep-2022,Cheque,53.80,00.00,58.13
03-Sep-2022,IMPS,00.00,14.53,43.60
03-Sep-2022,Interest,"1,813,351.75",00.00,"1,813,395.35"
03-Sep-2022,Miscellaneous,00.00,"181,339.54","1,632,055.82"
03-Sep-2022,RTGS,"15,814.71",00.00,"1,647,870.53"
03-Sep-2022,Cash,"1,763,079.00",00.00,"3,410,949.53"
03-Sep-2022,Interest,"529,818.75",00.00,"3,940,768.28"
03-Sep-2022,Purchase,00.00,"562,966.90","3,377,801.38"
03-Sep-2022,Miscellaneous,"28,275.00",00.00,"3,406,076.38"
03-Sep-2022,Bill,00.00,"567,679.40","2,838,396.98"
03-Sep-2022,Bill,218.20,00.00,"2,838,615.18"
03-Sep-2022,Miscellaneous,45.00,00.00,"2,838,660.18"
03-Sep-2022,Transfer,50.40,00.00,"2,838,710.58"
03-Sep-2022,ATM,00.00,"1,419,355.29","1,419,355.29"
03-Sep-2022,Purchase,00.00,"202,765.04","1,216,590.25"
03-Sep-2022,Interest,"937,902.00",00.00,"2,154,492.25"
03-Sep-2022,Commission,00.00,"307,784.61","1,846,707.64"
03-Sep-2022,Interest,"181,329.00",00.00,"2,028,036.64"
03-Sep-2022,Commission,"27,903.81",00.00,"2,055,940.45"
03-Sep-2022,Bill,00.00,"685,313.48","1,370,626.97"
03-Sep-2022,Debit Card,"231,855.16",00.00,"1,602,482.13"
03-Sep-2022,IMPS,00.00,"400,620.53","1,201,861.60"
03-Sep-2022,Debit Card,00.00,"600,930.80","600,930.80"
03-Sep-2022,Purchase,168.22,00.00,"601,099.02"
03-Sep-2022,ATM,36.00,00.00,"601,135.02"
03-Sep-2022,IMPS,00.00,"85,876.43","515,258.59"
03-Sep-2022,RTGS,"1,879.00",00.00,"517,137.59"
03-Sep-2022,Bill,00.00,"51,713.76","465,423.83"
03-Sep-2022,Transfer,00.00,"58,177.98","407,245.85"
03-Sep-2022,Commission,"25,749.12",00.00,"432,994.97"
03-Sep-2022,IMPS,00.00,"72,165.83","360,829.14"
03-Sep-2022,IMPS,00.00,"180,414.57","180,414.57"
03-Sep-2022,Commission,00.00,"60,138.19","120,276.38"
03-Sep-2022,Transfer,318.37,00.00,"120,594.75"
03-Sep-2022,NEFT,"679,552.00",00.00,"800,146.75"
03-Sep-2022,Debit Card,00.00,"400,073.38","400,073.38"
03-Sep-2022,Commission,"197,224.70",00.00,"597,298.08"
04-Sep-2022,Transfer,00.00,"298,649.04","298,649.04"
04-Sep-2022,Cash,"1,686,962.80",00.00,"1,985,611.84"
04-Sep-2022,Commission,"3,627.00",00.00,"1,989,238.84"
04-Sep-2022,Purchase,00.00,"284,176.98","1,705,061.86"
04-Sep-2022,Reversal,00.00,"170,506.19","1,534,555.67"
04-Sep-2022,Reversal,"38,448.72",00.00,"1,573,004.39"
04-Sep-2022,IMPS,04.60,00.00,"1,573,008.99"
04-Sep-2022,NEFT,00.00,"524,336.33","1,048,672.66"
04-Sep-2022,RTGS,00.00,"174,778.78","873,893.88"
04-Sep-2022,Purchase,"1,571.00",00.00,"875,464.88"
05-Sep-2022,Miscellaneous,01.00,00.00,"875,465.88"
05-Sep-2022,Bill,00.00,"109,433.24","766,032.64"
05-Sep-2022,Transfer,00.00,"153,206.53","612,826.11"
05-Sep-2022,IMPS,00.00,"68,091.79","544,734.32"
05-Sep-2022,Reversal,"9,396.52",00.00,"554,130.84"
05-Sep-2022,Cheque,"5,900.00",00.00,"560,030.84"
05-Sep-2022,Debit Card,00.00,"93,338.47","466,692.37"
05-Sep-2022,Purchase,00.00,"51,854.71","414,837.66"
05-Sep-2022,Commission,00.00,"207,418.83","207,418.83"
05-Sep-2022,RTGS,00.00,"103,709.42","103,709.42"
05-Sep-2022,Transfer,"29,295.30",00.00,"133,004.72"
05-Sep-2022,Reversal,"186,338.20",00.00,"319,342.92"
06-Sep-2022,RTGS,00.00,"63,868.58","255,474.34"
06-Sep-2022,Cash,"108,630.91",00.00,"364,105.25"
06-Sep-2022,Debit Card,06.00,00.00,"364,111.25"
06-Sep-2022,NEFT,00.00,"36,411.13","327,700.12"
06-Sep-2022,Reversal,"1,280.79",00.00,"328,980.91"
06-Sep-2022,Commission,164.40,00.00,"329,145.31"
06-Sep-2022,Purchase,00.00,"54,857.55","274,287.76"
06-Sep-2022,Transfer,00.00,"137,143.88","137,143.88"
06-Sep-2022,Debit Card,00.00,"19,591.98","117,551.90"
06-Sep-2022,Purchase,00.00,"39,183.97","78,367.93"
06-Sep-2022,Interest,"3,473.40",00.00,"81,841.33"
06-Sep-2022,Commission,49.00,00.00,"81,890.33"
06-Sep-2022,Commission,"1,846,024.50",00.00,"1,927,914.83"
06-Sep-2022,Bill,00.00,"642,638.28","1,285,276.55"
06-Sep-2022,Bill,"2,880.13",00.00,"1,288,156.68"
06-Sep-2022,RTGS,00.00,"161,019.59","1,127,137.10"
06-Sep-2022,NEFT,32.00,00.00,"1,127,169.10"
06-Sep-2022,Transfer,00.00,"375,723.03","751,446.07"
07-Sep-2022,Bill,00.00,"751,446.07",00.00
07-Sep-2022,Purchase,354.00,00.00,354.00
07-Sep-2022,Purchase,00.00,00.00,354.00
07-Sep-2022,Transfer,"3,907.90",00.00,"4,261.90"
07-Sep-2022,Cash,01.20,00.00,"4,263.10"
07-Sep-2022,Cash,04.70,00.00,"4,267.80"
07-Sep-2022,IMPS,20.53,00.00,"4,288.33"
07-Sep-2022,Interest,00.00,"4,288.33",00.00
07-Sep-2022,Purchase,30.15,00.00,30.15
07-Sep-2022,Debit Card,00.00,10.05,20.10
07-Sep-2022,Debit Card,00.00,20.10,00.00
07-Sep-2022,Purchase,"1,951,788.00",00.00,"1,951,788.00"
07-Sep-2022,Purchase,00.00,"243,973.50","1,707,814.50"
07-Sep-2022,Miscellaneous,53.90,00.00,"1,707,868.40"
07-Sep-2022,ATM,30.70,00.00,"1,707,899.10"
07-Sep-2022,Interest,"27,689.24",00.00,"1,735,588.34"
07-Sep-2022,Tax,00.00,"216,948.54","1,518,639.80"
07-Sep-2022,RTGS,00.00,"379,659.95","1,138,979.85"
07-Sep-2022,ATM,00.00,"142,372.48","996,607.37"
07-Sep-2022,Reversal,00.00,"124,575.92","872,031.45"
07-Sep-2022,Bill,00.00,"109,003.93","763,027.52"
07-Sep-2022,Bill,00.00,"76,302.75","686,724.77"
07-Sep-2022,Commission,00.00,"171,681.19","515,043.58"
07-Sep-2022,IMPS,"3,111.20",00.00,"518,154.78"
07-Sep-2022,Cash,00.00,"64,769.35","453,385.43"
07-Sep-2022,Interest,456.40,00.00,"453,841.83"
07-Sep-2022,ATM,22.00,00.00,"453,863.83"
07-Sep-2022,Reversal,00.00,"113,465.96","340,397.87"
07-Sep-2022,Bill,"13,916.40",00.00,"354,314.27"
07-Sep-2022,ATM,"2,449.90",00.00,"356,764.17"
07-Sep-2022,Purchase,00.00,"118,921.39","237,842.78"
07-Sep-2022,Cheque,"724,251.00",00.00,"962,093.78"
07-Sep-2022,NEFT,"1,481.60",00.00,"963,575.38"
07-Sep-2022,ATM,00.00,"240,893.85","722,681.54"
07-Sep-2022,ATM,08.00,00.00,"722,689.54"
07-Sep-2022,Commission,00.00,"80,298.84","642,390.70"
07-Sep-2022,Commission,"1,162,512.00",00.00,"1,804,902.70"
07-Sep-2022,Interest,"197,031.47",00.00,"2,001,934.17"
07-Sep-2022,Reversal,00.00,"667,311.39","1,334,622.78"
07-Sep-2022,Reversal,"11,929.00",00.00,"1,346,551.78"
07-Sep-2022,ATM,"3,968.00",00.00,"1,350,519.78"
07-Sep-2022,Bill,00.00,"450,173.26","900,346.52"
07-Sep-2022,IMPS,05.80,00.00,"900,352.32"
07-Sep-2022,ATM,347.17,00.00,"900,699.49"
07-Sep-2022,Tax,00.00,"900,699.49",00.00
07-Sep-2022,RTGS,309.58,00.00,309.58
07-Sep-2022,Bill,00.00,44.23,265.35
07-Sep-2022,Tax,"216,893.00",00.00,"217,158.35"
07-Sep-2022,ATM,00.00,"217,158.35",00.00
07-Sep-2022,Commission,"873,012.80",00.00,"873,012.80"
07-Sep-2022,Transfer,00.00,"87,301.28","785,711.52"
07-Sep-2022,Bill,03.10,00.00,"785,714.62"
07-Sep-2022,Miscellaneous,114.00,00.00,"785,828.62"
07-Sep-2022,Miscellaneous,"2,484.00",00.00,"788,312.62"
07-Sep-2022,Commission,00.00,"87,590.29","700,722.33"
07-Sep-2022,Miscellaneous,00.00,"70,072.23","630,650.10"
07-Sep-2022,Interest,00.00,"105,108.35","525,541.75"
07-Sep-2022,Miscellaneous,00.00,"52,554.18","472,987.58"
07-Sep-2022,Reversal,00.10,00.00,"472,987.68"
07-Sep-2022,Cheque,00.00,"52,554.19","420,433.49"
07-Sep-2022,Bill,00.00,"42,043.35","378,390.14"
08-Sep-2022,Commission,234.00,00.00,"378,624.14"
08-Sep-2022,Commission,"18,106.30",00.00,"396,730.44"
08-Sep-2022,ATM,"1,576.00",00.00,"398,306.44"
08-Sep-2022,IMPS,00.00,"99,576.61","298,729.83"
08-Sep-2022,IMPS,00.00,"149,364.92","149,364.92"
08-Sep-2022,Commission,684.53,00.00,"150,049.45"
08-Sep-2022,Interest,"91,679.00",00.00,"241,728.45"
08-Sep-2022,Reversal,209.00,00.00,"241,937.45"
08-Sep-2022,ATM,00.00,"120,968.73","120,968.72"
08-Sep-2022,Cheque,00.00,"15,121.09","105,847.63"
08-Sep-2022,ATM,00.00,"13,230.95","92,616.68"
08-Sep-2022,Reversal,"1,594,963.00",00.00,"1,687,579.68"
08-Sep-2022,Interest,00.00,"281,263.28","1,406,316.40"
08-Sep-2022,Cheque,00.00,"1,406,316.40",00.00
08-Sep-2022,Debit Card,68.30,00.00,68.30
08-Sep-2022,ATM,"1,726.00",00.00,"1,794.30"
09-Sep-2022,IMPS,06.00,00.00,"1,800.30"
09-Sep-2022,Cash,00.00,225.04,"1,575.26"
09-Sep-2022,Cheque,"233,855.25",00.00,"235,430.51"
09-Sep-2022,RTGS,03.00,00.00,"235,433.51"
09-Sep-2022,Miscellaneous,00.00,"235,433.51",00.00
09-Sep-2022,Cheque,32.50,00.00,32.50
09-Sep-2022,Reversal,00.00,03.61,28.89
09-Sep-2022,IMPS,00.00,14.45,14.44
09-Sep-2022,Tax,00.00,01.60,12.84
09-Sep-2022,Miscellaneous,"259,194.70",00.00,"259,207.54"
09-Sep-2022,ATM,"23,719.00",00.00,"282,926.54"
09-Sep-2022,RTGS,00.10,00.00,"282,926.64"
09-Sep-2022,Debit Card,"2,551.00",00.00,"285,477.64"
09-Sep-2022,Cash,00.00,"40,782.52","244,695.12"
09-Sep-2022,Miscellaneous,00.00,"48,939.02","195,756.10"
09-Sep-2022,IMPS,00.00,"19,575.61","176,180.49"
09-Sep-2022,Cheque,"18,109.00",00.00,"194,289.49"
09-Sep-2022,Reversal,11.00,00.00,"194,300.49"
09-Sep-2022,Cheque,"212,043.20",00.00,"406,343.69"
09-Sep-2022,RTGS,00.00,"58,049.10","348,294.59"
09-Sep-2022,Tax,00.00,"43,536.82","304,757.77"
09-Sep-2022,Cheque,438.00,00.00,"305,195.77"
09-Sep-2022,Bill,00.00,"305,195.77",00.00
09-Sep-2022,IMPS,04.00,00.00,04.00
09-Sep-2022,RTGS,00.00,01.00,03.00
09-Sep-2022,Interest,144.66,00.00,147.66
09-Sep-2022,Purchase,00.00,147.66,00.00
09-Sep-2022,IMPS,"2,442.10",00.00,"2,442.10"
09-Sep-2022,NEFT,00.00,271.34,"2,170.76"
09-Sep-2022,ATM,00.00,271.35,"1,899.42"
09-Sep-2022,Debit Card,24.00,00.00,"1,923.42"
09-Sep-2022,Reversal,00.00,240.43,"1,682.99"
09-Sep-2022,Debit Card,00.14,00.00,"1,683.13"
09-Sep-2022,Cash,"149,874.90",00.00,"151,558.03"
09-Sep-2022,Tax,00.00,"30,311.61","121,246.42"
09-Sep-2022,Debit Card,"13,615.52",00.00,"134,861.94"
09-Sep-2022,Tax,415.00,00.00,"135,276.94"
09-Sep-2022,Debit Card,00.00,"135,276.94",00.00
09-Sep-2022,Cash,02.00,00.00,02.00
09-Sep-2022,Bill,00.00,00.22,01.78
09-Sep-2022,Bill,"1,563.00",00.00,"1,564.78"
09-Sep-2022,Miscellaneous,262.70,00.00,"1,827.48"
09-Sep-2022,Commission,00.00,261.07,"1,566.41"
09-Sep-2022,IMPS,00.00,174.05,"1,392.36"
09-Sep-2022,Debit Card,06.00,00.00,"1,398.36"
09-Sep-2022,Tax,00.00,"1,398.36",00.00
09-Sep-2022,IMPS,"3,726.13",00.00,"3,726.13"
09-Sep-2022,Bill,00.00,"1,863.07","1,863.06"
09-Sep-2022,Bill,95.70,00.00,"1,958.76"
09-Sep-2022,RTGS,00.00,217.64,"1,741.12"
09-Sep-2022,RTGS,"63,996.40",00.00,"65,737.52"
09-Sep-2022,Cash,"130,765.00",00.00,"196,502.52"
09-Sep-2022,Transfer,58.20,00.00,"196,560.72"
09-Sep-2022,Tax,"1,985,982.00",00.00,"2,182,542.72"
09-Sep-2022,Transfer,00.00,"242,504.75","1,940,037.97"
09-Sep-2022,Transfer,"122,867.00",00.00,"2,062,904.97"
09-Sep-2022,ATM,24.52,00.00,"2,062,929.49"
09-Sep-2022,Tax,00.00,"343,821.58","1,719,107.91"
09-Sep-2022,Purchase,446.40,00.00,"1,719,554.31"
09-Sep-2022,NEFT,"7,400.05",00.00,"1,726,954.36"
09-Sep-2022,Reversal,"30,228.86",00.00,"1,757,183.22"
09-Sep-2022,IMPS,03.60,00.00,"1,757,186.82"
09-Sep-2022,Transfer,689.30,00.00,"1,757,876.12"
09-Sep-2022,Cash,00.00,"251,125.16","1,506,750.96"
09-Sep-2022,Tax,00.00,"753,375.48","753,375.48"
10-Sep-2022,IMPS,06.44,00.00,"753,381.92"
10-Sep-2022,Debit Card,"19,170.70",00.00,"772,552.62"
10-Sep-2022,Cheque,59.00,00.00,"772,611.62"
10-Sep-2022,Interest,00.00,"128,768.60","643,843.02"
10-Sep-2022,Transfer,"12,399.70",00.00,"656,242.72"
11-Sep-2022,Miscellaneous,00.00,"109,373.79","546,868.93"
11-Sep-2022,Cash,00.00,"60,763.21","486,105.72"
11-Sep-2022,Cash,63.70,00.00,"486,169.42"
11-Sep-2022,RTGS,653.30,00.00,"486,822.72"
11-Sep-2022,RTGS,00.00,"69,546.10","417,276.62"
11-Sep-2022,Cheque,00.00,"41,727.66","375,548.96"
11-Sep-2022,Tax,00.00,"37,554.90","337,994.06"
11-Sep-2022,Cash,"220,440.06",00.00,"558,434.12"
11-Sep-2022,Reversal,469.18,00.00,"558,903.30"
11-Sep-2022,Cheque,03.50,00.00,"558,906.80"
11-Sep-2022,IMPS,00.00,"93,151.13","465,755.67"
11-Sep-2022,Cash,00.00,"116,438.92","349,316.75"
11-Sep-2022,Debit Card,00.00,"58,219.46","291,097.29"
11-Sep-2022,Miscellaneous,"89,685.00",00.00,"380,782.29"
11-Sep-2022,Transfer,04.00,00.00,"380,786.29"
11-Sep-2022,RTGS,00.00,"190,393.15","190,393.14"
11-Sep-2022,Reversal,"90,967.80",00.00,"281,360.94"
11-Sep-2022,Bill,11.00,00.00,"281,371.94"
11-Sep-2022,IMPS,"212,787.50",00.00,"494,159.44"
11-Sep-2022,Bill,16.80,00.00,"494,176.24"
11-Sep-2022,Cheque,06.60,00.00,"494,182.84"
11-Sep-2022,Purchase,204.49,00.00,"494,387.33"
11-Sep-2022,RTGS,"2,264.70",00.00,"496,652.03"
11-Sep-2022,IMPS,"9,661.56",00.00,"506,313.59"
11-Sep-2022,Cash,16.00,00.00,"506,329.59"
11-Sep-2022,Purchase,00.00,"50,632.96","455,696.63"
11-Sep-2022,Tax,00.00,"45,569.66","410,126.97"
11-Sep-2022,Miscellaneous,14.00,00.00,"410,140.97"
11-Sep-2022,NEFT,00.00,"136,713.66","273,427.31"
11-Sep-2022,Miscellaneous,00.00,"39,061.04","234,366.27"
11-Sep-2022,Reversal,"211,605.00",00.00,"445,971.27"
11-Sep-2022,Cash,00.00,"148,657.09","297,314.18"
11-Sep-2022,NEFT,"66,881.30",00.00,"364,195.48"
11-Sep-2022,Purchase,"235,515.50",00.00,"599,710.98"
11-Sep-2022,Miscellaneous,00.00,"119,942.20","479,768.78"
11-Sep-2022,Cash,00.00,"68,538.40","411,230.38"
11-Sep-2022,Transfer,"712,301.25",00.00,"1,123,531.63"
11-Sep-2022,Purchase,00.00,"112,353.16","1,011,178.47"
11-Sep-2022,Cash,"46,795.30",00.00,"1,057,973.77"
11-Sep-2022,IMPS,00.00,"117,552.64","940,421.13"
11-Sep-2022,IMPS,"67,118.00",00.00,"1,007,539.13"
11-Sep-2022,Purchase,03.80,00.00,"1,007,542.93"
11-Sep-2022,Reversal,00.00,"100,754.29","906,788.64"
11-Sep-2022,IMPS,"754,675.50",00.00,"1,661,464.14"
11-Sep-2022,Miscellaneous,00.00,"184,607.13","1,476,857.01"
11-Sep-2022,Reversal,00.00,"492,285.67","984,571.34"
11-Sep-2022,RTGS,450.31,00.00,"985,021.65"
11-Sep-2022,Debit Card,"1,393.20",00.00,"986,414.85"
11-Sep-2022,Commission,03.10,00.00,"986,417.95"
11-Sep-2022,Miscellaneous,00.00,"246,604.49","739,813.46"
11-Sep-2022,RTGS,"907,444.00",00.00,"1,647,257.46"
11-Sep-2022,NEFT,00.00,"549,085.82","1,098,171.64"
11-Sep-2022,Commission,00.00,"219,634.33","878,537.31"
11-Sep-2022,Reversal,444.00,00.00,"878,981.31"
11-Sep-2022,Tax,"984,423.00",00.00,"1,863,404.31"
11-Sep-2022,Reversal,00.00,"621,134.77","1,242,269.54"
11-Sep-2022,Debit Card,17.98,00.00,"1,242,287.52"
11-Sep-2022,Transfer,197.00,00.00,"1,242,484.52"
11-Sep-2022,Miscellaneous,00.00,"621,242.26","621,242.26"
11-Sep-2022,Miscellaneous,00.00,"103,540.38","517,701.88"
11-Sep-2022,Commission,00.00,"172,567.29","345,134.59"
11-Sep-2022,Purchase,00.00,"86,283.65","258,850.94"
11-Sep-2022,Reversal,01.00,00.00,"258,851.94"
11-Sep-2022,Transfer,00.00,"64,712.99","194,138.96"
11-Sep-2022,Cheque,00.00,"21,571.00","172,567.96"
11-Sep-2022,Tax,"212,374.50",00.00,"384,942.46"
11-Sep-2022,Miscellaneous,"1,739.60",00.00,"386,682.06"
11-Sep-2022,RTGS,"214,567.00",00.00,"601,249.06"
11-Sep-2022,Debit Card,"137,216.66",00.00,"738,465.72"
11-Sep-2022,IMPS,292.00,00.00,"738,757.72"
11-Sep-2022,ATM,09.90,00.00,"738,767.62"
11-Sep-2022,ATM,00.00,"82,085.29","656,682.33"
11-Sep-2022,RTGS,00.00,"93,811.76","562,870.57"
11-Sep-2022,Commission,00.00,"562,870.57",00.00
11-Sep-2022,Cheque,285.14,00.00,285.14
11-Sep-2022,Cheque,364.00,00.00,649.14
11-Sep-2022,Cash,00.00,81.14,568.00
11-Sep-2022,Reversal,"123,467.00",00.00,"124,035.00"
11-Sep-2022,Debit Card,00.00,"17,719.29","106,315.71"
11-Sep-2022,Cash,01.00,00.00,"106,316.71"
11-Sep-2022,Bill,"22,863.70",00.00,"129,180.41"
11-Sep-2022,Bill,00.00,"18,454.34","110,726.07"
11-Sep-2022,Cash,00.00,"11,072.61","99,653.46"
11-Sep-2022,Cash,00.00,"33,217.82","66,435.64"
11-Sep-2022,Purchase,"172,538.20",00.00,"238,973.84"
11-Sep-2022,Miscellaneous,00.00,"59,743.46","179,230.38"
11-Sep-2022,NEFT,00.00,"35,846.08","143,384.30"
11-Sep-2022,Interest,"3,011.30",00.00,"146,395.60"
11-Sep-2022,Miscellaneous,"9,193.00",00.00,"155,588.60"
12-Sep-2022,Tax,00.00,"19,448.58","136,140.02"
12-Sep-2022,ATM,03.20,00.00,"136,143.22"
12-Sep-2022,Debit Card,313.06,00.00,"136,456.28"
12-Sep-2022,RTGS,00.00,"34,114.07","102,342.21"
12-Sep-2022,Bill,00.00,"11,371.36","90,970.85"
12-Sep-2022,Cash,"1,167.38",00.00,"92,138.23"
12-Sep-2022,Tax,267.18,00.00,"92,405.41"
12-Sep-2022,Cheque,"16,743.30",00.00,"109,148.71"
13-Sep-2022,Tax,00.00,"36,382.90","72,765.81"
13-Sep-2022,Transfer,"3,033.00",00.00,"75,798.81"
13-Sep-2022,IMPS,00.00,"18,949.70","56,849.11"
13-Sep-2022,Bill,00.00,"5,684.91","51,164.20"
13-Sep-2022,IMPS,00.00,"7,309.17","43,855.03"
13-Sep-2022,Commission,17.36,00.00,"43,872.39"
13-Sep-2022,Commission,00.00,"6,267.48","37,604.91"
13-Sep-2022,Cheque,00.00,"3,760.49","33,844.42"
13-Sep-2022,Purchase,53.00,00.00,"33,897.42"
14-Sep-2022,Bill,00.00,"4,237.18","29,660.24"
14-Sep-2022,Cash,"253,603.50",00.00,"283,263.74"
14-Sep-2022,RTGS,"2,745.05",00.00,"286,008.79"
14-Sep-2022,Tax,419.89,00.00,"286,428.68"
14-Sep-2022,Commission,00.00,"35,803.59","250,625.10"
14-Sep-2022,Cheque,22.20,00.00,"250,647.30"
15-Sep-2022,Cheque,00.00,"250,647.30",00.00
15-Sep-2022,Purchase,"259,679.00",00.00,"259,679.00"
15-Sep-2022,Reversal,00.00,"86,559.67","173,119.33"
15-Sep-2022,Interest,"31,501.00",00.00,"204,620.33"
15-Sep-2022,Miscellaneous,00.00,"40,924.07","163,696.26"
15-Sep-2022,RTGS,00.00,"23,385.18","140,311.08"
15-Sep-2022,Transfer,659.00,00.00,"140,970.08"
15-Sep-2022,Tax,"90,590.56",00.00,"231,560.64"
15-Sep-2022,Purchase,00.00,"28,945.08","202,615.56"
15-Sep-2022,ATM,00.00,"28,945.08","173,670.48"
15-Sep-2022,ATM,"150,557.20",00.00,"324,227.68"
15-Sep-2022,ATM,"173,647.50",00.00,"497,875.18"
15-Sep-2022,Cheque,00.00,"248,937.59","248,937.59"
15-Sep-2022,Reversal,00.00,"31,117.20","217,820.39"
15-Sep-2022,IMPS,"969,949.00",00.00,"1,187,769.39"
15-Sep-2022,Cheque,235.30,00.00,"1,188,004.69"
15-Sep-2022,Debit Card,"179,962.30",00.00,"1,367,966.99"
15-Sep-2022,ATM,00.00,"683,983.50","683,983.50"
15-Sep-2022,Cheque,00.00,"341,991.75","341,991.75"
15-Sep-2022,Reversal,00.00,"34,199.18","307,792.58"
15-Sep-2022,ATM,"752,437.25",00.00,"1,060,229.83"
15-Sep-2022,ATM,55.60,00.00,"1,060,285.43"
15-Sep-2022,Reversal,"1,435,298.80",00.00,"2,495,584.23"
15-Sep-2022,Commission,"1,665,568.50",00.00,"4,161,152.73"
15-Sep-2022,Reversal,06.20,00.00,"4,161,158.93"
15-Sep-2022,RTGS,"1,371,610.00",00.00,"5,532,768.93"
15-Sep-2022,ATM,"1,256,566.00",00.00,"6,789,334.93"
15-Sep-2022,Miscellaneous,00.00,"1,697,333.73","5,092,001.20"
15-Sep-2022,Reversal,00.00,"727,428.74","4,364,572.46"
15-Sep-2022,Debit Card,00.00,"4,364,572.46",00.00
15-Sep-2022,Debit Card,01.21,00.00,01.21
15-Sep-2022,Reversal,"23,094.00",00.00,"23,095.21"
15-Sep-2022,Miscellaneous,534.60,00.00,"23,629.81"
15-Sep-2022,Cash,00.00,"2,362.98","21,266.83"
15-Sep-2022,Tax,"3,891.00",00.00,"25,157.83"
15-Sep-2022,Cheque,00.00,"12,578.92","12,578.92"
15-Sep-2022,Reversal,00.00,"1,796.99","10,781.93"
15-Sep-2022,Cash,00.00,"1,796.99","8,984.94"
16-Sep-2022,Bill,00.00,"1,796.99","7,187.95"
16-Sep-2022,RTGS,"1,670,988.50",00.00,"1,678,176.45"
16-Sep-2022,Interest,"305,028.00",00.00,"1,983,204.45"
16-Sep-2022,IMPS,00.00,"1,983,204.45",00.00
16-Sep-2022,Interest,24.00,00.00,24.00
16-Sep-2022,Transfer,00.00,03.00,21.00
16-Sep-2022,IMPS,35.00,00.00,56.00
16-Sep-2022,Debit Card,"3,825.50",00.00,"3,881.50"
16-Sep-2022,NEFT,02.90,00.00,"3,884.40"
16-Sep-2022,Miscellaneous,00.00,388.44,"3,495.96"
17-Sep-2022,Transfer,00.00,699.19,"2,796.77"
17-Sep-2022,Transfer,510.20,00.00,"3,306.97"
17-Sep-2022,Commission,00.00,826.74,"2,480.23"
17-Sep-2022,Interest,03.78,00.00,"2,484.01"
18-Sep-2022,Bill,"133,785.70",00.00,"136,269.71"
18-Sep-2022,Commission,00.00,"136,269.71",00.00
19-Sep-2022,NEFT,04.42,00.00,04.42
19-Sep-2022,Transfer,00.00,02.21,02.21
19-Sep-2022,Bill,00.00,00.22,01.99
19-Sep-2022,RTGS,"7,859.00",00.00,"7,860.99"
19-Sep-2022,Interest,31.76,00.00,"7,892.75"
19-Sep-2022,Bill,61.58,00.00,"7,954.33"
19-Sep-2022,ATM,00.00,"7,954.33",00.00
19-Sep-2022,Reversal,428.87,00.00,428.87
20-Sep-2022,Miscellaneous,00.00,61.27,367.60
20-Sep-2022,Bill,07.73,00.00,375.33
20-Sep-2022,Reversal,48.20,00.00,423.53
20-Sep-2022,Miscellaneous,231.79,00.00,655.32
20-Sep-2022,Purchase,00.00,72.81,582.51
20-Sep-2022,Debit Card,00.00,83.22,499.29
20-Sep-2022,Transfer,"3,984.00",00.00,"4,483.29"
20-Sep-2022,NEFT,00.00,640.47,"3,842.82"
20-Sep-2022,Miscellaneous,63.80,00.00,"3,906.62"
20-Sep-2022,Commission,"27,486.60",00.00,"31,393.22"
20-Sep-2022,ATM,16.95,00.00,"31,410.17"
20-Sep-2022,Commission,"2,265.60",00.00,"33,675.77"
20-Sep-2022,Cash,284.69,00.00,"33,960.46"
20-Sep-2022,Debit Card,00.00,"8,490.12","25,470.34"
20-Sep-2022,Transfer,00.00,"8,490.11","16,980.23"
20-Sep-2022,Debit Card,"168,649.00",00.00,"185,629.23"
20-Sep-2022,Cheque,"193,570.00",00.00,"379,199.23"
20-Sep-2022,Debit Card,00.00,"54,171.32","325,027.91"
20-Sep-2022,NEFT,60.56,00.00,"325,088.47"
20-Sep-2022,Miscellaneous,00.00,"40,636.06","284,452.41"
20-Sep-2022,Miscellaneous,00.00,"284,452.41",00.00
20-Sep-2022,Tax,"157,651.00",00.00,"157,651.00"
20-Sep-2022,Tax,77.40,00.00,"157,728.40"
20-Sep-2022,Interest,431.00,00.00,"158,159.40"
20-Sep-2022,Tax,00.00,"15,815.94","142,343.46"
20-Sep-2022,ATM,00.00,"23,723.91","118,619.55"
20-Sep-2022,Cheque,"52,301.00",00.00,"170,920.55"
20-Sep-2022,ATM,00.00,"42,730.14","128,190.41"
20-Sep-2022,Reversal,00.00,"64,095.21","64,095.20"
20-Sep-2022,Transfer,107.20,00.00,"64,202.40"
20-Sep-2022,Cash,00.00,"32,101.20","32,101.20"
20-Sep-2022,Interest,00.00,"32,101.20",00.00
20-Sep-2022,Miscellaneous,45.00,00.00,45.00
20-Sep-2022,Miscellaneous,00.00,05.00,40.00
20-Sep-2022,Interest,00.00,05.71,34.29
20-Sep-2022,Reversal,06.98,00.00,41.27
20-Sep-2022,ATM,00.00,05.90,35.37
20-Sep-2022,Tax,00.00,17.69,17.68
20-Sep-2022,Debit Card,00.00,08.84,08.84
20-Sep-2022,Miscellaneous,"226,397.00",00.00,"226,405.84"
20-Sep-2022,Bill,00.00,"37,734.31","188,671.53"
20-Sep-2022,RTGS,113.00,00.00,"188,784.53"
20-Sep-2022,Commission,00.00,"20,976.06","167,808.47"
20-Sep-2022,RTGS,00.00,"16,780.85","151,027.62"
20-Sep-2022,Debit Card,"28,400.80",00.00,"179,428.42"
20-Sep-2022,Purchase,00.00,"25,632.63","153,795.79"
20-Sep-2022,Reversal,510.90,00.00,"154,306.69"
20-Sep-2022,Purchase,00.00,"15,430.67","138,876.02"
20-Sep-2022,RTGS,"11,037.00",00.00,"149,913.02"
20-Sep-2022,IMPS,"1,814.16",00.00,"151,727.18"
20-Sep-2022,Reversal,218.90,00.00,"151,946.08"
20-Sep-2022,Bill,"4,082.00",00.00,"156,028.08"
20-Sep-2022,NEFT,01.40,00.00,"156,029.48"
20-Sep-2022,Purchase,00.00,"78,014.74","78,014.74"
20-Sep-2022,Transfer,00.00,"78,014.74",00.00
20-Sep-2022,Commission,"174,295.00",00.00,"174,295.00"
20-Sep-2022,Commission,199.90,00.00,"174,494.90"
20-Sep-2022,Cheque,00.00,"24,927.84","149,567.06"
20-Sep-2022,Miscellaneous,147.00,00.00,"149,714.06"
20-Sep-2022,Cash,"2,865.20",00.00,"152,579.26"
20-Sep-2022,IMPS,00.00,"38,144.82","114,434.44"
20-Sep-2022,Transfer,"750,596.00",00.00,"865,030.44"
20-Sep-2022,Cheque,"1,576,099.20",00.00,"2,441,129.64"
20-Sep-2022,Cash,"9,206.20",00.00,"2,450,335.84"
20-Sep-2022,Reversal,00.00,"2,450,335.84",00.00
20-Sep-2022,Tax,01.59,00.00,01.59
20-Sep-2022,ATM,00.00,00.27,01.33
20-Sep-2022,Transfer,00.00,00.17,01.16
20-Sep-2022,Cash,813.63,00.00,814.79
20-Sep-2022,RTGS,00.00,203.70,611.09
20-Sep-2022,Miscellaneous,00.00,61.11,549.98
20-Sep-2022,Debit Card,"1,771,715.00",00.00,"1,772,264.98"
20-Sep-2022,Cash,00.00,"177,226.50","1,595,038.48"
20-Sep-2022,NEFT,00.00,"227,862.64","1,367,175.84"
20-Sep-2022,Debit Card,321.50,00.00,"1,367,497.34"
20-Sep-2022,Miscellaneous,00.00,"136,749.73","1,230,747.61"
20-Sep-2022,Bill,00.00,"1,230,747.61",00.00
20-Sep-2022,Commission,"82,293.94",00.00,"82,293.94"
20-Sep-2022,Bill,"18,005.74",00.00,"100,299.68"
20-Sep-2022,ATM,00.00,"25,074.92","75,224.76"
20-Sep-2022,ATM,00.00,"7,522.48","67,702.28"
20-Sep-2022,NEFT,00.00,"6,770.23","60,932.05"
21-Sep-2022,RTGS,00.00,"30,466.03","30,466.02"
21-Sep-2022,Miscellaneous,"2,496.88",00.00,"32,962.90"
21-Sep-2022,Purchase,00.00,"8,240.73","24,722.18"
21-Sep-2022,Miscellaneous,"2,970.60",00.00,"27,692.78"
21-Sep-2022,RTGS,57.64,00.00,"27,750.42"
21-Sep-2022,Commission,"1,032,879.00",00.00,"1,060,629.42"
21-Sep-2022,RTGS,485.40,00.00,"1,061,114.82"
21-Sep-2022,Cash,"6,574.00",00.00,"1,067,688.82"
21-Sep-2022,Transfer,"31,390.38",00.00,"1,099,079.20"
21-Sep-2022,Reversal,"153,914.00",00.00,"1,252,993.20"
21-Sep-2022,Transfer,00.00,"156,624.15","1,096,369.05"
21-Sep-2022,NEFT,00.00,"274,092.26","822,276.79"
21-Sep-2022,Cheque,00.00,"164,455.36","657,821.43"
21-Sep-2022,Tax,00.00,"131,564.29","526,257.14"
21-Sep-2022,Bill,00.00,"105,251.43","421,005.71"
21-Sep-2022,Purchase,00.00,"60,143.67","360,862.04"
21-Sep-2022,Cheque,02.00,00.00,"360,864.04"
21-Sep-2022,Debit Card,00.00,"360,864.04",00.00
21-Sep-2022,Reversal,"43,595.47",00.00,"43,595.47"
21-Sep-2022,NEFT,00.00,"43,595.47",00.00
21-Sep-2022,NEFT,"2,149.52",00.00,"2,149.52"
21-Sep-2022,Tax,00.00,537.38,"1,612.14"
21-Sep-2022,Debit Card,"235,074.00",00.00,"236,686.14"
21-Sep-2022,Commission,322.70,00.00,"237,008.84"
22-Sep-2022,Debit Card,00.00,"59,252.21","177,756.63"
22-Sep-2022,Cheque,00.00,"44,439.16","133,317.47"
22-Sep-2022,Purchase,56.20,00.00,"133,373.67"
22-Sep-2022,Interest,853.00,00.00,"134,226.67"
22-Sep-2022,Cheque,00.00,"19,175.24","115,051.43"
22-Sep-2022,Commission,"238,154.12",00.00,"353,205.55"
22-Sep-2022,Transfer,00.00,"117,735.18","235,470.37"
22-Sep-2022,Interest,00.00,"235,470.37",00.00
22-Sep-2022,Interest,"257,497.28",00.00,"257,497.28"
22-Sep-2022,RTGS,02.40,00.00,"257,499.68"
22-Sep-2022,RTGS,"78,749.00",00.00,"336,248.68"
22-Sep-2022,Interest,00.00,"112,082.89","224,165.79"
22-Sep-2022,Commission,00.00,"37,360.97","186,804.82"
22-Sep-2022,RTGS,"3,362.26",00.00,"190,167.08"
22-Sep-2022,Cash,03.00,00.00,"190,170.08"
22-Sep-2022,Miscellaneous,08.00,00.00,"190,178.08"
22-Sep-2022,Transfer,00.00,"19,017.81","171,160.27"
22-Sep-2022,IMPS,00.00,"57,053.42","114,106.85"
22-Sep-2022,RTGS,00.00,"57,053.43","57,053.42"
22-Sep-2022,Purchase,00.00,"6,339.27","50,714.15"
22-Sep-2022,Debit Card,00.00,"25,357.08","25,357.08"
22-Sep-2022,IMPS,"314,685.00",00.00,"340,042.08"
22-Sep-2022,Tax,00.00,"37,782.45","302,259.63"
22-Sep-2022,NEFT,02.92,00.00,"302,262.55"
22-Sep-2022,Cheque,228.50,00.00,"302,491.05"
22-Sep-2022,Reversal,00.00,"37,811.38","264,679.67"
22-Sep-2022,RTGS,00.00,"66,169.92","198,509.75"
22-Sep-2022,Interest,00.00,"198,509.75",00.00
22-Sep-2022,Commission,20.80,00.00,20.80
22-Sep-2022,Debit Card,00.00,10.40,10.40
22-Sep-2022,RTGS,00.00,05.20,05.20
22-Sep-2022,Transfer,00.00,00.52,04.68
22-Sep-2022,Cash,06.60,00.00,11.28
22-Sep-2022,Purchase,00.00,01.13,10.15
23-Sep-2022,Interest,00.00,10.15,00.00
23-Sep-2022,Cheque,"9,675.90",00.00,"9,675.90"
23-Sep-2022,Reversal,29.80,00.00,"9,705.70"
23-Sep-2022,Debit Card,"1,969.08",00.00,"11,674.78"
23-Sep-2022,Tax,00.00,"1,167.48","10,507.30"
23-Sep-2022,RTGS,00.00,"2,101.46","8,405.84"
23-Sep-2022,Bill,00.00,"1,050.73","7,355.11"
23-Sep-2022,Debit Card,00.00,817.23,"6,537.88"
23-Sep-2022,Reversal,00.00,726.43,"5,811.45"
23-Sep-2022,Bill,"88,446.70",00.00,"94,258.15"
23-Sep-2022,Interest,00.00,"13,465.45","80,792.70"
23-Sep-2022,Purchase,00.00,"8,976.97","71,815.73"
23-Sep-2022,Cash,00.00,"11,969.29","59,846.44"
23-Sep-2022,Cash,00.00,"8,549.49","51,296.95"
23-Sep-2022,Interest,00.00,"51,296.95",00.00
23-Sep-2022,Purchase,"1,801,962.00",00.00,"1,801,962.00"
23-Sep-2022,Purchase,"639,749.75",00.00,"2,441,711.75"
23-Sep-2022,Tax,00.00,"348,815.96","2,092,895.79"
23-Sep-2022,Miscellaneous,00.00,"418,579.16","1,674,316.63"
23-Sep-2022,Cheque,00.00,"558,105.54","1,116,211.09"
23-Sep-2022,Cheque,00.00,"558,105.55","558,105.55"
23-Sep-2022,Tax,00.00,"558,105.55",00.00
23-Sep-2022,Miscellaneous,"1,931,438.25",00.00,"1,931,438.25"
23-Sep-2022,Cheque,47.00,00.00,"1,931,485.25"
23-Sep-2022,Commission,03.40,00.00,"1,931,488.65"
23-Sep-2022,Interest,506.20,00.00,"1,931,994.85"
23-Sep-2022,NEFT,00.00,"386,398.97","1,545,595.88"
23-Sep-2022,RTGS,00.00,"1,545,595.88",00.00
23-Sep-2022,NEFT,03.00,00.00,03.00
23-Sep-2022,RTGS,"338,268.50",00.00,"338,271.50"
23-Sep-2022,Interest,"191,970.50",00.00,"530,242.00"
23-Sep-2022,ATM,"756,054.00",00.00,"1,286,296.00"
23-Sep-2022,Miscellaneous,"856,210.00",00.00,"2,142,506.00"
23-Sep-2022,Bill,00.00,"357,084.33","1,785,421.67"
23-Sep-2022,Reversal,263.76,00.00,"1,785,685.43"
24-Sep-2022,Miscellaneous,00.00,"223,210.68","1,562,474.75"
24-Sep-2022,Reversal,00.00,"156,247.48","1,406,227.28"
24-Sep-2022,ATM,00.00,"156,247.48","1,249,979.80"
24-Sep-2022,Tax,00.00,"624,989.90","624,989.90"
24-Sep-2022,Bill,461.00,00.00,"625,450.90"
24-Sep-2022,Cash,354.69,00.00,"625,805.59"
24-Sep-2022,IMPS,00.00,"69,533.95","556,271.64"
24-Sep-2022,Transfer,"3,867.18",00.00,"560,138.82"
24-Sep-2022,Interest,960.10,00.00,"561,098.92"
24-Sep-2022,Debit Card,"2,877.00",00.00,"563,975.92"
25-Sep-2022,Purchase,00.00,"281,987.96","281,987.96"
25-Sep-2022,Reversal,00.00,"28,198.80","253,789.16"
25-Sep-2022,NEFT,00.00,"31,723.65","222,065.52"
25-Sep-2022,Transfer,00.00,"22,206.55","199,858.97"
25-Sep-2022,NEFT,"143,660.00",00.00,"343,518.97"
25-Sep-2022,NEFT,"8,108.10",00.00,"351,627.07"
25-Sep-2022,Bill,"14,579.70",00.00,"366,206.77"
25-Sep-2022,IMPS,"1,030.26",00.00,"367,237.03"
25-Sep-2022,RTGS,"2,068.93",00.00,"369,305.96"
25-Sep-2022,RTGS,213.08,00.00,"369,519.04"
25-Sep-2022,RTGS,"21,094.88",00.00,"390,613.92"
25-Sep-2022,Interest,00.00,"130,204.64","260,409.28"
26-Sep-2022,Miscellaneous,"1,457,657.50",00.00,"1,718,066.78"
27-Sep-2022,RTGS,00.00,"859,033.39","859,033.39"
27-Sep-2022,NEFT,"23,233.00",00.00,"882,266.39"
27-Sep-2022,Debit Card,00.00,"220,566.60","661,699.79"
28-Sep-2022,Transfer,00.00,"132,339.96","529,359.83"
29-Sep-2022,Reversal,"3,480.84",00.00,"532,840.67"
29-Sep-2022,Tax,222.80,00.00,"533,063.47"
29-Sep-2022,Commission,00.00,"76,151.92","456,911.55"
29-Sep-2022,Cheque,"16,324.00",00.00,"473,235.55"
29-Sep-2022,Interest,00.00,"59,154.44","414,081.11"
29-Sep-2022,Miscellaneous,00.00,"69,013.52","345,067.59"
29-Sep-2022,RTGS,00.00,"34,506.76","310,560.83"
29-Sep-2022,Interest,00.00,"31,056.08","279,504.75"
29-Sep-2022,Commission,"29,682.30",00.00,"309,187.05"
29-Sep-2022,Bill,00.00,"77,296.76","231,890.29"
29-Sep-2022,Reversal,39.36,00.00,"231,929.65"
29-Sep-2022,Interest,00.00,"46,385.93","185,543.72"
29-Sep-2022,IMPS,"567,285.25",00.00,"752,828.97"
29-Sep-2022,Reversal,00.00,"83,647.66","669,181.31"
29-Sep-2022,Cash,00.00,"83,647.66","585,533.65"
29-Sep-2022,ATM,"15,772.06",00.00,"601,305.71"
29-Sep-2022,ATM,00.00,"120,261.14","481,044.57"
29-Sep-2022,ATM,00.00,"68,720.65","412,323.92"
29-Sep-2022,Purchase,00.00,"41,232.39","371,091.53"
29-Sep-2022,ATM,02.00,00.00,"371,093.53"
29-Sep-2022,Miscellaneous,00.00,"185,546.77","185,546.76"
29-Sep-2022,Interest,"2,056.40",00.00,"187,603.16"
29-Sep-2022,IMPS,00.00,"62,534.39","125,068.77"
29-Sep-2022,IMPS,01.00,00.00,"125,069.77"
29-Sep-2022,IMPS,00.00,"17,867.11","107,202.66"
29-Sep-2022,Commission,"65,874.00",00.00,"173,076.66"
29-Sep-2022,Miscellaneous,00.00,"34,615.33","138,461.33"
29-Sep-2022,Debit Card,00.00,"15,384.59","123,076.74"
29-Sep-2022,ATM,148.00,00.00,"123,224.74"
29-Sep-2022,Cash,"29,815.92",00.00,"153,040.66"
29-Sep-2022,Miscellaneous,00.00,"15,304.07","137,736.59"
29-Sep-2022,Cash,00.00,"19,676.66","118,059.93"
29-Sep-2022,Bill,00.00,"11,805.99","106,253.94"
29-Sep-2022,Commission,07.00,00.00,"106,260.94"
29-Sep-2022,ATM,00.00,"21,252.19","85,008.75"
29-Sep-2022,Debit Card,00.00,"12,144.11","72,864.64"
29-Sep-2022,IMPS,00.00,"12,144.11","60,720.53"
29-Sep-2022,Reversal,00.00,"10,120.09","50,600.44"
29-Sep-2022,Cheque,00.00,"7,228.63","43,371.81"
29-Sep-2022,Interest,"1,413,730.00",00.00,"1,457,101.81"
29-Sep-2022,Tax,53.63,00.00,"1,457,155.44"
29-Sep-2022,Miscellaneous,06.42,00.00,"1,457,161.86"
29-Sep-2022,Transfer,"92,968.97",00.00,"1,550,130.83"
29-Sep-2022,Cash,59.00,00.00,"1,550,189.83"
29-Sep-2022,Bill,"1,376.78",00.00,"1,551,566.61"
29-Sep-2022,Tax,00.00,"387,891.65","1,163,674.96"
29-Sep-2022,Miscellaneous,03.00,00.00,"1,163,677.96"
29-Sep-2022,Transfer,12.13,00.00,"1,163,690.09"
29-Sep-2022,RTGS,00.00,"290,922.52","872,767.57"
29-Sep-2022,Debit Card,00.00,"218,191.89","654,575.68"
29-Sep-2022,Transfer,00.00,"72,730.63","581,845.05"
29-Sep-2022,ATM,00.00,"96,974.18","484,870.88"
29-Sep-2022,Bill,"1,832.80",00.00,"486,703.68"
29-Sep-2022,ATM,84.79,00.00,"486,788.47"
29-Sep-2022,Commission,04.79,00.00,"486,793.26"
29-Sep-2022,Debit Card,00.00,"81,132.21","405,661.05"
29-Sep-2022,IMPS,00.00,"81,132.21","324,528.84"
29-Sep-2022,Commission,"1,265.70",00.00,"325,794.54"
29-Sep-2022,ATM,00.00,"36,199.39","289,595.15"
29-Sep-2022,Transfer,00.00,"72,398.79","217,196.36"
29-Sep-2022,Debit Card,258.83,00.00,"217,455.19"
29-Sep-2022,Purchase,00.00,"43,491.04","173,964.15"
29-Sep-2022,Cash,00.00,"21,745.52","152,218.63"
29-Sep-2022,IMPS,00.00,"30,443.73","121,774.90"
29-Sep-2022,Bill,00.00,"15,221.86","106,553.04"
29-Sep-2022,NEFT,00.00,"21,310.61","85,242.43"
29-Sep-2022,Reversal,00.00,"12,177.49","73,064.94"
29-Sep-2022,Tax,00.00,"10,437.85","62,627.09"
29-Sep-2022,NEFT,00.00,"8,946.73","53,680.36"
29-Sep-2022,Bill,00.00,"8,946.73","44,733.63"
29-Sep-2022,Bill,"3,224.90",00.00,"47,958.53"
29-Sep-2022,Transfer,330.30,00.00,"48,288.83"
29-Sep-2022,Transfer,00.00,"6,898.40","41,390.43"
29-Sep-2022,NEFT,00.00,"20,695.22","20,695.22"
29-Sep-2022,Purchase,"1,387,615.80",00.00,"1,408,311.02"
29-Sep-2022,NEFT,00.00,"1,408,311.02",00.00
29-Sep-2022,Cash,"233,572.66",00.00,"233,572.66"
29-Sep-2022,Commission,00.00,"46,714.53","186,858.13"
29-Sep-2022,RTGS,"2,776.00",00.00,"189,634.13"
29-Sep-2022,Commission,"597,392.50",00.00,"787,026.63"
29-Sep-2022,RTGS,00.00,"262,342.21","524,684.42"
29-Sep-2022,Reversal,00.00,"87,447.40","437,237.02"
29-Sep-2022,Transfer,"17,693.59",00.00,"454,930.61"
29-Sep-2022,Transfer,00.00,"454,930.61",00.00
29-Sep-2022,Cheque,307.00,00.00,307.00
29-Sep-2022,Commission,"6,082.00",00.00,"6,389.00"
29-Sep-2022,RTGS,00.00,798.63,"5,590.38"
29-Sep-2022,Bill,46.00,00.00,"5,636.38"
29-Sep-2022,ATM,268.70,00.00,"5,905.08"
29-Sep-2022,ATM,"2,322.12",00.00,"8,227.20"
29-Sep-2022,NEFT,00.00,"2,742.40","5,484.80"
29-Sep-2022,Cash,00.00,685.60,"4,799.20"
29-Sep-2022,Transfer,"1,229,553.20",00.00,"1,234,352.40"
29-Sep-2022,Cash,00.00,"123,435.24","1,110,917.16"
29-Sep-2022,NEFT,00.00,"158,702.45","952,214.71"
29-Sep-2022,Tax,"145,239.60",00.00,"1,097,454.31"
29-Sep-2022,Interest,00.00,"109,745.43","987,708.88"
29-Sep-2022,Reversal,"2,065,590.00",00.00,"3,053,298.88"
29-Sep-2022,RTGS,"7,326.00",00.00,"3,060,624.88"
29-Sep-2022,Cash,29.00,00.00,"3,060,653.88"
29-Sep-2022,Cash,"225,618.91",00.00,"3,286,272.79"
29-Sep-2022,Interest,02.51,00.00,"3,286,275.30"
29-Sep-2022,Bill,00.00,"1,643,137.65","1,643,137.65"
29-Sep-2022,IMPS,00.00,"234,733.95","1,408,403.70"
29-Sep-2022,Bill,01.10,00.00,"1,408,404.80"
29-Sep-2022,RTGS,00.00,"1,408,404.80",00.00
29-Sep-2022,IMPS,18.31,00.00,18.31
29-Sep-2022,Miscellaneous,00.00,03.05,15.26
29-Sep-2022,Purchase,"179,608.00",00.00,"179,623.26"
29-Sep-2022,Debit Card,00.00,"179,623.26",00.00
29-Sep-2022,Commission,23.25,00.00,23.25
29-Sep-2022,NEFT,00.00,23.25,00.00
29-Sep-2022,Reversal,"256,184.00",00.00,"256,184.00"
29-Sep-2022,Cheque,00.00,"256,184.00",00.00
29-Sep-2022,Cash,"192,911.72",00.00,"192,911.72"
29-Sep-2022,NEFT,00.00,"27,558.82","165,352.90"
29-Sep-2022,Transfer,00.00,"27,558.82","137,794.08"
29-Sep-2022,ATM,160.00,00.00,"137,954.08"
29-Sep-2022,Debit Card,"1,178,096.80",00.00,"1,316,050.88"
29-Sep-2022,RTGS,135.20,00.00,"1,316,186.08"
29-Sep-2022,Interest,00.00,"188,026.58","1,128,159.50"
29-Sep-2022,Reversal,"3,174.55",00.00,"1,131,334.05"
29-Sep-2022,Reversal,00.00,"282,833.51","848,500.54"
30-Sep-2022,Cheque,63.00,00.00,"848,563.54"
30-Sep-2022,Tax,02.25,00.00,"848,565.79"
30-Sep-2022,Reversal,02.21,00.00,"848,568.00"
30-Sep-2022,ATM,00.00,"212,142.00","636,426.00"
30-Sep-2022,Transfer,386.20,00.00,"636,812.20"
30-Sep-2022,Bill,"13,104.19",00.00,"649,916.39"
30-Sep-2022,IMPS,"3,614.22",00.00,"653,530.61"
30-Sep-2022,Reversal,"1,055.00",00.00,"654,585.61"
30-Sep-2022,Transfer,"2,603.22",00.00,"657,188.83"
30-Sep-2022,RTGS,52.89,00.00,"657,241.72"
30-Sep-2022,Debit Card,00.00,"109,540.29","547,701.43"
30-Sep-2022,Transfer,"17,559.95",00.00,"565,261.38"
30-Sep-2022,IMPS,"110,637.30",00.00,"675,898.68"
30-Sep-2022,ATM,"16,114.25",00.00,"692,012.93"
30-Sep-2022,ATM,"7,202.06",00.00,"699,214.99"
30-Sep-2022,Transfer,00.00,"69,921.50","629,293.49"
30-Sep-2022,ATM,00.00,"314,646.75","314,646.74"
01-Oct-2022,Commission,00.00,"62,929.35","251,717.39"
01-Oct-2022,Cash,"1,782,127.00",00.00,"2,033,844.39"
01-Oct-2022,Bill,00.00,"677,948.13","1,355,896.26"
01-Oct-2022,ATM,"1,527.13",00.00,"1,357,423.39"
01-Oct-2022,RTGS,"1,278.20",00.00,"1,358,701.59"
01-Oct-2022,Purchase,"1,093,626.00",00.00,"2,452,327.59"
01-Oct-2022,Miscellaneous,00.00,"1,226,163.80","1,226,163.80"
01-Oct-2022,Miscellaneous,"4,128.40",00.00,"1,230,292.20"
01-Oct-2022,IMPS,00.00,"153,786.53","1,076,505.68"
01-Oct-2022,NEFT,00.00,"358,835.23","717,670.45"
01-Oct-2022,RTGS,"1,448,969.00",00.00,"2,166,639.45"
01-Oct-2022,Cash,"31,526.35",00.00,"2,198,165.80"
01-Oct-2022,Tax,03.60,00.00,"2,198,169.40"
01-Oct-2022,Cash,00.00,"314,024.20","1,884,145.20"
01-Oct-2022,Commission,00.00,"209,349.47","1,674,795.73"
01-Oct-2022,Tax,00.00,"239,256.53","1,435,539.20"
01-Oct-2022,Interest,00.00,"358,884.80","1,076,654.40"
01-Oct-2022,Purchase,00.00,"538,327.20","538,327.20"
01-Oct-2022,Debit Card,"144,985.80",00.00,"683,313.00"
01-Oct-2022,ATM,00.00,"85,414.13","597,898.88"
01-Oct-2022,Debit Card,413.40,00.00,"598,312.28"
01-Oct-2022,Cash,"20,425.60",00.00,"618,737.88"
01-Oct-2022,Interest,00.00,"309,368.94","309,368.94"
01-Oct-2022,IMPS,00.00,"309,368.94",00.00
01-Oct-2022,Debit Card,"90,169.00",00.00,"90,169.00"
01-Oct-2022,RTGS,00.00,"9,016.90","81,152.10"
01-Oct-2022,RTGS,00.00,"11,593.16","69,558.94"
01-Oct-2022,Miscellaneous,00.00,"8,694.87","60,864.07"
01-Oct-2022,Bill,00.00,"60,864.07",00.00
01-Oct-2022,NEFT,"2,086.70",00.00,"2,086.70"
02-Oct-2022,IMPS,00.00,417.34,"1,669.36"
02-Oct-2022,Reversal,00.00,278.23,"1,391.13"
02-Oct-2022,Miscellaneous,00.00,139.11,"1,252.02"
02-Oct-2022,NEFT,00.00,208.67,"1,043.35"
02-Oct-2022,Interest,00.00,104.34,939.01
02-Oct-2022,IMPS,00.00,104.33,834.68
02-Oct-2022,Cheque,"2,054,896.20",00.00,"2,055,730.88"
02-Oct-2022,Miscellaneous,00.00,"256,966.36","1,798,764.52"
02-Oct-2022,IMPS,"168,406.00",00.00,"1,967,170.52"
02-Oct-2022,Purchase,492.70,00.00,"1,967,663.22"
02-Oct-2022,Bill,"208,146.40",00.00,"2,175,809.62"
02-Oct-2022,Bill,"3,621.99",00.00,"2,179,431.61"
02-Oct-2022,NEFT,"3,763.10",00.00,"2,183,194.71"
02-Oct-2022,NEFT,00.00,"363,865.79","1,819,328.92"
02-Oct-2022,Tax,52.40,00.00,"1,819,381.32"
02-Oct-2022,Tax,171.39,00.00,"1,819,552.71"
02-Oct-2022,Interest,00.00,"303,258.79","1,516,293.92"
03-Oct-2022,Transfer,"163,137.20",00.00,"1,679,431.12"
03-Oct-2022,Cheque,"134,775.00",00.00,"1,814,206.12"
03-Oct-2022,IMPS,166.00,00.00,"1,814,372.12"
03-Oct-2022,Tax,24.00,00.00,"1,814,396.12"
03-Oct-2022,Miscellaneous,219.00,00.00,"1,814,615.12"
03-Oct-2022,Miscellaneous,472.58,00.00,"1,815,087.70"
04-Oct-2022,Reversal,"1,122.62",00.00,"1,816,210.32"
04-Oct-2022,Commission,00.00,"454,052.58","1,362,157.74"
04-Oct-2022,Transfer,"10,212.49",00.00,"1,372,370.23"
04-Oct-2022,NEFT,00.00,"686,185.12","686,185.12"
04-Oct-2022,Purchase,00.00,"171,546.28","514,638.84"
04-Oct-2022,Commission,"5,864.70",00.00,"520,503.54"
04-Oct-2022,Interest,"654,874.50",00.00,"1,175,378.04"
04-Oct-2022,RTGS,00.00,"117,537.80","1,057,840.24"
04-Oct-2022,Cash,00.00,"151,120.03","906,720.21"
04-Oct-2022,Debit Card,05.00,00.00,"906,725.21"
04-Oct-2022,Bill,00.00,"129,532.17","777,193.04"
05-Oct-2022,Tax,00.00,"777,193.04",00.00
05-Oct-2022,Purchase,"230,307.88",00.00,"230,307.88"
05-Oct-2022,Reversal,"810,994.80",00.00,"1,041,302.68"
05-Oct-2022,Cash,00.00,"260,325.67","780,977.01"
06-Oct-2022,NEFT,"23,942.13",00.00,"804,919.14"
06-Oct-2022,Debit Card,32.70,00.00,"804,951.84"
06-Oct-2022,IMPS,00.00,"89,439.09","715,512.75"
06-Oct-2022,Transfer,"889,547.50",00.00,"1,605,060.25"
06-Oct-2022,Interest,34.90,00.00,"1,605,095.15"
06-Oct-2022,Transfer,"3,399.92",00.00,"1,608,495.07"
06-Oct-2022,NEFT,"4,076.00",00.00,"1,612,571.07"
06-Oct-2022,Interest,00.00,"179,174.56","1,433,396.51"
06-Oct-2022,Bill,"14,966.00",00.00,"1,448,362.51"
06-Oct-2022,IMPS,04.80,00.00,"1,448,367.31"
06-Oct-2022,Purchase,89.10,00.00,"1,448,456.41"
06-Oct-2022,Reversal,"18,293.50",00.00,"1,466,749.91"
06-Oct-2022,IMPS,"144,682.16",00.00,"1,611,432.07"
06-Oct-2022,Commission,00.00,"268,572.01","1,342,860.06"
06-Oct-2022,Purchase,37.00,00.00,"1,342,897.06"
06-Oct-2022,Transfer,204.76,00.00,"1,343,101.82"
06-Oct-2022,Commission,00.00,"268,620.36","1,074,481.46"
06-Oct-2022,RTGS,52.00,00.00,"1,074,533.46"
06-Oct-2022,Miscellaneous,46.40,00.00,"1,074,579.86"
06-Oct-2022,Reversal,"632,439.50",00.00,"1,707,019.36"
06-Oct-2022,Purchase,00.00,"1,707,019.36",00.00
06-Oct-2022,Transfer,279.55,00.00,279.55
06-Oct-2022,Tax,00.00,27.96,251.60
06-Oct-2022,Bill,07.00,00.00,258.60
06-Oct-2022,Bill,00.00,51.72,206.88
06-Oct-2022,IMPS,00.00,51.72,155.16
06-Oct-2022,Cheque,00.00,15.52,139.64
06-Oct-2022,ATM,00.00,69.82,69.82
06-Oct-2022,Interest,00.00,23.27,46.55
06-Oct-2022,Transfer,05.20,00.00,51.75
06-Oct-2022,Commission,00.00,17.25,34.50
06-Oct-2022,Debit Card,03.99,00.00,38.49
06-Oct-2022,Transfer,161.00,00.00,199.49
06-Oct-2022,Commission,"137,360.20",00.00,"137,559.69"
06-Oct-2022,Tax,00.00,"22,926.62","114,633.08"
06-Oct-2022,Transfer,"25,808.60",00.00,"140,441.68"
06-Oct-2022,IMPS,00.00,"17,555.21","122,886.47"
06-Oct-2022,IMPS,"231,285.60",00.00,"354,172.07"
06-Oct-2022,ATM,00.00,"50,596.01","303,576.06"
06-Oct-2022,Bill,"15,602.50",00.00,"319,178.56"
06-Oct-2022,Debit Card,00.00,"159,589.28","159,589.28"
06-Oct-2022,ATM,00.00,"79,794.64","79,794.64"
06-Oct-2022,Commission,"16,641.56",00.00,"96,436.20"
06-Oct-2022,Miscellaneous,123.50,00.00,"96,559.70"
06-Oct-2022,IMPS,00.00,"32,186.57","64,373.13"
07-Oct-2022,Reversal,279.90,00.00,"64,653.03"
07-Oct-2022,Bill,57.31,00.00,"64,710.34"
07-Oct-2022,ATM,00.00,"12,942.07","51,768.27"
07-Oct-2022,RTGS,"72,909.53",00.00,"124,677.80"
07-Oct-2022,Miscellaneous,00.00,"12,467.78","112,210.02"
07-Oct-2022,Interest,"31,946.00",00.00,"144,156.02"
07-Oct-2022,Tax,00.00,"18,019.50","126,136.52"
07-Oct-2022,Interest,05.70,00.00,"126,142.22"
07-Oct-2022,Interest,00.00,"63,071.11","63,071.11"
07-Oct-2022,Miscellaneous,00.00,"7,883.89","55,187.22"
07-Oct-2022,ATM,00.00,"13,796.81","41,390.42"
07-Oct-2022,Interest,00.00,"8,278.08","33,112.34"
07-Oct-2022,Commission,00.00,"8,278.09","24,834.25"
07-Oct-2022,Miscellaneous,"1,715.00",00.00,"26,549.25"
07-Oct-2022,Cash,"189,356.70",00.00,"215,905.95"
07-Oct-2022,Reversal,00.00,"43,181.19","172,724.76"
07-Oct-2022,IMPS,05.00,00.00,"172,729.76"
07-Oct-2022,ATM,"54,532.00",00.00,"227,261.76"
07-Oct-2022,Cash,00.00,"113,630.88","113,630.88"
07-Oct-2022,Reversal,"126,167.00",00.00,"239,797.88"
07-Oct-2022,Interest,"144,235.25",00.00,"384,033.13"
07-Oct-2022,ATM,00.00,"64,005.52","320,027.61"
07-Oct-2022,NEFT,00.00,"32,002.76","288,024.85"
07-Oct-2022,NEFT,05.00,00.00,"288,029.85"
07-Oct-2022,ATM,00.00,"36,003.73","252,026.12"
07-Oct-2022,Reversal,"2,842.20",00.00,"254,868.32"
07-Oct-2022,Tax,00.00,"84,956.11","169,912.21"
07-Oct-2022,Cheque,279.00,00.00,"170,191.21"
07-Oct-2022,Transfer,"667,984.00",00.00,"838,175.21"
07-Oct-2022,RTGS,"74,479.00",00.00,"912,654.21"
07-Oct-2022,Miscellaneous,00.00,"182,530.84","730,123.37"
07-Oct-2022,Reversal,01.76,00.00,"730,125.13"
07-Oct-2022,ATM,00.00,"730,125.13",00.00
08-Oct-2022,Bill,"1,569,582.80",00.00,"1,569,582.80"
08-Oct-2022,Debit Card,00.00,"392,395.70","1,177,187.10"
08-Oct-2022,Interest,00.00,"1,177,187.10",00.00
08-Oct-2022,Cheque,"2,262.90",00.00,"2,262.90"
08-Oct-2022,Cheque,"223,856.00",00.00,"226,118.90"
08-Oct-2022,Debit Card,00.00,"56,529.73","169,589.18"
08-Oct-2022,Bill,00.00,"16,958.92","152,630.26"
08-Oct-2022,RTGS,00.00,"152,630.26",00.00
08-Oct-2022,ATM,01.60,00.00,01.60
08-Oct-2022,IMPS,00.00,00.53,01.07
08-Oct-2022,Bill,00.00,00.18,00.89
08-Oct-2022,Bill,00.00,00.18,00.71
08-Oct-2022,RTGS,"1,462,791.75",00.00,"1,462,792.46"
08-Oct-2022,Miscellaneous,93.30,00.00,"1,462,885.76"
08-Oct-2022,Reversal,00.00,"292,577.15","1,170,308.61"
08-Oct-2022,IMPS,00.00,"234,061.72","936,246.89"
08-Oct-2022,Reversal,56.50,00.00,"936,303.39"
08-Oct-2022,Commission,"260,735.00",00.00,"1,197,038.39"
08-Oct-2022,Tax,00.00,"119,703.84","1,077,334.55"
08-Oct-2022,Tax,"88,902.00",00.00,"1,166,236.55"
08-Oct-2022,Purchase,"2,105.50",00.00,"1,168,342.05"
08-Oct-2022,Bill,00.00,"166,906.01","1,001,436.04"
08-Oct-2022,NEFT,00.00,"250,359.01","751,077.03"
08-Oct-2022,Cash,00.00,"187,769.26","563,307.77"
08-Oct-2022,Transfer,00.00,"62,589.75","500,718.02"
08-Oct-2022,Purchase,00.00,"500,718.02",00.00
08-Oct-2022,Cheque,04.00,00.00,04.00
08-Oct-2022,RTGS,"256,325.00",00.00,"256,329.00"
08-Oct-2022,Debit Card,129.00,00.00,"256,458.00"
08-Oct-2022,Interest,00.00,"28,495.33","227,962.67"
08-Oct-2022,Purchase,00.00,"56,990.67","170,972.00"
08-Oct-2022,Purchase,00.00,"17,097.20","153,874.80"
08-Oct-2022,ATM,00.00,"17,097.20","136,777.60"
08-Oct-2022,Interest,07.00,00.00,"136,784.60"
08-Oct-2022,IMPS,"121,971.50",00.00,"258,756.10"
08-Oct-2022,RTGS,"66,579.80",00.00,"325,335.90"
08-Oct-2022,Bill,00.00,"162,667.95","162,667.95"
08-Oct-2022,Cheque,00.00,"18,074.22","144,593.73"
09-Oct-2022,Reversal,00.00,"28,918.75","115,674.98"
09-Oct-2022,Reversal,00.00,"11,567.50","104,107.48"
09-Oct-2022,IMPS,00.00,"52,053.74","52,053.74"
09-Oct-2022,Tax,00.00,"10,410.75","41,642.99"
09-Oct-2022,Transfer,"2,153.00",00.00,"43,795.99"
09-Oct-2022,RTGS,21.00,00.00,"43,816.99"
09-Oct-2022,RTGS,"142,500.00",00.00,"186,316.99"
09-Oct-2022,Bill,02.10,00.00,"186,319.09"
09-Oct-2022,RTGS,"247,293.00",00.00,"433,612.09"
09-Oct-2022,Interest,00.00,"43,361.21","390,250.88"
09-Oct-2022,Bill,345.02,00.00,"390,595.90"
09-Oct-2022,ATM,00.00,"43,399.54","347,196.36"
09-Oct-2022,ATM,289.00,00.00,"347,485.36"
09-Oct-2022,IMPS,"20,996.16",00.00,"368,481.52"
09-Oct-2022,RTGS,"512,037.80",00.00,"880,519.32"
09-Oct-2022,Interest,00.00,"110,064.92","770,454.40"
09-Oct-2022,Transfer,"1,305.00",00.00,"771,759.40"
09-Oct-2022,Interest,01.40,00.00,"771,760.80"
09-Oct-2022,IMPS,06.30,00.00,"771,767.10"
09-Oct-2022,Cheque,189.50,00.00,"771,956.60"
09-Oct-2022,Transfer,"1,503,182.00",00.00,"2,275,138.60"
09-Oct-2022,Cash,"219,488.00",00.00,"2,494,626.60"
09-Oct-2022,Bill,00.00,"1,247,313.30","1,247,313.30"
09-Oct-2022,Transfer,139.67,00.00,"1,247,452.97"
09-Oct-2022,NEFT,03.00,00.00,"1,247,455.97"
09-Oct-2022,Tax,00.00,"138,606.22","1,108,849.75"
09-Oct-2022,ATM,"131,934.75",00.00,"1,240,784.50"
09-Oct-2022,Bill,00.00,"177,254.93","1,063,529.57"
09-Oct-2022,Miscellaneous,00.00,"265,882.39","797,647.18"
09-Oct-2022,Cheque,00.00,"88,627.46","709,019.72"
09-Oct-2022,Debit Card,256.90,00.00,"709,276.62"
09-Oct-2022,Cheque,"3,503.40",00.00,"712,780.02"
09-Oct-2022,NEFT,"1,181.00",00.00,"713,961.02"
09-Oct-2022,Interest,00.00,"142,792.20","571,168.82"
09-Oct-2022,Cheque,03.00,00.00,"571,171.82"
09-Oct-2022,Cheque,00.00,"81,595.97","489,575.85"
09-Oct-2022,Tax,00.00,"244,787.93","244,787.92"
09-Oct-2022,Debit Card,00.00,"27,198.66","217,589.26"
09-Oct-2022,Tax,"1,482,808.00",00.00,"1,700,397.26"
09-Oct-2022,Debit Card,00.00,"212,549.66","1,487,847.60"
09-Oct-2022,Cash,"2,668.70",00.00,"1,490,516.30"
09-Oct-2022,NEFT,07.30,00.00,"1,490,523.60"
09-Oct-2022,Cheque,00.00,"212,931.94","1,277,591.66"
09-Oct-2022,NEFT,00.00,"319,397.92","958,193.74"
09-Oct-2022,Debit Card,"256,848.03",00.00,"1,215,041.77"
09-Oct-2022,Purchase,01.60,00.00,"1,215,043.37"
09-Oct-2022,Commission,00.00,"243,008.67","972,034.70"
09-Oct-2022,Cash,00.00,"108,003.86","864,030.84"
09-Oct-2022,NEFT,00.00,"108,003.86","756,026.98"
09-Oct-2022,Reversal,01.25,00.00,"756,028.23"
09-Oct-2022,Tax,00.00,"189,007.06","567,021.17"
09-Oct-2022,Transfer,"4,631.98",00.00,"571,653.15"
09-Oct-2022,Bill,00.00,"57,165.32","514,487.84"
09-Oct-2022,RTGS,"1,356,760.00",00.00,"1,871,247.84"
09-Oct-2022,Tax,"25,139.06",00.00,"1,896,386.90"
09-Oct-2022,RTGS,"1,819.00",00.00,"1,898,205.90"
09-Oct-2022,Tax,00.00,"189,820.59","1,708,385.31"
09-Oct-2022,IMPS,00.00,"284,730.89","1,423,654.42"
09-Oct-2022,IMPS,798.00,00.00,"1,424,452.42"
09-Oct-2022,Purchase,00.00,"203,493.20","1,220,959.22"
09-Oct-2022,Cash,00.00,"244,191.84","976,767.38"
09-Oct-2022,Purchase,00.00,"976,767.38",00.00
09-Oct-2022,RTGS,394.00,00.00,394.00
10-Oct-2022,Cheque,394.00,00.00,788.00
10-Oct-2022,Bill,212.90,00.00,"1,000.90"
10-Oct-2022,Reversal,00.00,166.82,834.08
10-Oct-2022,Debit Card,04.00,00.00,838.08
10-Oct-2022,NEFT,00.00,119.73,718.35
10-Oct-2022,IMPS,13.00,00.00,731.35
10-Oct-2022,IMPS,00.00,104.48,626.87
10-Oct-2022,Interest,07.50,00.00,634.37
10-Oct-2022,NEFT,"617,157.50",00.00,"617,791.87"
10-Oct-2022,RTGS,00.00,"154,447.97","463,343.90"
10-Oct-2022,Interest,"41,007.00",00.00,"504,350.90"
10-Oct-2022,Cheque,00.00,"63,043.86","441,307.04"
10-Oct-2022,Commission,00.00,"110,326.76","330,980.28"
10-Oct-2022,NEFT,"2,052,376.00",00.00,"2,383,356.28"
10-Oct-2022,Miscellaneous,00.00,"297,919.54","2,085,436.74"
10-Oct-2022,ATM,"2,032,213.80",00.00,"4,117,650.54"
10-Oct-2022,Cash,00.00,"514,706.32","3,602,944.22"
10-Oct-2022,Reversal,"69,687.40",00.00,"3,672,631.62"
10-Oct-2022,Bill,00.00,"367,263.16","3,305,368.46"
11-Oct-2022,Tax,00.00,"1,101,789.49","2,203,578.97"
11-Oct-2022,Cheque,00.00,"2,203,578.97",00.00
11-Oct-2022,Purchase,"3,972.50",00.00,"3,972.50"
11-Oct-2022,Purchase,"41,110.00",00.00,"45,082.50"
11-Oct-2022,Transfer,"26,639.40",00.00,"71,721.90"
11-Oct-2022,Miscellaneous,07.00,00.00,"71,728.90"
11-Oct-2022,Purchase,00.00,"7,172.89","64,556.01"
12-Oct-2022,NEFT,"196,227.40",00.00,"260,783.41"
12-Oct-2022,Cash,00.00,"43,463.90","217,319.51"
12-Oct-2022,IMPS,"12,889.00",00.00,"230,208.51"
12-Oct-2022,Cash,00.00,"38,368.09","191,840.42"
12-Oct-2022,Bill,00.00,"27,405.77","164,434.65"
12-Oct-2022,ATM,42.80,00.00,"164,477.45"
12-Oct-2022,Interest,00.00,"23,496.78","140,980.67"
12-Oct-2022,Bill,02.80,00.00,"140,983.47"
12-Oct-2022,Miscellaneous,06.70,00.00,"140,990.17"
12-Oct-2022,NEFT,"732,372.75",00.00,"873,362.92"
12-Oct-2022,Miscellaneous,00.00,"436,681.46","436,681.46"
12-Oct-2022,Interest,00.00,"109,170.37","327,511.10"
12-Oct-2022,Reversal,00.00,"54,585.18","272,925.92"
12-Oct-2022,RTGS,00.00,"27,292.59","245,633.33"
12-Oct-2022,Interest,"3,041.00",00.00,"248,674.33"
12-Oct-2022,Cash,"3,218.30",00.00,"251,892.63"
12-Oct-2022,Reversal,03.27,00.00,"251,895.90"
12-Oct-2022,Cash,00.00,"27,988.43","223,907.47"
12-Oct-2022,Purchase,295.30,00.00,"224,202.77"
12-Oct-2022,Cash,00.00,"56,050.69","168,152.08"
12-Oct-2022,IMPS,00.00,"84,076.04","84,076.04"
12-Oct-2022,Purchase,00.00,"16,815.21","67,260.83"
12-Oct-2022,Cash,112.26,00.00,"67,373.09"
12-Oct-2022,RTGS,"3,091.00",00.00,"70,464.09"
12-Oct-2022,Tax,00.00,"14,092.82","56,371.27"
12-Oct-2022,Debit Card,00.00,"18,790.42","37,580.85"
12-Oct-2022,Cheque,00.00,"4,175.65","33,405.20"
12-Oct-2022,Bill,00.00,"5,567.53","27,837.67"
12-Oct-2022,NEFT,07.00,00.00,"27,844.67"
12-Oct-2022,IMPS,03.27,00.00,"27,847.94"
12-Oct-2022,Debit Card,01.80,00.00,"27,849.74"
13-Oct-2022,Tax,"32,889.00",00.00,"60,738.74"
13-Oct-2022,NEFT,138.62,00.00,"60,877.36"
13-Oct-2022,Cheque,156.48,00.00,"61,033.84"
13-Oct-2022,Tax,48.00,00.00,"61,081.84"
13-Oct-2022,Commission,21.48,00.00,"61,103.32"
13-Oct-2022,Cheque,00.00,"12,220.66","48,882.66"
13-Oct-2022,ATM,"3,880.50",00.00,"52,763.16"
13-Oct-2022,Commission,"1,633.90",00.00,"54,397.06"
13-Oct-2022,Transfer,"152,259.90",00.00,"206,656.96"
13-Oct-2022,Tax,00.00,"103,328.48","103,328.48"
13-Oct-2022,NEFT,356.68,00.00,"103,685.16"
13-Oct-2022,Reversal,195.00,00.00,"103,880.16"
13-Oct-2022,Tax,00.00,"20,776.03","83,104.13"
13-Oct-2022,RTGS,16.01,00.00,"83,120.14"
13-Oct-2022,Tax,38.51,00.00,"83,158.65"
13-Oct-2022,IMPS,00.00,"9,239.85","73,918.80"
13-Oct-2022,Reversal,00.00,"9,239.85","64,678.95"
13-Oct-2022,IMPS,00.00,"8,084.87","56,594.08"
13-Oct-2022,Tax,00.00,"9,432.35","47,161.73"
13-Oct-2022,ATM,00.00,"5,895.22","41,266.51"
13-Oct-2022,ATM,"1,521,224.00",00.00,"1,562,490.51"
13-Oct-2022,Purchase,00.00,"156,249.05","1,406,241.46"
13-Oct-2022,RTGS,00.00,"175,780.18","1,230,461.28"
13-Oct-2022,ATM,00.00,"123,046.13","1,107,415.15"
13-Oct-2022,Reversal,07.00,00.00,"1,107,422.15"
13-Oct-2022,Reversal,00.00,"369,140.72","738,281.43"
13-Oct-2022,Commission,00.00,"369,140.72","369,140.72"
13-Oct-2022,Tax,00.00,"92,285.18","276,855.54"
13-Oct-2022,Purchase,02.00,00.00,"276,857.54"
13-Oct-2022,Cash,00.00,"92,285.85","184,571.69"
13-Oct-2022,Purchase,15.00,00.00,"184,586.69"
13-Oct-2022,Commission,00.00,"18,458.67","166,128.02"
13-Oct-2022,Interest,00.00,"16,612.80","149,515.22"
13-Oct-2022,Transfer,00.00,"16,612.80","132,902.42"
13-Oct-2022,ATM,"32,887.80",00.00,"165,790.22"
13-Oct-2022,Cash,"945,884.50",00.00,"1,111,674.72"
13-Oct-2022,ATM,"1,202,324.20",00.00,"2,313,998.92"
13-Oct-2022,Bill,315.00,00.00,"2,314,313.92"
14-Oct-2022,NEFT,00.00,"578,578.48","1,735,735.44"
14-Oct-2022,Transfer,443.10,00.00,"1,736,178.54"
14-Oct-2022,Bill,55.42,00.00,"1,736,233.96"
14-Oct-2022,Miscellaneous,08.00,00.00,"1,736,241.96"
14-Oct-2022,Commission,"561,412.80",00.00,"2,297,654.76"
14-Oct-2022,Commission,00.00,"255,294.97","2,042,359.79"
14-Oct-2022,Commission,00.00,"1,021,179.90","1,021,179.90"
14-Oct-2022,Reversal,00.00,"170,196.65","850,983.25"
14-Oct-2022,Cheque,00.00,"141,830.54","709,152.71"
14-Oct-2022,Commission,"66,841.69",00.00,"775,994.40"
14-Oct-2022,Interest,"1,839,069.00",00.00,"2,615,063.40"
14-Oct-2022,Transfer,00.00,"290,562.60","2,324,500.80"
14-Oct-2022,Interest,00.00,"332,071.54","1,992,429.26"
14-Oct-2022,Bill,42.40,00.00,"1,992,471.66"
14-Oct-2022,Cash,00.00,"199,247.17","1,793,224.49"
14-Oct-2022,ATM,00.00,"1,793,224.49",00.00
14-Oct-2022,Interest,30.00,00.00,30.00
14-Oct-2022,Purchase,"3,439.00",00.00,"3,469.00"
14-Oct-2022,Commission,32.79,00.00,"3,501.79"
14-Oct-2022,Reversal,08.00,00.00,"3,509.79"
14-Oct-2022,Cash,05.00,00.00,"3,514.79"
14-Oct-2022,Bill,"544,606.50",00.00,"548,121.29"
14-Oct-2022,Debit Card,525.39,00.00,"548,646.68"
14-Oct-2022,Interest,00.00,"137,161.67","411,485.01"
14-Oct-2022,NEFT,06.70,00.00,"411,491.71"
14-Oct-2022,Interest,"157,295.19",00.00,"568,786.90"
14-Oct-2022,Purchase,00.00,"94,797.82","473,989.08"
14-Oct-2022,NEFT,00.00,"236,994.54","236,994.54"
14-Oct-2022,Cash,374.50,00.00,"237,369.04"
14-Oct-2022,Debit Card,"7,900.80",00.00,"245,269.84"
14-Oct-2022,Cash,00.00,"245,269.84",00.00
14-Oct-2022,Cheque,22.70,00.00,22.70
14-Oct-2022,Transfer,"1,350,441.75",00.00,"1,350,464.45"
14-Oct-2022,Debit Card,00.00,"168,808.06","1,181,656.39"
14-Oct-2022,Cheque,00.00,"118,165.64","1,063,490.75"
14-Oct-2022,Cash,00.00,"151,927.25","911,563.50"
14-Oct-2022,Tax,"26,620.45",00.00,"938,183.95"
14-Oct-2022,Purchase,"121,265.30",00.00,"1,059,449.25"
14-Oct-2022,Transfer,00.00,"353,149.75","706,299.50"
14-Oct-2022,Reversal,00.00,"353,149.75","353,149.75"
14-Oct-2022,IMPS,34.00,00.00,"353,183.75"
14-Oct-2022,Reversal,00.00,"39,242.64","313,941.11"
14-Oct-2022,Tax,00.00,"313,941.11",00.00
14-Oct-2022,Bill,"5,214.20",00.00,"5,214.20"
14-Oct-2022,IMPS,"1,968,354.75",00.00,"1,973,568.95"
14-Oct-2022,Cash,969.50,00.00,"1,974,538.45"
14-Oct-2022,Commission,06.00,00.00,"1,974,544.45"
14-Oct-2022,Cheque,00.00,"658,181.48","1,316,362.97"
14-Oct-2022,Debit Card,"125,143.00",00.00,"1,441,505.97"
14-Oct-2022,ATM,"128,263.44",00.00,"1,569,769.41"
14-Oct-2022,Transfer,00.00,"523,256.47","1,046,512.94"
14-Oct-2022,RTGS,"1,871,429.00",00.00,"2,917,941.94"
14-Oct-2022,Interest,00.00,"583,588.39","2,334,353.55"
14-Oct-2022,Interest,00.00,"778,117.85","1,556,235.70"
14-Oct-2022,Cheque,00.00,"194,529.46","1,361,706.24"
14-Oct-2022,Transfer,02.00,00.00,"1,361,708.24"
14-Oct-2022,IMPS,00.00,"272,341.65","1,089,366.59"
14-Oct-2022,Bill,"1,586,897.50",00.00,"2,676,264.09"
14-Oct-2022,Commission,00.00,"535,252.82","2,141,011.27"
14-Oct-2022,Commission,00.00,"1,070,505.64","1,070,505.64"
14-Oct-2022,Purchase,"228,989.80",00.00,"1,299,495.44"
14-Oct-2022,Interest,07.00,00.00,"1,299,502.44"
14-Oct-2022,ATM,00.00,"259,900.49","1,039,601.95"
14-Oct-2022,Debit Card,00.00,"1,039,601.95",00.00
14-Oct-2022,ATM,287.77,00.00,287.77
14-Oct-2022,Transfer,00.00,31.97,255.80
14-Oct-2022,ATM,"1,240,295.00",00.00,"1,240,550.80"
14-Oct-2022,Commission,21.00,00.00,"1,240,571.80"
14-Oct-2022,Tax,"169,268.75",00.00,"1,409,840.55"
14-Oct-2022,Interest,00.00,"201,405.79","1,208,434.76"
14-Oct-2022,Miscellaneous,"17,771.00",00.00,"1,226,205.76"
14-Oct-2022,Debit Card,"1,783,676.00",00.00,"3,009,881.76"
14-Oct-2022,IMPS,00.00,"752,470.44","2,257,411.32"
14-Oct-2022,NEFT,00.00,"752,470.44","1,504,940.88"
14-Oct-2022,RTGS,00.00,"150,494.09","1,354,446.79"
14-Oct-2022,Commission,"96,045.00",00.00,"1,450,491.79"
15-Oct-2022,ATM,01.00,00.00,"1,450,492.79"
15-Oct-2022,Cash,00.00,"207,213.26","1,243,279.53"
15-Oct-2022,ATM,00.00,"124,327.95","1,118,951.58"
15-Oct-2022,Transfer,"225,522.00",00.00,"1,344,473.58"
15-Oct-2022,IMPS,00.00,"268,894.72","1,075,578.86"
15-Oct-2022,Reversal,"183,090.00",00.00,"1,258,668.86"
15-Oct-2022,ATM,00.00,"125,866.89","1,132,801.97"
15-Oct-2022,Cash,00.00,"377,600.66","755,201.31"
15-Oct-2022,Purchase,"90,600.00",00.00,"845,801.31"
15-Oct-2022,Interest,00.00,"281,933.77","563,867.54"
15-Oct-2022,Debit Card,53.50,00.00,"563,921.04"
15-Oct-2022,Transfer,"962,792.00",00.00,"1,526,713.04"
15-Oct-2022,Cash,"30,397.31",00.00,"1,557,110.35"
15-Oct-2022,NEFT,00.00,"778,555.18","778,555.18"
16-Oct-2022,NEFT,"16,667.00",00.00,"795,222.18"
16-Oct-2022,Cash,00.00,"265,074.06","530,148.12"
16-Oct-2022,IMPS,"9,888.10",00.00,"540,036.22"
16-Oct-2022,Reversal,"196,580.50",00.00,"736,616.72"
16-Oct-2022,IMPS,00.00,"122,769.45","613,847.27"
16-Oct-2022,Purchase,00.00,"68,205.25","545,642.02"
16-Oct-2022,Tax,00.00,"60,626.89","485,015.13"
16-Oct-2022,ATM,00.00,"53,890.57","431,124.56"
16-Oct-2022,Interest,00.00,"71,854.09","359,270.47"
16-Oct-2022,Transfer,"7,649.12",00.00,"366,919.59"
16-Oct-2022,RTGS,00.00,"40,768.84","326,150.75"
16-Oct-2022,ATM,00.00,"326,150.75",00.00
16-Oct-2022,IMPS,357.45,00.00,357.45
16-Oct-2022,RTGS,00.00,89.36,268.09
17-Oct-2022,Interest,00.00,33.51,234.58
17-Oct-2022,Commission,00.00,58.65,175.94
17-Oct-2022,Reversal,00.00,43.99,131.95
17-Oct-2022,RTGS,01.90,00.00,133.85
17-Oct-2022,Cheque,00.00,13.39,120.46
17-Oct-2022,Cash,"42,082.00",00.00,"42,202.46"
17-Oct-2022,ATM,00.00,"14,067.49","28,134.97"
17-Oct-2022,Tax,"2,091.90",00.00,"30,226.87"
17-Oct-2022,NEFT,00.00,"10,075.62","20,151.25"
17-Oct-2022,IMPS,889.50,00.00,"21,040.75"
17-Oct-2022,NEFT,00.00,"5,260.19","15,780.56"
17-Oct-2022,Cash,"4,022.98",00.00,"19,803.54"
17-Oct-2022,Purchase,00.00,"9,901.77","9,901.77"
18-Oct-2022,Cash,427.00,00.00,"10,328.77"
18-Oct-2022,Debit Card,00.00,"3,442.92","6,885.85"
18-Oct-2022,Cash,59.00,00.00,"6,944.85"
18-Oct-2022,NEFT,00.00,"1,736.21","5,208.64"
18-Oct-2022,IMPS,00.00,868.11,"4,340.53"
18-Oct-2022,Commission,"13,682.00",00.00,"18,022.53"
18-Oct-2022,Commission,04.30,00.00,"18,026.83"
18-Oct-2022,RTGS,"1,606,686.75",00.00,"1,624,713.58"
18-Oct-2022,IMPS,00.00,"232,101.94","1,392,611.64"
18-Oct-2022,RTGS,00.00,"696,305.82","696,305.82"
18-Oct-2022,Debit Card,"2,105.11",00.00,"698,410.93"
18-Oct-2022,Debit Card,"9,433.78",00.00,"707,844.71"
18-Oct-2022,Bill,05.00,00.00,"707,849.71"
18-Oct-2022,RTGS,04.00,00.00,"707,853.71"
18-Oct-2022,Bill,"968,417.00",00.00,"1,676,270.71"
18-Oct-2022,Reversal,06.30,00.00,"1,676,277.01"
18-Oct-2022,Tax,31.00,00.00,"1,676,308.01"
18-Oct-2022,Cheque,255.70,00.00,"1,676,563.71"
19-Oct-2022,Bill,"120,613.50",00.00,"1,797,177.21"
19-Oct-2022,NEFT,00.00,"359,435.44","1,437,741.77"
19-Oct-2022,ATM,00.00,"179,717.72","1,258,024.05"
19-Oct-2022,Bill,00.00,"125,802.41","1,132,221.64"
19-Oct-2022,ATM,34.00,00.00,"1,132,255.64"
19-Oct-2022,Interest,00.00,"377,418.55","754,837.09"
19-Oct-2022,Cheque,00.00,"150,967.42","603,869.67"
19-Oct-2022,Interest,00.00,"201,289.89","402,579.78"
19-Oct-2022,Commission,723.32,00.00,"403,303.10"
19-Oct-2022,RTGS,00.00,"67,217.18","336,085.92"
19-Oct-2022,IMPS,"3,258.10",00.00,"339,344.02"
19-Oct-2022,Reversal,00.00,"169,672.01","169,672.01"
19-Oct-2022,NEFT,00.00,"18,852.45","150,819.56"
19-Oct-2022,RTGS,"973,680.75",00.00,"1,124,500.31"
19-Oct-2022,RTGS,"1,743,038.50",00.00,"2,867,538.81"
20-Oct-2022,Interest,00.00,"409,648.40","2,457,890.41"
20-Oct-2022,Miscellaneous,00.00,"614,472.60","1,843,417.81"
20-Oct-2022,Interest,"2,131.00",00.00,"1,845,548.81"
20-Oct-2022,Tax,05.70,00.00,"1,845,554.51"
20-Oct-2022,Transfer,60.20,00.00,"1,845,614.71"
20-Oct-2022,Tax,"151,200.00",00.00,"1,996,814.71"
20-Oct-2022,Commission,00.00,"1,996,814.71",00.00
20-Oct-2022,Miscellaneous,02.50,00.00,02.50
20-Oct-2022,RTGS,00.00,00.28,02.22
20-Oct-2022,Purchase,"27,604.20",00.00,"27,606.42"
20-Oct-2022,IMPS,00.00,"4,601.07","23,005.35"
20-Oct-2022,Miscellaneous,00.00,"2,875.67","20,129.68"
20-Oct-2022,Cheque,00.00,"5,032.42","15,097.26"
20-Oct-2022,Cash,00.00,"3,774.32","11,322.94"
20-Oct-2022,Purchase,00.00,"1,415.37","9,907.57"
20-Oct-2022,Miscellaneous,00.00,"1,238.45","8,669.12"
20-Oct-2022,Interest,00.00,"1,238.45","7,430.67"
20-Oct-2022,NEFT,00.00,825.63,"6,605.04"
20-Oct-2022,Commission,01.68,00.00,"6,606.72"
20-Oct-2022,ATM,00.00,"2,202.24","4,404.48"
20-Oct-2022,RTGS,277.49,00.00,"4,681.97"
20-Oct-2022,Miscellaneous,00.01,00.00,"4,681.98"
20-Oct-2022,Reversal,343.60,00.00,"5,025.58"
20-Oct-2022,ATM,00.00,"2,512.79","2,512.79"
20-Oct-2022,Cash,00.00,251.28,"2,261.51"
20-Oct-2022,ATM,"1,793,402.00",00.00,"1,795,663.51"
20-Oct-2022,Commission,32.70,00.00,"1,795,696.21"
20-Oct-2022,Tax,750.80,00.00,"1,796,447.01"
20-Oct-2022,Tax,00.00,"898,223.51","898,223.50"
20-Oct-2022,Interest,254.85,00.00,"898,478.35"
20-Oct-2022,Debit Card,01.00,00.00,"898,479.35"
20-Oct-2022,Bill,"257,506.80",00.00,"1,155,986.15"
20-Oct-2022,Interest,"3,286.87",00.00,"1,159,273.02"
20-Oct-2022,RTGS,"1,813.72",00.00,"1,161,086.74"
20-Oct-2022,RTGS,00.00,"580,543.37","580,543.37"
20-Oct-2022,Transfer,00.00,"145,135.84","435,407.53"
21-Oct-2022,Tax,"1,736,609.25",00.00,"2,172,016.78"
21-Oct-2022,Commission,00.00,"1,086,008.39","1,086,008.39"
21-Oct-2022,Transfer,00.00,"120,667.60","965,340.79"
21-Oct-2022,IMPS,00.00,"107,260.09","858,080.70"
21-Oct-2022,Cheque,00.00,"122,582.96","735,497.74"
21-Oct-2022,Bill,00.00,"122,582.96","612,914.78"
21-Oct-2022,Transfer,04.00,00.00,"612,918.78"
21-Oct-2022,Miscellaneous,00.00,"612,918.78",00.00
21-Oct-2022,IMPS,05.31,00.00,05.31
21-Oct-2022,ATM,33.00,00.00,38.31
21-Oct-2022,IMPS,03.00,00.00,41.31
21-Oct-2022,Interest,00.00,08.26,33.05
21-Oct-2022,ATM,00.00,33.05,00.00
21-Oct-2022,IMPS,189.68,00.00,189.68
21-Oct-2022,Miscellaneous,"209,124.97",00.00,"209,314.65"
21-Oct-2022,Purchase,00.00,"26,164.33","183,150.32"
21-Oct-2022,Debit Card,07.14,00.00,"183,157.46"
21-Oct-2022,NEFT,00.00,"45,789.37","137,368.10"
21-Oct-2022,IMPS,"1,835.30",00.00,"139,203.40"
21-Oct-2022,Purchase,00.00,"69,601.70","69,601.70"
21-Oct-2022,Cheque,00.00,"6,960.17","62,641.53"
21-Oct-2022,Bill,00.00,"20,880.51","41,761.02"
21-Oct-2022,Transfer,"156,677.70",00.00,"198,438.72"
21-Oct-2022,Cheque,00.00,"99,219.36","99,219.36"
21-Oct-2022,Bill,"7,234.41",00.00,"106,453.77"
21-Oct-2022,Bill,"25,894.00",00.00,"132,347.77"
21-Oct-2022,NEFT,"256,244.09",00.00,"388,591.86"
22-Oct-2022,Tax,"1,206.00",00.00,"389,797.86"
22-Oct-2022,Commission,00.00,"77,959.57","311,838.29"
22-Oct-2022,Tax,00.00,"311,838.29",00.00
22-Oct-2022,NEFT,"231,286.50",00.00,"231,286.50"
22-Oct-2022,Cheque,00.00,"77,095.50","154,191.00"
22-Oct-2022,Purchase,"27,188.90",00.00,"181,379.90"
22-Oct-2022,Transfer,00.00,"181,379.90",00.00
22-Oct-2022,Reversal,07.00,00.00,07.00
22-Oct-2022,NEFT,07.00,00.00,14.00
22-Oct-2022,Miscellaneous,"1,994.94",00.00,"2,008.94"
22-Oct-2022,Transfer,00.00,401.79,"1,607.15"
22-Oct-2022,Miscellaneous,"223,031.20",00.00,"224,638.35"
22-Oct-2022,IMPS,"1,223.30",00.00,"225,861.65"
23-Oct-2022,Cheque,00.00,"56,465.41","169,396.24"
23-Oct-2022,Interest,00.00,"24,199.46","145,196.78"
23-Oct-2022,Transfer,"2,158.00",00.00,"147,354.78"
23-Oct-2022,Interest,262.20,00.00,"147,616.98"
23-Oct-2022,Debit Card,00.00,"49,205.66","98,411.32"
23-Oct-2022,Cash,00.00,"14,058.76","84,352.56"
23-Oct-2022,Purchase,00.00,"8,435.26","75,917.30"
23-Oct-2022,Miscellaneous,393.80,00.00,"76,311.10"
23-Oct-2022,Cash,00.00,"9,538.89","66,772.21"
23-Oct-2022,Transfer,00.00,"13,354.44","53,417.77"
23-Oct-2022,Commission,00.00,"53,417.77",00.00
23-Oct-2022,Commission,00.78,00.00,00.78
23-Oct-2022,IMPS,"8,545.00",00.00,"8,545.78"
23-Oct-2022,Interest,"65,637.25",00.00,"74,183.03"
23-Oct-2022,Reversal,00.00,"8,242.56","65,940.47"
23-Oct-2022,ATM,"12,705.18",00.00,"78,645.65"
23-Oct-2022,NEFT,00.00,"11,235.09","67,410.56"
23-Oct-2022,RTGS,00.00,"13,482.11","53,928.45"
23-Oct-2022,Bill,00.00,"7,704.06","46,224.39"
23-Oct-2022,IMPS,00.00,"5,778.05","40,446.34"
23-Oct-2022,Commission,00.00,"8,089.27","32,357.07"
23-Oct-2022,NEFT,00.00,"4,044.63","28,312.44"
23-Oct-2022,Reversal,"2,465.40",00.00,"30,777.84"
23-Oct-2022,Bill,00.00,"15,388.92","15,388.92"
23-Oct-2022,Cash,06.00,00.00,"15,394.92"
23-Oct-2022,Transfer,00.00,"1,539.49","13,855.43"
23-Oct-2022,Debit Card,00.00,"1,385.54","12,469.89"
23-Oct-2022,Purchase,"1,288.80",00.00,"13,758.69"
23-Oct-2022,Reversal,00.00,"1,375.87","12,382.82"
23-Oct-2022,Purchase,"322,966.00",00.00,"335,348.82"
23-Oct-2022,Reversal,00.00,"111,782.94","223,565.88"
23-Oct-2022,Miscellaneous,"63,358.94",00.00,"286,924.82"
23-Oct-2022,Reversal,00.00,"286,924.82",00.00
23-Oct-2022,Tax,32.42,00.00,32.42
23-Oct-2022,ATM,56.80,00.00,89.22
23-Oct-2022,Commission,"1,211,890.00",00.00,"1,211,979.22"
23-Oct-2022,IMPS,00.00,"605,989.61","605,989.61"
23-Oct-2022,NEFT,00.00,"100,998.27","504,991.34"
23-Oct-2022,IMPS,00.00,"100,998.27","403,993.07"
23-Oct-2022,NEFT,01.50,00.00,"403,994.57"
23-Oct-2022,Cheque,00.00,"44,888.29","359,106.28"
23-Oct-2022,Reversal,"3,718.20",00.00,"362,824.48"
23-Oct-2022,Transfer,"108,081.30",00.00,"470,905.78"
23-Oct-2022,Commission,00.00,"67,272.25","403,633.53"
23-Oct-2022,Debit Card,483.60,00.00,"404,117.13"
23-Oct-2022,IMPS,"15,304.00",00.00,"419,421.13"
23-Oct-2022,Cheque,00.00,"59,917.30","359,503.83"
24-Oct-2022,Reversal,361.00,00.00,"359,864.83"
24-Oct-2022,RTGS,00.00,"51,409.26","308,455.57"
24-Oct-2022,ATM,797.00,00.00,"309,252.57"
24-Oct-2022,Reversal,00.00,"34,361.40","274,891.17"
24-Oct-2022,RTGS,438.10,00.00,"275,329.27"
24-Oct-2022,Cash,231.97,00.00,"275,561.24"
24-Oct-2022,Debit Card,00.00,"55,112.25","220,448.99"
24-Oct-2022,Transfer,00.00,"220,448.99",00.00
24-Oct-2022,IMPS,394.90,00.00,394.90
24-Oct-2022,Transfer,"368,745.00",00.00,"369,139.90"
24-Oct-2022,RTGS,00.00,"52,734.27","316,405.63"
24-Oct-2022,Purchase,00.00,"35,156.18","281,249.45"
24-Oct-2022,Miscellaneous,"1,743,348.50",00.00,"2,024,597.95"
24-Oct-2022,Tax,00.00,"2,024,597.95",00.00
24-Oct-2022,Transfer,34.00,00.00,34.00
24-Oct-2022,Purchase,00.00,04.86,29.14
24-Oct-2022,Cash,317.00,00.00,346.14
24-Oct-2022,Tax,00.00,57.69,288.45
24-Oct-2022,Reversal,"27,736.40",00.00,"28,024.85"
24-Oct-2022,Interest,"462,812.75",00.00,"490,837.60"
24-Oct-2022,Bill,03.40,00.00,"490,841.00"
24-Oct-2022,Bill,00.00,"98,168.20","392,672.80"
24-Oct-2022,Tax,00.00,"49,084.10","343,588.70"
24-Oct-2022,Cheque,"31,585.75",00.00,"375,174.45"
24-Oct-2022,ATM,47.00,00.00,"375,221.45"
24-Oct-2022,Commission,00.00,"41,691.27","333,530.18"
24-Oct-2022,Tax,35.00,00.00,"333,565.18"
24-Oct-2022,Interest,00.00,"33,356.52","300,208.66"
24-Oct-2022,ATM,"24,020.51",00.00,"324,229.17"
24-Oct-2022,Cheque,00.00,"64,845.83","259,383.34"
24-Oct-2022,NEFT,"1,460,442.00",00.00,"1,719,825.34"
24-Oct-2022,IMPS,"2,983.73",00.00,"1,722,809.07"
24-Oct-2022,Reversal,00.00,"191,423.23","1,531,385.84"
24-Oct-2022,Transfer,407.80,00.00,"1,531,793.64"
24-Oct-2022,Purchase,00.00,"170,199.29","1,361,594.35"
24-Oct-2022,Reversal,31.20,00.00,"1,361,625.55"
24-Oct-2022,Tax,"31,502.81",00.00,"1,393,128.36"
24-Oct-2022,Cash,108.00,00.00,"1,393,236.36"
24-Oct-2022,Reversal,56.99,00.00,"1,393,293.35"
24-Oct-2022,RTGS,55.60,00.00,"1,393,348.95"
24-Oct-2022,Cheque,00.00,"139,334.90","1,254,014.06"
24-Oct-2022,Cheque,00.00,"1,254,014.06",00.00
24-Oct-2022,NEFT,"1,919,547.00",00.00,"1,919,547.00"
24-Oct-2022,Commission,00.00,"479,886.75","1,439,660.25"
24-Oct-2022,Cheque,00.00,"719,830.13","719,830.12"
24-Oct-2022,Transfer,573.30,00.00,"720,403.42"
24-Oct-2022,Transfer,00.00,"180,100.86","540,302.57"
24-Oct-2022,Tax,00.00,"90,050.43","450,252.14"
24-Oct-2022,Bill,"47,572.94",00.00,"497,825.08"
24-Oct-2022,Cheque,"2,308.83",00.00,"500,133.91"
24-Oct-2022,Transfer,00.00,"100,026.78","400,107.13"
24-Oct-2022,Cash,142.00,00.00,"400,249.13"
24-Oct-2022,Miscellaneous,406.70,00.00,"400,655.83"
24-Oct-2022,Purchase,55.00,00.00,"400,710.83"
25-Oct-2022,RTGS,"196,156.00",00.00,"596,866.83"
25-Oct-2022,Cash,"10,510.12",00.00,"607,376.95"
25-Oct-2022,RTGS,00.00,"303,688.48","303,688.47"
25-Oct-2022,Cash,"1,443,789.00",00.00,"1,747,477.47"
25-Oct-2022,Debit Card,00.00,"873,738.74","873,738.74"
25-Oct-2022,Commission,00.00,"174,747.75","698,990.99"
25-Oct-2022,Reversal,00.00,"698,990.99",00.00
25-Oct-2022,Transfer,"70,106.00",00.00,"70,106.00"
25-Oct-2022,Debit Card,00.00,"10,015.14","60,090.86"
25-Oct-2022,Purchase,06.30,00.00,"60,097.16"
25-Oct-2022,Miscellaneous,00.00,"10,016.19","50,080.97"
25-Oct-2022,Purchase,"1,900,659.20",00.00,"1,950,740.17"
25-Oct-2022,ATM,803.50,00.00,"1,951,543.67"
25-Oct-2022,IMPS,"393,217.00",00.00,"2,344,760.67"
25-Oct-2022,Commission,00.00,"781,586.89","1,563,173.78"
25-Oct-2022,Purchase,00.00,"312,634.76","1,250,539.02"
25-Oct-2022,NEFT,48.18,00.00,"1,250,587.20"
25-Oct-2022,Transfer,00.00,"125,058.72","1,125,528.48"
25-Oct-2022,Purchase,00.00,"375,176.16","750,352.32"
25-Oct-2022,IMPS,08.00,00.00,"750,360.32"
25-Oct-2022,Cheque,00.00,"150,072.06","600,288.26"
25-Oct-2022,Interest,116.39,00.00,"600,404.65"
25-Oct-2022,Reversal,"35,924.60",00.00,"636,329.25"
25-Oct-2022,Tax,"30,004.40",00.00,"666,333.65"
25-Oct-2022,Cash,00.00,"222,111.22","444,222.43"
25-Oct-2022,Cheque,00.00,"44,422.24","399,800.19"
25-Oct-2022,ATM,"1,422,336.00",00.00,"1,822,136.19"
25-Oct-2022,Miscellaneous,00.00,"182,213.62","1,639,922.57"
25-Oct-2022,Reversal,"2,035,145.00",00.00,"3,675,067.57"
25-Oct-2022,Reversal,00.00,"408,340.84","3,266,726.73"
25-Oct-2022,Purchase,00.00,"653,345.35","2,613,381.38"
25-Oct-2022,Transfer,"384,002.25",00.00,"2,997,383.63"
25-Oct-2022,NEFT,870.00,00.00,"2,998,253.63"
25-Oct-2022,NEFT,15.68,00.00,"2,998,269.31"
25-Oct-2022,Commission,725.00,00.00,"2,998,994.31"
25-Oct-2022,Purchase,"4,036.70",00.00,"3,003,031.01"
25-Oct-2022,Transfer,00.00,"750,757.75","2,252,273.26"
25-Oct-2022,Commission,00.00,"321,753.32","1,930,519.94"
25-Oct-2022,RTGS,00.00,"482,629.99","1,447,889.96"
25-Oct-2022,Bill,01.40,00.00,"1,447,891.36"
25-Oct-2022,Interest,00.00,"723,945.68","723,945.68"
25-Oct-2022,IMPS,00.00,"120,657.61","603,288.07"
25-Oct-2022,Interest,"1,072,555.50",00.00,"1,675,843.57"
25-Oct-2022,Reversal,00.00,"239,406.22","1,436,437.35"
25-Oct-2022,Miscellaneous,04.80,00.00,"1,436,442.15"
25-Oct-2022,Transfer,05.90,00.00,"1,436,448.05"
25-Oct-2022,Purchase,447.00,00.00,"1,436,895.05"
25-Oct-2022,Purchase,00.00,"1,436,895.05",00.00
25-Oct-2022,Debit Card,"26,722.00",00.00,"26,722.00"
25-Oct-2022,NEFT,00.00,"2,672.20","24,049.80"
25-Oct-2022,Purchase,00.00,"3,435.69","20,614.11"
25-Oct-2022,Bill,"1,681,713.00",00.00,"1,702,327.11"
25-Oct-2022,Tax,00.00,"1,702,327.11",00.00
25-Oct-2022,Cheque,400.30,00.00,400.30
25-Oct-2022,Miscellaneous,"13,963.95",00.00,"14,364.25"
25-Oct-2022,IMPS,00.00,"7,182.13","7,182.12"
25-Oct-2022,Miscellaneous,00.00,718.21,"6,463.91"
25-Oct-2022,Cash,00.00,"1,615.98","4,847.93"
25-Oct-2022,Miscellaneous,00.00,538.66,"4,309.27"
25-Oct-2022,Miscellaneous,00.00,"1,077.32","3,231.95"
25-Oct-2022,ATM,130.00,00.00,"3,361.95"
25-Oct-2022,Miscellaneous,"18,472.60",00.00,"21,834.55"
25-Oct-2022,Debit Card,07.93,00.00,"21,842.48"
25-Oct-2022,Interest,00.00,"10,921.24","10,921.24"
25-Oct-2022,Reversal,07.25,00.00,"10,928.49"
25-Oct-2022,ATM,00.00,"2,185.70","8,742.79"
25-Oct-2022,Cheque,00.00,"1,457.13","7,285.66"
25-Oct-2022,Cheque,00.00,"1,214.28","6,071.38"
25-Oct-2022,Transfer,00.00,607.14,"5,464.24"
25-Oct-2022,Bill,01.25,00.00,"5,465.49"
25-Oct-2022,Interest,157.60,00.00,"5,623.09"
25-Oct-2022,Bill,00.00,562.31,"5,060.78"
25-Oct-2022,Reversal,07.70,00.00,"5,068.48"
25-Oct-2022,RTGS,00.00,506.85,"4,561.63"
25-Oct-2022,Debit Card,290.00,00.00,"4,851.63"
25-Oct-2022,Interest,00.00,485.16,"4,366.47"
26-Oct-2022,Purchase,"587,917.00",00.00,"592,283.47"
26-Oct-2022,Tax,00.00,"65,809.27","526,474.20"
26-Oct-2022,Tax,00.00,"131,618.55","394,855.65"
26-Oct-2022,ATM,"19,912.00",00.00,"414,767.65"
26-Oct-2022,ATM,00.00,"46,085.29","368,682.36"
26-Oct-2022,Debit Card,"1,228,355.80",00.00,"1,597,038.16"
27-Oct-2022,Interest,"25,774.40",00.00,"1,622,812.56"
27-Oct-2022,Bill,01.91,00.00,"1,622,814.47"
27-Oct-2022,Commission,00.00,"324,562.89","1,298,251.58"
27-Oct-2022,Purchase,00.00,"324,562.90","973,688.68"
27-Oct-2022,Cheque,00.00,"108,187.63","865,501.05"
27-Oct-2022,Miscellaneous,37.83,00.00,"865,538.88"
27-Oct-2022,IMPS,00.00,"173,107.78","692,431.10"
27-Oct-2022,Purchase,05.87,00.00,"692,436.97"
27-Oct-2022,Bill,243.42,00.00,"692,680.39"
27-Oct-2022,Commission,00.00,"115,446.73","577,233.66"
27-Oct-2022,Commission,"42,361.00",00.00,"619,594.66"
28-Oct-2022,NEFT,00.00,"206,531.55","413,063.11"
28-Oct-2022,RTGS,00.00,"68,843.85","344,219.26"
28-Oct-2022,RTGS,"2,087.00",00.00,"346,306.26"
28-Oct-2022,Cheque,"30,323.06",00.00,"376,629.32"
28-Oct-2022,Debit Card,"208,538.00",00.00,"585,167.32"
28-Oct-2022,Reversal,00.00,"292,583.66","292,583.66"
28-Oct-2022,Interest,00.00,"292,583.66",00.00
28-Oct-2022,Reversal,51.00,00.00,51.00
28-Oct-2022,Miscellaneous,445.63,00.00,496.63
28-Oct-2022,RTGS,00.00,62.08,434.55
28-Oct-2022,Reversal,"1,021.30",00.00,"1,455.85"
28-Oct-2022,NEFT,00.00,181.98,"1,273.87"
28-Oct-2022,Interest,00.00,254.77,"1,019.10"
28-Oct-2022,Commission,"903,260.00",00.00,"904,279.10"
28-Oct-2022,Reversal,00.00,"301,426.37","602,852.73"
28-Oct-2022,Interest,00.00,"66,983.64","535,869.09"
28-Oct-2022,Transfer,"1,559.00",00.00,"537,428.09"
28-Oct-2022,Miscellaneous,00.00,"67,178.51","470,249.58"
28-Oct-2022,ATM,60.64,00.00,"470,310.22"
28-Oct-2022,ATM,00.00,"78,385.04","391,925.18"
28-Oct-2022,IMPS,00.00,"48,990.65","342,934.53"
28-Oct-2022,Reversal,208.90,00.00,"343,143.43"
28-Oct-2022,Cheque,166.19,00.00,"343,309.62"
28-Oct-2022,ATM,00.00,"85,827.41","257,482.22"
28-Oct-2022,Miscellaneous,"832,783.00",00.00,"1,090,265.22"
28-Oct-2022,Cheque,00.00,"1,090,265.22",00.00
28-Oct-2022,Transfer,63.41,00.00,63.41
28-Oct-2022,Cash,"513,702.00",00.00,"513,765.41"
28-Oct-2022,Debit Card,00.00,"64,220.68","449,544.73"
28-Oct-2022,Miscellaneous,00.00,"149,848.24","299,696.49"
28-Oct-2022,Cash,"1,196.01",00.00,"300,892.50"
28-Oct-2022,NEFT,00.00,"300,892.50",00.00
28-Oct-2022,Interest,"195,019.00",00.00,"195,019.00"
28-Oct-2022,IMPS,"148,608.00",00.00,"343,627.00"
28-Oct-2022,Miscellaneous,"4,153.00",00.00,"347,780.00"
28-Oct-2022,Purchase,"5,171.50",00.00,"352,951.50"
28-Oct-2022,Interest,59.00,00.00,"353,010.50"
28-Oct-2022,Cheque,04.12,00.00,"353,014.62"
28-Oct-2022,ATM,00.00,"88,253.66","264,760.96"
28-Oct-2022,RTGS,00.00,"44,126.83","220,634.13"
28-Oct-2022,Bill,254.00,00.00,"220,888.13"
28-Oct-2022,Cash,"916,184.50",00.00,"1,137,072.63"
28-Oct-2022,Transfer,58.20,00.00,"1,137,130.83"
28-Oct-2022,Bill,18.15,00.00,"1,137,148.98"
28-Oct-2022,Reversal,00.00,00.00,"1,137,148.98"
28-Oct-2022,RTGS,00.00,"126,349.89","1,010,799.09"
29-Oct-2022,Cheque,00.00,"144,399.87","866,399.22"
29-Oct-2022,NEFT,00.00,"86,639.92","779,759.30"
29-Oct-2022,Interest,00.00,"77,975.93","701,783.37"
29-Oct-2022,Cheque,"4,064.09",00.00,"705,847.46"
29-Oct-2022,IMPS,00.00,"78,427.50","627,419.96"
29-Oct-2022,Reversal,00.00,"78,427.50","548,992.46"
29-Oct-2022,Purchase,00.00,"548,992.46",00.00
29-Oct-2022,Commission,18.00,00.00,18.00
29-Oct-2022,Interest,"2,005,497.25",00.00,"2,005,515.25"
29-Oct-2022,Bill,00.00,"286,502.18","1,719,013.07"
29-Oct-2022,Miscellaneous,00.00,"214,876.63","1,504,136.44"
29-Oct-2022,Tax,"1,758,212.50",00.00,"3,262,348.94"
29-Oct-2022,Cash,"3,229.90",00.00,"3,265,578.84"
29-Oct-2022,Commission,"52,527.80",00.00,"3,318,106.64"
29-Oct-2022,Transfer,273.00,00.00,"3,318,379.64"
29-Oct-2022,Interest,44.69,00.00,"3,318,424.33"
29-Oct-2022,Cash,"1,447.81",00.00,"3,319,872.14"
30-Oct-2022,Purchase,"32,629.00",00.00,"3,352,501.14"
30-Oct-2022,Cheque,343.00,00.00,"3,352,844.14"
31-Oct-2022,RTGS,06.65,00.00,"3,352,850.79"
31-Oct-2022,Miscellaneous,00.00,"670,570.16","2,682,280.63"
31-Oct-2022,Cheque,480.90,00.00,"2,682,761.53"
31-Oct-2022,Interest,39.00,00.00,"2,682,800.53"
31-Oct-2022,IMPS,"141,023.00",00.00,"2,823,823.53"
31-Oct-2022,NEFT,00.00,"2,823,823.53",00.00
31-Oct-2022,Cash,478.60,00.00,478.60
01-Nov-2022,ATM,00.00,59.83,418.78
01-Nov-2022,NEFT,"19,686.10",00.00,"20,104.88"
01-Nov-2022,Reversal,00.00,"2,872.13","17,232.75"
01-Nov-2022,Interest,00.00,"4,308.19","12,924.56"
01-Nov-2022,Bill,24.00,00.00,"12,948.56"
01-Nov-2022,Transfer,38.00,00.00,"12,986.56"
01-Nov-2022,Transfer,"2,485.20",00.00,"15,471.76"
01-Nov-2022,Reversal,"1,894.00",00.00,"17,365.76"
01-Nov-2022,Interest,"1,717.24",00.00,"19,083.00"
01-Nov-2022,Reversal,00.00,"1,908.30","17,174.70"
01-Nov-2022,Cash,00.00,"1,717.47","15,457.23"
01-Nov-2022,Transfer,00.00,"15,457.23",00.00
01-Nov-2022,Purchase,"1,165.77",00.00,"1,165.77"
01-Nov-2022,Debit Card,09.00,00.00,"1,174.77"
01-Nov-2022,Cash,00.00,146.85,"1,027.92"
01-Nov-2022,Commission,07.00,00.00,"1,034.92"
01-Nov-2022,Cash,00.00,517.46,517.46
01-Nov-2022,Purchase,00.00,51.75,465.71
01-Nov-2022,Miscellaneous,43.00,00.00,508.71
01-Nov-2022,IMPS,22.00,00.00,530.71
01-Nov-2022,Commission,"145,010.22",00.00,"145,540.93"
01-Nov-2022,Tax,220.00,00.00,"145,760.93"
01-Nov-2022,Purchase,00.00,"29,152.19","116,608.74"
01-Nov-2022,ATM,45.20,00.00,"116,653.94"
01-Nov-2022,Miscellaneous,06.50,00.00,"116,660.44"
01-Nov-2022,Bill,01.00,00.00,"116,661.44"
01-Nov-2022,ATM,00.00,"23,332.29","93,329.15"
01-Nov-2022,RTGS,00.00,"18,665.83","74,663.32"
01-Nov-2022,Miscellaneous,320.88,00.00,"74,984.20"
01-Nov-2022,Purchase,00.00,"7,498.42","67,485.78"
01-Nov-2022,Interest,00.00,"67,485.78",00.00
01-Nov-2022,Purchase,387.70,00.00,387.70
01-Nov-2022,Bill,"1,961.00",00.00,"2,348.70"
01-Nov-2022,Commission,"112,497.10",00.00,"114,845.80"
01-Nov-2022,ATM,117.00,00.00,"114,962.80"
01-Nov-2022,IMPS,"21,539.00",00.00,"136,501.80"
01-Nov-2022,Interest,00.00,"45,500.60","91,001.20"
02-Nov-2022,Cheque,195.30,00.00,"91,196.50"
02-Nov-2022,Purchase,00.00,"91,196.50",00.00
02-Nov-2022,IMPS,"145,389.00",00.00,"145,389.00"
02-Nov-2022,Interest,00.00,"29,077.80","116,311.20"
02-Nov-2022,Cheque,00.00,"38,770.40","77,540.80"
02-Nov-2022,Transfer,00.00,"77,540.80",00.00
03-Nov-2022,NEFT,"12,499.00",00.00,"12,499.00"
03-Nov-2022,Cheque,00.00,"4,166.33","8,332.67"
03-Nov-2022,Commission,00.00,"1,041.58","7,291.09"
03-Nov-2022,Commission,"4,276.64",00.00,"11,567.73"
03-Nov-2022,Purchase,00.00,"1,156.77","10,410.96"
03-Nov-2022,Miscellaneous,00.00,"2,602.74","7,808.22"
03-Nov-2022,RTGS,00.00,"2,602.74","5,205.48"
03-Nov-2022,ATM,00.00,"1,041.10","4,164.38"
03-Nov-2022,Interest,268.40,00.00,"4,432.78"
03-Nov-2022,Cash,07.00,00.00,"4,439.78"
03-Nov-2022,Purchase,145.75,00.00,"4,585.53"
03-Nov-2022,Bill,"1,563.00",00.00,"6,148.53"
03-Nov-2022,Debit Card,07.18,00.00,"6,155.71"
03-Nov-2022,Debit Card,"246,803.59",00.00,"252,959.30"
03-Nov-2022,Purchase,00.00,"126,479.65","126,479.65"
03-Nov-2022,RTGS,00.00,"12,647.97","113,831.68"
03-Nov-2022,IMPS,00.00,"37,943.89","75,887.79"
03-Nov-2022,Cheque,"2,888.60",00.00,"78,776.39"
03-Nov-2022,NEFT,"14,775.00",00.00,"93,551.39"
03-Nov-2022,NEFT,"1,387.80",00.00,"94,939.19"
03-Nov-2022,Bill,"1,570,063.00",00.00,"1,665,002.19"
03-Nov-2022,Purchase,00.00,"416,250.55","1,248,751.64"
03-Nov-2022,Reversal,00.00,"416,250.55","832,501.09"
03-Nov-2022,Tax,00.00,"208,125.27","624,375.82"
03-Nov-2022,ATM,"4,047.80",00.00,"628,423.62"
03-Nov-2022,Miscellaneous,00.00,"209,474.54","418,949.08"
03-Nov-2022,Cash,"257,975.40",00.00,"676,924.48"
03-Nov-2022,IMPS,"163,635.41",00.00,"840,559.89"
03-Nov-2022,Cash,00.00,"140,093.32","700,466.58"
03-Nov-2022,Cash,00.00,"77,829.62","622,636.96"
03-Nov-2022,Cash,00.00,"77,829.62","544,807.34"
03-Nov-2022,Cheque,00.00,"544,807.34",00.00
03-Nov-2022,Purchase,202.30,00.00,202.30
03-Nov-2022,Miscellaneous,"164,919.00",00.00,"165,121.30"
03-Nov-2022,Cash,07.00,00.00,"165,128.30"
03-Nov-2022,Tax,"3,641.40",00.00,"168,769.70"
03-Nov-2022,Purchase,"142,111.38",00.00,"310,881.08"
03-Nov-2022,Cash,00.00,"310,881.08",00.00
03-Nov-2022,NEFT,162.80,00.00,162.80
03-Nov-2022,Cheque,"44,520.53",00.00,"44,683.33"
03-Nov-2022,Interest,00.00,"11,170.83","33,512.50"
03-Nov-2022,RTGS,58.61,00.00,"33,571.11"
03-Nov-2022,Transfer,165.60,00.00,"33,736.71"
03-Nov-2022,NEFT,"222,413.00",00.00,"256,149.71"
03-Nov-2022,Transfer,00.00,"64,037.43","192,112.28"
03-Nov-2022,RTGS,403.00,00.00,"192,515.28"
03-Nov-2022,Miscellaneous,00.00,"24,064.41","168,450.87"
03-Nov-2022,RTGS,31.78,00.00,"168,482.65"
03-Nov-2022,Bill,00.00,"84,241.33","84,241.32"
03-Nov-2022,Reversal,307.80,00.00,"84,549.12"
03-Nov-2022,Cash,00.00,"9,394.35","75,154.77"
03-Nov-2022,Bill,"1,602,701.25",00.00,"1,677,856.02"
03-Nov-2022,NEFT,"1,382,119.00",00.00,"3,059,975.02"
03-Nov-2022,Tax,437.24,00.00,"3,060,412.26"
03-Nov-2022,Cheque,02.30,00.00,"3,060,414.56"
03-Nov-2022,Debit Card,"28,814.25",00.00,"3,089,228.81"
03-Nov-2022,Cheque,00.00,"3,089,228.81",00.00
03-Nov-2022,Transfer,"100,777.70",00.00,"100,777.70"
03-Nov-2022,Commission,"38,370.00",00.00,"139,147.70"
03-Nov-2022,Debit Card,606.60,00.00,"139,754.30"
03-Nov-2022,Commission,"157,939.62",00.00,"297,693.92"
03-Nov-2022,RTGS,00.00,"74,423.48","223,270.44"
03-Nov-2022,Bill,00.00,"111,635.22","111,635.22"
03-Nov-2022,ATM,232.84,00.00,"111,868.06"
03-Nov-2022,Cash,00.00,"12,429.78","99,438.28"
03-Nov-2022,Reversal,"450,772.00",00.00,"550,210.28"
03-Nov-2022,Tax,00.00,"183,403.43","366,806.85"
03-Nov-2022,Interest,00.00,"45,850.86","320,955.99"
03-Nov-2022,Purchase,"1,815.41",00.00,"322,771.40"
03-Nov-2022,RTGS,00.54,00.00,"322,771.94"
03-Nov-2022,Tax,"260,268.60",00.00,"583,040.54"
03-Nov-2022,NEFT,312.10,00.00,"583,352.64"
03-Nov-2022,Debit Card,00.00,"145,838.16","437,514.48"
03-Nov-2022,Interest,00.00,"145,838.16","291,676.32"
03-Nov-2022,Miscellaneous,"622,272.00",00.00,"913,948.32"
03-Nov-2022,Cash,00.00,"130,564.05","783,384.27"
03-Nov-2022,Bill,00.00,"97,923.03","685,461.24"
03-Nov-2022,Bill,55.30,00.00,"685,516.54"
03-Nov-2022,Tax,00.00,"97,930.93","587,585.61"
03-Nov-2022,Transfer,"2,056,386.00",00.00,"2,643,971.61"
03-Nov-2022,Reversal,"28,487.30",00.00,"2,672,458.91"
03-Nov-2022,Cheque,00.00,"2,672,458.91",00.00
03-Nov-2022,Bill,"1,786,966.00",00.00,"1,786,966.00"
03-Nov-2022,Bill,00.00,"178,696.60","1,608,269.40"
03-Nov-2022,IMPS,"499,903.00",00.00,"2,108,172.40"
03-Nov-2022,Reversal,00.00,"351,362.07","1,756,810.33"
03-Nov-2022,NEFT,"600,208.50",00.00,"2,357,018.83"
03-Nov-2022,NEFT,00.00,"471,403.77","1,885,615.06"
03-Nov-2022,Tax,00.00,"269,373.58","1,616,241.48"
03-Nov-2022,Interest,00.00,"538,747.16","1,077,494.32"
03-Nov-2022,Miscellaneous,00.00,"153,927.76","923,566.56"
03-Nov-2022,Interest,00.00,"230,891.64","692,674.92"
03-Nov-2022,NEFT,941.80,00.00,"693,616.72"
03-Nov-2022,Commission,"1,426,137.00",00.00,"2,119,753.72"
03-Nov-2022,RTGS,"51,709.00",00.00,"2,171,462.72"
03-Nov-2022,NEFT,01.34,00.00,"2,171,464.06"
03-Nov-2022,Interest,00.00,"361,910.68","1,809,553.38"
03-Nov-2022,Bill,00.00,"226,194.17","1,583,359.21"
03-Nov-2022,Purchase,00.00,"263,893.20","1,319,466.01"
03-Nov-2022,Commission,"16,344.00",00.00,"1,335,810.01"
03-Nov-2022,Cash,198.79,00.00,"1,336,008.80"
03-Nov-2022,Transfer,56.00,00.00,"1,336,064.80"
03-Nov-2022,IMPS,04.40,00.00,"1,336,069.20"
03-Nov-2022,Purchase,00.00,"222,678.20","1,113,391.00"
03-Nov-2022,Bill,00.00,"371,130.33","742,260.67"
03-Nov-2022,Transfer,00.00,"92,782.58","649,478.09"
03-Nov-2022,Cheque,00.00,"64,947.81","584,530.28"
03-Nov-2022,Interest,00.00,"116,906.06","467,624.22"
03-Nov-2022,Tax,00.00,"51,958.25","415,665.97"
03-Nov-2022,NEFT,"170,844.60",00.00,"586,510.57"
03-Nov-2022,IMPS,294.63,00.00,"586,805.20"
03-Nov-2022,Interest,"28,843.30",00.00,"615,648.50"
03-Nov-2022,Miscellaneous,00.00,"307,824.25","307,824.25"
03-Nov-2022,RTGS,432.70,00.00,"308,256.95"
03-Nov-2022,Tax,00.00,"102,752.32","205,504.63"
03-Nov-2022,Reversal,00.00,"41,100.93","164,403.70"
03-Nov-2022,Purchase,00.00,"54,801.23","109,602.47"
03-Nov-2022,Reversal,00.00,"27,400.62","82,201.85"
03-Nov-2022,Debit Card,925.10,00.00,"83,126.95"
03-Nov-2022,Commission,00.00,"9,236.33","73,890.62"
03-Nov-2022,Commission,"2,282.10",00.00,"76,172.72"
03-Nov-2022,Commission,"2,391.70",00.00,"78,564.42"
03-Nov-2022,Tax,00.00,"39,282.21","39,282.21"
03-Nov-2022,Miscellaneous,00.00,"3,928.22","35,353.99"
03-Nov-2022,Bill,00.00,"5,892.33","29,461.66"
03-Nov-2022,Debit Card,39.00,00.00,"29,500.66"
03-Nov-2022,Tax,"169,927.81",00.00,"199,428.47"
03-Nov-2022,Miscellaneous,"236,244.80",00.00,"435,673.27"
03-Nov-2022,NEFT,"4,512.38",00.00,"440,185.65"
03-Nov-2022,Reversal,07.70,00.00,"440,193.35"
03-Nov-2022,Purchase,43.00,00.00,"440,236.35"
03-Nov-2022,Purchase,00.00,"48,915.15","391,321.20"
03-Nov-2022,Interest,"33,360.40",00.00,"424,681.60"
03-Nov-2022,Bill,00.00,"42,468.16","382,213.44"
03-Nov-2022,Cheque,"241,172.00",00.00,"623,385.44"
03-Nov-2022,Bill,00.00,"89,055.06","534,330.38"
03-Nov-2022,Transfer,00.00,"59,370.04","474,960.34"
03-Nov-2022,Cheque,00.00,"237,480.17","237,480.17"
03-Nov-2022,Debit Card,24.00,00.00,"237,504.17"
03-Nov-2022,Miscellaneous,00.50,00.00,"237,504.67"
03-Nov-2022,Miscellaneous,00.00,"47,500.93","190,003.74"
04-Nov-2022,IMPS,00.00,"95,001.87","95,001.87"
04-Nov-2022,Commission,"67,981.00",00.00,"162,982.87"
04-Nov-2022,Purchase,00.00,"23,283.27","139,699.60"
04-Nov-2022,Bill,06.00,00.00,"139,705.60"
04-Nov-2022,Commission,"1,453,456.00",00.00,"1,593,161.60"
04-Nov-2022,Cash,00.00,"199,145.20","1,394,016.40"
04-Nov-2022,IMPS,00.00,"154,890.71","1,239,125.69"
04-Nov-2022,Tax,00.00,"247,825.14","991,300.55"
04-Nov-2022,Cash,03.06,00.00,"991,303.61"
04-Nov-2022,RTGS,00.00,"495,651.81","495,651.80"
04-Nov-2022,Bill,"27,965.00",00.00,"523,616.80"
04-Nov-2022,Debit Card,00.00,"104,723.36","418,893.44"
04-Nov-2022,Miscellaneous,"400,533.80",00.00,"819,427.24"
04-Nov-2022,Tax,"2,009.60",00.00,"821,436.84"
04-Nov-2022,IMPS,00.00,"102,679.61","718,757.24"
04-Nov-2022,Purchase,07.60,00.00,"718,764.84"
04-Nov-2022,Cheque,00.00,"71,876.48","646,888.36"
04-Nov-2022,Cheque,00.00,"215,629.45","431,258.91"
04-Nov-2022,Transfer,207.50,00.00,"431,466.41"
04-Nov-2022,Interest,"948,464.00",00.00,"1,379,930.41"
04-Nov-2022,RTGS,"2,567.00",00.00,"1,382,497.41"
04-Nov-2022,Bill,00.00,"460,832.47","921,664.94"
04-Nov-2022,Commission,00.00,"153,610.82","768,054.12"
04-Nov-2022,IMPS,00.00,"153,610.82","614,443.30"
04-Nov-2022,ATM,00.00,"153,610.83","460,832.48"
04-Nov-2022,Tax,04.00,00.00,"460,836.48"
04-Nov-2022,NEFT,346.60,00.00,"461,183.08"
04-Nov-2022,Transfer,47.60,00.00,"461,230.68"
04-Nov-2022,Purchase,00.00,"230,615.34","230,615.34"
04-Nov-2022,Commission,00.00,"57,653.84","172,961.50"
04-Nov-2022,Commission,00.00,"57,653.83","115,307.67"
04-Nov-2022,ATM,00.00,"28,826.92","86,480.75"
04-Nov-2022,RTGS,03.28,00.00,"86,484.03"
04-Nov-2022,Commission,"1,931.00",00.00,"88,415.03"
04-Nov-2022,Cheque,00.00,"22,103.76","66,311.27"
04-Nov-2022,Bill,247.00,00.00,"66,558.27"
04-Nov-2022,Commission,00.00,"16,639.57","49,918.70"
04-Nov-2022,Cash,00.00,"24,959.35","24,959.35"
04-Nov-2022,Bill,00.35,00.00,"24,959.70"
04-Nov-2022,RTGS,00.00,"4,991.94","19,967.76"
05-Nov-2022,Debit Card,00.00,"6,655.92","13,311.84"
05-Nov-2022,Transfer,00.00,"2,218.64","11,093.20"
05-Nov-2022,NEFT,"46,526.00",00.00,"57,619.20"
05-Nov-2022,RTGS,00.00,"57,619.20",00.00
05-Nov-2022,Transfer,"1,683,885.75",00.00,"1,683,885.75"
05-Nov-2022,Interest,200.28,00.00,"1,684,086.03"
05-Nov-2022,Commission,00.00,"280,681.01","1,403,405.02"
05-Nov-2022,Commission,08.00,00.00,"1,403,413.02"
05-Nov-2022,Purchase,00.00,"467,804.34","935,608.68"
05-Nov-2022,IMPS,00.00,"116,951.09","818,657.60"
05-Nov-2022,ATM,00.00,"163,731.52","654,926.08"
05-Nov-2022,Miscellaneous,00.00,"218,308.69","436,617.39"
05-Nov-2022,Cheque,"1,974.60",00.00,"438,591.99"
05-Nov-2022,IMPS,00.00,"219,296.00","219,296.00"
05-Nov-2022,NEFT,"103,639.00",00.00,"322,935.00"
05-Nov-2022,Transfer,00.00,"32,293.50","290,641.50"
05-Nov-2022,IMPS,00.00,"29,064.15","261,577.35"
05-Nov-2022,Reversal,00.00,"37,368.19","224,209.16"
05-Nov-2022,ATM,00.00,"44,841.83","179,367.33"
05-Nov-2022,Cash,"26,240.97",00.00,"205,608.30"
05-Nov-2022,IMPS,"156,007.22",00.00,"361,615.52"
05-Nov-2022,Miscellaneous,"2,194.10",00.00,"363,809.62"
06-Nov-2022,Cheque,00.00,"45,476.20","318,333.42"
07-Nov-2022,Debit Card,79.74,00.00,"318,413.16"
07-Nov-2022,RTGS,00.00,"159,206.58","159,206.58"
07-Nov-2022,Transfer,00.00,"15,920.66","143,285.92"
07-Nov-2022,Cheque,446.00,00.00,"143,731.92"
07-Nov-2022,Bill,00.00,"143,731.92",00.00
07-Nov-2022,NEFT,"1,240,000.00",00.00,"1,240,000.00"
08-Nov-2022,Bill,00.95,00.00,"1,240,000.95"
08-Nov-2022,RTGS,00.00,"155,000.12","1,085,000.83"
08-Nov-2022,Tax,125.51,00.00,"1,085,126.34"
08-Nov-2022,Miscellaneous,"28,555.80",00.00,"1,113,682.14"
08-Nov-2022,RTGS,00.00,"111,368.21","1,002,313.93"
08-Nov-2022,Tax,00.00,"167,052.32","835,261.61"
08-Nov-2022,Purchase,984.00,00.00,"836,245.61"
08-Nov-2022,Tax,695.00,00.00,"836,940.61"
08-Nov-2022,Bill,00.00,"119,562.94","717,377.67"
08-Nov-2022,Cheque,07.40,00.00,"717,385.07"
08-Nov-2022,Debit Card,00.00,"239,128.36","478,256.71"
08-Nov-2022,ATM,00.00,"79,709.45","398,547.26"
08-Nov-2022,ATM,00.00,"39,854.73","358,692.53"
08-Nov-2022,NEFT,00.00,"44,836.57","313,855.96"
08-Nov-2022,RTGS,"47,700.00",00.00,"361,555.96"
08-Nov-2022,RTGS,00.00,"120,518.65","241,037.31"
08-Nov-2022,Purchase,"252,172.19",00.00,"493,209.50"
08-Nov-2022,Interest,"2,929.27",00.00,"496,138.77"
08-Nov-2022,Cash,38.90,00.00,"496,177.67"
08-Nov-2022,Miscellaneous,41.00,00.00,"496,218.67"
08-Nov-2022,IMPS,00.00,"99,243.73","396,974.94"
08-Nov-2022,NEFT,00.00,"56,710.71","340,264.23"
08-Nov-2022,Reversal,"195,427.00",00.00,"535,691.23"
08-Nov-2022,Cheque,61.80,00.00,"535,753.03"
08-Nov-2022,ATM,00.00,"107,150.61","428,602.42"
08-Nov-2022,RTGS,"7,727.90",00.00,"436,330.32"
08-Nov-2022,Bill,00.00,"54,541.29","381,789.03"
08-Nov-2022,Transfer,257.60,00.00,"382,046.63"
08-Nov-2022,NEFT,00.00,"76,409.33","305,637.30"
08-Nov-2022,IMPS,00.00,"305,637.30",00.00
08-Nov-2022,RTGS,"207,372.00",00.00,"207,372.00"
08-Nov-2022,Reversal,00.00,"103,686.00","103,686.00"
08-Nov-2022,Bill,00.00,"20,737.20","82,948.80"
08-Nov-2022,Tax,"20,312.00",00.00,"103,260.80"
08-Nov-2022,Transfer,00.00,"20,652.16","82,608.64"
08-Nov-2022,RTGS,00.00,"9,178.74","73,429.90"
08-Nov-2022,Tax,00.00,"73,429.90",00.00
08-Nov-2022,Purchase,"216,164.03",00.00,"216,164.03"
08-Nov-2022,Debit Card,"173,040.20",00.00,"389,204.23"
08-Nov-2022,Tax,00.00,"389,204.23",00.00
08-Nov-2022,Transfer,"3,568.00",00.00,"3,568.00"
09-Nov-2022,Reversal,00.00,446.00,"3,122.00"
09-Nov-2022,IMPS,"3,099.30",00.00,"6,221.30"
09-Nov-2022,Commission,"734,544.80",00.00,"740,766.10"
09-Nov-2022,Purchase,00.00,"148,153.22","592,612.88"
09-Nov-2022,Miscellaneous,00.00,"592,612.88",00.00
09-Nov-2022,NEFT,"203,640.00",00.00,"203,640.00"
09-Nov-2022,RTGS,00.00,"25,455.00","178,185.00"
09-Nov-2022,Transfer,"2,257.90",00.00,"180,442.90"
09-Nov-2022,Reversal,00.00,"45,110.73","135,332.17"
09-Nov-2022,IMPS,00.00,"135,332.17",00.00
09-Nov-2022,Tax,58.63,00.00,58.63
09-Nov-2022,Reversal,00.00,11.73,46.90
09-Nov-2022,Cheque,00.00,23.45,23.45
09-Nov-2022,NEFT,"1,343.00",00.00,"1,366.45"
09-Nov-2022,Purchase,04.00,00.00,"1,370.45"
09-Nov-2022,Cash,00.00,171.31,"1,199.14"
09-Nov-2022,Commission,04.52,00.00,"1,203.66"
09-Nov-2022,ATM,00.00,150.46,"1,053.20"
09-Nov-2022,Reversal,499.09,00.00,"1,552.29"
09-Nov-2022,NEFT,00.00,194.04,"1,358.25"
09-Nov-2022,Tax,00.00,194.04,"1,164.21"
09-Nov-2022,Commission,"17,051.60",00.00,"18,215.81"
09-Nov-2022,Cash,"1,591,791.75",00.00,"1,610,007.56"
09-Nov-2022,ATM,00.00,"161,000.76","1,449,006.80"
09-Nov-2022,Transfer,00.00,"241,501.13","1,207,505.67"
09-Nov-2022,NEFT,00.00,"150,938.21","1,056,567.46"
09-Nov-2022,Purchase,00.00,"1,056,567.46",00.00
09-Nov-2022,IMPS,"151,380.10",00.00,"151,380.10"
09-Nov-2022,Purchase,00.00,"21,625.73","129,754.37"
09-Nov-2022,Transfer,00.00,"129,754.37",00.00
09-Nov-2022,Commission,"5,507.84",00.00,"5,507.84"
09-Nov-2022,Interest,00.00,550.78,"4,957.06"
09-Nov-2022,Miscellaneous,00.00,619.63,"4,337.43"
09-Nov-2022,Debit Card,00.00,"4,337.43",00.00
09-Nov-2022,Debit Card,33.93,00.00,33.93
09-Nov-2022,Miscellaneous,13.00,00.00,46.93
09-Nov-2022,Transfer,00.00,23.47,23.46
10-Nov-2022,Transfer,00.00,02.93,20.53
10-Nov-2022,Interest,00.00,02.57,17.96
10-Nov-2022,RTGS,00.00,02.57,15.39
10-Nov-2022,Purchase,35.97,00.00,51.36
10-Nov-2022,Bill,"32,158.90",00.00,"32,210.26"
10-Nov-2022,NEFT,507.10,00.00,"32,717.36"
10-Nov-2022,NEFT,00.00,"10,905.79","21,811.57"
10-Nov-2022,Purchase,00.00,"3,635.26","18,176.31"
10-Nov-2022,NEFT,00.00,"6,058.77","12,117.54"
10-Nov-2022,Purchase,"2,299.00",00.00,"14,416.54"
10-Nov-2022,NEFT,00.00,"4,805.51","9,611.03"
10-Nov-2022,Commission,"1,826.00",00.00,"11,437.03"
10-Nov-2022,Reversal,142.00,00.00,"11,579.03"
10-Nov-2022,Commission,"1,279,860.75",00.00,"1,291,439.78"
10-Nov-2022,Commission,00.00,"184,491.40","1,106,948.38"
10-Nov-2022,Tax,00.00,"221,389.68","885,558.70"
10-Nov-2022,Purchase,00.00,"885,558.70",00.00
10-Nov-2022,Bill,"6,356.10",00.00,"6,356.10"
10-Nov-2022,ATM,00.00,"1,589.03","4,767.08"
10-Nov-2022,Debit Card,624.65,00.00,"5,391.73"
10-Nov-2022,ATM,00.00,"5,391.73",00.00
10-Nov-2022,Miscellaneous,"133,947.00",00.00,"133,947.00"
10-Nov-2022,Debit Card,00.00,"33,486.75","100,460.25"
10-Nov-2022,Purchase,00.00,"11,162.25","89,298.00"
10-Nov-2022,Commission,"75,430.00",00.00,"164,728.00"
10-Nov-2022,Commission,00.00,"54,909.33","109,818.67"
10-Nov-2022,RTGS,00.00,"18,303.11","91,515.56"
10-Nov-2022,Cheque,00.00,"11,439.45","80,076.11"
11-Nov-2022,NEFT,00.00,"8,007.61","72,068.50"
11-Nov-2022,Miscellaneous,06.50,00.00,"72,075.00"
11-Nov-2022,NEFT,53.00,00.00,"72,128.00"
11-Nov-2022,NEFT,46.90,00.00,"72,174.90"
11-Nov-2022,IMPS,00.00,"9,021.86","63,153.04"
11-Nov-2022,Cheque,00.00,"7,017.00","56,136.04"
11-Nov-2022,Tax,62.14,00.00,"56,198.18"
11-Nov-2022,Cash,"224,675.20",00.00,"280,873.38"
11-Nov-2022,Reversal,00.00,"93,624.46","187,248.92"
11-Nov-2022,Purchase,03.35,00.00,"187,252.27"
11-Nov-2022,NEFT,00.00,"26,750.32","160,501.95"
11-Nov-2022,NEFT,00.00,"22,928.85","137,573.10"
11-Nov-2022,Bill,03.00,00.00,"137,576.10"
11-Nov-2022,Interest,00.00,"13,757.61","123,818.49"
11-Nov-2022,Purchase,00.00,"15,477.31","108,341.18"
11-Nov-2022,NEFT,00.00,"15,477.31","92,863.87"
11-Nov-2022,Debit Card,149.00,00.00,"93,012.87"
11-Nov-2022,Bill,05.80,00.00,"93,018.67"
11-Nov-2022,Bill,45.30,00.00,"93,063.97"
11-Nov-2022,NEFT,00.00,"93,063.97",00.00
12-Nov-2022,NEFT,"710,804.00",00.00,"710,804.00"
12-Nov-2022,NEFT,00.00,"355,402.00","355,402.00"
12-Nov-2022,NEFT,00.00,"88,850.50","266,551.50"
12-Nov-2022,Miscellaneous,142.20,00.00,"266,693.70"
12-Nov-2022,RTGS,00.00,"26,669.37","240,024.33"
12-Nov-2022,NEFT,50.20,00.00,"240,074.53"
12-Nov-2022,Miscellaneous,00.00,"240,074.53",00.00
12-Nov-2022,ATM,00.00,00.00,00.00
12-Nov-2022,Cash,64.00,00.00,64.00
12-Nov-2022,Cash,00.00,32.00,32.00
12-Nov-2022,Transfer,04.30,00.00,36.30
12-Nov-2022,Miscellaneous,00.00,09.08,27.22
12-Nov-2022,RTGS,00.00,09.07,18.15
12-Nov-2022,Miscellaneous,00.00,01.82,16.33
12-Nov-2022,ATM,00.78,00.00,17.11
12-Nov-2022,IMPS,00.00,02.44,14.67
12-Nov-2022,ATM,"1,432.00",00.00,"1,446.67"
12-Nov-2022,ATM,57.00,00.00,"1,503.67"
12-Nov-2022,IMPS,00.00,375.92,"1,127.75"
12-Nov-2022,NEFT,00.00,187.96,939.79
12-Nov-2022,Reversal,00.00,156.63,783.16
12-Nov-2022,ATM,00.00,97.90,685.26
12-Nov-2022,Purchase,03.00,00.00,688.26
12-Nov-2022,Cheque,00.00,344.13,344.13
12-Nov-2022,Cheque,"1,643.20",00.00,"1,987.33"
12-Nov-2022,Miscellaneous,"17,091.00",00.00,"19,078.33"
12-Nov-2022,Transfer,"28,251.40",00.00,"47,329.73"
12-Nov-2022,Commission,"1,808,983.25",00.00,"1,856,312.98"
13-Nov-2022,Miscellaneous,00.00,"618,770.99","1,237,541.99"
13-Nov-2022,Transfer,27.00,00.00,"1,237,568.99"
13-Nov-2022,Cash,"3,438.00",00.00,"1,241,006.99"
13-Nov-2022,Cheque,196.63,00.00,"1,241,203.62"
13-Nov-2022,Reversal,00.00,"413,734.54","827,469.08"
13-Nov-2022,Cheque,33.00,00.00,"827,502.08"
13-Nov-2022,ATM,00.00,"103,437.76","724,064.32"
13-Nov-2022,Transfer,"168,335.70",00.00,"892,400.02"
13-Nov-2022,Miscellaneous,00.00,"223,100.01","669,300.02"
13-Nov-2022,Cash,"239,725.34",00.00,"909,025.36"
13-Nov-2022,Cash,00.00,"151,504.23","757,521.13"
13-Nov-2022,IMPS,00.00,"378,760.57","378,760.56"
13-Nov-2022,RTGS,00.00,"37,876.06","340,884.50"
13-Nov-2022,Cash,295.50,00.00,"341,180.00"
13-Nov-2022,Cheque,"2,234.30",00.00,"343,414.30"
13-Nov-2022,Cash,00.00,"85,853.58","257,560.72"
13-Nov-2022,RTGS,00.00,"36,794.39","220,766.33"
13-Nov-2022,Reversal,"173,494.09",00.00,"394,260.42"
13-Nov-2022,Purchase,00.00,"49,282.55","344,977.87"
13-Nov-2022,Cheque,00.00,"57,496.31","287,481.56"
13-Nov-2022,ATM,00.00,"95,827.19","191,654.37"
13-Nov-2022,Miscellaneous,"21,439.00",00.00,"213,093.37"
13-Nov-2022,ATM,00.00,"53,273.34","159,820.03"
13-Nov-2022,Commission,00.00,"19,977.50","139,842.53"
13-Nov-2022,RTGS,00.00,"19,977.50","119,865.03"
13-Nov-2022,Transfer,00.00,"13,318.34","106,546.69"
13-Nov-2022,Reversal,968.00,00.00,"107,514.69"
13-Nov-2022,Tax,07.60,00.00,"107,522.29"
13-Nov-2022,RTGS,17.60,00.00,"107,539.89"
13-Nov-2022,Reversal,00.00,"10,753.99","96,785.90"
13-Nov-2022,Cash,00.00,"19,357.18","77,428.72"
13-Nov-2022,IMPS,00.00,"8,603.19","68,825.53"
13-Nov-2022,Miscellaneous,00.00,"8,603.19","60,222.34"
13-Nov-2022,Interest,00.00,"15,055.59","45,166.76"
13-Nov-2022,Miscellaneous,00.00,"5,645.85","39,520.92"
13-Nov-2022,Reversal,"153,266.20",00.00,"192,787.12"
13-Nov-2022,Transfer,"15,017.10",00.00,"207,804.22"
13-Nov-2022,Commission,00.00,"20,780.42","187,023.80"
14-Nov-2022,Interest,12.00,00.00,"187,035.80"
15-Nov-2022,ATM,00.00,"18,703.58","168,332.22"
15-Nov-2022,IMPS,00.00,"18,703.58","149,628.64"
15-Nov-2022,Cheque,13.20,00.00,"149,641.84"
15-Nov-2022,IMPS,00.00,"29,928.37","119,713.47"
15-Nov-2022,Bill,00.00,"14,964.18","104,749.29"
15-Nov-2022,Commission,00.00,"10,474.93","94,274.36"
15-Nov-2022,RTGS,00.00,"31,424.79","62,849.57"
15-Nov-2022,Cash,02.90,00.00,"62,852.47"
15-Nov-2022,Debit Card,36.91,00.00,"62,889.38"
15-Nov-2022,Debit Card,"3,669.00",00.00,"66,558.38"
15-Nov-2022,Purchase,06.00,00.00,"66,564.38"
15-Nov-2022,Transfer,"1,271,638.50",00.00,"1,338,202.88"
15-Nov-2022,Debit Card,00.00,"669,101.44","669,101.44"
15-Nov-2022,Debit Card,00.00,"334,550.72","334,550.72"
15-Nov-2022,Reversal,00.00,"37,172.30","297,378.42"
15-Nov-2022,Cheque,"31,250.00",00.00,"328,628.42"
15-Nov-2022,Reversal,206.37,00.00,"328,834.79"
15-Nov-2022,IMPS,00.00,"109,611.60","219,223.19"
15-Nov-2022,Interest,"1,095,311.00",00.00,"1,314,534.19"
15-Nov-2022,Cheque,00.00,"131,453.42","1,183,080.77"
15-Nov-2022,Commission,00.00,"169,011.54","1,014,069.23"
15-Nov-2022,Cash,00.00,"1,014,069.23",00.00
15-Nov-2022,IMPS,00.01,00.00,00.01
15-Nov-2022,RTGS,11.80,00.00,11.81
15-Nov-2022,RTGS,04.00,00.00,15.81
15-Nov-2022,Miscellaneous,00.00,03.16,12.65
15-Nov-2022,RTGS,"815,060.80",00.00,"815,073.45"
15-Nov-2022,Transfer,02.00,00.00,"815,075.45"
15-Nov-2022,Cash,07.00,00.00,"815,082.45"
15-Nov-2022,RTGS,06.05,00.00,"815,088.50"
16-Nov-2022,ATM,00.00,"407,544.25","407,544.25"
16-Nov-2022,Bill,"140,707.70",00.00,"548,251.95"
16-Nov-2022,NEFT,00.00,"548,251.95",00.00
16-Nov-2022,IMPS,"1,070.51",00.00,"1,070.51"
16-Nov-2022,Transfer,209.73,00.00,"1,280.24"
16-Nov-2022,RTGS,00.00,213.37,"1,066.87"
16-Nov-2022,Reversal,00.00,133.36,933.51
16-Nov-2022,Debit Card,00.00,133.36,800.15
16-Nov-2022,RTGS,"3,581.20",00.00,"4,381.35"
16-Nov-2022,Reversal,"3,031.60",00.00,"7,412.95"
16-Nov-2022,Reversal,"189,194.41",00.00,"196,607.36"
16-Nov-2022,Debit Card,00.00,"24,575.92","172,031.44"
16-Nov-2022,Tax,"1,907,168.80",00.00,"2,079,200.24"
16-Nov-2022,IMPS,"1,395.00",00.00,"2,080,595.24"
16-Nov-2022,IMPS,00.00,"520,148.81","1,560,446.43"
16-Nov-2022,Interest,"17,762.10",00.00,"1,578,208.53"
16-Nov-2022,Miscellaneous,00.00,"526,069.51","1,052,139.02"
16-Nov-2022,Tax,00.00,"131,517.38","920,621.64"
16-Nov-2022,Debit Card,09.00,00.00,"920,630.64"
16-Nov-2022,ATM,00.00,"460,315.32","460,315.32"
16-Nov-2022,Cheque,00.00,"92,063.06","368,252.26"
16-Nov-2022,Reversal,01.00,00.00,"368,253.26"
16-Nov-2022,IMPS,00.00,"184,126.63","184,126.63"
16-Nov-2022,Commission,00.00,"61,375.54","122,751.09"
16-Nov-2022,Transfer,00.00,"24,550.22","98,200.87"
16-Nov-2022,Miscellaneous,"28,603.50",00.00,"126,804.37"
16-Nov-2022,Transfer,"1,540.60",00.00,"128,344.97"
16-Nov-2022,Bill,00.00,"64,172.49","64,172.48"
16-Nov-2022,Debit Card,00.00,"7,130.28","57,042.20"
16-Nov-2022,IMPS,"1,899,482.50",00.00,"1,956,524.70"
16-Nov-2022,RTGS,"20,895.50",00.00,"1,977,420.20"
16-Nov-2022,Miscellaneous,"1,842,164.00",00.00,"3,819,584.20"
16-Nov-2022,Cheque,00.00,"424,398.24","3,395,185.96"
16-Nov-2022,Bill,"2,102.00",00.00,"3,397,287.96"
16-Nov-2022,Miscellaneous,00.00,"485,326.85","2,911,961.11"
16-Nov-2022,Interest,00.00,"727,990.28","2,183,970.83"
16-Nov-2022,Transfer,02.20,00.00,"2,183,973.03"
16-Nov-2022,Purchase,05.00,00.00,"2,183,978.03"
16-Nov-2022,Commission,00.00,"242,664.23","1,941,313.80"
16-Nov-2022,ATM,07.63,00.00,"1,941,321.43"
16-Nov-2022,Transfer,17.93,00.00,"1,941,339.36"
16-Nov-2022,Cheque,00.00,"388,267.87","1,553,071.49"
16-Nov-2022,RTGS,00.00,"258,845.25","1,294,226.24"
16-Nov-2022,ATM,"248,114.62",00.00,"1,542,340.86"
16-Nov-2022,Transfer,00.00,"154,234.09","1,388,106.77"
16-Nov-2022,IMPS,00.00,"173,513.35","1,214,593.42"
16-Nov-2022,RTGS,00.00,"134,954.82","1,079,638.60"
17-Nov-2022,Commission,00.00,"539,819.30","539,819.30"
17-Nov-2022,Commission,04.70,00.00,"539,824.00"
17-Nov-2022,Interest,"2,433.60",00.00,"542,257.60"
17-Nov-2022,IMPS,"197,922.16",00.00,"740,179.76"
17-Nov-2022,Reversal,00.00,"370,089.88","370,089.88"
17-Nov-2022,Commission,00.00,"74,017.98","296,071.90"
17-Nov-2022,Miscellaneous,"204,603.56",00.00,"500,675.46"
17-Nov-2022,Reversal,174.32,00.00,"500,849.78"
17-Nov-2022,NEFT,00.00,"166,949.93","333,899.85"
17-Nov-2022,Bill,00.00,"333,899.85",00.00
17-Nov-2022,Purchase,"1,006.00",00.00,"1,006.00"
17-Nov-2022,Interest,"10,403.00",00.00,"11,409.00"
17-Nov-2022,Interest,"2,217.00",00.00,"13,626.00"
17-Nov-2022,IMPS,"2,538.00",00.00,"16,164.00"
18-Nov-2022,Interest,00.00,"2,309.14","13,854.86"
18-Nov-2022,Commission,06.78,00.00,"13,861.64"
18-Nov-2022,NEFT,"1,208,524.00",00.00,"1,222,385.64"
18-Nov-2022,Debit Card,00.00,"122,238.56","1,100,147.08"
18-Nov-2022,RTGS,00.00,"122,238.56","977,908.52"
19-Nov-2022,Miscellaneous,31.52,00.00,"977,940.04"
19-Nov-2022,IMPS,07.00,00.00,"977,947.04"
19-Nov-2022,Tax,"143,993.34",00.00,"1,121,940.38"
19-Nov-2022,IMPS,"14,596.00",00.00,"1,136,536.38"
19-Nov-2022,ATM,00.00,"142,067.05","994,469.33"
19-Nov-2022,Commission,"124,616.25",00.00,"1,119,085.58"
19-Nov-2022,Miscellaneous,12.00,00.00,"1,119,097.58"
19-Nov-2022,Commission,00.00,"559,548.79","559,548.79"
19-Nov-2022,Purchase,06.00,00.00,"559,554.79"
19-Nov-2022,Debit Card,00.00,"186,518.26","373,036.53"
19-Nov-2022,NEFT,"18,072.26",00.00,"391,108.79"
19-Nov-2022,Interest,"1,088,094.00",00.00,"1,479,202.79"
19-Nov-2022,ATM,00.00,"369,800.70","1,109,402.09"
19-Nov-2022,Cheque,05.00,00.00,"1,109,407.09"
19-Nov-2022,Debit Card,00.00,"158,486.73","950,920.36"
19-Nov-2022,Cheque,00.00,"475,460.18","475,460.18"
19-Nov-2022,IMPS,00.00,"47,546.02","427,914.16"
19-Nov-2022,Transfer,00.00,"42,791.42","385,122.74"
19-Nov-2022,Interest,00.00,"128,374.25","256,748.49"
19-Nov-2022,Debit Card,00.00,"51,349.70","205,398.79"
19-Nov-2022,NEFT,00.00,"102,699.40","102,699.40"
19-Nov-2022,Bill,"30,930.70",00.00,"133,630.10"
19-Nov-2022,Transfer,00.00,"26,726.02","106,904.08"
19-Nov-2022,Debit Card,217.00,00.00,"107,121.08"
19-Nov-2022,Cash,04.00,00.00,"107,125.08"
19-Nov-2022,Debit Card,"914,009.00",00.00,"1,021,134.08"
19-Nov-2022,Reversal,164.10,00.00,"1,021,298.18"
19-Nov-2022,Commission,11.00,00.00,"1,021,309.18"
19-Nov-2022,Debit Card,00.00,"127,663.65","893,645.53"
20-Nov-2022,Debit Card,"157,108.50",00.00,"1,050,754.03"
20-Nov-2022,Cheque,01.00,00.00,"1,050,755.03"
20-Nov-2022,Miscellaneous,170.00,00.00,"1,050,925.03"
20-Nov-2022,Cheque,00.00,"262,731.26","788,193.77"
20-Nov-2022,Commission,"2,409.00",00.00,"790,602.77"
20-Nov-2022,Miscellaneous,00.00,"79,060.28","711,542.49"
20-Nov-2022,Bill,"1,506,656.50",00.00,"2,218,198.99"
21-Nov-2022,Interest,00.00,"739,399.66","1,478,799.33"
21-Nov-2022,Bill,00.00,"1,478,799.33",00.00
21-Nov-2022,Transfer,02.85,00.00,02.85
21-Nov-2022,Reversal,00.00,00.36,02.49
21-Nov-2022,Reversal,00.00,00.83,01.66
21-Nov-2022,Bill,00.00,00.33,01.33
21-Nov-2022,NEFT,04.00,00.00,05.33
21-Nov-2022,NEFT,00.00,01.07,04.26
21-Nov-2022,IMPS,35.36,00.00,39.62
21-Nov-2022,NEFT,00.00,04.40,35.22
21-Nov-2022,Reversal,00.00,35.22,00.00
21-Nov-2022,Cash,913.00,00.00,913.00
21-Nov-2022,Interest,"1,182,785.00",00.00,"1,183,698.00"
22-Nov-2022,RTGS,"7,642.00",00.00,"1,191,340.00"
22-Nov-2022,RTGS,00.00,"238,268.00","953,072.00"
22-Nov-2022,Cheque,00.00,"953,072.00",00.00
23-Nov-2022,NEFT,01.34,00.00,01.34
23-Nov-2022,Bill,00.00,01.34,00.00
23-Nov-2022,Miscellaneous,266.00,00.00,266.00
23-Nov-2022,IMPS,183.00,00.00,449.00
23-Nov-2022,Tax,"745,447.00",00.00,"745,896.00"
23-Nov-2022,RTGS,00.00,"124,316.00","621,580.00"
23-Nov-2022,Purchase,06.00,00.00,"621,586.00"
23-Nov-2022,RTGS,00.00,"207,195.33","414,390.67"
24-Nov-2022,NEFT,00.00,"51,798.83","362,591.84"
24-Nov-2022,NEFT,44.64,00.00,"362,636.48"
24-Nov-2022,Tax,00.00,"362,636.48",00.00
24-Nov-2022,Interest,05.40,00.00,05.40
24-Nov-2022,Transfer,"27,960.00",00.00,"27,965.40"
24-Nov-2022,Miscellaneous,12.91,00.00,"27,978.31"
24-Nov-2022,RTGS,02.70,00.00,"27,981.01"
24-Nov-2022,Transfer,"434,616.50",00.00,"462,597.51"
24-Nov-2022,NEFT,00.00,"462,597.51",00.00
24-Nov-2022,Cash,20.00,00.00,20.00
24-Nov-2022,Miscellaneous,00.00,03.33,16.67
24-Nov-2022,Miscellaneous,00.00,01.85,14.82
24-Nov-2022,NEFT,00.00,02.47,12.35
24-Nov-2022,RTGS,00.00,06.18,06.18
24-Nov-2022,Interest,"1,233,472.75",00.00,"1,233,478.93"
24-Nov-2022,Tax,159.00,00.00,"1,233,637.93"
24-Nov-2022,Purchase,00.00,"308,409.48","925,228.45"
24-Nov-2022,Debit Card,"16,688.00",00.00,"941,916.45"
24-Nov-2022,Bill,385.10,00.00,"942,301.55"
24-Nov-2022,Cash,"1,117,481.50",00.00,"2,059,783.05"
24-Nov-2022,Cash,02.12,00.00,"2,059,785.17"
24-Nov-2022,Miscellaneous,54.00,00.00,"2,059,839.17"
24-Nov-2022,Miscellaneous,"2,732.10",00.00,"2,062,571.27"
24-Nov-2022,Tax,"37,212.60",00.00,"2,099,783.87"
24-Nov-2022,Purchase,00.00,"209,978.39","1,889,805.48"
24-Nov-2022,Miscellaneous,921.00,00.00,"1,890,726.48"
24-Nov-2022,Cheque,00.00,"189,072.65","1,701,653.83"
24-Nov-2022,Transfer,00.00,"170,165.38","1,531,488.45"
24-Nov-2022,Cash,"3,899.75",00.00,"1,535,388.20"
24-Nov-2022,Purchase,00.00,"219,341.17","1,316,047.03"
24-Nov-2022,Miscellaneous,00.00,"188,006.72","1,128,040.31"
24-Nov-2022,IMPS,00.00,"188,006.72","940,033.59"
24-Nov-2022,Commission,00.00,"156,672.27","783,361.32"
24-Nov-2022,Purchase,39.70,00.00,"783,401.02"
24-Nov-2022,Interest,"2,624.44",00.00,"786,025.46"
24-Nov-2022,Tax,00.00,"112,289.35","673,736.11"
24-Nov-2022,Purchase,00.00,"74,859.57","598,876.54"
24-Nov-2022,RTGS,00.00,"119,775.31","479,101.23"
24-Nov-2022,Transfer,"717,843.00",00.00,"1,196,944.23"
24-Nov-2022,Cash,00.00,"170,992.03","1,025,952.20"
24-Nov-2022,RTGS,"3,866.00",00.00,"1,029,818.20"
24-Nov-2022,Miscellaneous,07.00,00.00,"1,029,825.20"
24-Nov-2022,Cash,00.00,"205,965.04","823,860.16"
24-Nov-2022,Commission,"70,589.40",00.00,"894,449.56"
24-Nov-2022,RTGS,00.00,"149,074.93","745,374.63"
24-Nov-2022,Cash,02.60,00.00,"745,377.23"
24-Nov-2022,IMPS,00.00,"124,229.54","621,147.69"
24-Nov-2022,Interest,00.00,"69,016.41","552,131.28"
24-Nov-2022,Tax,186.50,00.00,"552,317.78"
24-Nov-2022,Cash,00.00,"138,079.45","414,238.34"
24-Nov-2022,Debit Card,"1,469.00",00.00,"415,707.34"
24-Nov-2022,Miscellaneous,430.03,00.00,"416,137.37"
24-Nov-2022,Transfer,00.00,"46,237.49","369,899.88"
24-Nov-2022,ATM,"127,301.00",00.00,"497,200.88"
24-Nov-2022,Interest,45.06,00.00,"497,245.94"
24-Nov-2022,Purchase,"1,280,828.00",00.00,"1,778,073.94"
24-Nov-2022,Reversal,00.00,"889,036.97","889,036.97"
24-Nov-2022,Cash,00.00,"222,259.24","666,777.73"
24-Nov-2022,Debit Card,00.00,"111,129.62","555,648.11"
24-Nov-2022,Commission,298.10,00.00,"555,946.21"
24-Nov-2022,NEFT,"157,410.91",00.00,"713,357.12"
24-Nov-2022,Transfer,33.00,00.00,"713,390.12"
24-Nov-2022,Transfer,"25,073.57",00.00,"738,463.69"
24-Nov-2022,NEFT,"30,014.29",00.00,"768,477.98"
24-Nov-2022,Tax,00.00,"76,847.80","691,630.18"
24-Nov-2022,Bill,08.00,00.00,"691,638.18"
24-Nov-2022,Miscellaneous,00.00,"138,327.64","553,310.54"
24-Nov-2022,RTGS,500.00,00.00,"553,810.54"
24-Nov-2022,RTGS,10.95,00.00,"553,821.49"
24-Nov-2022,Debit Card,00.00,"276,910.75","276,910.74"
24-Nov-2022,NEFT,00.00,"34,613.84","242,296.90"
24-Nov-2022,RTGS,"27,274.00",00.00,"269,570.90"
24-Nov-2022,Debit Card,05.00,00.00,"269,575.90"
24-Nov-2022,Transfer,"49,204.20",00.00,"318,780.10"
24-Nov-2022,IMPS,00.00,"35,420.01","283,360.09"
24-Nov-2022,NEFT,00.00,"35,420.01","247,940.08"
24-Nov-2022,ATM,00.00,"247,940.08",00.00
24-Nov-2022,ATM,04.50,00.00,04.50
24-Nov-2022,Transfer,00.00,04.50,00.00
24-Nov-2022,ATM,"1,500,094.00",00.00,"1,500,094.00"
24-Nov-2022,Cash,"892,966.25",00.00,"2,393,060.25"
24-Nov-2022,Reversal,01.55,00.00,"2,393,061.80"
24-Nov-2022,NEFT,"172,304.50",00.00,"2,565,366.30"
24-Nov-2022,Tax,00.00,"285,040.70","2,280,325.60"
24-Nov-2022,Cash,00.00,"2,280,325.60",00.00
24-Nov-2022,Transfer,07.00,00.00,07.00
24-Nov-2022,Interest,00.00,03.50,03.50
24-Nov-2022,Purchase,00.00,01.75,01.75
24-Nov-2022,Transfer,00.00,00.29,01.46
25-Nov-2022,Interest,00.45,00.00,01.91
25-Nov-2022,Transfer,"5,713.20",00.00,"5,715.11"
25-Nov-2022,Purchase,00.00,816.44,"4,898.67"
25-Nov-2022,Transfer,26.00,00.00,"4,924.67"
25-Nov-2022,Interest,"1,737,145.00",00.00,"1,742,069.67"
25-Nov-2022,Cash,00.00,"193,563.30","1,548,506.37"
25-Nov-2022,Miscellaneous,"1,735.66",00.00,"1,550,242.03"
25-Nov-2022,Purchase,00.00,"172,249.11","1,377,992.92"
25-Nov-2022,ATM,60.00,00.00,"1,378,052.92"
25-Nov-2022,Debit Card,00.00,"275,610.58","1,102,442.34"
25-Nov-2022,Reversal,"14,274.00",00.00,"1,116,716.34"
25-Nov-2022,RTGS,00.00,"223,343.27","893,373.07"
25-Nov-2022,Interest,"117,231.00",00.00,"1,010,604.07"
25-Nov-2022,Debit Card,02.70,00.00,"1,010,606.77"
25-Nov-2022,Transfer,00.00,"202,121.35","808,485.42"
25-Nov-2022,Transfer,"32,739.40",00.00,"841,224.82"
25-Nov-2022,IMPS,"71,439.00",00.00,"912,663.82"
25-Nov-2022,IMPS,"148,930.70",00.00,"1,061,594.52"
25-Nov-2022,Miscellaneous,00.00,"1,061,594.52",00.00
25-Nov-2022,ATM,"2,809.00",00.00,"2,809.00"
25-Nov-2022,Purchase,00.00,401.29,"2,407.71"
25-Nov-2022,NEFT,07.10,00.00,"2,414.81"
25-Nov-2022,Interest,"202,562.80",00.00,"204,977.61"
25-Nov-2022,Purchase,00.00,"68,325.87","136,651.74"
25-Nov-2022,IMPS,"23,322.00",00.00,"159,973.74"
25-Nov-2022,Tax,00.00,"39,993.44","119,980.30"
25-Nov-2022,Cash,00.00,"23,996.06","95,984.24"
25-Nov-2022,ATM,00.00,"15,997.37","79,986.87"
25-Nov-2022,Cheque,"239,547.40",00.00,"319,534.27"
25-Nov-2022,Bill,00.00,"319,534.27",00.00
25-Nov-2022,IMPS,"149,629.60",00.00,"149,629.60"
25-Nov-2022,Interest,00.00,"14,962.96","134,666.64"
25-Nov-2022,Tax,00.00,"67,333.32","67,333.32"
25-Nov-2022,IMPS,07.40,00.00,"67,340.72"
26-Nov-2022,Miscellaneous,"1,799,239.50",00.00,"1,866,580.22"
26-Nov-2022,RTGS,00.00,"1,866,580.22",00.00
26-Nov-2022,RTGS,"1,557.00",00.00,"1,557.00"
26-Nov-2022,Reversal,348.00,00.00,"1,905.00"
26-Nov-2022,Cheque,"188,296.31",00.00,"190,201.31"
26-Nov-2022,Debit Card,00.00,"21,133.48","169,067.83"
26-Nov-2022,Debit Card,"220,859.50",00.00,"389,927.33"
26-Nov-2022,Miscellaneous,00.00,"194,963.67","194,963.66"
26-Nov-2022,Bill,00.00,"24,370.46","170,593.20"
26-Nov-2022,NEFT,28.53,00.00,"170,621.73"
26-Nov-2022,Transfer,00.00,"18,957.97","151,663.76"
26-Nov-2022,ATM,00.00,"16,851.53","134,812.23"
26-Nov-2022,Interest,"10,508.00",00.00,"145,320.23"
26-Nov-2022,Commission,00.00,"20,760.03","124,560.20"
26-Nov-2022,Bill,"31,466.20",00.00,"156,026.40"
26-Nov-2022,ATM,"1,057.59",00.00,"157,083.99"
26-Nov-2022,Interest,00.00,"15,708.40","141,375.59"
26-Nov-2022,NEFT,00.00,"47,125.20","94,250.39"
26-Nov-2022,NEFT,"92,303.60",00.00,"186,553.99"
26-Nov-2022,Cheque,06.76,00.00,"186,560.75"
26-Nov-2022,ATM,00.00,"23,320.09","163,240.66"
26-Nov-2022,Commission,39.10,00.00,"163,279.76"
26-Nov-2022,Cash,00.00,"23,325.68","139,954.08"
26-Nov-2022,Debit Card,"10,874.81",00.00,"150,828.89"
26-Nov-2022,Reversal,00.00,"50,276.30","100,552.59"
26-Nov-2022,NEFT,13.50,00.00,"100,566.09"
26-Nov-2022,ATM,00.00,"50,283.05","50,283.04"
26-Nov-2022,Cheque,00.00,"16,761.01","33,522.03"
26-Nov-2022,Tax,04.50,00.00,"33,526.53"
26-Nov-2022,Interest,"181,692.25",00.00,"215,218.78"
26-Nov-2022,Transfer,"14,391.00",00.00,"229,609.78"
26-Nov-2022,Miscellaneous,00.00,"38,268.30","191,341.48"
26-Nov-2022,Interest,"5,939.94",00.00,"197,281.42"
26-Nov-2022,IMPS,"746,975.20",00.00,"944,256.62"
26-Nov-2022,Reversal,00.00,"94,425.66","849,830.96"
26-Nov-2022,Debit Card,08.00,00.00,"849,838.96"
26-Nov-2022,Purchase,"1,388,186.50",00.00,"2,238,025.46"
26-Nov-2022,NEFT,00.00,"279,753.18","1,958,272.28"
26-Nov-2022,Cheque,00.00,"326,378.71","1,631,893.57"
26-Nov-2022,ATM,245.83,00.00,"1,632,139.40"
26-Nov-2022,RTGS,05.80,00.00,"1,632,145.20"
26-Nov-2022,Interest,"30,872.08",00.00,"1,663,017.28"
26-Nov-2022,Bill,155.00,00.00,"1,663,172.28"
26-Nov-2022,IMPS,"2,073,715.00",00.00,"3,736,887.28"
26-Nov-2022,Cash,00.00,"1,868,443.64","1,868,443.64"
26-Nov-2022,NEFT,"810,504.00",00.00,"2,678,947.64"
26-Nov-2022,Tax,00.00,"535,789.53","2,143,158.11"
26-Nov-2022,Tax,"23,041.00",00.00,"2,166,199.11"
26-Nov-2022,NEFT,00.50,00.00,"2,166,199.61"
26-Nov-2022,Debit Card,00.00,"433,239.92","1,732,959.69"
26-Nov-2022,Cheque,03.26,00.00,"1,732,962.95"
26-Nov-2022,Cheque,00.00,"247,566.14","1,485,396.81"
26-Nov-2022,IMPS,178.00,00.00,"1,485,574.81"
26-Nov-2022,Transfer,00.00,"495,191.60","990,383.21"
26-Nov-2022,Miscellaneous,06.80,00.00,"990,390.01"
26-Nov-2022,IMPS,"6,807.18",00.00,"997,197.19"
26-Nov-2022,Commission,02.50,00.00,"997,199.69"
26-Nov-2022,NEFT,00.00,"124,649.96","872,549.73"
26-Nov-2022,Cheque,00.00,"145,424.96","727,124.78"
26-Nov-2022,Transfer,"2,243.75",00.00,"729,368.53"
26-Nov-2022,IMPS,"29,298.40",00.00,"758,666.93"
26-Nov-2022,Reversal,"168,970.53",00.00,"927,637.46"
26-Nov-2022,RTGS,05.00,00.00,"927,642.46"
26-Nov-2022,Purchase,98.90,00.00,"927,741.36"
26-Nov-2022,Interest,00.00,"103,082.37","824,658.99"
26-Nov-2022,IMPS,45.54,00.00,"824,704.53"
26-Nov-2022,Interest,"5,829.00",00.00,"830,533.53"
26-Nov-2022,Transfer,"1,025,220.80",00.00,"1,855,754.33"
27-Nov-2022,Transfer,"20,772.00",00.00,"1,876,526.33"
27-Nov-2022,Bill,131.10,00.00,"1,876,657.43"
27-Nov-2022,Reversal,"1,816,460.00",00.00,"3,693,117.43"
27-Nov-2022,Tax,"227,415.80",00.00,"3,920,533.23"
27-Nov-2022,Debit Card,00.00,"3,920,533.23",00.00
27-Nov-2022,Purchase,"2,775.81",00.00,"2,775.81"
27-Nov-2022,Cash,01.00,00.00,"2,776.81"
27-Nov-2022,ATM,00.00,462.80,"2,314.01"
27-Nov-2022,Commission,05.00,00.00,"2,319.01"
28-Nov-2022,ATM,488.80,00.00,"2,807.81"
28-Nov-2022,ATM,00.00,"1,403.91","1,403.90"
28-Nov-2022,Purchase,00.00,200.56,"1,203.34"
28-Nov-2022,Cash,"75,412.40",00.00,"76,615.74"
28-Nov-2022,RTGS,00.00,"38,307.87","38,307.87"
28-Nov-2022,Interest,00.00,"6,384.65","31,923.22"
28-Nov-2022,Transfer,00.00,"31,923.22",00.00
28-Nov-2022,Commission,"1,494.56",00.00,"1,494.56"
28-Nov-2022,Interest,00.00,166.06,"1,328.50"
28-Nov-2022,Tax,494.60,00.00,"1,823.10"
28-Nov-2022,Debit Card,00.00,227.89,"1,595.21"
28-Nov-2022,Miscellaneous,04.60,00.00,"1,599.81"
28-Nov-2022,Cheque,07.00,00.00,"1,606.81"
28-Nov-2022,RTGS,"2,603.69",00.00,"4,210.50"
28-Nov-2022,Cheque,00.00,701.75,"3,508.75"
28-Nov-2022,Debit Card,00.00,877.19,"2,631.56"
28-Nov-2022,Commission,00.00,526.31,"2,105.25"
28-Nov-2022,Commission,00.00,526.31,"1,578.94"
28-Nov-2022,Commission,"22,171.70",00.00,"23,750.64"
28-Nov-2022,Bill,00.00,"11,875.32","11,875.32"
28-Nov-2022,NEFT,"1,821,967.20",00.00,"1,833,842.52"
28-Nov-2022,Reversal,00.00,"183,384.25","1,650,458.27"
29-Nov-2022,ATM,"2,052,828.75",00.00,"3,703,287.02"
29-Nov-2022,ATM,00.00,"925,821.76","2,777,465.26"
29-Nov-2022,Transfer,00.00,"1,388,732.63","1,388,732.63"
29-Nov-2022,ATM,00.00,"277,746.53","1,110,986.10"
29-Nov-2022,Transfer,00.00,"123,442.90","987,543.20"
29-Nov-2022,RTGS,00.00,"197,508.64","790,034.56"
29-Nov-2022,Cash,"105,510.70",00.00,"895,545.26"
29-Nov-2022,Debit Card,116.08,00.00,"895,661.34"
29-Nov-2022,Bill,00.00,"298,553.78","597,107.56"
29-Nov-2022,Tax,43.00,00.00,"597,150.56"
30-Nov-2022,NEFT,00.00,"298,575.28","298,575.28"
30-Nov-2022,Transfer,"193,659.20",00.00,"492,234.48"
30-Nov-2022,RTGS,06.86,00.00,"492,241.34"
30-Nov-2022,Commission,"10,488.00",00.00,"502,729.34"
30-Nov-2022,Debit Card,62.90,00.00,"502,792.24"
30-Nov-2022,Miscellaneous,00.00,"83,798.71","418,993.53"
30-Nov-2022,Tax,421.60,00.00,"419,415.13"
30-Nov-2022,RTGS,00.00,"69,902.52","349,512.61"
30-Nov-2022,Reversal,149.19,00.00,"349,661.80"
30-Nov-2022,IMPS,"3,212.91",00.00,"352,874.71"
30-Nov-2022,NEFT,"206,207.00",00.00,"559,081.71"
30-Nov-2022,Cheque,39.70,00.00,"559,121.41"
01-Dec-2022,NEFT,"776,449.00",00.00,"1,335,570.41"
01-Dec-2022,ATM,00.00,"445,190.14","890,380.27"
01-Dec-2022,Transfer,01.49,00.00,"890,381.76"
01-Dec-2022,Interest,297.00,00.00,"890,678.76"
01-Dec-2022,NEFT,00.00,"445,339.38","445,339.38"
01-Dec-2022,Interest,"1,144,390.00",00.00,"1,589,729.38"
01-Dec-2022,Bill,"25,888.03",00.00,"1,615,617.41"
01-Dec-2022,ATM,00.00,"230,802.49","1,384,814.92"
01-Dec-2022,Commission,"151,445.00",00.00,"1,536,259.92"
01-Dec-2022,Reversal,00.00,"153,625.99","1,382,633.93"
01-Dec-2022,RTGS,"50,462.59",00.00,"1,433,096.52"
01-Dec-2022,Miscellaneous,00.00,"204,728.07","1,228,368.45"
01-Dec-2022,Debit Card,00.00,"409,456.15","818,912.30"
01-Dec-2022,Reversal,781.00,00.00,"819,693.30"
01-Dec-2022,Cheque,00.00,"204,923.33","614,769.98"
02-Dec-2022,Debit Card,00.00,"68,307.78","546,462.20"
02-Dec-2022,Debit Card,55.46,00.00,"546,517.66"
02-Dec-2022,RTGS,"402,215.00",00.00,"948,732.66"
02-Dec-2022,NEFT,00.00,"94,873.27","853,859.39"
02-Dec-2022,Tax,00.00,"94,873.27","758,986.12"
02-Dec-2022,IMPS,302.00,00.00,"759,288.12"
02-Dec-2022,Commission,00.00,"379,644.06","379,644.06"
02-Dec-2022,IMPS,"141,197.80",00.00,"520,841.86"
02-Dec-2022,ATM,58.00,00.00,"520,899.86"
02-Dec-2022,Reversal,00.00,"65,112.48","455,787.38"
02-Dec-2022,Purchase,00.00,"151,929.13","303,858.25"
02-Dec-2022,Commission,348.19,00.00,"304,206.44"
02-Dec-2022,Miscellaneous,00.00,"43,458.06","260,748.38"
02-Dec-2022,ATM,"7,406.85",00.00,"268,155.23"
02-Dec-2022,Tax,00.00,"268,155.23",00.00
02-Dec-2022,RTGS,"4,053.50",00.00,"4,053.50"
02-Dec-2022,Transfer,"29,727.65",00.00,"33,781.15"
03-Dec-2022,Interest,00.00,"3,378.12","30,403.04"
03-Dec-2022,Reversal,00.00,"10,134.35","20,268.69"
03-Dec-2022,Bill,"15,737.00",00.00,"36,005.69"
04-Dec-2022,Reversal,00.00,"7,201.14","28,804.55"
04-Dec-2022,Cheque,05.00,00.00,"28,809.55"
04-Dec-2022,Transfer,00.00,"3,201.06","25,608.49"
04-Dec-2022,Tax,145.10,00.00,"25,753.59"
04-Dec-2022,ATM,00.00,"25,753.59",00.00
04-Dec-2022,Commission,"19,281.00",00.00,"19,281.00"
04-Dec-2022,Tax,"1,804,489.00",00.00,"1,823,770.00"
04-Dec-2022,Bill,00.00,"202,641.11","1,621,128.89"
04-Dec-2022,Miscellaneous,14.10,00.00,"1,621,142.99"
04-Dec-2022,Interest,00.00,"540,381.00","1,080,761.99"
04-Dec-2022,Bill,00.00,"135,095.25","945,666.74"
04-Dec-2022,Purchase,00.00,"236,416.69","709,250.06"
04-Dec-2022,Miscellaneous,385.29,00.00,"709,635.35"
04-Dec-2022,RTGS,00.00,"78,848.37","630,786.98"
04-Dec-2022,NEFT,"27,060.00",00.00,"657,846.98"
05-Dec-2022,Transfer,01.71,00.00,"657,848.69"
05-Dec-2022,Tax,01.00,00.00,"657,849.69"
05-Dec-2022,Cheque,00.00,"328,924.85","328,924.84"
05-Dec-2022,IMPS,25.00,00.00,"328,949.84"
05-Dec-2022,Interest,00.00,"328,949.84",00.00
05-Dec-2022,RTGS,"3,332.00",00.00,"3,332.00"
05-Dec-2022,IMPS,00.00,"1,666.00","1,666.00"
05-Dec-2022,ATM,00.00,833.00,833.00
05-Dec-2022,Debit Card,"101,027.00",00.00,"101,860.00"
05-Dec-2022,Debit Card,"88,325.00",00.00,"190,185.00"
05-Dec-2022,IMPS,00.00,"38,037.00","152,148.00"
05-Dec-2022,RTGS,04.20,00.00,"152,152.20"
05-Dec-2022,Cash,00.00,"76,076.10","76,076.10"
05-Dec-2022,IMPS,12.20,00.00,"76,088.30"
06-Dec-2022,Debit Card,237.80,00.00,"76,326.10"
06-Dec-2022,Cash,00.00,"25,442.03","50,884.07"
06-Dec-2022,Bill,00.00,"5,088.41","45,795.66"
06-Dec-2022,Cash,"165,311.60",00.00,"211,107.26"
06-Dec-2022,Miscellaneous,29.21,00.00,"211,136.47"
06-Dec-2022,RTGS,00.00,"211,136.47",00.00
06-Dec-2022,Tax,58.02,00.00,58.02
06-Dec-2022,IMPS,00.00,29.01,29.01
06-Dec-2022,Transfer,00.00,04.14,24.87
06-Dec-2022,Miscellaneous,"1,155,233.00",00.00,"1,155,257.87"
06-Dec-2022,IMPS,"3,239.00",00.00,"1,158,496.87"
06-Dec-2022,Miscellaneous,"1,688,146.50",00.00,"2,846,643.37"
06-Dec-2022,Bill,00.00,"316,293.71","2,530,349.66"
06-Dec-2022,Debit Card,00.00,"281,149.96","2,249,199.70"
06-Dec-2022,Debit Card,"208,534.97",00.00,"2,457,734.67"
06-Dec-2022,Purchase,"138,222.00",00.00,"2,595,956.67"
06-Dec-2022,ATM,00.00,"2,595,956.67",00.00
06-Dec-2022,Debit Card,56.00,00.00,56.00
06-Dec-2022,RTGS,"241,821.00",00.00,"241,877.00"
06-Dec-2022,IMPS,00.00,"24,187.70","217,689.30"
06-Dec-2022,NEFT,"2,283.50",00.00,"219,972.80"
06-Dec-2022,IMPS,00.00,"73,324.27","146,648.53"
06-Dec-2022,Purchase,"16,423.00",00.00,"163,071.53"
06-Dec-2022,NEFT,"1,624,580.00",00.00,"1,787,651.53"
06-Dec-2022,IMPS,249.00,00.00,"1,787,900.53"
06-Dec-2022,Tax,00.00,"595,966.84","1,191,933.69"
06-Dec-2022,Cash,00.00,"170,276.24","1,021,657.45"
06-Dec-2022,Tax,"15,322.00",00.00,"1,036,979.45"
06-Dec-2022,Debit Card,00.00,"148,139.92","888,839.53"
06-Dec-2022,Cash,00.00,"88,883.95","799,955.58"
06-Dec-2022,Miscellaneous,"3,985.00",00.00,"803,940.58"
06-Dec-2022,Miscellaneous,113.40,00.00,"804,053.98"
06-Dec-2022,NEFT,285.61,00.00,"804,339.59"
06-Dec-2022,Cash,"12,248.40",00.00,"816,587.99"
06-Dec-2022,Interest,00.00,"116,655.43","699,932.56"
06-Dec-2022,Miscellaneous,00.00,"69,993.26","629,939.30"
06-Dec-2022,Tax,35.00,00.00,"629,974.30"
06-Dec-2022,Commission,00.00,"69,997.14","559,977.16"
06-Dec-2022,RTGS,26.21,00.00,"560,003.37"
06-Dec-2022,RTGS,"1,335,728.00",00.00,"1,895,731.37"
07-Dec-2022,Cheque,00.00,"315,955.23","1,579,776.14"
07-Dec-2022,Cash,"1,515,641.00",00.00,"3,095,417.14"
07-Dec-2022,IMPS,00.00,"442,202.45","2,653,214.69"
07-Dec-2022,Tax,10.79,00.00,"2,653,225.48"
07-Dec-2022,Purchase,"29,057.00",00.00,"2,682,282.48"
07-Dec-2022,ATM,"63,224.00",00.00,"2,745,506.48"
07-Dec-2022,Interest,"68,346.00",00.00,"2,813,852.48"
07-Dec-2022,Commission,00.00,"468,975.41","2,344,877.07"
07-Dec-2022,Transfer,00.00,"1,172,438.54","1,172,438.53"
07-Dec-2022,Transfer,00.00,"586,219.27","586,219.26"
07-Dec-2022,RTGS,405.81,00.00,"586,625.07"
07-Dec-2022,RTGS,00.00,"146,656.27","439,968.80"
07-Dec-2022,Tax,00.00,"73,328.13","366,640.67"
07-Dec-2022,Bill,00.00,"73,328.13","293,312.54"
07-Dec-2022,RTGS,00.00,"97,770.85","195,541.69"
07-Dec-2022,IMPS,"2,233.68",00.00,"197,775.37"
07-Dec-2022,Tax,00.00,"98,887.69","98,887.68"
07-Dec-2022,Commission,915.70,00.00,"99,803.38"
07-Dec-2022,Cash,"89,641.10",00.00,"189,444.48"
07-Dec-2022,IMPS,"24,627.40",00.00,"214,071.88"
07-Dec-2022,IMPS,41.80,00.00,"214,113.68"
07-Dec-2022,IMPS,00.00,"214,113.68",00.00
07-Dec-2022,Interest,130.00,00.00,130.00
07-Dec-2022,Purchase,00.00,16.25,113.75
07-Dec-2022,Reversal,64.00,00.00,177.75
07-Dec-2022,Tax,196.79,00.00,374.54
07-Dec-2022,Interest,07.00,00.00,381.54
07-Dec-2022,IMPS,02.80,00.00,384.34
07-Dec-2022,Miscellaneous,00.00,54.91,329.43
07-Dec-2022,Interest,00.00,164.72,164.72
07-Dec-2022,Interest,"1,137,761.80",00.00,"1,137,926.52"
07-Dec-2022,ATM,00.00,"284,481.63","853,444.89"
08-Dec-2022,Interest,"1,952,519.25",00.00,"2,805,964.14"
08-Dec-2022,Commission,00.00,"1,402,982.07","1,402,982.07"
08-Dec-2022,RTGS,18.10,00.00,"1,403,000.17"
08-Dec-2022,Miscellaneous,00.00,"1,403,000.17",00.00
08-Dec-2022,Debit Card,"12,953.28",00.00,"12,953.28"
08-Dec-2022,Bill,00.00,"1,619.16","11,334.12"
08-Dec-2022,Transfer,00.00,"1,889.02","9,445.10"
08-Dec-2022,Cash,00.00,"1,049.46","8,395.64"
08-Dec-2022,Bill,00.00,"4,197.82","4,197.82"
08-Dec-2022,RTGS,"506,503.00",00.00,"510,700.82"
08-Dec-2022,Interest,"18,804.00",00.00,"529,504.82"
08-Dec-2022,Commission,"237,755.06",00.00,"767,259.88"
08-Dec-2022,Transfer,00.00,"85,251.10","682,008.78"
08-Dec-2022,Reversal,"93,634.00",00.00,"775,642.78"
08-Dec-2022,NEFT,07.64,00.00,"775,650.42"
08-Dec-2022,RTGS,"1,836,211.50",00.00,"2,611,861.92"
08-Dec-2022,Transfer,41.10,00.00,"2,611,903.02"
08-Dec-2022,ATM,"25,356.95",00.00,"2,637,259.97"
08-Dec-2022,Commission,"195,424.75",00.00,"2,832,684.72"
08-Dec-2022,Reversal,"246,117.81",00.00,"3,078,802.53"
08-Dec-2022,Bill,01.36,00.00,"3,078,803.89"
08-Dec-2022,Reversal,"165,057.00",00.00,"3,243,860.89"
08-Dec-2022,Bill,00.00,"405,482.61","2,838,378.28"
08-Dec-2022,Commission,04.20,00.00,"2,838,382.48"
08-Dec-2022,Interest,00.00,"473,063.75","2,365,318.73"
08-Dec-2022,Transfer,01.00,00.00,"2,365,319.73"
08-Dec-2022,Cash,00.00,"473,063.95","1,892,255.78"
08-Dec-2022,IMPS,00.00,"236,531.97","1,655,723.81"
09-Dec-2022,RTGS,00.00,"413,930.95","1,241,792.86"
09-Dec-2022,Transfer,00.00,"248,358.57","993,434.29"
09-Dec-2022,ATM,00.00,00.00,"993,434.29"
09-Dec-2022,Cash,00.00,"99,343.43","894,090.86"
09-Dec-2022,Miscellaneous,00.00,"127,727.27","766,363.59"
09-Dec-2022,Miscellaneous,"133,893.10",00.00,"900,256.69"
09-Dec-2022,RTGS,02.90,00.00,"900,259.59"
09-Dec-2022,RTGS,00.00,"300,086.53","600,173.06"
09-Dec-2022,NEFT,06.90,00.00,"600,179.96"
09-Dec-2022,Cheque,00.00,"600,179.96",00.00
09-Dec-2022,Tax,"103,104.00",00.00,"103,104.00"
09-Dec-2022,Debit Card,"24,199.80",00.00,"127,303.80"
09-Dec-2022,Reversal,"17,227.00",00.00,"144,530.80"
09-Dec-2022,IMPS,00.00,"144,530.80",00.00
10-Dec-2022,Transfer,08.30,00.00,08.30
10-Dec-2022,Debit Card,"14,793.00",00.00,"14,801.30"
10-Dec-2022,Transfer,00.00,"4,933.77","9,867.53"
10-Dec-2022,Miscellaneous,00.00,"1,096.39","8,771.14"
10-Dec-2022,Tax,00.00,"1,754.23","7,016.91"
10-Dec-2022,IMPS,"135,105.00",00.00,"142,121.91"
11-Dec-2022,Debit Card,06.00,00.00,"142,127.91"
11-Dec-2022,Interest,348.44,00.00,"142,476.35"
11-Dec-2022,RTGS,355.00,00.00,"142,831.35"
12-Dec-2022,Cheque,"204,336.81",00.00,"347,168.16"
12-Dec-2022,Commission,00.00,"34,716.82","312,451.34"
12-Dec-2022,Reversal,26.00,00.00,"312,477.34"
12-Dec-2022,NEFT,00.00,"156,238.67","156,238.67"
12-Dec-2022,Bill,02.00,00.00,"156,240.67"
12-Dec-2022,Purchase,00.00,"156,240.67",00.00
12-Dec-2022,Debit Card,05.53,00.00,05.53
12-Dec-2022,RTGS,00.00,00.55,04.98
12-Dec-2022,Bill,00.00,00.55,04.43
12-Dec-2022,Debit Card,00.00,00.74,03.69
12-Dec-2022,RTGS,"190,443.00",00.00,"190,446.69"
12-Dec-2022,Interest,00.00,"27,206.67","163,240.02"
13-Dec-2022,Interest,"651,703.50",00.00,"814,943.52"
13-Dec-2022,ATM,00.00,"162,988.70","651,954.82"
13-Dec-2022,Purchase,"1,314,817.00",00.00,"1,966,771.82"
13-Dec-2022,Transfer,05.36,00.00,"1,966,777.18"
13-Dec-2022,Cheque,"900,018.50",00.00,"2,866,795.68"
13-Dec-2022,Interest,00.00,"318,532.85","2,548,262.83"
13-Dec-2022,IMPS,00.00,"254,826.28","2,293,436.55"
13-Dec-2022,Purchase,00.00,"382,239.43","1,911,197.12"
13-Dec-2022,Tax,00.00,"1,911,197.12",00.00
13-Dec-2022,Cash,90.00,00.00,90.00
13-Dec-2022,IMPS,02.00,00.00,92.00
14-Dec-2022,Cheque,445.33,00.00,537.33
14-Dec-2022,Debit Card,00.00,67.17,470.16
14-Dec-2022,RTGS,00.00,94.03,376.13
14-Dec-2022,RTGS,278.23,00.00,654.36
14-Dec-2022,Cash,00.00,130.87,523.49
14-Dec-2022,Commission,02.00,00.00,525.49
14-Dec-2022,Commission,00.00,58.39,467.10
14-Dec-2022,Debit Card,00.00,66.73,400.37
14-Dec-2022,Cheque,00.00,44.49,355.88
14-Dec-2022,Tax,01.50,00.00,357.38
14-Dec-2022,Bill,00.00,44.67,312.71
14-Dec-2022,Cheque,00.00,156.36,156.35
14-Dec-2022,RTGS,"64,948.47",00.00,"65,104.82"
14-Dec-2022,Bill,00.00,"7,233.87","57,870.95"
14-Dec-2022,Cheque,00.00,"57,870.95",00.00
14-Dec-2022,Interest,"42,180.00",00.00,"42,180.00"
14-Dec-2022,Interest,00.00,"10,545.00","31,635.00"
14-Dec-2022,Miscellaneous,00.00,"3,163.50","28,471.50"
14-Dec-2022,Bill,00.00,"28,471.50",00.00
14-Dec-2022,Interest,39.27,00.00,39.27
14-Dec-2022,Miscellaneous,112.98,00.00,152.25
14-Dec-2022,Miscellaneous,00.57,00.00,152.82
14-Dec-2022,Cash,63.30,00.00,216.12
14-Dec-2022,IMPS,00.00,72.04,144.08
14-Dec-2022,Reversal,00.00,14.41,129.67
14-Dec-2022,IMPS,00.00,25.93,103.74
14-Dec-2022,Debit Card,00.00,10.37,93.37
14-Dec-2022,Debit Card,00.00,46.69,46.68
14-Dec-2022,NEFT,00.00,05.84,40.84
14-Dec-2022,Reversal,"1,900.00",00.00,"1,940.84"
14-Dec-2022,Debit Card,417.00,00.00,"2,357.84"
15-Dec-2022,NEFT,00.00,336.83,"2,021.01"
15-Dec-2022,Bill,00.00,224.56,"1,796.45"
15-Dec-2022,Purchase,00.00,359.29,"1,437.16"
15-Dec-2022,Debit Card,00.00,359.29,"1,077.87"
15-Dec-2022,ATM,00.00,359.29,718.58
15-Dec-2022,IMPS,00.00,102.65,615.93
15-Dec-2022,Purchase,370.55,00.00,986.48
15-Dec-2022,Interest,"126,107.00",00.00,"127,093.48"
15-Dec-2022,Cheque,"2,307.00",00.00,"129,400.48"
16-Dec-2022,Cash,224.60,00.00,"129,625.08"
16-Dec-2022,Cash,00.00,"25,925.02","103,700.06"
16-Dec-2022,Commission,"718,814.00",00.00,"822,514.06"
16-Dec-2022,ATM,00.00,"137,085.68","685,428.38"
16-Dec-2022,Transfer,"26,131.00",00.00,"711,559.38"
16-Dec-2022,Tax,07.00,00.00,"711,566.38"
16-Dec-2022,Cheque,00.00,"142,313.28","569,253.10"
16-Dec-2022,Tax,"45,695.38",00.00,"614,948.48"
16-Dec-2022,Commission,00.00,"307,474.24","307,474.24"
16-Dec-2022,Debit Card,"251,650.00",00.00,"559,124.24"
16-Dec-2022,Bill,"13,577.00",00.00,"572,701.24"
16-Dec-2022,Tax,"1,862,918.00",00.00,"2,435,619.24"
16-Dec-2022,Tax,"12,227.00",00.00,"2,447,846.24"
16-Dec-2022,Reversal,00.00,00.00,"2,447,846.24"
16-Dec-2022,NEFT,00.00,"1,223,923.12","1,223,923.12"
16-Dec-2022,Debit Card,00.00,"1,223,923.12",00.00
16-Dec-2022,Commission,"1,997,237.00",00.00,"1,997,237.00"
16-Dec-2022,ATM,"238,860.30",00.00,"2,236,097.30"
16-Dec-2022,NEFT,79.00,00.00,"2,236,176.30"
16-Dec-2022,NEFT,00.00,"447,235.26","1,788,941.04"
16-Dec-2022,Interest,00.00,"198,771.23","1,590,169.81"
17-Dec-2022,IMPS,49.00,00.00,"1,590,218.81"
17-Dec-2022,Bill,00.00,"795,109.41","795,109.40"
18-Dec-2022,Reversal,"32,584.00",00.00,"827,693.40"
18-Dec-2022,RTGS,"212,399.30",00.00,"1,040,092.70"
18-Dec-2022,ATM,00.00,"260,023.18","780,069.52"
18-Dec-2022,Interest,00.00,"156,013.90","624,055.62"
18-Dec-2022,Transfer,50.00,00.00,"624,105.62"
18-Dec-2022,Cheque,"241,161.70",00.00,"865,267.32"
18-Dec-2022,IMPS,"3,245.04",00.00,"868,512.36"
19-Dec-2022,Interest,00.00,"289,504.12","579,008.24"
19-Dec-2022,Cash,00.00,"579,008.24",00.00
19-Dec-2022,ATM,345.88,00.00,345.88
19-Dec-2022,Transfer,00.00,43.24,302.64
19-Dec-2022,Debit Card,226.03,00.00,528.67
19-Dec-2022,Cheque,"107,309.00",00.00,"107,837.67"
19-Dec-2022,Bill,04.00,00.00,"107,841.67"
19-Dec-2022,Cash,385.00,00.00,"108,226.67"
19-Dec-2022,IMPS,00.00,"108,226.67",00.00
19-Dec-2022,Bill,04.00,00.00,04.00
19-Dec-2022,Bill,"1,430.30",00.00,"1,434.30"
19-Dec-2022,Miscellaneous,00.00,239.05,"1,195.25"
19-Dec-2022,Transfer,04.10,00.00,"1,199.35"
19-Dec-2022,Miscellaneous,00.00,299.84,899.51
19-Dec-2022,Bill,"29,671.00",00.00,"30,570.51"
19-Dec-2022,NEFT,00.00,"3,396.72","27,173.79"
19-Dec-2022,Bill,00.00,"4,528.97","22,644.82"
19-Dec-2022,Tax,442.50,00.00,"23,087.32"
19-Dec-2022,Bill,00.00,"4,617.46","18,469.86"
19-Dec-2022,NEFT,44.46,00.00,"18,514.32"
20-Dec-2022,Miscellaneous,00.00,"6,171.44","12,342.88"
20-Dec-2022,RTGS,00.00,"1,763.27","10,579.61"
20-Dec-2022,Bill,00.00,"2,115.92","8,463.69"
20-Dec-2022,Transfer,"1,421,141.50",00.00,"1,429,605.19"
20-Dec-2022,Interest,30.60,00.00,"1,429,635.79"
20-Dec-2022,Reversal,501.70,00.00,"1,430,137.49"
20-Dec-2022,IMPS,00.00,"357,534.37","1,072,603.12"
20-Dec-2022,Interest,"75,378.06",00.00,"1,147,981.18"
20-Dec-2022,Transfer,00.00,"163,997.31","983,983.87"
20-Dec-2022,RTGS,00.00,"122,997.98","860,985.89"
20-Dec-2022,Cash,00.00,"86,098.59","774,887.30"
20-Dec-2022,Miscellaneous,11.00,00.00,"774,898.30"
20-Dec-2022,RTGS,00.00,"774,898.30",00.00
20-Dec-2022,Commission,"28,569.80",00.00,"28,569.80"
20-Dec-2022,Debit Card,"1,213,913.00",00.00,"1,242,482.80"
20-Dec-2022,NEFT,00.00,"177,497.54","1,064,985.26"
20-Dec-2022,IMPS,00.00,"118,331.70","946,653.56"
20-Dec-2022,IMPS,00.00,"189,330.71","757,322.85"
20-Dec-2022,Miscellaneous,"469,740.00",00.00,"1,227,062.85"
20-Dec-2022,Bill,02.83,00.00,"1,227,065.68"
20-Dec-2022,Purchase,00.00,"245,413.14","981,652.54"
20-Dec-2022,IMPS,00.00,"109,072.50","872,580.04"
20-Dec-2022,Interest,35.07,00.00,"872,615.11"
20-Dec-2022,Transfer,00.00,"174,523.02","698,092.09"
20-Dec-2022,Cash,"2,110.00",00.00,"700,202.09"
20-Dec-2022,Cash,00.00,"100,028.87","600,173.22"
20-Dec-2022,Purchase,00.00,"100,028.87","500,144.35"
20-Dec-2022,Interest,00.00,"100,028.87","400,115.48"
20-Dec-2022,Transfer,"28,823.25",00.00,"428,938.73"
20-Dec-2022,Bill,"13,309.50",00.00,"442,248.23"
20-Dec-2022,Miscellaneous,"33,725.00",00.00,"475,973.23"
20-Dec-2022,Cash,259.32,00.00,"476,232.55"
20-Dec-2022,Reversal,41.50,00.00,"476,274.05"
20-Dec-2022,RTGS,00.00,"119,068.51","357,205.54"
20-Dec-2022,Tax,00.00,"71,441.11","285,764.43"
20-Dec-2022,RTGS,00.00,"28,576.44","257,187.99"
20-Dec-2022,NEFT,"348,861.25",00.00,"606,049.24"
20-Dec-2022,Transfer,"100,786.90",00.00,"706,836.14"
20-Dec-2022,Miscellaneous,00.00,"176,709.04","530,127.10"
20-Dec-2022,Cheque,00.00,"53,012.71","477,114.39"
20-Dec-2022,Interest,383.00,00.00,"477,497.39"
20-Dec-2022,RTGS,34.95,00.00,"477,532.34"
20-Dec-2022,Debit Card,27.60,00.00,"477,559.94"
21-Dec-2022,Cheque,38.90,00.00,"477,598.84"
21-Dec-2022,Commission,"12,477.60",00.00,"490,076.44"
21-Dec-2022,Transfer,00.00,"54,452.94","435,623.50"
21-Dec-2022,Cheque,00.00,"62,231.93","373,391.57"
21-Dec-2022,Miscellaneous,00.00,"373,391.57",00.00
21-Dec-2022,Debit Card,103.00,00.00,103.00
21-Dec-2022,Interest,"131,171.00",00.00,"131,274.00"
21-Dec-2022,Reversal,"157,504.00",00.00,"288,778.00"
21-Dec-2022,Transfer,23.00,00.00,"288,801.00"
21-Dec-2022,RTGS,03.35,00.00,"288,804.35"
21-Dec-2022,Bill,00.00,"28,880.44","259,923.91"
21-Dec-2022,Cheque,00.00,"43,320.65","216,603.26"
21-Dec-2022,ATM,243.60,00.00,"216,846.86"
21-Dec-2022,Bill,06.60,00.00,"216,853.46"
21-Dec-2022,Tax,"141,233.80",00.00,"358,087.26"
21-Dec-2022,ATM,00.00,"179,043.63","179,043.63"
21-Dec-2022,ATM,29.35,00.00,"179,072.98"
21-Dec-2022,Cash,"612,399.00",00.00,"791,471.98"
21-Dec-2022,Commission,00.00,"158,294.40","633,177.58"
21-Dec-2022,Tax,"3,286.00",00.00,"636,463.58"
21-Dec-2022,NEFT,"25,325.31",00.00,"661,788.89"
21-Dec-2022,Commission,"68,766.30",00.00,"730,555.19"
21-Dec-2022,Transfer,"1,439.00",00.00,"731,994.19"
21-Dec-2022,Tax,209.00,00.00,"732,203.19"
21-Dec-2022,Bill,00.00,"183,050.80","549,152.39"
21-Dec-2022,Commission,00.00,"183,050.80","366,101.59"
21-Dec-2022,Transfer,"251,117.90",00.00,"617,219.49"
21-Dec-2022,Debit Card,35.00,00.00,"617,254.49"
21-Dec-2022,Commission,02.10,00.00,"617,256.59"
21-Dec-2022,Tax,00.00,"154,314.15","462,942.44"
21-Dec-2022,Interest,"1,458.99",00.00,"464,401.43"
21-Dec-2022,Miscellaneous,00.00,"232,200.72","232,200.72"
21-Dec-2022,RTGS,438.00,00.00,"232,638.72"
21-Dec-2022,Cash,"220,511.00",00.00,"453,149.72"
21-Dec-2022,Reversal,00.00,"64,735.67","388,414.05"
21-Dec-2022,Interest,01.00,00.00,"388,415.05"
21-Dec-2022,Interest,"17,790.35",00.00,"406,205.40"
21-Dec-2022,Cash,00.00,"101,551.35","304,654.05"
21-Dec-2022,Debit Card,"7,248.00",00.00,"311,902.05"
22-Dec-2022,Debit Card,00.00,"62,380.41","249,521.64"
22-Dec-2022,RTGS,06.90,00.00,"249,528.54"
22-Dec-2022,Reversal,00.00,"31,191.07","218,337.47"
22-Dec-2022,Debit Card,00.00,"31,191.07","187,146.40"
22-Dec-2022,NEFT,00.00,"187,146.40",00.00
22-Dec-2022,ATM,"86,318.00",00.00,"86,318.00"
22-Dec-2022,Cash,279.79,00.00,"86,597.79"
22-Dec-2022,Bill,00.00,"9,621.98","76,975.81"
22-Dec-2022,Cash,02.00,00.00,"76,977.81"
22-Dec-2022,NEFT,00.00,"10,996.83","65,980.98"
22-Dec-2022,Cash,00.98,00.00,"65,981.96"
22-Dec-2022,Miscellaneous,"22,428.30",00.00,"88,410.26"
22-Dec-2022,RTGS,00.00,"44,205.13","44,205.13"
22-Dec-2022,Bill,880.90,00.00,"45,086.03"
22-Dec-2022,RTGS,00.00,"7,514.34","37,571.69"
22-Dec-2022,Reversal,232.20,00.00,"37,803.89"
22-Dec-2022,IMPS,00.00,"12,601.30","25,202.59"
22-Dec-2022,Transfer,"2,719.00",00.00,"27,921.59"
22-Dec-2022,NEFT,00.00,"27,921.59",00.00
22-Dec-2022,Interest,29.00,00.00,29.00
22-Dec-2022,Purchase,39.98,00.00,68.98
22-Dec-2022,Interest,"80,147.06",00.00,"80,216.04"
22-Dec-2022,Purchase,00.00,"20,054.01","60,162.03"
22-Dec-2022,Transfer,00.00,"12,032.41","48,129.62"
22-Dec-2022,Tax,61.70,00.00,"48,191.32"
22-Dec-2022,Miscellaneous,00.00,"6,884.47","41,306.85"
22-Dec-2022,Transfer,00.00,"13,768.95","27,537.90"
22-Dec-2022,Transfer,00.00,"27,537.90",00.00
22-Dec-2022,Reversal,41.84,00.00,41.84
22-Dec-2022,Cash,08.00,00.00,49.84
22-Dec-2022,Interest,00.00,49.84,00.00
22-Dec-2022,Debit Card,"822,472.00",00.00,"822,472.00"
23-Dec-2022,Cash,00.00,"164,494.40","657,977.60"
23-Dec-2022,Bill,"1,294,345.50",00.00,"1,952,323.10"
23-Dec-2022,RTGS,00.00,"650,774.37","1,301,548.73"
23-Dec-2022,Tax,00.00,"185,935.53","1,115,613.20"
23-Dec-2022,Cheque,00.00,"123,957.02","991,656.18"
24-Dec-2022,Interest,00.00,"123,957.02","867,699.16"
24-Dec-2022,Purchase,00.00,"86,769.92","780,929.24"
24-Dec-2022,Reversal,"85,863.75",00.00,"866,792.99"
24-Dec-2022,Commission,"27,320.90",00.00,"894,113.89"
24-Dec-2022,Commission,00.00,"111,764.24","782,349.65"
24-Dec-2022,Commission,00.00,"260,783.22","521,566.43"
24-Dec-2022,Commission,"30,171.60",00.00,"551,738.03"
24-Dec-2022,Cheque,"2,304.70",00.00,"554,042.73"
24-Dec-2022,NEFT,00.00,"79,148.96","474,893.77"
24-Dec-2022,Tax,00.00,"52,765.97","422,127.80"
24-Dec-2022,Commission,"12,481.00",00.00,"434,608.80"
24-Dec-2022,Cash,00.00,"62,086.97","372,521.83"
24-Dec-2022,Bill,36.50,00.00,"372,558.33"
24-Dec-2022,NEFT,00.00,"74,511.67","298,046.66"
25-Dec-2022,Commission,"160,355.88",00.00,"458,402.54"
25-Dec-2022,Transfer,00.00,"114,600.64","343,801.90"
25-Dec-2022,Bill,00.00,"57,300.32","286,501.58"
26-Dec-2022,Cheque,00.00,"57,300.32","229,201.26"
26-Dec-2022,Transfer,"2,034,602.00",00.00,"2,263,803.26"
26-Dec-2022,Miscellaneous,00.00,"452,760.65","1,811,042.61"
26-Dec-2022,ATM,"25,507.18",00.00,"1,836,549.79"
26-Dec-2022,Cash,00.00,"612,183.26","1,224,366.53"
26-Dec-2022,NEFT,00.00,"153,045.82","1,071,320.71"
26-Dec-2022,ATM,"1,400.89",00.00,"1,072,721.60"
26-Dec-2022,Tax,00.00,"1,072,721.60",00.00
26-Dec-2022,Miscellaneous,"4,065.72",00.00,"4,065.72"
26-Dec-2022,Tax,00.00,508.22,"3,557.50"
26-Dec-2022,RTGS,"1,579.60",00.00,"5,137.10"
26-Dec-2022,NEFT,00.00,"1,284.28","3,852.82"
26-Dec-2022,Debit Card,00.00,550.40,"3,302.42"
26-Dec-2022,Transfer,00.00,471.77,"2,830.65"
26-Dec-2022,IMPS,00.00,353.83,"2,476.82"
26-Dec-2022,Tax,00.00,412.80,"2,064.02"
26-Dec-2022,Interest,00.00,229.34,"1,834.68"
26-Dec-2022,NEFT,"2,779.00",00.00,"4,613.68"
26-Dec-2022,ATM,"16,893.28",00.00,"21,506.96"
26-Dec-2022,Purchase,"147,342.90",00.00,"168,849.86"
26-Dec-2022,Cash,00.00,"33,769.97","135,079.89"
26-Dec-2022,Debit Card,56.90,00.00,"135,136.79"
26-Dec-2022,NEFT,00.00,"67,568.40","67,568.40"
26-Dec-2022,Miscellaneous,00.00,"67,568.40",00.00
26-Dec-2022,Debit Card,"178,007.28",00.00,"178,007.28"
26-Dec-2022,Purchase,00.00,"19,778.59","158,228.69"
26-Dec-2022,Tax,20.80,00.00,"158,249.49"
26-Dec-2022,Transfer,"1,778,701.50",00.00,"1,936,950.99"
26-Dec-2022,Bill,00.00,"193,695.10","1,743,255.89"
26-Dec-2022,Cheque,00.00,"871,627.95","871,627.94"
26-Dec-2022,ATM,"1,046,026.75",00.00,"1,917,654.69"
26-Dec-2022,ATM,00.00,"319,609.12","1,598,045.58"
26-Dec-2022,Cheque,00.00,"399,511.40","1,198,534.18"
26-Dec-2022,RTGS,00.00,"149,816.77","1,048,717.41"
26-Dec-2022,Tax,"1,079,005.75",00.00,"2,127,723.16"
26-Dec-2022,Transfer,00.00,"212,772.32","1,914,950.84"
26-Dec-2022,IMPS,401.00,00.00,"1,915,351.84"
26-Dec-2022,IMPS,00.00,"273,621.69","1,641,730.15"
26-Dec-2022,RTGS,00.00,"1,641,730.15",00.00
26-Dec-2022,Cash,"1,036,958.50",00.00,"1,036,958.50"
27-Dec-2022,Commission,00.00,"103,695.85","933,262.65"
27-Dec-2022,IMPS,05.00,00.00,"933,267.65"
27-Dec-2022,Debit Card,16.40,00.00,"933,284.05"
27-Dec-2022,Debit Card,"225,751.00",00.00,"1,159,035.05"
27-Dec-2022,Cash,"2,422.46",00.00,"1,161,457.51"
27-Dec-2022,Reversal,00.00,"232,291.50","929,166.01"
27-Dec-2022,Tax,00.00,"232,291.50","696,874.51"
27-Dec-2022,Bill,"1,781.20",00.00,"698,655.71"
27-Dec-2022,Interest,488.80,00.00,"699,144.51"
27-Dec-2022,Purchase,00.00,"99,877.79","599,266.72"
27-Dec-2022,IMPS,00.00,"599,266.72",00.00
27-Dec-2022,Debit Card,409.00,00.00,409.00
27-Dec-2022,Miscellaneous,03.40,00.00,412.40
27-Dec-2022,Tax,00.00,103.10,309.30
27-Dec-2022,Commission,00.00,103.10,206.20
27-Dec-2022,IMPS,00.00,68.73,137.47
27-Dec-2022,Purchase,60.30,00.00,197.77
27-Dec-2022,Reversal,46.00,00.00,243.77
27-Dec-2022,Reversal,406.47,00.00,650.24
27-Dec-2022,Transfer,00.00,216.75,433.49
27-Dec-2022,Cheque,00.00,72.25,361.24
27-Dec-2022,ATM,00.00,36.12,325.12
27-Dec-2022,Miscellaneous,00.00,36.12,289.00
27-Dec-2022,NEFT,"34,208.50",00.00,"34,497.50"
27-Dec-2022,NEFT,00.00,"3,833.06","30,664.44"
27-Dec-2022,NEFT,"20,805.41",00.00,"51,469.85"
27-Dec-2022,Cash,00.00,"6,433.73","45,036.12"
27-Dec-2022,Debit Card,00.00,"4,503.61","40,532.51"
27-Dec-2022,Bill,03.60,00.00,"40,536.11"
27-Dec-2022,Cheque,"11,542.10",00.00,"52,078.21"
28-Dec-2022,Cash,"768,617.00",00.00,"820,695.21"
29-Dec-2022,ATM,00.00,"410,347.61","410,347.60"
29-Dec-2022,Transfer,00.00,"51,293.45","359,054.15"
29-Dec-2022,Miscellaneous,436.00,00.00,"359,490.15"
29-Dec-2022,Cheque,01.00,00.00,"359,491.15"
29-Dec-2022,Transfer,"1,790,482.00",00.00,"2,149,973.15"
29-Dec-2022,ATM,00.00,"214,997.32","1,934,975.84"
29-Dec-2022,Transfer,"1,811,131.00",00.00,"3,746,106.84"
29-Dec-2022,Transfer,00.00,"749,221.37","2,996,885.47"
29-Dec-2022,Cash,00.00,"1,498,442.74","1,498,442.74"
29-Dec-2022,NEFT,00.00,"1,498,442.74",00.00
29-Dec-2022,RTGS,"91,078.00",00.00,"91,078.00"
29-Dec-2022,Transfer,17.20,00.00,"91,095.20"
30-Dec-2022,Cash,"462,631.50",00.00,"553,726.70"
30-Dec-2022,Cheque,00.00,"55,372.67","498,354.03"
30-Dec-2022,ATM,75.20,00.00,"498,429.23"
30-Dec-2022,Cash,00.00,"498,429.23",00.00
31-Dec-2022,NEFT,"31,852.50",00.00,"31,852.50"
31-Dec-2022,Interest,22.47,00.00,"31,874.97"
31-Dec-2022,RTGS,39.00,00.00,"31,913.97"
31-Dec-2022,Interest,"2,828.00",00.00,"34,741.97"
31-Dec-2022,Cash,00.00,"5,790.33","28,951.64"
31-Dec-2022,Cash,00.00,"3,216.85","25,734.79"
31-Dec-2022,Transfer,"19,970.60",00.00,"45,705.39"
31-Dec-2022,Miscellaneous,00.00,"45,705.39",00.00
31-Dec-2022,RTGS,43.80,00.00,43.80
31-Dec-2022,Cash,"1,313,616.20",00.00,"1,313,660.00"
31-Dec-2022,Transfer,"61,958.00",00.00,"1,375,618.00"
31-Dec-2022,Cheque,05.00,00.00,"1,375,623.00"
31-Dec-2022,NEFT,00.00,"275,124.60","1,100,498.40"
31-Dec-2022,Reversal,00.00,"1,100,498.40",00.00
31-Dec-2022,Cheque,"178,219.62",00.00,"178,219.62"
31-Dec-2022,Reversal,06.40,00.00,"178,226.02"
31-Dec-2022,Miscellaneous,00.00,"25,460.86","152,765.16"
01-Jan-2023,Cash,00.00,"15,276.52","137,488.64"
01-Jan-2023,NEFT,00.00,"22,914.77","114,573.87"
01-Jan-2023,Cheque,25.72,00.00,"114,599.59"
01-Jan-2023,Bill,383.00,00.00,"114,982.59"
01-Jan-2023,NEFT,"761,881.25",00.00,"876,863.84"
01-Jan-2023,Debit Card,33.44,00.00,"876,897.28"
01-Jan-2023,Reversal,"249,256.80",00.00,"1,126,154.08"
01-Jan-2023,Commission,00.00,"225,230.82","900,923.26"
01-Jan-2023,ATM,"25,126.44",00.00,"926,049.70"
01-Jan-2023,Interest,36.00,00.00,"926,085.70"
01-Jan-2023,Reversal,00.00,"102,898.41","823,187.29"
01-Jan-2023,Cheque,00.00,"137,197.88","685,989.41"
01-Jan-2023,Tax,"3,270.90",00.00,"689,260.31"
01-Jan-2023,RTGS,00.00,"98,465.76","590,794.55"
01-Jan-2023,Reversal,02.30,00.00,"590,796.85"
01-Jan-2023,RTGS,502.80,00.00,"591,299.65"
02-Jan-2023,RTGS,00.00,"84,471.38","506,828.27"
02-Jan-2023,Debit Card,00.00,"126,707.07","380,121.20"
02-Jan-2023,Transfer,00.00,"42,235.69","337,885.51"
02-Jan-2023,Reversal,"13,608.00",00.00,"351,493.51"
02-Jan-2023,IMPS,"160,445.00",00.00,"511,938.51"
03-Jan-2023,NEFT,00.00,"51,193.85","460,744.66"
03-Jan-2023,Miscellaneous,00.00,"51,193.85","409,550.81"
03-Jan-2023,Tax,00.00,"102,387.70","307,163.11"
03-Jan-2023,ATM,00.00,"51,193.85","255,969.26"
03-Jan-2023,RTGS,"11,484.20",00.00,"267,453.46"
03-Jan-2023,IMPS,08.17,00.00,"267,461.63"
03-Jan-2023,ATM,00.00,"66,865.41","200,596.22"
03-Jan-2023,Miscellaneous,162.00,00.00,"200,758.22"
03-Jan-2023,ATM,00.00,"50,189.56","150,568.66"
03-Jan-2023,Purchase,"2,778.39",00.00,"153,347.05"
03-Jan-2023,NEFT,"216,500.80",00.00,"369,847.85"
03-Jan-2023,Bill,"1,054,158.00",00.00,"1,424,005.85"
03-Jan-2023,Transfer,"8,196.00",00.00,"1,432,201.85"
03-Jan-2023,Commission,00.00,"204,600.26","1,227,601.59"
03-Jan-2023,Tax,"692,418.00",00.00,"1,920,019.59"
03-Jan-2023,NEFT,"1,406,385.25",00.00,"3,326,404.84"
03-Jan-2023,Debit Card,115.00,00.00,"3,326,519.84"
03-Jan-2023,ATM,00.00,"665,303.97","2,661,215.87"
03-Jan-2023,RTGS,00.00,"1,330,607.94","1,330,607.94"
03-Jan-2023,Debit Card,00.00,"133,060.79","1,197,547.15"
03-Jan-2023,Debit Card,61.40,00.00,"1,197,608.55"
03-Jan-2023,Interest,"1,135,537.75",00.00,"2,333,146.30"
03-Jan-2023,Miscellaneous,00.00,"333,306.61","1,999,839.69"
03-Jan-2023,Cash,00.00,"285,691.38","1,714,148.31"
03-Jan-2023,Debit Card,303.06,00.00,"1,714,451.37"
03-Jan-2023,Miscellaneous,00.00,"214,306.42","1,500,144.95"
03-Jan-2023,Tax,00.00,"1,500,144.95",00.00
03-Jan-2023,Cash,38.73,00.00,38.73
03-Jan-2023,Bill,00.00,05.53,33.20
03-Jan-2023,Purchase,00.00,08.30,24.90
03-Jan-2023,ATM,43.64,00.00,68.54
03-Jan-2023,Bill,00.00,09.79,58.75
03-Jan-2023,Bill,360.00,00.00,418.75
03-Jan-2023,Interest,"378,474.80",00.00,"378,893.55"
03-Jan-2023,Purchase,00.00,"54,127.65","324,765.90"
03-Jan-2023,RTGS,00.00,"108,255.30","216,510.60"
03-Jan-2023,RTGS,47.00,00.00,"216,557.60"
03-Jan-2023,Transfer,00.00,"30,936.80","185,620.80"
03-Jan-2023,Tax,00.00,"61,873.60","123,747.20"
03-Jan-2023,Purchase,00.00,"123,747.20",00.00
03-Jan-2023,Debit Card,"5,060.20",00.00,"5,060.20"
03-Jan-2023,Debit Card,00.00,506.02,"4,554.18"
03-Jan-2023,Transfer,00.00,910.84,"3,643.34"
03-Jan-2023,RTGS,00.00,"3,643.34",00.00
03-Jan-2023,Reversal,"228,667.00",00.00,"228,667.00"
03-Jan-2023,ATM,00.00,"38,111.17","190,555.83"
03-Jan-2023,Miscellaneous,00.00,"47,638.96","142,916.87"
03-Jan-2023,Transfer,00.00,"23,819.48","119,097.39"
03-Jan-2023,Bill,00.00,"14,887.17","104,210.22"
03-Jan-2023,Tax,364.80,00.00,"104,575.02"
03-Jan-2023,NEFT,54.00,00.00,"104,629.02"
03-Jan-2023,Reversal,00.00,"20,925.80","83,703.22"
03-Jan-2023,IMPS,00.00,"8,370.32","75,332.90"
03-Jan-2023,IMPS,00.00,"37,666.45","37,666.45"
03-Jan-2023,Interest,00.00,"37,666.45",00.00
03-Jan-2023,Transfer,"12,499.70",00.00,"12,499.70"
03-Jan-2023,Cheque,00.00,"1,249.97","11,249.73"
03-Jan-2023,NEFT,990.37,00.00,"12,240.10"
03-Jan-2023,Tax,"3,429.10",00.00,"15,669.20"
03-Jan-2023,Cash,00.00,"1,566.92","14,102.28"
03-Jan-2023,Tax,140.33,00.00,"14,242.61"
03-Jan-2023,Miscellaneous,00.00,"1,582.51","12,660.10"
03-Jan-2023,Debit Card,288.39,00.00,"12,948.49"
03-Jan-2023,Miscellaneous,00.00,"1,849.78","11,098.71"
03-Jan-2023,Reversal,321.00,00.00,"11,419.71"
03-Jan-2023,Cheque,"164,816.00",00.00,"176,235.71"
03-Jan-2023,Reversal,"1,017,600.50",00.00,"1,193,836.21"
03-Jan-2023,Miscellaneous,"18,396.40",00.00,"1,212,232.61"
03-Jan-2023,Tax,00.00,"606,116.31","606,116.31"
03-Jan-2023,Interest,30.57,00.00,"606,146.88"
03-Jan-2023,RTGS,00.00,"60,614.69","545,532.19"
03-Jan-2023,Cash,00.00,"60,614.69","484,917.50"
04-Jan-2023,Tax,"210,076.62",00.00,"694,994.12"
04-Jan-2023,RTGS,"51,801.09",00.00,"746,795.21"
04-Jan-2023,Miscellaneous,00.00,"373,397.61","373,397.60"
04-Jan-2023,Interest,"12,476.00",00.00,"385,873.60"
04-Jan-2023,Interest,"51,030.00",00.00,"436,903.60"
04-Jan-2023,Commission,00.00,"48,544.84","388,358.76"
04-Jan-2023,ATM,"1,666,930.00",00.00,"2,055,288.76"
04-Jan-2023,ATM,00.00,"228,365.42","1,826,923.34"
04-Jan-2023,IMPS,"200,003.00",00.00,"2,026,926.34"
04-Jan-2023,Cheque,"2,140.78",00.00,"2,029,067.12"
04-Jan-2023,Reversal,00.00,"405,813.42","1,623,253.70"
04-Jan-2023,NEFT,50.90,00.00,"1,623,304.60"
04-Jan-2023,NEFT,00.00,"324,660.92","1,298,643.68"
04-Jan-2023,Cash,00.00,"324,660.92","973,982.76"
04-Jan-2023,ATM,385.28,00.00,"974,368.04"
04-Jan-2023,IMPS,00.00,"139,195.43","835,172.61"
04-Jan-2023,Miscellaneous,04.00,00.00,"835,176.61"
04-Jan-2023,Interest,00.00,"167,035.32","668,141.29"
04-Jan-2023,Debit Card,93.28,00.00,"668,234.57"
04-Jan-2023,Debit Card,"1,807.00",00.00,"670,041.57"
04-Jan-2023,Transfer,62.60,00.00,"670,104.17"
04-Jan-2023,Transfer,00.00,"223,368.06","446,736.11"
04-Jan-2023,RTGS,21.19,00.00,"446,757.30"
04-Jan-2023,ATM,25.00,00.00,"446,782.30"
04-Jan-2023,Commission,00.00,"89,356.46","357,425.84"
04-Jan-2023,Tax,00.00,"35,742.58","321,683.26"
04-Jan-2023,Cash,04.00,00.00,"321,687.26"
04-Jan-2023,IMPS,00.00,"107,229.09","214,458.17"
04-Jan-2023,Miscellaneous,00.00,"71,486.06","142,972.11"
04-Jan-2023,IMPS,"597,357.80",00.00,"740,329.91"
04-Jan-2023,NEFT,"8,552.80",00.00,"748,882.71"
04-Jan-2023,IMPS,05.50,00.00,"748,888.21"
04-Jan-2023,Bill,00.00,"748,888.21",00.00
04-Jan-2023,ATM,04.20,00.00,04.20
04-Jan-2023,Tax,403.04,00.00,407.24
04-Jan-2023,Debit Card,115.50,00.00,522.74
04-Jan-2023,NEFT,00.00,52.27,470.47
04-Jan-2023,Purchase,230.60,00.00,701.07
04-Jan-2023,ATM,00.00,116.85,584.22
04-Jan-2023,Bill,"1,139.00",00.00,"1,723.22"
04-Jan-2023,Debit Card,50.00,00.00,"1,773.22"
04-Jan-2023,Cheque,00.00,253.32,"1,519.90"
04-Jan-2023,Transfer,"156,816.60",00.00,"158,336.50"
04-Jan-2023,Reversal,00.00,"17,592.94","140,743.56"
04-Jan-2023,Purchase,"2,077,182.00",00.00,"2,217,925.56"
04-Jan-2023,Interest,00.00,"221,792.56","1,996,133.00"
04-Jan-2023,Cheque,"90,939.94",00.00,"2,087,072.94"
04-Jan-2023,Cheque,00.00,"1,043,536.47","1,043,536.47"
04-Jan-2023,Purchase,"4,694.64",00.00,"1,048,231.11"
04-Jan-2023,Transfer,00.00,"1,048,231.11",00.00
04-Jan-2023,Reversal,51.55,00.00,51.55
04-Jan-2023,IMPS,"1,735,394.25",00.00,"1,735,445.80"
04-Jan-2023,Cash,"16,603.80",00.00,"1,752,049.60"
04-Jan-2023,RTGS,00.00,"876,024.80","876,024.80"
04-Jan-2023,Reversal,00.00,"292,008.27","584,016.53"
04-Jan-2023,Transfer,"20,657.10",00.00,"604,673.63"
04-Jan-2023,Debit Card,07.90,00.00,"604,681.53"
04-Jan-2023,NEFT,00.00,"604,681.53",00.00
04-Jan-2023,Miscellaneous,"2,108.00",00.00,"2,108.00"
04-Jan-2023,RTGS,"244,617.00",00.00,"246,725.00"
04-Jan-2023,Reversal,00.00,"24,672.50","222,052.50"
04-Jan-2023,Bill,06.80,00.00,"222,059.30"
04-Jan-2023,Reversal,00.00,"24,673.26","197,386.04"
04-Jan-2023,Transfer,00.00,"98,693.02","98,693.02"
04-Jan-2023,Purchase,42.54,00.00,"98,735.56"
04-Jan-2023,ATM,"23,099.90",00.00,"121,835.46"
04-Jan-2023,Cheque,"21,216.80",00.00,"143,052.26"
04-Jan-2023,Cash,175.00,00.00,"143,227.26"
04-Jan-2023,ATM,"1,971,296.00",00.00,"2,114,523.26"
04-Jan-2023,Transfer,00.00,"211,452.33","1,903,070.93"
04-Jan-2023,Interest,00.00,"634,356.98","1,268,713.95"
04-Jan-2023,Transfer,00.00,"211,452.33","1,057,261.62"
04-Jan-2023,Tax,00.00,"211,452.32","845,809.30"
04-Jan-2023,RTGS,48.00,00.00,"845,857.30"
04-Jan-2023,Purchase,00.00,"422,928.65","422,928.65"
04-Jan-2023,Bill,00.00,"84,585.73","338,342.92"
04-Jan-2023,Reversal,227.00,00.00,"338,569.92"
04-Jan-2023,Transfer,00.00,"48,367.13","290,202.79"
04-Jan-2023,Debit Card,00.00,"41,457.54","248,745.25"
04-Jan-2023,Miscellaneous,49.20,00.00,"248,794.45"
04-Jan-2023,Bill,"31,542.00",00.00,"280,336.45"
04-Jan-2023,Reversal,00.00,"28,033.65","252,302.81"
04-Jan-2023,Bill,"14,980.79",00.00,"267,283.60"
04-Jan-2023,Commission,"3,519.74",00.00,"270,803.34"
04-Jan-2023,Bill,39.09,00.00,"270,842.43"
04-Jan-2023,Debit Card,"13,194.00",00.00,"284,036.43"
04-Jan-2023,Debit Card,"15,355.00",00.00,"299,391.43"
04-Jan-2023,Debit Card,00.00,"149,695.72","149,695.72"
04-Jan-2023,Bill,00.00,"14,969.57","134,726.15"
04-Jan-2023,Tax,00.00,"26,945.23","107,780.92"
04-Jan-2023,Debit Card,01.82,00.00,"107,782.74"
04-Jan-2023,Transfer,00.00,"21,556.55","86,226.19"
04-Jan-2023,IMPS,06.89,00.00,"86,233.08"
04-Jan-2023,Debit Card,00.00,"8,623.31","77,609.77"
04-Jan-2023,Cheque,"132,764.00",00.00,"210,373.77"
04-Jan-2023,NEFT,"150,147.25",00.00,"360,521.02"
04-Jan-2023,Cash,"798,829.00",00.00,"1,159,350.02"
04-Jan-2023,Debit Card,00.00,"231,870.00","927,480.02"
04-Jan-2023,Reversal,"203,948.00",00.00,"1,131,428.02"
05-Jan-2023,NEFT,00.00,"226,285.60","905,142.42"
05-Jan-2023,Cash,00.00,"100,571.38","804,571.04"
05-Jan-2023,Cheque,527.57,00.00,"805,098.61"
05-Jan-2023,RTGS,00.00,"100,637.33","704,461.28"
05-Jan-2023,Cheque,00.00,"140,892.26","563,569.02"
05-Jan-2023,Interest,332.23,00.00,"563,901.25"
05-Jan-2023,Transfer,343.00,00.00,"564,244.25"
05-Jan-2023,Cheque,364.80,00.00,"564,609.05"
05-Jan-2023,Debit Card,"6,404.69",00.00,"571,013.74"
05-Jan-2023,Debit Card,00.00,"95,168.96","475,844.78"
05-Jan-2023,Cheque,00.00,"158,614.93","317,229.85"
05-Jan-2023,Cheque,00.00,"79,307.46","237,922.39"
06-Jan-2023,Interest,00.00,"118,961.20","118,961.20"
06-Jan-2023,Reversal,"8,629.39",00.00,"127,590.59"
07-Jan-2023,Cheque,53.04,00.00,"127,643.63"
07-Jan-2023,Debit Card,00.00,"14,182.63","113,461.00"
07-Jan-2023,IMPS,"75,138.28",00.00,"188,599.28"
07-Jan-2023,Cash,00.00,"188,599.28",00.00
07-Jan-2023,Commission,"187,574.00",00.00,"187,574.00"
07-Jan-2023,Transfer,"1,773,094.00",00.00,"1,960,668.00"
07-Jan-2023,Cash,04.60,00.00,"1,960,672.60"
07-Jan-2023,Transfer,01.10,00.00,"1,960,673.70"
07-Jan-2023,Purchase,02.00,00.00,"1,960,675.70"
07-Jan-2023,Interest,00.00,"392,135.14","1,568,540.56"
07-Jan-2023,Interest,05.10,00.00,"1,568,545.66"
07-Jan-2023,Cheque,00.00,"174,282.85","1,394,262.81"
07-Jan-2023,Reversal,966.40,00.00,"1,395,229.21"
07-Jan-2023,Purchase,62.00,00.00,"1,395,291.21"
07-Jan-2023,Commission,"40,131.41",00.00,"1,435,422.62"
07-Jan-2023,Commission,00.00,"143,542.26","1,291,880.36"
07-Jan-2023,Commission,"1,272,616.75",00.00,"2,564,497.11"
07-Jan-2023,Commission,"1,317,814.50",00.00,"3,882,311.61"
07-Jan-2023,Purchase,00.00,"970,577.90","2,911,733.71"
07-Jan-2023,RTGS,00.00,"582,346.74","2,329,386.97"
07-Jan-2023,Cash,"1,586,747.75",00.00,"3,916,134.72"
07-Jan-2023,Debit Card,"1,445,073.50",00.00,"5,361,208.22"
07-Jan-2023,Tax,00.00,"765,886.89","4,595,321.33"
07-Jan-2023,Debit Card,00.00,"1,148,830.33","3,446,491.00"
07-Jan-2023,Cash,07.95,00.00,"3,446,498.95"
07-Jan-2023,RTGS,00.00,"1,723,249.48","1,723,249.48"
07-Jan-2023,NEFT,"3,733.88",00.00,"1,726,983.36"
07-Jan-2023,Transfer,00.00,"1,726,983.36",00.00
07-Jan-2023,Bill,31.00,00.00,31.00
08-Jan-2023,Interest,"62,268.90",00.00,"62,299.90"
08-Jan-2023,Debit Card,"250,599.20",00.00,"312,899.10"
08-Jan-2023,Cheque,"26,069.00",00.00,"338,968.10"
08-Jan-2023,IMPS,00.00,"67,793.62","271,174.48"
08-Jan-2023,ATM,"27,703.50",00.00,"298,877.98"
08-Jan-2023,Purchase,"225,301.30",00.00,"524,179.28"
08-Jan-2023,RTGS,00.00,"87,363.21","436,816.07"
08-Jan-2023,Cheque,"27,715.10",00.00,"464,531.17"
08-Jan-2023,ATM,00.00,"464,531.17",00.00
08-Jan-2023,Purchase,"3,200.50",00.00,"3,200.50"
08-Jan-2023,Transfer,151.70,00.00,"3,352.20"
08-Jan-2023,Interest,00.00,558.70,"2,793.50"
08-Jan-2023,Bill,00.00,310.39,"2,483.11"
08-Jan-2023,Cash,00.91,00.00,"2,484.02"
08-Jan-2023,Commission,258.40,00.00,"2,742.42"
08-Jan-2023,RTGS,36.01,00.00,"2,778.43"
08-Jan-2023,Transfer,00.00,277.84,"2,500.59"
08-Jan-2023,IMPS,00.00,"1,250.30","1,250.30"
08-Jan-2023,Purchase,00.00,625.15,625.15
08-Jan-2023,Reversal,53.00,00.00,678.15
08-Jan-2023,Bill,00.00,169.54,508.61
08-Jan-2023,Miscellaneous,00.00,56.51,452.10
08-Jan-2023,NEFT,36.00,00.00,488.10
08-Jan-2023,Commission,00.00,81.35,406.75
08-Jan-2023,Bill,464.00,00.00,870.75
08-Jan-2023,RTGS,10.80,00.00,881.55
08-Jan-2023,Purchase,192.00,00.00,"1,073.55"
08-Jan-2023,Purchase,00.00,119.28,954.27
08-Jan-2023,RTGS,"49,853.00",00.00,"50,807.27"
08-Jan-2023,Tax,"88,011.53",00.00,"138,818.80"
08-Jan-2023,NEFT,"1,314,142.00",00.00,"1,452,960.80"
08-Jan-2023,Cash,"22,891.20",00.00,"1,475,852.00"
08-Jan-2023,Interest,00.00,"1,475,852.00",00.00
08-Jan-2023,Transfer,190.70,00.00,190.70
08-Jan-2023,Cheque,00.00,47.68,143.02
08-Jan-2023,RTGS,"15,205.00",00.00,"15,348.02"
08-Jan-2023,RTGS,00.00,"15,348.02",00.00
08-Jan-2023,IMPS,02.62,00.00,02.62
08-Jan-2023,Bill,06.99,00.00,09.61
08-Jan-2023,Interest,"1,139,679.75",00.00,"1,139,689.36"
08-Jan-2023,Purchase,494.30,00.00,"1,140,183.66"
08-Jan-2023,ATM,"1,000,101.25",00.00,"2,140,284.91"
08-Jan-2023,RTGS,"1,521,983.00",00.00,"3,662,267.91"
08-Jan-2023,Miscellaneous,05.60,00.00,"3,662,273.51"
08-Jan-2023,Cash,"5,348.30",00.00,"3,667,621.81"
09-Jan-2023,Interest,00.00,"523,945.97","3,143,675.84"
09-Jan-2023,NEFT,00.00,"392,959.48","2,750,716.36"
10-Jan-2023,Bill,"2,639.45",00.00,"2,753,355.81"
10-Jan-2023,NEFT,02.60,00.00,"2,753,358.41"
10-Jan-2023,Interest,"3,466.60",00.00,"2,756,825.01"
10-Jan-2023,Cash,00.00,"393,832.14","2,362,992.87"
10-Jan-2023,ATM,"236,779.10",00.00,"2,599,771.97"
10-Jan-2023,Cheque,404.00,00.00,"2,600,175.97"
10-Jan-2023,ATM,"16,618.00",00.00,"2,616,793.97"
10-Jan-2023,RTGS,00.00,"290,754.89","2,326,039.08"
10-Jan-2023,Transfer,"1,390.20",00.00,"2,327,429.28"
10-Jan-2023,RTGS,00.00,"1,163,714.64","1,163,714.64"
10-Jan-2023,NEFT,00.00,"387,904.88","775,809.76"
10-Jan-2023,Tax,220.00,00.00,"776,029.76"
10-Jan-2023,Transfer,00.00,"110,861.39","665,168.37"
10-Jan-2023,Interest,"1,185,340.50",00.00,"1,850,508.87"
10-Jan-2023,ATM,14.00,00.00,"1,850,522.87"
10-Jan-2023,Tax,00.00,"925,261.44","925,261.44"
10-Jan-2023,ATM,"27,121.80",00.00,"952,383.24"
10-Jan-2023,Transfer,00.00,"158,730.54","793,652.70"
10-Jan-2023,Cheque,346.63,00.00,"793,999.33"
11-Jan-2023,RTGS,283.80,00.00,"794,283.13"
11-Jan-2023,ATM,380.00,00.00,"794,663.13"
11-Jan-2023,Commission,00.00,"198,665.78","595,997.35"
11-Jan-2023,IMPS,"1,809.00",00.00,"597,806.35"
11-Jan-2023,Bill,00.00,"74,725.79","523,080.56"
11-Jan-2023,Tax,285.90,00.00,"523,366.46"
11-Jan-2023,Interest,00.00,"174,455.49","348,910.97"
11-Jan-2023,NEFT,"107,911.66",00.00,"456,822.63"
11-Jan-2023,Cheque,00.00,"50,758.07","406,064.56"
11-Jan-2023,Reversal,"1,139.58",00.00,"407,204.14"
11-Jan-2023,Reversal,01.90,00.00,"407,206.04"
11-Jan-2023,Purchase,"136,512.20",00.00,"543,718.24"
11-Jan-2023,ATM,00.00,"271,859.12","271,859.12"
11-Jan-2023,ATM,"484,349.75",00.00,"756,208.87"
11-Jan-2023,Debit Card,00.00,"94,526.11","661,682.76"
11-Jan-2023,Bill,"251,164.41",00.00,"912,847.17"
11-Jan-2023,Cheque,02.00,00.00,"912,849.17"
11-Jan-2023,RTGS,00.00,"152,141.53","760,707.64"
11-Jan-2023,Miscellaneous,"1,257,150.50",00.00,"2,017,858.14"
11-Jan-2023,Debit Card,01.80,00.00,"2,017,859.94"
11-Jan-2023,Reversal,00.00,"2,017,859.94",00.00
11-Jan-2023,Interest,06.00,00.00,06.00
11-Jan-2023,Tax,00.00,06.00,00.00
11-Jan-2023,Commission,00.63,00.00,00.63
11-Jan-2023,Cash,18.00,00.00,18.63
11-Jan-2023,Bill,104.90,00.00,123.53
11-Jan-2023,Debit Card,00.25,00.00,123.78
11-Jan-2023,RTGS,00.00,30.95,92.84
11-Jan-2023,Reversal,"8,876.00",00.00,"8,968.84"
11-Jan-2023,Tax,00.00,"1,793.77","7,175.07"
11-Jan-2023,Debit Card,"1,130,991.50",00.00,"1,138,166.57"
11-Jan-2023,Transfer,00.00,"142,270.82","995,895.75"
11-Jan-2023,Cheque,"9,202.89",00.00,"1,005,098.64"
11-Jan-2023,ATM,00.00,"100,509.86","904,588.78"
11-Jan-2023,Reversal,00.00,"226,147.20","678,441.58"
11-Jan-2023,IMPS,00.00,"67,844.16","610,597.42"
11-Jan-2023,Cheque,00.00,"610,597.42",00.00
11-Jan-2023,RTGS,"1,344,015.80",00.00,"1,344,015.80"
11-Jan-2023,Purchase,37.00,00.00,"1,344,052.80"
11-Jan-2023,Cash,00.00,"336,013.20","1,008,039.60"
11-Jan-2023,Purchase,"230,639.00",00.00,"1,238,678.60"
11-Jan-2023,IMPS,00.00,"1,238,678.60",00.00
11-Jan-2023,Commission,400.61,00.00,400.61
11-Jan-2023,Purchase,00.00,400.61,00.00
11-Jan-2023,RTGS,"22,605.91",00.00,"22,605.91"
11-Jan-2023,Commission,04.63,00.00,"22,610.54"
11-Jan-2023,NEFT,07.00,00.00,"22,617.54"
11-Jan-2023,Interest,126.30,00.00,"22,743.84"
12-Jan-2023,IMPS,00.00,"2,527.09","20,216.75"
12-Jan-2023,RTGS,38.00,00.00,"20,254.75"
12-Jan-2023,Miscellaneous,"147,618.80",00.00,"167,873.55"
12-Jan-2023,Cash,00.00,"20,984.19","146,889.36"
12-Jan-2023,Debit Card,00.00,"14,688.94","132,200.42"
12-Jan-2023,Commission,00.00,"18,885.77","113,314.65"
12-Jan-2023,Commission,00.00,"18,885.78","94,428.88"
12-Jan-2023,Commission,142.40,00.00,"94,571.28"
12-Jan-2023,Cash,00.00,"13,510.18","81,061.10"
12-Jan-2023,Debit Card,02.00,00.00,"81,063.10"
12-Jan-2023,IMPS,00.00,"20,265.78","60,797.32"
12-Jan-2023,IMPS,"11,673.00",00.00,"72,470.32"
12-Jan-2023,Interest,00.00,"9,058.79","63,411.53"
12-Jan-2023,Tax,00.00,"9,058.79","54,352.74"
12-Jan-2023,Miscellaneous,43.00,00.00,"54,395.74"
12-Jan-2023,Purchase,00.00,"10,879.15","43,516.59"
12-Jan-2023,Interest,00.00,"14,505.53","29,011.06"
12-Jan-2023,IMPS,"3,970.00",00.00,"32,981.06"
12-Jan-2023,RTGS,00.00,"3,298.11","29,682.95"
12-Jan-2023,Cheque,"158,817.00",00.00,"188,499.95"
12-Jan-2023,Miscellaneous,20.10,00.00,"188,520.05"
12-Jan-2023,Miscellaneous,04.30,00.00,"188,524.35"
12-Jan-2023,Tax,00.00,"20,947.15","167,577.20"
12-Jan-2023,RTGS,511.00,00.00,"168,088.20"
12-Jan-2023,Interest,02.00,00.00,"168,090.20"
12-Jan-2023,Debit Card,"174,059.34",00.00,"342,149.54"
12-Jan-2023,Miscellaneous,34.61,00.00,"342,184.15"
12-Jan-2023,Purchase,00.00,"85,546.04","256,638.11"
12-Jan-2023,Tax,07.50,00.00,"256,645.61"
12-Jan-2023,IMPS,58.80,00.00,"256,704.41"
12-Jan-2023,Cash,05.40,00.00,"256,709.81"
12-Jan-2023,Transfer,00.00,"51,341.96","205,367.85"
12-Jan-2023,Transfer,00.00,"20,536.79","184,831.06"
12-Jan-2023,Reversal,"2,918.81",00.00,"187,749.87"
12-Jan-2023,Commission,"14,093.70",00.00,"201,843.57"
12-Jan-2023,Reversal,"189,323.00",00.00,"391,166.57"
12-Jan-2023,ATM,00.00,"97,791.64","293,374.93"
12-Jan-2023,Miscellaneous,400.11,00.00,"293,775.04"
12-Jan-2023,Tax,00.00,"97,925.01","195,850.03"
12-Jan-2023,Transfer,"19,405.00",00.00,"215,255.03"
12-Jan-2023,Cash,00.00,"53,813.76","161,441.27"
12-Jan-2023,IMPS,352.90,00.00,"161,794.17"
12-Jan-2023,Cheque,15.00,00.00,"161,809.17"
12-Jan-2023,Purchase,07.19,00.00,"161,816.36"
12-Jan-2023,Transfer,00.00,"32,363.27","129,453.09"
12-Jan-2023,Miscellaneous,"1,343.86",00.00,"130,796.95"
12-Jan-2023,Debit Card,48.00,00.00,"130,844.95"
12-Jan-2023,Bill,00.00,"26,168.99","104,675.96"
12-Jan-2023,Transfer,00.00,"52,337.98","52,337.98"
12-Jan-2023,NEFT,"1,713.00",00.00,"54,050.98"
12-Jan-2023,NEFT,"3,324.80",00.00,"57,375.78"
12-Jan-2023,IMPS,00.00,"28,687.89","28,687.89"
12-Jan-2023,Commission,"116,662.50",00.00,"145,350.39"
12-Jan-2023,Reversal,00.00,"145,350.39",00.00
12-Jan-2023,Miscellaneous,"21,960.84",00.00,"21,960.84"
12-Jan-2023,Cheque,00.00,"10,980.42","10,980.42"
13-Jan-2023,NEFT,00.00,"5,490.21","5,490.21"
13-Jan-2023,Reversal,62.31,00.00,"5,552.52"
13-Jan-2023,Cheque,"1,085.00",00.00,"6,637.52"
13-Jan-2023,Debit Card,00.00,829.69,"5,807.83"
14-Jan-2023,Bill,"2,909.00",00.00,"8,716.83"
14-Jan-2023,RTGS,"17,037.00",00.00,"25,753.83"
14-Jan-2023,Cash,"3,039.00",00.00,"28,792.83"
14-Jan-2023,Miscellaneous,23.00,00.00,"28,815.83"
14-Jan-2023,Tax,00.00,"7,203.96","21,611.87"
14-Jan-2023,Purchase,05.00,00.00,"21,616.87"
14-Jan-2023,NEFT,00.00,"2,161.69","19,455.18"
14-Jan-2023,Debit Card,00.00,"19,455.18",00.00
14-Jan-2023,Bill,476.00,00.00,476.00
14-Jan-2023,Reversal,"213,273.47",00.00,"213,749.47"
14-Jan-2023,Transfer,"1,976,546.00",00.00,"2,190,295.47"
14-Jan-2023,ATM,00.00,"273,786.93","1,916,508.54"
14-Jan-2023,Debit Card,00.00,"1,916,508.54",00.00
14-Jan-2023,Reversal,"232,062.80",00.00,"232,062.80"
14-Jan-2023,ATM,"124,147.60",00.00,"356,210.40"
14-Jan-2023,Commission,00.00,"89,052.60","267,157.80"
14-Jan-2023,IMPS,00.00,"267,157.80",00.00
14-Jan-2023,Debit Card,01.00,00.00,01.00
14-Jan-2023,Purchase,00.00,00.17,00.83
14-Jan-2023,Interest,"866,423.20",00.00,"866,424.03"
14-Jan-2023,Commission,06.80,00.00,"866,430.83"
14-Jan-2023,Commission,"23,800.60",00.00,"890,231.43"
14-Jan-2023,Debit Card,00.00,"127,175.92","763,055.51"
14-Jan-2023,Reversal,00.00,"190,763.88","572,291.63"
14-Jan-2023,RTGS,00.00,"286,145.82","286,145.82"
14-Jan-2023,Miscellaneous,00.00,"35,768.23","250,377.59"
14-Jan-2023,Cheque,00.00,"25,037.76","225,339.83"
14-Jan-2023,Transfer,00.00,"37,556.64","187,783.19"
14-Jan-2023,Miscellaneous,00.00,"37,556.64","150,226.55"
14-Jan-2023,Cash,00.00,"21,460.94","128,765.61"
14-Jan-2023,Reversal,"184,793.00",00.00,"313,558.61"
14-Jan-2023,ATM,494.00,00.00,"314,052.61"
14-Jan-2023,Cheque,00.00,"39,256.58","274,796.03"
14-Jan-2023,Transfer,00.00,"39,256.58","235,539.45"
14-Jan-2023,Reversal,55.75,00.00,"235,595.20"
14-Jan-2023,RTGS,05.00,00.00,"235,600.20"
14-Jan-2023,ATM,00.00,"23,560.02","212,040.18"
15-Jan-2023,Debit Card,00.00,"70,680.06","141,360.12"
15-Jan-2023,ATM,00.00,"15,706.68","125,653.44"
15-Jan-2023,Cheque,00.00,"31,413.36","94,240.08"
15-Jan-2023,NEFT,00.00,"18,848.02","75,392.06"
15-Jan-2023,IMPS,00.00,"12,565.34","62,826.72"
15-Jan-2023,Purchase,00.00,"15,706.68","47,120.04"
15-Jan-2023,Cheque,00.00,"7,853.34","39,266.70"
15-Jan-2023,RTGS,00.00,"5,609.53","33,657.17"
15-Jan-2023,Bill,"10,426.36",00.00,"44,083.53"
15-Jan-2023,IMPS,00.00,"4,898.17","39,185.36"
15-Jan-2023,Miscellaneous,00.00,"4,898.17","34,287.19"
15-Jan-2023,Purchase,00.00,"11,429.06","22,858.13"
15-Jan-2023,Debit Card,00.00,"2,857.27","20,000.86"
15-Jan-2023,Reversal,00.00,"2,857.27","17,143.59"
15-Jan-2023,Commission,00.00,"5,714.53","11,429.06"
15-Jan-2023,Commission,06.00,00.00,"11,435.06"
15-Jan-2023,Tax,05.90,00.00,"11,440.96"
15-Jan-2023,Interest,177.40,00.00,"11,618.36"
15-Jan-2023,Cash,00.00,"1,161.84","10,456.52"
16-Jan-2023,Interest,"380,772.00",00.00,"391,228.52"
16-Jan-2023,Transfer,"21,113.75",00.00,"412,342.27"
16-Jan-2023,Commission,"8,355.60",00.00,"420,697.87"
16-Jan-2023,Transfer,00.00,"42,069.79","378,628.08"
16-Jan-2023,Bill,463.77,00.00,"379,091.85"
16-Jan-2023,RTGS,"2,360.00",00.00,"381,451.85"
16-Jan-2023,Cheque,"1,280,800.00",00.00,"1,662,251.85"
16-Jan-2023,RTGS,00.00,"207,781.48","1,454,470.37"
16-Jan-2023,Interest,00.00,"181,808.80","1,272,661.57"
16-Jan-2023,Bill,"32,341.84",00.00,"1,305,003.41"
16-Jan-2023,Interest,00.00,"145,000.38","1,160,003.03"
16-Jan-2023,IMPS,10.77,00.00,"1,160,013.80"
16-Jan-2023,Cash,00.00,"290,003.45","870,010.35"
16-Jan-2023,RTGS,"5,232.00",00.00,"875,242.35"
16-Jan-2023,ATM,00.00,"87,524.24","787,718.12"
16-Jan-2023,Cash,190.38,00.00,"787,908.50"
16-Jan-2023,Commission,"177,818.00",00.00,"965,726.50"
16-Jan-2023,Cheque,"2,887.00",00.00,"968,613.50"
16-Jan-2023,Debit Card,00.00,"242,153.38","726,460.12"
16-Jan-2023,RTGS,"188,800.16",00.00,"915,260.28"
17-Jan-2023,Cheque,00.00,"130,751.47","784,508.81"
17-Jan-2023,ATM,00.00,00.00,"784,508.81"
17-Jan-2023,IMPS,00.00,"78,450.88","706,057.93"
17-Jan-2023,Purchase,"33,808.53",00.00,"739,866.46"
17-Jan-2023,Cash,50.60,00.00,"739,917.06"
17-Jan-2023,Bill,00.00,"73,991.71","665,925.35"
18-Jan-2023,Commission,"17,556.90",00.00,"683,482.25"
18-Jan-2023,Purchase,00.00,"113,913.71","569,568.54"
18-Jan-2023,Commission,"807,921.00",00.00,"1,377,489.54"
18-Jan-2023,Bill,00.90,00.00,"1,377,490.44"
18-Jan-2023,Reversal,"17,410.54",00.00,"1,394,900.98"
18-Jan-2023,Tax,00.00,"199,271.57","1,195,629.41"
18-Jan-2023,NEFT,02.30,00.00,"1,195,631.71"
18-Jan-2023,Tax,20.07,00.00,"1,195,651.78"
18-Jan-2023,Reversal,00.00,"239,130.36","956,521.42"
18-Jan-2023,Miscellaneous,182.90,00.00,"956,704.32"
18-Jan-2023,Commission,00.00,"318,901.44","637,802.88"
18-Jan-2023,Commission,"96,759.00",00.00,"734,561.88"
18-Jan-2023,Purchase,00.00,"91,820.24","642,741.64"
18-Jan-2023,Tax,00.00,"64,274.16","578,467.48"
18-Jan-2023,Cash,05.00,00.00,"578,472.48"
18-Jan-2023,Debit Card,00.00,"144,618.12","433,854.36"
18-Jan-2023,Purchase,"80,714.44",00.00,"514,568.80"
18-Jan-2023,Debit Card,302.40,00.00,"514,871.20"
18-Jan-2023,Reversal,00.00,"128,717.80","386,153.40"
18-Jan-2023,ATM,"361,984.80",00.00,"748,138.20"
18-Jan-2023,Debit Card,00.00,"74,813.82","673,324.38"
18-Jan-2023,Commission,00.00,"67,332.44","605,991.94"
18-Jan-2023,Cheque,00.00,"151,497.99","454,493.95"
19-Jan-2023,Reversal,00.00,"454,493.95",00.00
19-Jan-2023,Cash,"2,169.50",00.00,"2,169.50"
19-Jan-2023,Cheque,507.60,00.00,"2,677.10"
19-Jan-2023,Tax,00.00,"2,677.10",00.00
19-Jan-2023,RTGS,00.70,00.00,00.70
19-Jan-2023,Miscellaneous,00.00,00.09,00.61
19-Jan-2023,Purchase,00.00,00.20,00.41
19-Jan-2023,Tax,"133,252.00",00.00,"133,252.41"
19-Jan-2023,NEFT,00.00,"19,036.06","114,216.35"
19-Jan-2023,ATM,00.00,"28,554.09","85,662.26"
19-Jan-2023,Interest,"8,477.00",00.00,"94,139.26"
19-Jan-2023,RTGS,"1,573,833.00",00.00,"1,667,972.26"
19-Jan-2023,Cash,00.00,"166,797.23","1,501,175.03"
19-Jan-2023,NEFT,"260,703.30",00.00,"1,761,878.33"
19-Jan-2023,RTGS,00.00,"440,469.58","1,321,408.75"
19-Jan-2023,Miscellaneous,"7,172.30",00.00,"1,328,581.05"
19-Jan-2023,Commission,281.80,00.00,"1,328,862.85"
20-Jan-2023,Cheque,02.62,00.00,"1,328,865.47"
20-Jan-2023,Cash,"2,679.70",00.00,"1,331,545.17"
20-Jan-2023,RTGS,00.00,"332,886.29","998,658.88"
20-Jan-2023,ATM,"3,372.00",00.00,"1,002,030.88"
20-Jan-2023,Miscellaneous,00.00,"111,336.76","890,694.12"
20-Jan-2023,Bill,00.00,"445,347.06","445,347.06"
20-Jan-2023,Reversal,00.00,"44,534.71","400,812.35"
20-Jan-2023,ATM,00.00,"80,162.47","320,649.88"
20-Jan-2023,ATM,00.00,"160,324.94","160,324.94"
20-Jan-2023,Commission,00.00,"22,903.56","137,421.38"
21-Jan-2023,Cash,00.00,"17,177.67","120,243.71"
21-Jan-2023,ATM,00.00,"120,243.71",00.00
21-Jan-2023,Tax,"1,184,550.00",00.00,"1,184,550.00"
21-Jan-2023,Debit Card,00.00,"131,616.67","1,052,933.33"
21-Jan-2023,Interest,00.00,"350,977.78","701,955.55"
21-Jan-2023,Purchase,00.00,"175,488.89","526,466.66"
21-Jan-2023,ATM,"1,508,929.50",00.00,"2,035,396.16"
21-Jan-2023,Bill,"4,156.77",00.00,"2,039,552.93"
21-Jan-2023,Cheque,"1,833.96",00.00,"2,041,386.89"
21-Jan-2023,Cheque,645.00,00.00,"2,042,031.89"
21-Jan-2023,Commission,06.70,00.00,"2,042,038.59"
21-Jan-2023,Purchase,00.00,"255,254.82","1,786,783.77"
21-Jan-2023,Transfer,01.00,00.00,"1,786,784.77"
21-Jan-2023,Miscellaneous,00.00,"357,356.95","1,429,427.82"
21-Jan-2023,Commission,00.00,"357,356.96","1,072,070.86"
21-Jan-2023,Transfer,"2,049,751.00",00.00,"3,121,821.86"
21-Jan-2023,Bill,00.00,"346,869.10","2,774,952.76"
21-Jan-2023,Interest,09.00,00.00,"2,774,961.76"
21-Jan-2023,Tax,"127,402.30",00.00,"2,902,364.06"
21-Jan-2023,RTGS,"2,419.30",00.00,"2,904,783.36"
21-Jan-2023,IMPS,371.37,00.00,"2,905,154.73"
21-Jan-2023,Cheque,00.00,"1,452,577.37","1,452,577.36"
21-Jan-2023,Cheque,"143,581.70",00.00,"1,596,159.06"
21-Jan-2023,NEFT,00.00,"266,026.51","1,330,132.55"
21-Jan-2023,IMPS,00.00,"166,266.57","1,163,865.98"
21-Jan-2023,NEFT,00.00,"166,266.57","997,599.41"
21-Jan-2023,Transfer,"1,306,664.50",00.00,"2,304,263.91"
21-Jan-2023,Miscellaneous,00.00,"1,152,131.96","1,152,131.96"
21-Jan-2023,Commission,00.00,"230,426.39","921,705.57"
21-Jan-2023,Tax,00.79,00.00,"921,706.36"
21-Jan-2023,Cash,"4,027.00",00.00,"925,733.36"
21-Jan-2023,Miscellaneous,00.00,"308,577.79","617,155.57"
21-Jan-2023,Reversal,00.00,"205,718.52","411,437.05"
21-Jan-2023,Debit Card,253.10,00.00,"411,690.15"
21-Jan-2023,Tax,00.00,"58,812.88","352,877.27"
21-Jan-2023,Cheque,45.19,00.00,"352,922.46"
21-Jan-2023,Bill,"112,472.00",00.00,"465,394.46"
21-Jan-2023,Tax,"754,755.80",00.00,"1,220,150.26"
21-Jan-2023,ATM,00.00,"174,307.18","1,045,843.08"
21-Jan-2023,Miscellaneous,00.00,"116,204.79","929,638.29"
21-Jan-2023,Transfer,41.45,00.00,"929,679.74"
21-Jan-2023,Reversal,00.00,"929,679.74",00.00
21-Jan-2023,Commission,"57,684.50",00.00,"57,684.50"
21-Jan-2023,Cash,00.00,"9,614.08","48,070.42"
21-Jan-2023,ATM,"93,242.00",00.00,"141,312.42"
21-Jan-2023,Cash,00.00,"141,312.42",00.00
21-Jan-2023,NEFT,"3,270.30",00.00,"3,270.30"
21-Jan-2023,NEFT,"2,039.20",00.00,"5,309.50"
21-Jan-2023,Transfer,00.00,"1,061.90","4,247.60"
21-Jan-2023,RTGS,04.00,00.00,"4,251.60"
21-Jan-2023,Reversal,"1,585,066.00",00.00,"1,589,317.60"
21-Jan-2023,Purchase,00.00,"529,772.53","1,059,545.07"
21-Jan-2023,IMPS,04.00,00.00,"1,059,549.07"
21-Jan-2023,IMPS,00.00,"132,443.63","927,105.44"
21-Jan-2023,Interest,07.12,00.00,"927,112.56"
21-Jan-2023,ATM,"715,413.20",00.00,"1,642,525.76"
21-Jan-2023,Cheque,00.00,"328,505.15","1,314,020.61"
22-Jan-2023,Miscellaneous,366.00,00.00,"1,314,386.61"
22-Jan-2023,Purchase,"1,870,976.00",00.00,"3,185,362.61"
22-Jan-2023,RTGS,00.00,"353,929.18","2,831,433.43"
22-Jan-2023,Transfer,04.83,00.00,"2,831,438.26"
22-Jan-2023,NEFT,"256,827.00",00.00,"3,088,265.26"
22-Jan-2023,Reversal,05.30,00.00,"3,088,270.56"
22-Jan-2023,Cash,00.00,"308,827.06","2,779,443.50"
22-Jan-2023,Reversal,322.00,00.00,"2,779,765.50"
22-Jan-2023,Commission,02.43,00.00,"2,779,767.93"
22-Jan-2023,Interest,"1,660,886.50",00.00,"4,440,654.43"
22-Jan-2023,Cash,183.50,00.00,"4,440,837.93"
22-Jan-2023,Cash,04.60,00.00,"4,440,842.53"
22-Jan-2023,Debit Card,00.00,"555,105.32","3,885,737.21"
22-Jan-2023,Debit Card,"189,681.50",00.00,"4,075,418.71"
22-Jan-2023,Interest,"4,057.00",00.00,"4,079,475.71"
22-Jan-2023,ATM,200.00,00.00,"4,079,675.71"
22-Jan-2023,Purchase,25.50,00.00,"4,079,701.21"
22-Jan-2023,Bill,248.84,00.00,"4,079,950.05"
23-Jan-2023,Commission,00.00,"1,359,983.35","2,719,966.70"
23-Jan-2023,Cheque,00.00,"271,996.67","2,447,970.03"
23-Jan-2023,IMPS,24.00,00.00,"2,447,994.03"
23-Jan-2023,RTGS,26.33,00.00,"2,448,020.36"
23-Jan-2023,Debit Card,00.00,"408,003.39","2,040,016.97"
23-Jan-2023,NEFT,00.00,"680,005.66","1,360,011.31"
23-Jan-2023,ATM,00.00,"151,112.37","1,208,898.94"
23-Jan-2023,Purchase,283.63,00.00,"1,209,182.57"
23-Jan-2023,IMPS,00.00,"1,209,182.57",00.00
23-Jan-2023,Tax,30.00,00.00,30.00
23-Jan-2023,ATM,01.30,00.00,31.30
23-Jan-2023,Interest,00.00,15.65,15.65
23-Jan-2023,Transfer,"1,926,189.20",00.00,"1,926,204.85"
23-Jan-2023,Cash,00.00,"192,620.49","1,733,584.36"
24-Jan-2023,Reversal,"1,368,091.00",00.00,"3,101,675.36"
24-Jan-2023,NEFT,"1,544.40",00.00,"3,103,219.76"
24-Jan-2023,Miscellaneous,"3,295.59",00.00,"3,106,515.35"
24-Jan-2023,ATM,00.00,"621,303.07","2,485,212.28"
24-Jan-2023,Tax,07.00,00.00,"2,485,219.28"
24-Jan-2023,Cash,00.00,"276,135.48","2,209,083.80"
24-Jan-2023,Miscellaneous,00.00,"368,180.63","1,840,903.17"
24-Jan-2023,ATM,00.00,"306,817.20","1,534,085.98"
24-Jan-2023,Reversal,863.00,00.00,"1,534,948.98"
24-Jan-2023,Tax,07.08,00.00,"1,534,956.06"
24-Jan-2023,Reversal,00.00,"255,826.01","1,279,130.05"
24-Jan-2023,Reversal,00.00,"213,188.34","1,065,941.71"
24-Jan-2023,Tax,"891,507.75",00.00,"1,957,449.46"
24-Jan-2023,Reversal,"1,617,993.50",00.00,"3,575,442.96"
24-Jan-2023,Interest,00.00,"1,191,814.32","2,383,628.64"
24-Jan-2023,RTGS,"112,558.38",00.00,"2,496,187.02"
24-Jan-2023,Reversal,00.00,"2,496,187.02",00.00
24-Jan-2023,Miscellaneous,"22,440.07",00.00,"22,440.07"
24-Jan-2023,Purchase,00.00,"3,205.72","19,234.35"
24-Jan-2023,NEFT,00.00,"2,404.29","16,830.06"
24-Jan-2023,RTGS,00.00,"16,830.06",00.00
24-Jan-2023,Transfer,"31,421.00",00.00,"31,421.00"
24-Jan-2023,Cash,00.00,"3,142.10","28,278.90"
24-Jan-2023,IMPS,"54,057.00",00.00,"82,335.90"
24-Jan-2023,Commission,"15,949.60",00.00,"98,285.50"
24-Jan-2023,Purchase,00.00,"14,040.79","84,244.71"
24-Jan-2023,Tax,00.00,"10,530.59","73,714.12"
24-Jan-2023,Transfer,"410,740.00",00.00,"484,454.12"
24-Jan-2023,Purchase,00.00,"242,227.06","242,227.06"
24-Jan-2023,Reversal,00.00,"24,222.71","218,004.35"
24-Jan-2023,Cash,"258,232.66",00.00,"476,237.01"
24-Jan-2023,ATM,00.00,"238,118.51","238,118.50"
24-Jan-2023,Commission,00.00,"79,372.83","158,745.67"
24-Jan-2023,Transfer,00.00,"17,638.41","141,107.26"
24-Jan-2023,Debit Card,06.90,00.00,"141,114.16"
24-Jan-2023,Debit Card,00.00,"47,038.05","94,076.11"
24-Jan-2023,Interest,00.00,"15,679.35","78,396.76"
24-Jan-2023,Tax,00.00,"15,679.35","62,717.41"
24-Jan-2023,ATM,"27,969.68",00.00,"90,687.09"
24-Jan-2023,Bill,00.00,"10,076.34","80,610.75"
24-Jan-2023,ATM,00.00,"8,061.08","72,549.68"
24-Jan-2023,IMPS,05.10,00.00,"72,554.78"
24-Jan-2023,ATM,00.00,"7,255.48","65,299.30"
24-Jan-2023,Commission,"191,548.00",00.00,"256,847.30"
24-Jan-2023,Transfer,00.00,"25,684.73","231,162.57"
24-Jan-2023,Cheque,03.60,00.00,"231,166.17"
25-Jan-2023,Tax,00.00,"57,791.54","173,374.63"
25-Jan-2023,RTGS,00.00,"28,895.77","144,478.86"
25-Jan-2023,Bill,00.00,"18,059.86","126,419.00"
25-Jan-2023,Tax,00.00,"18,059.86","108,359.14"
25-Jan-2023,IMPS,00.00,"18,059.86","90,299.28"
25-Jan-2023,Bill,00.00,"18,059.86","72,239.42"
25-Jan-2023,Bill,"27,622.30",00.00,"99,861.72"
25-Jan-2023,Interest,00.00,"49,930.86","49,930.86"
25-Jan-2023,Reversal,24.00,00.00,"49,954.86"
25-Jan-2023,Reversal,00.00,"8,325.81","41,629.05"
25-Jan-2023,Transfer,00.00,"6,938.18","34,690.88"
25-Jan-2023,RTGS,"192,726.30",00.00,"227,417.18"
25-Jan-2023,ATM,81.00,00.00,"227,498.18"
25-Jan-2023,ATM,"16,485.20",00.00,"243,983.38"
25-Jan-2023,Cheque,00.00,"48,796.68","195,186.70"
25-Jan-2023,Commission,00.00,"97,593.35","97,593.35"
25-Jan-2023,Debit Card,149.00,00.00,"97,742.35"
25-Jan-2023,Debit Card,"1,683,767.00",00.00,"1,781,509.35"
25-Jan-2023,RTGS,16.69,00.00,"1,781,526.04"
25-Jan-2023,Cash,"4,072.77",00.00,"1,785,598.81"
25-Jan-2023,Interest,"24,529.50",00.00,"1,810,128.31"
25-Jan-2023,Purchase,"900,802.00",00.00,"2,710,930.31"
25-Jan-2023,Debit Card,"21,316.46",00.00,"2,732,246.77"
25-Jan-2023,Purchase,"12,620.44",00.00,"2,744,867.21"
25-Jan-2023,Transfer,"19,216.10",00.00,"2,764,083.31"
25-Jan-2023,Reversal,00.00,"691,020.83","2,073,062.48"
25-Jan-2023,RTGS,03.00,00.00,"2,073,065.48"
25-Jan-2023,IMPS,00.00,"259,133.19","1,813,932.30"
25-Jan-2023,ATM,"14,377.10",00.00,"1,828,309.40"
25-Jan-2023,Miscellaneous,00.00,"203,145.49","1,625,163.91"
25-Jan-2023,Reversal,133.00,00.00,"1,625,296.91"
26-Jan-2023,RTGS,"229,343.00",00.00,"1,854,639.91"
26-Jan-2023,IMPS,01.10,00.00,"1,854,641.01"
26-Jan-2023,Transfer,00.00,"463,660.25","1,390,980.76"
26-Jan-2023,Purchase,00.00,"463,660.25","927,320.51"
26-Jan-2023,RTGS,00.00,"115,915.06","811,405.45"
26-Jan-2023,Miscellaneous,"161,110.00",00.00,"972,515.45"
26-Jan-2023,Commission,00.00,"121,564.43","850,951.02"
26-Jan-2023,RTGS,00.00,"141,825.17","709,125.85"
26-Jan-2023,Cash,"224,833.94",00.00,"933,959.79"
26-Jan-2023,NEFT,"1,252,559.25",00.00,"2,186,519.04"
26-Jan-2023,Bill,00.00,"364,419.84","1,822,099.20"
26-Jan-2023,Purchase,00.00,"182,209.92","1,639,889.28"
26-Jan-2023,ATM,40.00,00.00,"1,639,929.28"
26-Jan-2023,Commission,"3,738.79",00.00,"1,643,668.07"
26-Jan-2023,Reversal,00.00,"821,834.04","821,834.04"
26-Jan-2023,Purchase,00.00,"91,314.89","730,519.15"
26-Jan-2023,Cash,00.00,"146,103.83","584,415.32"
26-Jan-2023,Transfer,00.00,"97,402.55","487,012.77"
26-Jan-2023,Miscellaneous,00.00,"69,573.25","417,439.52"
26-Jan-2023,Interest,00.00,"83,487.90","333,951.62"
26-Jan-2023,ATM,"2,567.00",00.00,"336,518.62"
26-Jan-2023,Purchase,00.00,"112,172.87","224,345.75"
26-Jan-2023,ATM,"1,201,562.00",00.00,"1,425,907.75"
26-Jan-2023,Tax,207.10,00.00,"1,426,114.85"
26-Jan-2023,Interest,04.00,00.00,"1,426,118.85"
26-Jan-2023,Debit Card,04.00,00.00,"1,426,122.85"
26-Jan-2023,Interest,00.00,"237,687.14","1,188,435.71"
26-Jan-2023,Cash,"6,549.10",00.00,"1,194,984.81"
26-Jan-2023,RTGS,44.00,00.00,"1,195,028.81"
27-Jan-2023,Purchase,43.10,00.00,"1,195,071.91"
27-Jan-2023,Miscellaneous,00.00,"170,724.56","1,024,347.35"
27-Jan-2023,Cheque,00.00,"102,434.74","921,912.62"
27-Jan-2023,Reversal,00.00,"115,239.08","806,673.54"
27-Jan-2023,Purchase,00.00,"806,673.54",00.00
28-Jan-2023,Commission,"1,691,387.00",00.00,"1,691,387.00"
28-Jan-2023,NEFT,00.00,"422,846.75","1,268,540.25"
28-Jan-2023,Cheque,00.00,"181,220.04","1,087,320.21"
28-Jan-2023,Debit Card,00.00,"155,331.46","931,988.75"
28-Jan-2023,Bill,00.00,"232,997.19","698,991.56"
28-Jan-2023,Reversal,00.00,"77,665.73","621,325.83"
28-Jan-2023,Interest,00.00,"77,665.73","543,660.10"
28-Jan-2023,NEFT,"98,701.00",00.00,"642,361.10"
28-Jan-2023,NEFT,00.00,"80,295.14","562,065.96"
28-Jan-2023,Debit Card,00.00,"281,032.98","281,032.98"
28-Jan-2023,Cash,"7,788.30",00.00,"288,821.28"
28-Jan-2023,Cheque,00.00,"32,091.25","256,730.03"
29-Jan-2023,Miscellaneous,"27,628.00",00.00,"284,358.03"
29-Jan-2023,Bill,00.00,"284,358.03",00.00
29-Jan-2023,IMPS,43.46,00.00,43.46
29-Jan-2023,Tax,00.00,06.21,37.25
29-Jan-2023,RTGS,00.00,09.31,27.94
29-Jan-2023,ATM,33.00,00.00,60.94
29-Jan-2023,NEFT,00.00,12.19,48.75
29-Jan-2023,IMPS,00.00,00.00,48.75
29-Jan-2023,Reversal,00.00,09.75,39.00
29-Jan-2023,Cheque,00.00,07.80,31.20
29-Jan-2023,Miscellaneous,00.00,06.24,24.96
29-Jan-2023,NEFT,170.00,00.00,194.96
29-Jan-2023,Transfer,"124,851.62",00.00,"125,046.58"
29-Jan-2023,Reversal,52.90,00.00,"125,099.48"
29-Jan-2023,RTGS,00.00,"41,699.83","83,399.65"
29-Jan-2023,Transfer,00.00,"16,679.93","66,719.72"
29-Jan-2023,Tax,00.00,"6,671.97","60,047.75"
29-Jan-2023,NEFT,00.00,"6,671.97","53,375.78"
29-Jan-2023,Cheque,00.00,"5,337.58","48,038.20"
29-Jan-2023,Miscellaneous,"575,065.00",00.00,"623,103.20"
29-Jan-2023,Tax,"136,346.00",00.00,"759,449.20"
29-Jan-2023,Tax,05.00,00.00,"759,454.20"
29-Jan-2023,ATM,"2,926.00",00.00,"762,380.20"
29-Jan-2023,Tax,00.00,"152,476.04","609,904.16"
29-Jan-2023,Commission,"6,635.47",00.00,"616,539.63"
29-Jan-2023,RTGS,265.80,00.00,"616,805.43"
29-Jan-2023,Purchase,"2,026.40",00.00,"618,831.83"
29-Jan-2023,Interest,00.00,"123,766.37","495,065.46"
29-Jan-2023,Tax,138.10,00.00,"495,203.56"
29-Jan-2023,Bill,06.00,00.00,"495,209.56"
29-Jan-2023,Miscellaneous,00.00,"61,901.20","433,308.36"
29-Jan-2023,Miscellaneous,"19,995.00",00.00,"453,303.36"
29-Jan-2023,Transfer,00.00,"113,325.84","339,977.52"
29-Jan-2023,Debit Card,445.00,00.00,"340,422.52"
29-Jan-2023,Cash,00.00,"56,737.09","283,685.43"
29-Jan-2023,Miscellaneous,"4,721.00",00.00,"288,406.43"
29-Jan-2023,IMPS,"23,642.98",00.00,"312,049.41"
29-Jan-2023,Interest,00.00,"104,016.47","208,032.94"
29-Jan-2023,NEFT,"75,730.00",00.00,"283,762.94"
29-Jan-2023,Interest,00.00,"28,376.29","255,386.65"
29-Jan-2023,NEFT,"235,369.25",00.00,"490,755.90"
29-Jan-2023,Cheque,"161,292.72",00.00,"652,048.62"
29-Jan-2023,Miscellaneous,00.00,"81,506.08","570,542.54"
29-Jan-2023,ATM,"3,463.40",00.00,"574,005.94"
29-Jan-2023,NEFT,00.00,"71,750.74","502,255.20"
29-Jan-2023,RTGS,00.00,"100,451.04","401,804.16"
29-Jan-2023,Debit Card,00.00,"200,902.08","200,902.08"
29-Jan-2023,Cash,00.00,"40,180.42","160,721.66"
29-Jan-2023,Reversal,223.33,00.00,"160,944.99"
29-Jan-2023,IMPS,00.00,"20,118.12","140,826.87"
29-Jan-2023,Tax,01.00,00.00,"140,827.87"
29-Jan-2023,NEFT,00.00,"35,206.97","105,620.90"
29-Jan-2023,IMPS,"9,098.70",00.00,"114,719.60"
29-Jan-2023,RTGS,08.00,00.00,"114,727.60"
29-Jan-2023,Interest,00.00,"11,472.76","103,254.84"
29-Jan-2023,ATM,05.00,00.00,"103,259.84"
29-Jan-2023,Debit Card,00.00,"10,325.98","92,933.86"
29-Jan-2023,Cheque,00.00,"23,233.47","69,700.40"
29-Jan-2023,Cash,"31,624.37",00.00,"101,324.77"
29-Jan-2023,IMPS,00.00,"16,887.46","84,437.31"
29-Jan-2023,Purchase,00.00,"8,443.73","75,993.58"
29-Jan-2023,Bill,00.00,"10,856.23","65,137.35"
29-Jan-2023,Cash,00.00,"13,027.47","52,109.88"
29-Jan-2023,Transfer,00.40,00.00,"52,110.28"
29-Jan-2023,Miscellaneous,31.00,00.00,"52,141.28"
29-Jan-2023,Reversal,00.00,"5,214.13","46,927.15"
29-Jan-2023,NEFT,00.00,"6,703.88","40,223.27"
30-Jan-2023,Bill,00.00,"4,022.33","36,200.94"
30-Jan-2023,Cash,"17,442.36",00.00,"53,643.30"
30-Jan-2023,Transfer,00.00,"10,728.66","42,914.64"
30-Jan-2023,Miscellaneous,00.00,"4,768.29","38,146.35"
30-Jan-2023,Tax,"165,848.00",00.00,"203,994.35"
30-Jan-2023,ATM,00.00,"33,999.06","169,995.29"
30-Jan-2023,RTGS,00.00,"56,665.10","113,330.19"
30-Jan-2023,RTGS,00.50,00.00,"113,330.69"
30-Jan-2023,Tax,06.00,00.00,"113,336.69"
30-Jan-2023,Cash,"126,285.00",00.00,"239,621.69"
30-Jan-2023,Cheque,"190,558.09",00.00,"430,179.78"
30-Jan-2023,ATM,"109,191.80",00.00,"539,371.58"
30-Jan-2023,IMPS,00.00,"107,874.32","431,497.26"
30-Jan-2023,ATM,"1,809,944.00",00.00,"2,241,441.26"
30-Jan-2023,Reversal,00.00,"747,147.09","1,494,294.17"
30-Jan-2023,Purchase,23.80,00.00,"1,494,317.97"
30-Jan-2023,Cash,"4,044.77",00.00,"1,498,362.74"
30-Jan-2023,RTGS,00.00,"166,484.75","1,331,877.99"
30-Jan-2023,RTGS,00.00,"665,939.00","665,939.00"
30-Jan-2023,NEFT,"1,754,132.00",00.00,"2,420,071.00"
30-Jan-2023,Bill,20.00,00.00,"2,420,091.00"
30-Jan-2023,IMPS,00.00,"806,697.00","1,613,394.00"
30-Jan-2023,Cash,00.00,"1,613,394.00",00.00
30-Jan-2023,NEFT,07.00,00.00,07.00
30-Jan-2023,Commission,"137,574.00",00.00,"137,581.00"
30-Jan-2023,Tax,"1,565.10",00.00,"139,146.10"
31-Jan-2023,Transfer,00.00,"27,829.22","111,316.88"
31-Jan-2023,Interest,"244,813.31",00.00,"356,130.19"
31-Jan-2023,Cheque,00.00,"39,570.02","316,560.17"
31-Jan-2023,Cash,00.00,"31,656.02","284,904.15"
31-Jan-2023,Purchase,"4,046.20",00.00,"288,950.35"
31-Jan-2023,Interest,"37,126.00",00.00,"326,076.35"
31-Jan-2023,IMPS,00.00,"46,582.34","279,494.01"
31-Jan-2023,IMPS,00.00,"46,582.34","232,911.68"
01-Feb-2023,Reversal,"2,976.40",00.00,"235,888.08"
01-Feb-2023,Cheque,00.00,"26,209.79","209,678.29"
01-Feb-2023,Interest,00.00,"20,967.83","188,710.46"
01-Feb-2023,Cash,00.00,"62,903.49","125,806.97"
01-Feb-2023,Miscellaneous,00.00,"62,903.49","62,903.48"
01-Feb-2023,NEFT,14.00,00.00,"62,917.48"
01-Feb-2023,Cash,07.00,00.00,"62,924.48"
01-Feb-2023,Debit Card,16.76,00.00,"62,941.24"
01-Feb-2023,Cash,00.00,"15,735.31","47,205.93"
01-Feb-2023,IMPS,00.00,"5,245.10","41,960.83"
01-Feb-2023,Interest,00.00,"10,490.21","31,470.62"
01-Feb-2023,RTGS,00.00,"3,147.06","28,323.56"
01-Feb-2023,Commission,00.00,"9,441.19","18,882.37"
01-Feb-2023,IMPS,00.00,"3,776.47","15,105.90"
01-Feb-2023,Miscellaneous,00.12,00.00,"15,106.02"
01-Feb-2023,Reversal,00.00,"1,510.60","13,595.42"
02-Feb-2023,IMPS,00.00,"1,510.60","12,084.82"
02-Feb-2023,Tax,38.20,00.00,"12,123.02"
02-Feb-2023,Bill,00.00,"2,424.60","9,698.42"
02-Feb-2023,Debit Card,504.20,00.00,"10,202.62"
02-Feb-2023,ATM,"11,937.00",00.00,"22,139.62"
02-Feb-2023,Commission,00.00,"2,213.96","19,925.66"
02-Feb-2023,Transfer,00.00,"19,925.66",00.00
02-Feb-2023,Interest,22.00,00.00,22.00
02-Feb-2023,Cash,00.00,02.20,19.80
02-Feb-2023,RTGS,"3,926.00",00.00,"3,945.80"
02-Feb-2023,Miscellaneous,00.00,438.42,"3,507.38"
02-Feb-2023,ATM,00.00,701.48,"2,805.90"
02-Feb-2023,Commission,00.00,"1,402.95","1,402.95"
02-Feb-2023,Bill,00.00,467.65,935.30
02-Feb-2023,Reversal,09.63,00.00,944.93
02-Feb-2023,Miscellaneous,26.00,00.00,970.93
03-Feb-2023,Miscellaneous,"31,235.00",00.00,"32,205.93"
03-Feb-2023,Cash,"54,168.50",00.00,"86,374.43"
03-Feb-2023,Interest,"18,768.00",00.00,"105,142.43"
03-Feb-2023,Purchase,"23,935.30",00.00,"129,077.73"
03-Feb-2023,IMPS,00.00,"64,538.87","64,538.86"
03-Feb-2023,Debit Card,00.00,"6,453.89","58,084.97"
03-Feb-2023,ATM,"1,982,867.25",00.00,"2,040,952.22"
03-Feb-2023,ATM,00.00,"2,040,952.22",00.00
03-Feb-2023,Debit Card,"44,833.00",00.00,"44,833.00"
03-Feb-2023,Cash,"5,027.70",00.00,"49,860.70"
03-Feb-2023,ATM,"2,674.90",00.00,"52,535.60"
03-Feb-2023,Cash,00.00,"8,755.93","43,779.67"
03-Feb-2023,Interest,00.00,"10,944.92","32,834.75"
03-Feb-2023,Miscellaneous,00.00,"16,417.38","16,417.38"
04-Feb-2023,Interest,"41,367.20",00.00,"57,784.58"
05-Feb-2023,IMPS,"1,286.10",00.00,"59,070.68"
06-Feb-2023,Commission,00.00,"7,383.84","51,686.84"
06-Feb-2023,Tax,08.00,00.00,"51,694.84"
06-Feb-2023,Reversal,"16,393.00",00.00,"68,087.84"
06-Feb-2023,IMPS,"1,791,550.00",00.00,"1,859,637.84"
06-Feb-2023,NEFT,"2,373.00",00.00,"1,862,010.84"
06-Feb-2023,Interest,63.00,00.00,"1,862,073.84"
06-Feb-2023,Bill,00.00,"232,759.23","1,629,314.61"
06-Feb-2023,RTGS,00.00,"232,759.23","1,396,555.38"
06-Feb-2023,Interest,00.00,"1,396,555.38",00.00
06-Feb-2023,Purchase,02.09,00.00,02.09
06-Feb-2023,NEFT,48.10,00.00,50.19
06-Feb-2023,Transfer,06.07,00.00,56.26
06-Feb-2023,Bill,00.00,08.04,48.22
06-Feb-2023,Bill,00.00,48.22,00.00
06-Feb-2023,Cheque,"34,384.70",00.00,"34,384.70"
06-Feb-2023,Miscellaneous,500.88,00.00,"34,885.58"
06-Feb-2023,Transfer,00.00,"3,876.18","31,009.40"
06-Feb-2023,Interest,00.00,"10,336.47","20,672.93"
06-Feb-2023,RTGS,"9,578.10",00.00,"30,251.03"
06-Feb-2023,RTGS,358.40,00.00,"30,609.43"
06-Feb-2023,NEFT,"3,290.00",00.00,"33,899.43"
06-Feb-2023,Commission,00.00,"3,389.94","30,509.49"
06-Feb-2023,Interest,"174,501.00",00.00,"205,010.49"
06-Feb-2023,IMPS,00.00,"68,336.83","136,673.66"
06-Feb-2023,Debit Card,00.00,"22,778.94","113,894.72"
06-Feb-2023,Debit Card,00.00,"56,947.36","56,947.36"
06-Feb-2023,Bill,133.40,00.00,"57,080.76"
06-Feb-2023,Commission,00.00,"14,270.19","42,810.57"
06-Feb-2023,RTGS,00.00,"8,562.11","34,248.46"
06-Feb-2023,Miscellaneous,00.00,"4,281.06","29,967.40"
06-Feb-2023,RTGS,00.00,"14,983.70","14,983.70"
06-Feb-2023,Bill,"195,905.40",00.00,"210,889.10"
06-Feb-2023,Tax,00.00,"26,361.14","184,527.96"
06-Feb-2023,Miscellaneous,40.90,00.00,"184,568.86"
06-Feb-2023,ATM,00.00,"184,568.86",00.00
07-Feb-2023,Tax,04.90,00.00,04.90
07-Feb-2023,IMPS,"238,666.22",00.00,"238,671.12"
07-Feb-2023,Commission,00.00,"34,095.87","204,575.25"
07-Feb-2023,IMPS,00.00,"29,225.04","175,350.21"
07-Feb-2023,Interest,00.50,00.00,"175,350.71"
07-Feb-2023,Purchase,02.00,00.00,"175,352.71"
07-Feb-2023,Bill,303.60,00.00,"175,656.31"
07-Feb-2023,Reversal,"9,014.90",00.00,"184,671.21"
07-Feb-2023,Tax,00.00,"26,381.60","158,289.61"
07-Feb-2023,RTGS,"2,086.40",00.00,"160,376.01"
07-Feb-2023,Cash,02.00,00.00,"160,378.01"
07-Feb-2023,Bill,"736,285.25",00.00,"896,663.26"
07-Feb-2023,Debit Card,61.75,00.00,"896,725.01"
07-Feb-2023,Reversal,01.12,00.00,"896,726.13"
07-Feb-2023,Interest,00.00,"896,726.13",00.00
07-Feb-2023,Bill,"27,685.00",00.00,"27,685.00"
07-Feb-2023,Reversal,"3,819.00",00.00,"31,504.00"
07-Feb-2023,Bill,00.00,"3,150.40","28,353.60"
08-Feb-2023,Transfer,19.32,00.00,"28,372.92"
08-Feb-2023,Reversal,"1,704,131.20",00.00,"1,732,504.12"
08-Feb-2023,IMPS,"132,502.00",00.00,"1,865,006.12"
09-Feb-2023,Cheque,"186,218.00",00.00,"2,051,224.12"
09-Feb-2023,NEFT,"2,063.00",00.00,"2,053,287.12"
09-Feb-2023,Bill,07.00,00.00,"2,053,294.12"
09-Feb-2023,Cash,296.70,00.00,"2,053,590.82"
09-Feb-2023,Interest,00.00,"684,530.27","1,369,060.55"
09-Feb-2023,NEFT,00.00,"684,530.28","684,530.28"
09-Feb-2023,Transfer,06.30,00.00,"684,536.58"
09-Feb-2023,IMPS,00.00,"68,453.66","616,082.92"
09-Feb-2023,Interest,"144,899.00",00.00,"760,981.92"
09-Feb-2023,IMPS,26.92,00.00,"761,008.84"
09-Feb-2023,IMPS,00.00,"95,126.11","665,882.74"
09-Feb-2023,Reversal,"1,662.00",00.00,"667,544.74"
09-Feb-2023,Debit Card,00.00,"95,363.53","572,181.21"
09-Feb-2023,Commission,428.00,00.00,"572,609.21"
09-Feb-2023,Transfer,00.00,"190,869.74","381,739.47"
09-Feb-2023,ATM,00.00,"38,173.95","343,565.52"
09-Feb-2023,Interest,251.00,00.00,"343,816.52"
09-Feb-2023,Cash,06.00,00.00,"343,822.52"
09-Feb-2023,RTGS,00.00,"171,911.26","171,911.26"
09-Feb-2023,Reversal,00.00,"17,191.13","154,720.13"
09-Feb-2023,IMPS,"921,583.75",00.00,"1,076,303.88"
09-Feb-2023,Commission,00.00,"179,383.98","896,919.90"
09-Feb-2023,ATM,00.00,"149,486.65","747,433.25"
09-Feb-2023,ATM,"31,546.00",00.00,"778,979.25"
09-Feb-2023,NEFT,"157,220.00",00.00,"936,199.25"
09-Feb-2023,Debit Card,00.00,"187,239.85","748,959.40"
09-Feb-2023,Miscellaneous,"4,016.00",00.00,"752,975.40"
09-Feb-2023,RTGS,01.42,00.00,"752,976.82"
09-Feb-2023,Cheque,"111,838.70",00.00,"864,815.52"
09-Feb-2023,Purchase,00.00,"86,481.55","778,333.97"
09-Feb-2023,NEFT,00.00,"389,166.99","389,166.98"
09-Feb-2023,Miscellaneous,00.00,"55,595.28","333,571.70"
09-Feb-2023,Interest,00.00,"111,190.57","222,381.13"
09-Feb-2023,RTGS,138.00,00.00,"222,519.13"
10-Feb-2023,Transfer,"9,406.00",00.00,"231,925.13"
10-Feb-2023,Miscellaneous,00.00,"38,654.19","193,270.94"
10-Feb-2023,IMPS,00.00,"32,211.82","161,059.12"
10-Feb-2023,RTGS,04.50,00.00,"161,063.62"
10-Feb-2023,Miscellaneous,00.00,"20,132.95","140,930.67"
10-Feb-2023,Cash,382.00,00.00,"141,312.67"
10-Feb-2023,Tax,00.00,"15,701.41","125,611.26"
10-Feb-2023,Purchase,00.00,"125,611.26",00.00
10-Feb-2023,Cheque,"1,051,140.20",00.00,"1,051,140.20"
10-Feb-2023,Tax,"25,851.00",00.00,"1,076,991.20"
10-Feb-2023,RTGS,"2,047,105.75",00.00,"3,124,096.95"
10-Feb-2023,Purchase,"42,820.90",00.00,"3,166,917.85"
10-Feb-2023,NEFT,00.00,"633,383.57","2,533,534.28"
10-Feb-2023,Bill,00.00,"2,533,534.28",00.00
10-Feb-2023,Transfer,"14,390.00",00.00,"14,390.00"
10-Feb-2023,Interest,"89,284.30",00.00,"103,674.30"
10-Feb-2023,Commission,"8,508.00",00.00,"112,182.30"
10-Feb-2023,Cash,00.00,"37,394.10","74,788.20"
10-Feb-2023,Reversal,12.00,00.00,"74,800.20"
10-Feb-2023,Bill,06.00,00.00,"74,806.20"
10-Feb-2023,Tax,"1,066,829.20",00.00,"1,141,635.40"
10-Feb-2023,Reversal,"6,383.00",00.00,"1,148,018.40"
10-Feb-2023,Miscellaneous,62.00,00.00,"1,148,080.40"
10-Feb-2023,Commission,15.00,00.00,"1,148,095.40"
10-Feb-2023,NEFT,"941,648.25",00.00,"2,089,743.65"
10-Feb-2023,Debit Card,00.00,"1,044,871.83","1,044,871.82"
10-Feb-2023,Cash,00.00,"116,096.87","928,774.95"
10-Feb-2023,Cheque,00.00,"232,193.74","696,581.21"
10-Feb-2023,Tax,00.00,"174,145.30","522,435.91"
10-Feb-2023,Reversal,"1,502.00",00.00,"523,937.91"
10-Feb-2023,Commission,00.00,"65,492.24","458,445.67"
10-Feb-2023,Bill,00.00,"91,689.13","366,756.54"
10-Feb-2023,Purchase,00.00,"122,252.18","244,504.36"
10-Feb-2023,Debit Card,"99,173.00",00.00,"343,677.36"
10-Feb-2023,Transfer,00.00,"34,367.74","309,309.62"
10-Feb-2023,RTGS,00.00,"103,103.21","206,206.41"
10-Feb-2023,Debit Card,07.00,00.00,"206,213.41"
10-Feb-2023,RTGS,00.00,"22,912.60","183,300.81"
10-Feb-2023,NEFT,00.00,"36,660.16","146,640.65"
10-Feb-2023,IMPS,02.06,00.00,"146,642.71"
10-Feb-2023,Debit Card,00.00,"14,664.27","131,978.44"
10-Feb-2023,Commission,"2,904.81",00.00,"134,883.25"
10-Feb-2023,Miscellaneous,00.00,"16,860.41","118,022.84"
10-Feb-2023,Bill,03.40,00.00,"118,026.24"
10-Feb-2023,Transfer,07.75,00.00,"118,033.99"
10-Feb-2023,Interest,36.08,00.00,"118,070.07"
10-Feb-2023,Debit Card,00.00,"13,118.90","104,951.17"
10-Feb-2023,IMPS,00.00,"34,983.72","69,967.45"
10-Feb-2023,Tax,"57,712.30",00.00,"127,679.75"
10-Feb-2023,Miscellaneous,00.00,"31,919.94","95,759.81"
10-Feb-2023,Commission,00.00,"15,959.97","79,799.84"
10-Feb-2023,RTGS,00.00,"15,959.97","63,839.87"
10-Feb-2023,Interest,484.56,00.00,"64,324.43"
10-Feb-2023,Transfer,"30,741.98",00.00,"95,066.41"
10-Feb-2023,Bill,00.00,00.00,"95,066.41"
10-Feb-2023,Cash,"1,196,368.50",00.00,"1,291,434.91"
10-Feb-2023,ATM,19.63,00.00,"1,291,454.54"
10-Feb-2023,Purchase,00.00,"161,431.82","1,130,022.72"
10-Feb-2023,NEFT,00.00,"1,130,022.72",00.00
10-Feb-2023,Cash,01.10,00.00,01.10
10-Feb-2023,Miscellaneous,00.00,00.28,00.82
10-Feb-2023,Miscellaneous,00.00,00.16,00.66
10-Feb-2023,Debit Card,00.00,00.22,00.44
10-Feb-2023,IMPS,"2,268.00",00.00,"2,268.44"
10-Feb-2023,Miscellaneous,00.00,567.11,"1,701.33"
10-Feb-2023,Interest,"1,870.00",00.00,"3,571.33"
10-Feb-2023,Cash,"11,674.68",00.00,"15,246.01"
10-Feb-2023,Miscellaneous,00.00,"3,811.50","11,434.51"
10-Feb-2023,NEFT,"218,390.20",00.00,"229,824.71"
10-Feb-2023,IMPS,"241,197.38",00.00,"471,022.09"
11-Feb-2023,ATM,08.00,00.00,"471,030.09"
11-Feb-2023,Cash,"3,327.20",00.00,"474,357.29"
11-Feb-2023,ATM,00.00,"59,294.66","415,062.63"
11-Feb-2023,Debit Card,00.00,"69,177.11","345,885.52"
11-Feb-2023,RTGS,35.90,00.00,"345,921.42"
11-Feb-2023,Reversal,"97,690.94",00.00,"443,612.36"
11-Feb-2023,Miscellaneous,00.00,"73,935.39","369,676.97"
11-Feb-2023,IMPS,"3,564.60",00.00,"373,241.57"
11-Feb-2023,Commission,32.00,00.00,"373,273.57"
11-Feb-2023,Transfer,"422,610.50",00.00,"795,884.07"
11-Feb-2023,Commission,00.00,"88,431.56","707,452.51"
11-Feb-2023,IMPS,00.40,00.00,"707,452.91"
11-Feb-2023,Miscellaneous,00.00,"353,726.46","353,726.46"
11-Feb-2023,NEFT,"2,718.21",00.00,"356,444.67"
11-Feb-2023,ATM,319.20,00.00,"356,763.87"
11-Feb-2023,NEFT,411.67,00.00,"357,175.54"
11-Feb-2023,Cheque,00.00,"71,435.11","285,740.43"
11-Feb-2023,Tax,00.00,"31,748.94","253,991.49"
11-Feb-2023,Tax,00.00,"63,497.87","190,493.62"
11-Feb-2023,Cash,00.00,"38,098.72","152,394.90"
12-Feb-2023,Bill,00.00,"19,049.36","133,345.54"
12-Feb-2023,IMPS,"31,530.10",00.00,"164,875.64"
12-Feb-2023,Tax,00.00,"23,553.66","141,321.98"
12-Feb-2023,Commission,00.00,"20,188.85","121,133.13"
12-Feb-2023,Cash,"71,286.10",00.00,"192,419.23"
12-Feb-2023,Purchase,00.00,"192,419.23",00.00
12-Feb-2023,Miscellaneous,38.80,00.00,38.80
12-Feb-2023,Bill,31.00,00.00,69.80
12-Feb-2023,Cash,"14,039.10",00.00,"14,108.90"
12-Feb-2023,Tax,00.00,"4,702.97","9,405.93"
12-Feb-2023,Debit Card,"861,769.00",00.00,"871,174.93"
12-Feb-2023,Interest,00.00,"96,797.21","774,377.72"
12-Feb-2023,IMPS,"145,935.00",00.00,"920,312.72"
12-Feb-2023,Bill,00.00,"184,062.54","736,250.18"
13-Feb-2023,Debit Card,07.00,00.00,"736,257.18"
13-Feb-2023,NEFT,00.00,"73,625.72","662,631.46"
13-Feb-2023,Interest,00.00,"220,877.15","441,754.31"
13-Feb-2023,Cheque,"24,712.70",00.00,"466,467.01"
13-Feb-2023,Interest,"28,319.70",00.00,"494,786.71"
13-Feb-2023,Debit Card,00.00,"247,393.36","247,393.36"
13-Feb-2023,Reversal,01.00,00.00,"247,394.36"
13-Feb-2023,IMPS,00.00,"24,739.44","222,654.92"
14-Feb-2023,Miscellaneous,00.00,"24,739.44","197,915.48"
14-Feb-2023,NEFT,00.00,"197,915.48",00.00
14-Feb-2023,Transfer,"1,748,047.80",00.00,"1,748,047.80"
14-Feb-2023,Bill,"251,256.70",00.00,"1,999,304.50"
14-Feb-2023,Interest,00.00,"666,434.83","1,332,869.67"
14-Feb-2023,RTGS,03.00,00.00,"1,332,872.67"
14-Feb-2023,Cheque,00.00,"1,332,872.67",00.00
14-Feb-2023,RTGS,35.00,00.00,35.00
14-Feb-2023,NEFT,00.00,08.75,26.25
14-Feb-2023,Purchase,"9,310.91",00.00,"9,337.16"
14-Feb-2023,Transfer,00.00,"1,167.15","8,170.02"
14-Feb-2023,RTGS,00.00,"1,361.67","6,808.35"
14-Feb-2023,Tax,12.70,00.00,"6,821.05"
14-Feb-2023,NEFT,00.00,852.63,"5,968.42"
14-Feb-2023,IMPS,00.00,852.63,"5,115.79"
14-Feb-2023,Commission,00.00,730.83,"4,384.96"
14-Feb-2023,IMPS,00.00,730.83,"3,654.13"
14-Feb-2023,IMPS,00.00,"1,218.04","2,436.09"
14-Feb-2023,Interest,"3,862.43",00.00,"6,298.52"
14-Feb-2023,IMPS,41.00,00.00,"6,339.52"
14-Feb-2023,RTGS,181.00,00.00,"6,520.52"
14-Feb-2023,IMPS,17.00,00.00,"6,537.52"
14-Feb-2023,IMPS,00.00,"1,089.59","5,447.93"
14-Feb-2023,Bill,00.00,544.79,"4,903.14"
14-Feb-2023,Tax,"3,746.20",00.00,"8,649.34"
14-Feb-2023,Cheque,50.95,00.00,"8,700.29"
14-Feb-2023,RTGS,00.00,"1,242.90","7,457.39"
14-Feb-2023,Miscellaneous,164.00,00.00,"7,621.39"
14-Feb-2023,ATM,00.00,952.67,"6,668.72"
14-Feb-2023,Miscellaneous,340.00,00.00,"7,008.72"
14-Feb-2023,Miscellaneous,"122,555.00",00.00,"129,563.72"
14-Feb-2023,ATM,"5,758.04",00.00,"135,321.76"
15-Feb-2023,Commission,00.00,"13,532.18","121,789.58"
15-Feb-2023,Purchase,00.00,"60,894.79","60,894.79"
15-Feb-2023,Interest,00.00,"15,223.70","45,671.09"
15-Feb-2023,NEFT,514.00,00.00,"46,185.09"
15-Feb-2023,Cheque,06.00,00.00,"46,191.09"
15-Feb-2023,NEFT,00.00,"6,598.73","39,592.36"
15-Feb-2023,IMPS,"1,188,251.00",00.00,"1,227,843.36"
16-Feb-2023,Cash,00.00,"245,568.67","982,274.69"
16-Feb-2023,Commission,00.00,"140,324.96","841,949.73"
16-Feb-2023,Tax,00.00,"93,549.97","748,399.76"
16-Feb-2023,NEFT,00.00,"106,914.25","641,485.51"
16-Feb-2023,Interest,"25,621.00",00.00,"667,106.51"
16-Feb-2023,Interest,336.00,00.00,"667,442.51"
16-Feb-2023,Cheque,00.00,"166,860.63","500,581.88"
16-Feb-2023,Commission,00.00,"250,290.94","250,290.94"
16-Feb-2023,Transfer,00.00,"83,430.31","166,860.63"
16-Feb-2023,Reversal,"2,858.00",00.00,"169,718.63"
16-Feb-2023,Commission,00.00,"42,429.66","127,288.97"
16-Feb-2023,Cheque,00.00,"18,184.14","109,104.83"
16-Feb-2023,Commission,138.40,00.00,"109,243.23"
16-Feb-2023,Cheque,"13,414.00",00.00,"122,657.23"
16-Feb-2023,Cheque,06.00,00.00,"122,663.23"
16-Feb-2023,Transfer,06.00,00.00,"122,669.23"
16-Feb-2023,ATM,702.10,00.00,"123,371.33"
16-Feb-2023,RTGS,339.00,00.00,"123,710.33"
17-Feb-2023,NEFT,393.00,00.00,"124,103.33"
17-Feb-2023,RTGS,00.00,"24,820.67","99,282.66"
17-Feb-2023,ATM,"1,721,567.50",00.00,"1,820,850.16"
17-Feb-2023,Cheque,"2,027,295.00",00.00,"3,848,145.16"
17-Feb-2023,Cash,00.00,"1,924,072.58","1,924,072.58"
17-Feb-2023,Reversal,02.00,00.00,"1,924,074.58"
17-Feb-2023,Cash,00.00,"240,509.32","1,683,565.26"
17-Feb-2023,ATM,01.00,00.00,"1,683,566.26"
17-Feb-2023,Reversal,69.00,00.00,"1,683,635.26"
17-Feb-2023,Reversal,00.00,"336,727.05","1,346,908.21"
17-Feb-2023,Debit Card,00.00,"134,690.82","1,212,217.39"
17-Feb-2023,Cheque,302.00,00.00,"1,212,519.39"
17-Feb-2023,Purchase,"157,595.88",00.00,"1,370,115.27"
17-Feb-2023,Purchase,05.90,00.00,"1,370,121.17"
17-Feb-2023,NEFT,00.00,"342,530.29","1,027,590.88"
17-Feb-2023,Cheque,00.00,"1,027,590.88",00.00
17-Feb-2023,Bill,467.84,00.00,467.84
17-Feb-2023,Debit Card,00.00,93.57,374.27
17-Feb-2023,Interest,"9,210.00",00.00,"9,584.27"
17-Feb-2023,Bill,404.60,00.00,"9,988.87"
17-Feb-2023,Miscellaneous,00.00,"2,497.22","7,491.65"
17-Feb-2023,Cash,"1,004,025.00",00.00,"1,011,516.65"
17-Feb-2023,Commission,"14,216.10",00.00,"1,025,732.75"
17-Feb-2023,IMPS,00.00,"113,970.31","911,762.44"
17-Feb-2023,Tax,"1,617,760.00",00.00,"2,529,522.44"
17-Feb-2023,NEFT,"9,804.20",00.00,"2,539,326.64"
17-Feb-2023,Tax,462.00,00.00,"2,539,788.64"
17-Feb-2023,Bill,"86,498.16",00.00,"2,626,286.80"
17-Feb-2023,Purchase,"3,260.40",00.00,"2,629,547.20"
17-Feb-2023,Cheque,00.00,"2,629,547.20",00.00
17-Feb-2023,Cheque,"1,799.90",00.00,"1,799.90"
17-Feb-2023,IMPS,00.00,199.99,"1,599.91"
17-Feb-2023,Purchase,00.00,228.56,"1,371.35"
17-Feb-2023,Cash,"1,189.53",00.00,"2,560.88"
17-Feb-2023,Tax,00.00,"2,560.88",00.00
17-Feb-2023,Cheque,"7,226.86",00.00,"7,226.86"
17-Feb-2023,Cash,00.00,"1,806.72","5,420.14"
17-Feb-2023,Cash,00.00,"1,355.04","4,065.11"
17-Feb-2023,Purchase,00.00,"1,355.04","2,710.07"
17-Feb-2023,Reversal,00.00,338.76,"2,371.31"
17-Feb-2023,Transfer,00.00,338.76,"2,032.55"
17-Feb-2023,ATM,53.50,00.00,"2,086.05"
17-Feb-2023,Commission,00.60,00.00,"2,086.65"
17-Feb-2023,IMPS,00.00,260.83,"1,825.82"
17-Feb-2023,Reversal,"30,778.86",00.00,"32,604.68"
17-Feb-2023,Bill,"1,356.90",00.00,"33,961.58"
17-Feb-2023,Reversal,05.40,00.00,"33,966.98"
17-Feb-2023,Commission,00.00,"11,322.33","22,644.65"
17-Feb-2023,Miscellaneous,00.00,"7,548.22","15,096.43"
17-Feb-2023,Cash,00.00,"2,156.63","12,939.80"
17-Feb-2023,IMPS,00.00,"1,437.76","11,502.04"
17-Feb-2023,Transfer,"92,080.00",00.00,"103,582.04"
17-Feb-2023,Tax,"1,059,693.00",00.00,"1,163,275.04"
17-Feb-2023,Transfer,00.00,"232,655.01","930,620.03"
17-Feb-2023,Transfer,"1,217.48",00.00,"931,837.51"
17-Feb-2023,IMPS,00.00,"133,119.64","798,717.87"
17-Feb-2023,Tax,06.00,00.00,"798,723.87"
17-Feb-2023,Miscellaneous,"21,000.60",00.00,"819,724.47"
17-Feb-2023,Commission,02.24,00.00,"819,726.71"
17-Feb-2023,Reversal,00.00,"91,080.75","728,645.96"
17-Feb-2023,Purchase,191.90,00.00,"728,837.86"
17-Feb-2023,NEFT,00.00,"364,418.93","364,418.93"
18-Feb-2023,Cheque,00.00,"36,441.89","327,977.04"
18-Feb-2023,Transfer,18.20,00.00,"327,995.24"
18-Feb-2023,Tax,00.00,"163,997.62","163,997.62"
18-Feb-2023,Debit Card,"99,369.80",00.00,"263,367.42"
18-Feb-2023,Transfer,"1,312,656.00",00.00,"1,576,023.42"
18-Feb-2023,Transfer,"72,393.91",00.00,"1,648,417.33"
18-Feb-2023,Purchase,47.00,00.00,"1,648,464.33"
18-Feb-2023,NEFT,00.00,"412,116.08","1,236,348.25"
18-Feb-2023,RTGS,"1,257,098.50",00.00,"2,493,446.75"
18-Feb-2023,RTGS,"25,852.29",00.00,"2,519,299.04"
18-Feb-2023,Tax,246.00,00.00,"2,519,545.04"
18-Feb-2023,RTGS,00.00,"629,886.26","1,889,658.78"
18-Feb-2023,Cheque,183.60,00.00,"1,889,842.38"
18-Feb-2023,Commission,00.00,"209,982.49","1,679,859.89"
18-Feb-2023,ATM,00.00,"335,971.98","1,343,887.91"
18-Feb-2023,Debit Card,00.00,"1,343,887.91",00.00
18-Feb-2023,Miscellaneous,"25,196.10",00.00,"25,196.10"
18-Feb-2023,Tax,00.00,"25,196.10",00.00
18-Feb-2023,Bill,304.20,00.00,304.20
18-Feb-2023,Interest,"30,199.00",00.00,"30,503.20"
18-Feb-2023,ATM,107.00,00.00,"30,610.20"
18-Feb-2023,Interest,00.00,"30,610.20",00.00
18-Feb-2023,Transfer,31.00,00.00,31.00
18-Feb-2023,IMPS,00.00,04.43,26.57
18-Feb-2023,IMPS,"1,664,694.00",00.00,"1,664,720.57"
18-Feb-2023,Commission,00.00,"554,906.86","1,109,813.71"
18-Feb-2023,Tax,08.30,00.00,"1,109,822.01"
18-Feb-2023,Miscellaneous,217.60,00.00,"1,110,039.61"
18-Feb-2023,Miscellaneous,79.00,00.00,"1,110,118.61"
18-Feb-2023,Bill,06.10,00.00,"1,110,124.71"
18-Feb-2023,Commission,"130,447.40",00.00,"1,240,572.11"
18-Feb-2023,IMPS,00.00,"155,071.51","1,085,500.60"
18-Feb-2023,Reversal,"78,097.56",00.00,"1,163,598.16"
18-Feb-2023,NEFT,00.00,"166,228.31","997,369.85"
18-Feb-2023,RTGS,00.00,"997,369.85",00.00
18-Feb-2023,IMPS,27.80,00.00,27.80
18-Feb-2023,Cheque,00.00,05.56,22.24
18-Feb-2023,Tax,"1,852,903.20",00.00,"1,852,925.44"
19-Feb-2023,Interest,00.00,"1,852,925.44",00.00
19-Feb-2023,ATM,05.00,00.00,05.00
19-Feb-2023,Miscellaneous,03.71,00.00,08.71
19-Feb-2023,Reversal,00.00,08.71,00.00
19-Feb-2023,Tax,"821,372.00",00.00,"821,372.00"
20-Feb-2023,Cash,"19,407.12",00.00,"840,779.12"
20-Feb-2023,Tax,00.00,"140,129.85","700,649.27"
20-Feb-2023,Cheque,00.00,"87,581.16","613,068.11"
20-Feb-2023,Debit Card,"228,685.00",00.00,"841,753.11"
20-Feb-2023,Transfer,"194,111.34",00.00,"1,035,864.45"
20-Feb-2023,ATM,00.00,"258,966.11","776,898.34"
20-Feb-2023,RTGS,95.20,00.00,"776,993.54"
20-Feb-2023,ATM,00.00,"97,124.19","679,869.35"
20-Feb-2023,Transfer,"1,254,605.80",00.00,"1,934,475.15"
20-Feb-2023,Cheque,00.00,"967,237.58","967,237.58"
20-Feb-2023,Cash,48.20,00.00,"967,285.78"
20-Feb-2023,Bill,35.69,00.00,"967,321.47"
20-Feb-2023,Cheque,00.00,"967,321.47",00.00
20-Feb-2023,Purchase,29.00,00.00,29.00
20-Feb-2023,IMPS,"9,716.00",00.00,"9,745.00"
20-Feb-2023,Cash,"159,805.00",00.00,"169,550.00"
20-Feb-2023,Transfer,00.00,"33,910.00","135,640.00"
20-Feb-2023,Interest,"582,441.50",00.00,"718,081.50"
20-Feb-2023,Bill,"203,771.00",00.00,"921,852.50"
20-Feb-2023,Cheque,00.00,"92,185.25","829,667.25"
20-Feb-2023,Debit Card,"169,504.84",00.00,"999,172.09"
20-Feb-2023,ATM,"7,812.00",00.00,"1,006,984.09"
20-Feb-2023,Reversal,"1,544,540.00",00.00,"2,551,524.09"
20-Feb-2023,Bill,00.00,"2,551,524.09",00.00
20-Feb-2023,Commission,01.60,00.00,01.60
20-Feb-2023,Purchase,00.00,00.80,00.80
20-Feb-2023,Tax,06.34,00.00,07.14
20-Feb-2023,Bill,07.60,00.00,14.74
20-Feb-2023,Transfer,"597,068.80",00.00,"597,083.54"
20-Feb-2023,Bill,05.00,00.00,"597,088.54"
20-Feb-2023,Commission,00.00,"298,544.27","298,544.27"
20-Feb-2023,Tax,"267,604.00",00.00,"566,148.27"
20-Feb-2023,Commission,00.00,"113,229.65","452,918.62"
20-Feb-2023,Cash,"76,282.69",00.00,"529,201.31"
20-Feb-2023,Miscellaneous,00.00,"529,201.31",00.00
20-Feb-2023,RTGS,"253,575.88",00.00,"253,575.88"
21-Feb-2023,Commission,00.00,"253,575.88",00.00
21-Feb-2023,Cash,42.53,00.00,42.53
21-Feb-2023,Transfer,"1,645.00",00.00,"1,687.53"
21-Feb-2023,Bill,"85,273.00",00.00,"86,960.53"
21-Feb-2023,Commission,428.00,00.00,"87,388.53"
21-Feb-2023,Interest,00.00,"21,847.13","65,541.40"
21-Feb-2023,Miscellaneous,"24,841.00",00.00,"90,382.40"
21-Feb-2023,Cash,00.10,00.00,"90,382.50"
21-Feb-2023,Cheque,19.30,00.00,"90,401.80"
21-Feb-2023,Cash,00.00,"11,300.23","79,101.58"
21-Feb-2023,Commission,00.00,"11,300.23","67,801.35"
21-Feb-2023,RTGS,"9,483.00",00.00,"77,284.35"
21-Feb-2023,Reversal,"1,312.00",00.00,"78,596.35"
21-Feb-2023,Cheque,00.00,"19,649.09","58,947.26"
21-Feb-2023,Purchase,41.90,00.00,"58,989.16"
21-Feb-2023,Debit Card,03.00,00.00,"58,992.16"
22-Feb-2023,NEFT,"151,971.84",00.00,"210,964.00"
22-Feb-2023,Miscellaneous,"1,089,852.00",00.00,"1,300,816.00"
22-Feb-2023,Purchase,00.00,"433,605.33","867,210.67"
22-Feb-2023,Reversal,"30,733.00",00.00,"897,943.67"
22-Feb-2023,ATM,06.20,00.00,"897,949.87"
22-Feb-2023,Debit Card,00.00,"149,658.31","748,291.56"
22-Feb-2023,Commission,"1,580,311.25",00.00,"2,328,602.81"
22-Feb-2023,Miscellaneous,"19,679.50",00.00,"2,348,282.31"
22-Feb-2023,IMPS,00.00,"293,535.29","2,054,747.02"
22-Feb-2023,IMPS,00.00,"256,843.38","1,797,903.64"
22-Feb-2023,Miscellaneous,00.00,"179,790.36","1,618,113.28"
22-Feb-2023,Purchase,03.50,00.00,"1,618,116.78"
22-Feb-2023,IMPS,"1,294,840.00",00.00,"2,912,956.78"
22-Feb-2023,Transfer,"1,803.59",00.00,"2,914,760.37"
22-Feb-2023,Debit Card,334.00,00.00,"2,915,094.37"
22-Feb-2023,Transfer,"1,971.00",00.00,"2,917,065.37"
22-Feb-2023,RTGS,00.00,"364,633.17","2,552,432.20"
23-Feb-2023,NEFT,"21,217.63",00.00,"2,573,649.83"
23-Feb-2023,Transfer,"118,024.00",00.00,"2,691,673.83"
23-Feb-2023,RTGS,00.00,"897,224.61","1,794,449.22"
23-Feb-2023,Transfer,05.00,00.00,"1,794,454.22"
23-Feb-2023,Transfer,343.30,00.00,"1,794,797.52"
23-Feb-2023,Miscellaneous,"226,172.41",00.00,"2,020,969.93"
23-Feb-2023,Transfer,00.00,00.00,"2,020,969.93"
23-Feb-2023,Miscellaneous,00.00,"1,010,484.97","1,010,484.96"
23-Feb-2023,Tax,00.00,"202,096.99","808,387.97"
23-Feb-2023,Reversal,00.00,"808,387.97",00.00
23-Feb-2023,Commission,"3,765.80",00.00,"3,765.80"
23-Feb-2023,NEFT,00.00,376.58,"3,389.22"
23-Feb-2023,Bill,"69,179.00",00.00,"72,568.22"
23-Feb-2023,ATM,00.00,"36,284.11","36,284.11"
23-Feb-2023,Interest,322.00,00.00,"36,606.11"
23-Feb-2023,Purchase,00.00,"12,202.04","24,404.07"
23-Feb-2023,Interest,00.00,"2,711.56","21,692.51"
23-Feb-2023,Transfer,00.00,"21,692.51",00.00
23-Feb-2023,Cheque,31.00,00.00,31.00
23-Feb-2023,Cash,00.00,03.44,27.56
23-Feb-2023,Tax,00.00,05.51,22.05
23-Feb-2023,Miscellaneous,33.04,00.00,55.09
23-Feb-2023,RTGS,00.00,06.89,48.20
23-Feb-2023,Transfer,00.00,24.10,24.10
23-Feb-2023,Commission,"190,717.30",00.00,"190,741.40"
23-Feb-2023,Cheque,00.00,"190,741.40",00.00
23-Feb-2023,Transfer,00.60,00.00,00.60
23-Feb-2023,Commission,"224,418.00",00.00,"224,418.60"
23-Feb-2023,ATM,00.00,"28,052.33","196,366.28"
24-Feb-2023,Cash,119.05,00.00,"196,485.33"
24-Feb-2023,Cash,"344,047.00",00.00,"540,532.33"
24-Feb-2023,Bill,"2,817.00",00.00,"543,349.33"
24-Feb-2023,Bill,00.00,"543,349.33",00.00
24-Feb-2023,Debit Card,"21,467.00",00.00,"21,467.00"
24-Feb-2023,Purchase,54.90,00.00,"21,521.90"
24-Feb-2023,IMPS,00.00,"3,586.98","17,934.92"
24-Feb-2023,Purchase,00.00,"2,241.87","15,693.05"
24-Feb-2023,NEFT,00.00,"1,743.67","13,949.38"
24-Feb-2023,Debit Card,00.00,"1,394.94","12,554.44"
24-Feb-2023,Bill,19.60,00.00,"12,574.04"
24-Feb-2023,Cheque,"92,674.81",00.00,"105,248.85"
24-Feb-2023,NEFT,"353,982.20",00.00,"459,231.05"
24-Feb-2023,Transfer,00.00,"153,077.02","306,154.03"
24-Feb-2023,Transfer,"2,065,819.80",00.00,"2,371,973.83"
24-Feb-2023,ATM,"2,570.60",00.00,"2,374,544.43"
24-Feb-2023,IMPS,00.00,00.00,"2,374,544.43"
25-Feb-2023,Tax,27.41,00.00,"2,374,571.84"
25-Feb-2023,Interest,00.00,"395,761.97","1,978,809.87"
26-Feb-2023,IMPS,00.00,"989,404.94","989,404.94"
26-Feb-2023,Transfer,00.00,"123,675.62","865,729.32"
26-Feb-2023,Commission,03.00,00.00,"865,732.32"
26-Feb-2023,Transfer,144.00,00.00,"865,876.32"
26-Feb-2023,Miscellaneous,00.00,"173,175.26","692,701.06"
26-Feb-2023,Tax,00.00,"76,966.78","615,734.28"
26-Feb-2023,Miscellaneous,06.00,00.00,"615,740.28"
26-Feb-2023,Commission,"8,474.00",00.00,"624,214.28"
26-Feb-2023,Commission,00.00,"208,071.43","416,142.85"
26-Feb-2023,Transfer,00.00,"104,035.71","312,107.14"
26-Feb-2023,Interest,"25,775.40",00.00,"337,882.54"
27-Feb-2023,Miscellaneous,58.00,00.00,"337,940.54"
27-Feb-2023,Commission,00.00,"37,548.95","300,391.59"
27-Feb-2023,Bill,283.00,00.00,"300,674.59"
27-Feb-2023,Cash,"25,095.10",00.00,"325,769.69"
27-Feb-2023,Transfer,"129,099.34",00.00,"454,869.03"
27-Feb-2023,Debit Card,00.00,"56,858.63","398,010.40"
27-Feb-2023,ATM,23.80,00.00,"398,034.20"
27-Feb-2023,Tax,00.00,"49,754.28","348,279.92"
27-Feb-2023,Purchase,"1,214,766.00",00.00,"1,563,045.92"
27-Feb-2023,Debit Card,227.00,00.00,"1,563,272.92"
27-Feb-2023,Tax,347.69,00.00,"1,563,620.61"
27-Feb-2023,Tax,00.00,"312,724.12","1,250,896.49"
27-Feb-2023,Tax,"152,084.09",00.00,"1,402,980.58"
27-Feb-2023,IMPS,"33,229.80",00.00,"1,436,210.38"
27-Feb-2023,Reversal,00.00,"159,578.93","1,276,631.45"
27-Feb-2023,Miscellaneous,01.90,00.00,"1,276,633.35"
27-Feb-2023,Interest,15.00,00.00,"1,276,648.35"
27-Feb-2023,RTGS,00.00,"425,549.45","851,098.90"
27-Feb-2023,Interest,00.00,"85,109.89","765,989.01"
27-Feb-2023,Purchase,33.30,00.00,"766,022.31"
27-Feb-2023,Purchase,00.00,"766,022.31",00.00
27-Feb-2023,RTGS,58.10,00.00,58.10
27-Feb-2023,Cash,565.87,00.00,623.97
27-Feb-2023,Miscellaneous,"129,143.80",00.00,"129,767.77"
27-Feb-2023,Miscellaneous,00.00,"129,767.77",00.00
27-Feb-2023,Purchase,"15,422.50",00.00,"15,422.50"
27-Feb-2023,Reversal,"117,115.91",00.00,"132,538.41"
27-Feb-2023,ATM,"14,525.60",00.00,"147,064.01"
27-Feb-2023,Cash,"1,811,629.00",00.00,"1,958,693.01"
27-Feb-2023,Cheque,08.00,00.00,"1,958,701.01"
27-Feb-2023,RTGS,00.00,"326,450.17","1,632,250.84"
27-Feb-2023,RTGS,"84,758.00",00.00,"1,717,008.84"
27-Feb-2023,Purchase,34.00,00.00,"1,717,042.84"
27-Feb-2023,RTGS,00.00,"245,291.83","1,471,751.01"
27-Feb-2023,IMPS,184.75,00.00,"1,471,935.76"
27-Feb-2023,Reversal,19.00,00.00,"1,471,954.76"
27-Feb-2023,Cash,00.00,"147,195.48","1,324,759.28"
27-Feb-2023,Tax,00.00,"331,189.82","993,569.46"
27-Feb-2023,Transfer,00.00,"993,569.46",00.00
27-Feb-2023,Purchase,481.00,00.00,481.00
27-Feb-2023,IMPS,"11,033.10",00.00,"11,514.10"
27-Feb-2023,RTGS,"878,923.50",00.00,"890,437.60"
27-Feb-2023,Commission,931.30,00.00,"891,368.90"
27-Feb-2023,NEFT,176.00,00.00,"891,544.90"
27-Feb-2023,Transfer,"184,407.09",00.00,"1,075,951.99"
27-Feb-2023,NEFT,"2,266.39",00.00,"1,078,218.38"
27-Feb-2023,IMPS,06.16,00.00,"1,078,224.54"
28-Feb-2023,NEFT,344.50,00.00,"1,078,569.04"
28-Feb-2023,IMPS,"109,945.47",00.00,"1,188,514.51"
28-Feb-2023,ATM,00.00,"132,057.17","1,056,457.34"
28-Feb-2023,Cheque,"1,694,673.00",00.00,"2,751,130.34"
28-Feb-2023,NEFT,336.50,00.00,"2,751,466.84"
28-Feb-2023,Interest,00.00,"393,066.69","2,358,400.15"
28-Feb-2023,Transfer,00.00,"2,358,400.15",00.00
28-Feb-2023,Commission,"18,004.25",00.00,"18,004.25"
28-Feb-2023,ATM,00.00,"3,600.85","14,403.40"
28-Feb-2023,Commission,"32,207.28",00.00,"46,610.68"
28-Feb-2023,IMPS,00.00,"23,305.34","23,305.34"
28-Feb-2023,Debit Card,"3,757.86",00.00,"27,063.20"
28-Feb-2023,Reversal,"2,131.63",00.00,"29,194.83"
28-Feb-2023,Bill,"2,837.00",00.00,"32,031.83"
28-Feb-2023,IMPS,00.00,"4,003.98","28,027.85"
28-Feb-2023,Debit Card,"117,479.30",00.00,"145,507.15"
28-Feb-2023,Cheque,"912,780.00",00.00,"1,058,287.15"
28-Feb-2023,NEFT,"1,951.20",00.00,"1,060,238.35"
28-Feb-2023,Transfer,06.10,00.00,"1,060,244.45"
28-Feb-2023,RTGS,00.00,"212,048.89","848,195.56"
28-Feb-2023,Purchase,00.00,"106,024.45","742,171.12"
28-Feb-2023,Bill,"3,421.00",00.00,"745,592.12"
28-Feb-2023,Reversal,00.00,"93,199.02","652,393.10"
28-Feb-2023,NEFT,00.00,"65,239.31","587,153.79"
28-Feb-2023,Reversal,00.00,"146,788.45","440,365.34"
28-Feb-2023,RTGS,"2,454.00",00.00,"442,819.34"
28-Feb-2023,Cash,00.00,"88,563.87","354,255.47"
28-Feb-2023,RTGS,00.00,"118,085.16","236,170.31"
28-Feb-2023,Interest,00.00,"59,042.58","177,127.73"
28-Feb-2023,NEFT,00.00,"35,425.55","141,702.18"
28-Feb-2023,Purchase,"100,451.81",00.00,"242,153.99"
28-Feb-2023,Cash,"190,225.00",00.00,"432,378.99"
28-Feb-2023,Commission,00.00,"43,237.90","389,141.09"
28-Feb-2023,RTGS,00.00,"97,285.27","291,855.82"
28-Feb-2023,ATM,103.00,00.00,"291,958.82"
28-Feb-2023,Debit Card,00.00,"97,319.61","194,639.21"
28-Feb-2023,RTGS,05.00,00.00,"194,644.21"
28-Feb-2023,Debit Card,19.10,00.00,"194,663.31"
28-Feb-2023,Bill,147.68,00.00,"194,810.99"
28-Feb-2023,Transfer,00.00,"194,810.99",00.00
28-Feb-2023,IMPS,03.26,00.00,03.26
28-Feb-2023,Cash,"3,190.50",00.00,"3,193.76"
28-Feb-2023,Cheque,"7,497.00",00.00,"10,690.76"
28-Feb-2023,Cash,00.00,"1,781.79","8,908.97"
28-Feb-2023,Commission,00.00,"8,908.97",00.00
28-Feb-2023,Debit Card,04.00,00.00,04.00
28-Feb-2023,IMPS,"647,498.00",00.00,"647,502.00"
28-Feb-2023,Commission,"1,459,154.00",00.00,"2,106,656.00"
28-Feb-2023,NEFT,"1,829,476.00",00.00,"3,936,132.00"
28-Feb-2023,Miscellaneous,00.00,"787,226.40","3,148,905.60"
28-Feb-2023,Debit Card,00.00,"3,148,905.60",00.00
28-Feb-2023,Tax,"116,967.00",00.00,"116,967.00"
28-Feb-2023,Transfer,"2,395.70",00.00,"119,362.70"
28-Feb-2023,IMPS,447.20,00.00,"119,809.90"
28-Feb-2023,Purchase,"2,251.10",00.00,"122,061.00"
28-Feb-2023,Tax,03.50,00.00,"122,064.50"
28-Feb-2023,RTGS,00.00,"13,562.72","108,501.78"
28-Feb-2023,Interest,07.44,00.00,"108,509.22"
28-Feb-2023,Bill,"9,808.00",00.00,"118,317.22"
28-Feb-2023,RTGS,02.83,00.00,"118,320.05"
28-Feb-2023,Commission,00.00,"59,160.03","59,160.02"
28-Feb-2023,ATM,"130,013.09",00.00,"189,173.11"
28-Feb-2023,Transfer,00.00,"47,293.28","141,879.83"
28-Feb-2023,Reversal,00.00,"28,375.97","113,503.86"
28-Feb-2023,NEFT,36.62,00.00,"113,540.48"
28-Feb-2023,Reversal,05.00,00.00,"113,545.48"
28-Feb-2023,Debit Card,00.00,"113,545.48",00.00
28-Feb-2023,Tax,"2,300.00",00.00,"2,300.00"
28-Feb-2023,Transfer,32.00,00.00,"2,332.00"
28-Feb-2023,Cash,00.00,233.20,"2,098.80"
28-Feb-2023,Transfer,"11,949.00",00.00,"14,047.80"
28-Feb-2023,Commission,00.00,"7,023.90","7,023.90"
28-Feb-2023,Debit Card,00.00,"7,023.90",00.00
28-Feb-2023,Purchase,13.11,00.00,13.11
28-Feb-2023,RTGS,00.00,02.19,10.92
28-Feb-2023,NEFT,00.00,01.56,09.36
28-Feb-2023,Tax,444.93,00.00,454.29
28-Feb-2023,Interest,11.00,00.00,465.29
28-Feb-2023,Reversal,00.00,116.32,348.97
28-Feb-2023,NEFT,"2,913.66",00.00,"3,262.63"
28-Feb-2023,Interest,"12,605.00",00.00,"15,867.63"
28-Feb-2023,NEFT,00.00,"3,966.91","11,900.72"
28-Feb-2023,Bill,01.20,00.00,"11,901.92"
28-Feb-2023,Interest,00.00,"3,967.31","7,934.61"
28-Feb-2023,ATM,00.00,"1,983.65","5,950.96"
28-Feb-2023,IMPS,"1,725,114.80",00.00,"1,731,065.76"
28-Feb-2023,IMPS,296.00,00.00,"1,731,361.76"
01-Mar-2023,Cheque,120.00,00.00,"1,731,481.76"
01-Mar-2023,Cheque,00.00,"1,731,481.76",00.00
01-Mar-2023,Reversal,"20,918.00",00.00,"20,918.00"
01-Mar-2023,Reversal,00.00,"2,614.75","18,303.25"
01-Mar-2023,RTGS,00.00,"3,660.65","14,642.60"
01-Mar-2023,ATM,299.60,00.00,"14,942.20"
01-Mar-2023,Tax,341.00,00.00,"15,283.20"
01-Mar-2023,IMPS,"66,298.00",00.00,"81,581.20"
01-Mar-2023,RTGS,05.60,00.00,"81,586.80"
01-Mar-2023,Cash,00.00,"11,655.26","69,931.54"
01-Mar-2023,IMPS,00.00,"34,965.77","34,965.77"
01-Mar-2023,Commission,09.73,00.00,"34,975.50"
02-Mar-2023,Cash,"2,092,185.25",00.00,"2,127,160.75"
02-Mar-2023,RTGS,"1,741,075.00",00.00,"3,868,235.75"
02-Mar-2023,NEFT,00.00,"1,934,117.88","1,934,117.88"
02-Mar-2023,Miscellaneous,16.20,00.00,"1,934,134.08"
03-Mar-2023,Miscellaneous,00.00,"214,903.79","1,719,230.29"
03-Mar-2023,NEFT,00.00,"859,615.15","859,615.14"
03-Mar-2023,Reversal,05.00,00.00,"859,620.14"
03-Mar-2023,NEFT,"2,970.50",00.00,"862,590.64"
03-Mar-2023,Bill,00.00,"86,259.06","776,331.58"
03-Mar-2023,NEFT,"1,343,177.00",00.00,"2,119,508.58"
03-Mar-2023,Debit Card,00.00,"2,119,508.58",00.00
03-Mar-2023,Tax,"3,150.99",00.00,"3,150.99"
03-Mar-2023,ATM,"12,372.04",00.00,"15,523.03"
03-Mar-2023,NEFT,"189,314.00",00.00,"204,837.03"
03-Mar-2023,Cheque,00.00,"25,604.63","179,232.40"
03-Mar-2023,ATM,"1,895,061.50",00.00,"2,074,293.90"
03-Mar-2023,IMPS,00.00,"414,858.78","1,659,435.12"
03-Mar-2023,Interest,"1,696,511.00",00.00,"3,355,946.12"
03-Mar-2023,IMPS,"907,986.80",00.00,"4,263,932.92"
03-Mar-2023,Debit Card,00.00,"710,655.49","3,553,277.43"
04-Mar-2023,Debit Card,00.00,"1,776,638.72","1,776,638.72"
04-Mar-2023,Cash,00.00,"222,079.84","1,554,558.88"
04-Mar-2023,Tax,00.00,"155,455.89","1,399,102.99"
04-Mar-2023,Miscellaneous,00.00,"279,820.60","1,119,282.39"
04-Mar-2023,NEFT,00.00,"559,641.20","559,641.19"
04-Mar-2023,Tax,194.00,00.00,"559,835.19"
04-Mar-2023,NEFT,00.00,"79,976.46","479,858.73"
05-Mar-2023,NEFT,51.00,00.00,"479,909.73"
05-Mar-2023,Miscellaneous,00.00,"159,969.91","319,939.82"
05-Mar-2023,Transfer,"245,040.00",00.00,"564,979.82"
05-Mar-2023,Bill,00.00,"94,163.30","470,816.52"
05-Mar-2023,Transfer,"65,064.00",00.00,"535,880.52"
05-Mar-2023,Debit Card,00.00,"66,985.07","468,895.46"
05-Mar-2023,Commission,328.93,00.00,"469,224.39"
05-Mar-2023,Bill,02.80,00.00,"469,227.19"
05-Mar-2023,NEFT,20.00,00.00,"469,247.19"
05-Mar-2023,Debit Card,288.00,00.00,"469,535.19"
05-Mar-2023,RTGS,87.60,00.00,"469,622.79"
05-Mar-2023,NEFT,"248,070.00",00.00,"717,692.79"
05-Mar-2023,ATM,00.00,"102,527.54","615,165.25"
05-Mar-2023,Cheque,"79,674.90",00.00,"694,840.15"
05-Mar-2023,NEFT,"300,705.00",00.00,"995,545.15"
05-Mar-2023,Debit Card,00.00,"331,848.38","663,696.77"
05-Mar-2023,RTGS,684.20,00.00,"664,380.97"
05-Mar-2023,Cash,"653,722.00",00.00,"1,318,102.97"
05-Mar-2023,Bill,05.08,00.00,"1,318,108.05"
05-Mar-2023,Cheque,"1,693.00",00.00,"1,319,801.05"
05-Mar-2023,Bill,00.00,"1,319,801.05",00.00
05-Mar-2023,IMPS,"260,479.66",00.00,"260,479.66"
05-Mar-2023,RTGS,"2,762.40",00.00,"263,242.06"
05-Mar-2023,Debit Card,00.00,"52,648.41","210,593.65"
05-Mar-2023,Tax,00.00,"70,197.88","140,395.77"
05-Mar-2023,Bill,00.00,"15,599.53","124,796.24"
05-Mar-2023,NEFT,00.00,"15,599.53","109,196.71"
05-Mar-2023,Interest,"2,855.90",00.00,"112,052.61"
05-Mar-2023,Purchase,02.00,00.00,"112,054.61"
05-Mar-2023,Bill,"776,355.00",00.00,"888,409.61"
05-Mar-2023,Transfer,00.00,"296,136.54","592,273.07"
05-Mar-2023,Reversal,153.32,00.00,"592,426.39"
05-Mar-2023,Tax,05.90,00.00,"592,432.29"
05-Mar-2023,Cheque,00.00,"74,054.04","518,378.25"
05-Mar-2023,Commission,"43,595.00",00.00,"561,973.25"
06-Mar-2023,RTGS,"3,060.00",00.00,"565,033.25"
06-Mar-2023,Cash,01.00,00.00,"565,034.25"
06-Mar-2023,Bill,"6,399.00",00.00,"571,433.25"
06-Mar-2023,Tax,00.00,"190,477.75","380,955.50"
06-Mar-2023,Cheque,00.00,"95,238.88","285,716.62"
06-Mar-2023,Tax,09.00,00.00,"285,725.62"
06-Mar-2023,Debit Card,00.00,"57,145.12","228,580.50"
06-Mar-2023,Bill,"3,358.40",00.00,"231,938.90"
06-Mar-2023,IMPS,49.00,00.00,"231,987.90"
06-Mar-2023,Debit Card,00.00,"23,198.79","208,789.11"
06-Mar-2023,RTGS,31.00,00.00,"208,820.11"
06-Mar-2023,Purchase,01.00,00.00,"208,821.11"
06-Mar-2023,Purchase,226.08,00.00,"209,047.19"
06-Mar-2023,Cheque,"89,941.31",00.00,"298,988.50"
06-Mar-2023,Bill,00.00,"42,712.64","256,275.86"
06-Mar-2023,RTGS,00.00,"28,475.10","227,800.76"
06-Mar-2023,Miscellaneous,01.53,00.00,"227,802.29"
06-Mar-2023,Tax,00.00,"75,934.10","151,868.19"
06-Mar-2023,RTGS,00.00,"30,373.64","121,494.55"
06-Mar-2023,Debit Card,00.00,"15,186.82","106,307.73"
06-Mar-2023,Cash,00.00,"15,186.82","91,120.91"
07-Mar-2023,Bill,"14,942.00",00.00,"106,062.91"
07-Mar-2023,IMPS,00.00,"53,031.46","53,031.46"
07-Mar-2023,Cash,00.00,"6,628.93","46,402.53"
07-Mar-2023,Transfer,"3,006.40",00.00,"49,408.93"
07-Mar-2023,Cash,00.00,"6,176.12","43,232.81"
07-Mar-2023,ATM,00.00,"5,404.10","37,828.71"
07-Mar-2023,Reversal,00.00,"37,828.71",00.00
07-Mar-2023,ATM,135.00,00.00,135.00
07-Mar-2023,Debit Card,53.00,00.00,188.00
07-Mar-2023,Purchase,33.00,00.00,221.00
07-Mar-2023,Purchase,402.00,00.00,623.00
07-Mar-2023,Purchase,00.00,155.75,467.25
07-Mar-2023,Commission,00.00,93.45,373.80
07-Mar-2023,Purchase,"3,954.70",00.00,"4,328.50"
07-Mar-2023,Interest,00.00,"1,082.13","3,246.38"
07-Mar-2023,Cash,00.00,360.71,"2,885.67"
07-Mar-2023,Reversal,00.00,"2,885.67",00.00
07-Mar-2023,Interest,"3,478.90",00.00,"3,478.90"
07-Mar-2023,IMPS,"1,796,006.00",00.00,"1,799,484.90"
07-Mar-2023,Reversal,00.00,"599,828.30","1,199,656.60"
07-Mar-2023,Tax,00.00,"239,931.32","959,725.28"
07-Mar-2023,RTGS,00.00,"319,908.43","639,816.85"
07-Mar-2023,Commission,21.99,00.00,"639,838.84"
07-Mar-2023,Miscellaneous,00.00,"159,959.71","479,879.13"
07-Mar-2023,Debit Card,03.04,00.00,"479,882.17"
07-Mar-2023,Purchase,00.00,"239,941.09","239,941.08"
07-Mar-2023,Tax,00.00,"119,970.54","119,970.54"
07-Mar-2023,RTGS,00.00,"14,996.32","104,974.22"
07-Mar-2023,Cheque,"13,026.50",00.00,"118,000.72"
07-Mar-2023,Cash,369.45,00.00,"118,370.17"
07-Mar-2023,Cash,339.03,00.00,"118,709.20"
07-Mar-2023,Transfer,47.00,00.00,"118,756.20"
07-Mar-2023,Interest,433.70,00.00,"119,189.90"
07-Mar-2023,Miscellaneous,00.00,"14,898.74","104,291.16"
07-Mar-2023,RTGS,"1,057,810.00",00.00,"1,162,101.16"
07-Mar-2023,Cheque,06.21,00.00,"1,162,107.37"
07-Mar-2023,IMPS,58.70,00.00,"1,162,166.07"
07-Mar-2023,Reversal,"30,675.00",00.00,"1,192,841.07"
07-Mar-2023,Debit Card,203.60,00.00,"1,193,044.67"
07-Mar-2023,Miscellaneous,00.00,"298,261.17","894,783.50"
07-Mar-2023,Purchase,426.07,00.00,"895,209.57"
07-Mar-2023,Debit Card,"234,115.00",00.00,"1,129,324.57"
07-Mar-2023,Reversal,"125,825.00",00.00,"1,255,149.57"
07-Mar-2023,Interest,01.00,00.00,"1,255,150.57"
07-Mar-2023,Miscellaneous,00.00,"1,255,150.57",00.00
07-Mar-2023,Tax,54.40,00.00,54.40
07-Mar-2023,Reversal,53.90,00.00,108.30
07-Mar-2023,Cash,00.00,13.54,94.76
07-Mar-2023,Bill,"1,275,140.50",00.00,"1,275,235.26"
07-Mar-2023,Bill,00.00,"127,523.53","1,147,711.73"
07-Mar-2023,RTGS,16.00,00.00,"1,147,727.73"
07-Mar-2023,Tax,16.72,00.00,"1,147,744.45"
07-Mar-2023,Tax,00.00,"114,774.45","1,032,970.00"
07-Mar-2023,Miscellaneous,00.00,"344,323.33","688,646.67"
07-Mar-2023,Interest,00.00,"114,774.45","573,872.23"
07-Mar-2023,ATM,00.00,"71,734.03","502,138.20"
07-Mar-2023,Purchase,989.40,00.00,"503,127.60"
07-Mar-2023,Transfer,00.00,"100,625.52","402,502.08"
07-Mar-2023,Miscellaneous,00.00,"100,625.52","301,876.56"
07-Mar-2023,RTGS,60.72,00.00,"301,937.28"
07-Mar-2023,Bill,00.00,"150,968.64","150,968.64"
07-Mar-2023,Miscellaneous,00.00,"30,193.73","120,774.91"
07-Mar-2023,Cheque,02.28,00.00,"120,777.19"
07-Mar-2023,Bill,"1,989.60",00.00,"122,766.79"
07-Mar-2023,Reversal,00.00,"40,922.26","81,844.53"
07-Mar-2023,NEFT,"1,900.00",00.00,"83,744.53"
07-Mar-2023,NEFT,"3,189.00",00.00,"86,933.53"
07-Mar-2023,Commission,00.00,"14,488.92","72,444.61"
07-Mar-2023,Cheque,23.66,00.00,"72,468.27"
07-Mar-2023,NEFT,63.00,00.00,"72,531.27"
07-Mar-2023,RTGS,00.00,"36,265.64","36,265.64"
07-Mar-2023,Reversal,00.00,"12,088.55","24,177.09"
07-Mar-2023,Purchase,00.00,"4,835.42","19,341.67"
07-Mar-2023,Tax,508.00,00.00,"19,849.67"
07-Mar-2023,Interest,00.00,"19,849.67",00.00
07-Mar-2023,Interest,"3,490.27",00.00,"3,490.27"
07-Mar-2023,Purchase,"1,265,313.50",00.00,"1,268,803.77"
07-Mar-2023,Commission,00.00,"211,467.30","1,057,336.48"
07-Mar-2023,Commission,21.20,00.00,"1,057,357.68"
07-Mar-2023,Interest,00.00,"176,226.28","881,131.40"
07-Mar-2023,Interest,31.00,00.00,"881,162.40"
07-Mar-2023,Purchase,04.00,00.00,"881,166.40"
07-Mar-2023,Interest,00.00,"881,166.40",00.00
07-Mar-2023,RTGS,"4,046.30",00.00,"4,046.30"
07-Mar-2023,Commission,00.00,"4,046.30",00.00
07-Mar-2023,Purchase,20.56,00.00,20.56
07-Mar-2023,ATM,30.00,00.00,50.56
07-Mar-2023,Cheque,00.00,12.64,37.92
07-Mar-2023,Reversal,"1,350.79",00.00,"1,388.71"
07-Mar-2023,Interest,"131,967.30",00.00,"133,356.01"
07-Mar-2023,Transfer,154.00,00.00,"133,510.01"
07-Mar-2023,Bill,27.00,00.00,"133,537.01"
07-Mar-2023,Transfer,02.00,00.00,"133,539.01"
07-Mar-2023,Reversal,26.00,00.00,"133,565.01"
07-Mar-2023,Miscellaneous,"10,672.86",00.00,"144,237.87"
07-Mar-2023,Miscellaneous,05.20,00.00,"144,243.07"
07-Mar-2023,Tax,00.00,"48,081.02","96,162.05"
07-Mar-2023,Cheque,00.00,"96,162.05",00.00
07-Mar-2023,Bill,"10,343.03",00.00,"10,343.03"
07-Mar-2023,Reversal,56.00,00.00,"10,399.03"
07-Mar-2023,IMPS,00.00,"1,155.45","9,243.58"
07-Mar-2023,NEFT,00.00,"2,310.90","6,932.68"
07-Mar-2023,Tax,00.00,693.27,"6,239.41"
07-Mar-2023,Commission,48.00,00.00,"6,287.41"
07-Mar-2023,Miscellaneous,"1,136,094.00",00.00,"1,142,381.41"
07-Mar-2023,Commission,00.00,"571,190.71","571,190.70"
07-Mar-2023,Interest,00.00,"95,198.45","475,992.25"
07-Mar-2023,NEFT,02.20,00.00,"475,994.45"
07-Mar-2023,IMPS,"30,631.90",00.00,"506,626.35"
07-Mar-2023,Tax,00.00,"50,662.64","455,963.72"
07-Mar-2023,NEFT,00.00,"65,137.67","390,826.05"
07-Mar-2023,NEFT,00.00,"130,275.35","260,550.70"
07-Mar-2023,Miscellaneous,00.00,"52,110.14","208,440.56"
07-Mar-2023,IMPS,"425,388.00",00.00,"633,828.56"
07-Mar-2023,Reversal,00.00,"79,228.57","554,599.99"
07-Mar-2023,Cheque,00.00,"61,622.22","492,977.77"
07-Mar-2023,Reversal,329.80,00.00,"493,307.57"
07-Mar-2023,Cheque,"53,753.91",00.00,"547,061.48"
07-Mar-2023,Commission,"3,603.00",00.00,"550,664.48"
07-Mar-2023,NEFT,"253,236.00",00.00,"803,900.48"
07-Mar-2023,Transfer,07.00,00.00,"803,907.48"
07-Mar-2023,Cash,00.00,"80,390.75","723,516.73"
07-Mar-2023,Tax,00.00,"723,516.73",00.00
07-Mar-2023,Interest,62.50,00.00,62.50
07-Mar-2023,Miscellaneous,"2,007.30",00.00,"2,069.80"
07-Mar-2023,Reversal,00.00,517.45,"1,552.35"
07-Mar-2023,Tax,"140,482.00",00.00,"142,034.35"
07-Mar-2023,Reversal,00.00,"14,203.44","127,830.92"
07-Mar-2023,Reversal,00.00,"14,203.44","113,627.48"
07-Mar-2023,Transfer,00.00,"56,813.74","56,813.74"
07-Mar-2023,ATM,06.92,00.00,"56,820.66"
07-Mar-2023,Cheque,220.08,00.00,"57,040.74"
07-Mar-2023,Reversal,00.00,"19,013.58","38,027.16"
07-Mar-2023,Purchase,00.00,"3,802.72","34,224.44"
07-Mar-2023,Cash,00.00,"4,889.21","29,335.23"
07-Mar-2023,RTGS,00.00,"4,190.75","25,144.48"
07-Mar-2023,RTGS,00.00,"3,143.06","22,001.42"
07-Mar-2023,NEFT,02.00,00.00,"22,003.42"
07-Mar-2023,Tax,00.00,"2,444.82","19,558.60"
07-Mar-2023,Cheque,00.00,"9,779.30","9,779.30"
07-Mar-2023,Debit Card,06.10,00.00,"9,785.40"
07-Mar-2023,Transfer,00.00,"1,397.91","8,387.49"
07-Mar-2023,Transfer,"920,059.00",00.00,"928,446.49"
07-Mar-2023,Interest,"114,638.00",00.00,"1,043,084.49"
07-Mar-2023,Miscellaneous,00.00,"347,694.83","695,389.66"
07-Mar-2023,Tax,00.00,"69,538.97","625,850.69"
07-Mar-2023,Bill,"1,843,974.00",00.00,"2,469,824.69"
08-Mar-2023,Cheque,00.00,"823,274.90","1,646,549.79"
08-Mar-2023,Bill,00.00,"329,309.96","1,317,239.83"
09-Mar-2023,NEFT,327.96,00.00,"1,317,567.79"
09-Mar-2023,Cash,00.00,"219,594.63","1,097,973.16"
09-Mar-2023,Purchase,02.25,00.00,"1,097,975.41"
09-Mar-2023,Tax,00.00,"548,987.71","548,987.70"
09-Mar-2023,Miscellaneous,00.00,"109,797.54","439,190.16"
09-Mar-2023,Bill,00.00,"219,595.08","219,595.08"
09-Mar-2023,RTGS,03.00,00.00,"219,598.08"
09-Mar-2023,NEFT,05.00,00.00,"219,603.08"
09-Mar-2023,Tax,24.80,00.00,"219,627.88"
09-Mar-2023,Cheque,340.50,00.00,"219,968.38"
09-Mar-2023,Transfer,"7,117.92",00.00,"227,086.30"
10-Mar-2023,IMPS,00.00,"37,847.72","189,238.58"
10-Mar-2023,Miscellaneous,00.00,"31,539.76","157,698.82"
10-Mar-2023,Commission,00.00,"78,849.41","78,849.41"
10-Mar-2023,Debit Card,00.00,"7,884.94","70,964.47"
10-Mar-2023,RTGS,00.67,00.00,"70,965.14"
10-Mar-2023,Commission,217.39,00.00,"71,182.53"
10-Mar-2023,Purchase,58.44,00.00,"71,240.97"
10-Mar-2023,Purchase,00.00,"11,873.50","59,367.48"
10-Mar-2023,Reversal,"3,541.30",00.00,"62,908.78"
10-Mar-2023,Miscellaneous,27.00,00.00,"62,935.78"
10-Mar-2023,IMPS,"1,068,904.00",00.00,"1,131,839.78"
10-Mar-2023,Transfer,773.00,00.00,"1,132,612.78"
10-Mar-2023,Interest,00.00,"125,845.86","1,006,766.92"
10-Mar-2023,Purchase,00.00,"167,794.49","838,972.43"
10-Mar-2023,Interest,00.00,"139,828.74","699,143.69"
10-Mar-2023,Commission,"29,898.11",00.00,"729,041.80"
10-Mar-2023,RTGS,00.00,"104,148.83","624,892.97"
10-Mar-2023,IMPS,160.00,00.00,"625,052.97"
10-Mar-2023,Tax,"3,415.00",00.00,"628,467.97"
10-Mar-2023,IMPS,00.00,"314,233.99","314,233.98"
10-Mar-2023,Commission,00.00,"314,233.98",00.00
11-Mar-2023,Reversal,"792,319.20",00.00,"792,319.20"
11-Mar-2023,Interest,00.00,"396,159.60","396,159.60"
11-Mar-2023,Bill,00.00,"396,159.60",00.00
11-Mar-2023,Purchase,05.95,00.00,05.95
11-Mar-2023,Reversal,"3,788.90",00.00,"3,794.85"
11-Mar-2023,Bill,"33,882.50",00.00,"37,677.35"
11-Mar-2023,Tax,17.40,00.00,"37,694.75"
11-Mar-2023,Interest,00.00,"9,423.69","28,271.06"
11-Mar-2023,Debit Card,"479,013.20",00.00,"507,284.26"
11-Mar-2023,Reversal,00.00,"101,456.85","405,827.41"
11-Mar-2023,ATM,00.00,"202,913.71","202,913.70"
11-Mar-2023,Interest,"76,082.00",00.00,"278,995.70"
11-Mar-2023,Purchase,"295,720.25",00.00,"574,715.95"
11-Mar-2023,Debit Card,"5,706.00",00.00,"580,421.95"
11-Mar-2023,Commission,00.00,"145,105.49","435,316.46"
11-Mar-2023,Reversal,"71,981.00",00.00,"507,297.46"
11-Mar-2023,Miscellaneous,38.00,00.00,"507,335.46"
11-Mar-2023,Interest,00.00,"84,555.91","422,779.55"
11-Mar-2023,Commission,"789,464.80",00.00,"1,212,244.35"
11-Mar-2023,Miscellaneous,00.00,"173,177.76","1,039,066.59"
11-Mar-2023,Cash,49.40,00.00,"1,039,115.99"
11-Mar-2023,Cash,03.00,00.00,"1,039,118.99"
11-Mar-2023,Tax,00.00,"519,559.50","519,559.50"
11-Mar-2023,Interest,07.30,00.00,"519,566.80"
11-Mar-2023,Cheque,00.00,"173,188.93","346,377.87"
11-Mar-2023,NEFT,00.00,"43,297.23","303,080.64"
11-Mar-2023,NEFT,"111,059.84",00.00,"414,140.48"
11-Mar-2023,Cash,"97,496.00",00.00,"511,636.48"
11-Mar-2023,Cheque,730.73,00.00,"512,367.21"
11-Mar-2023,Miscellaneous,00.00,"170,789.07","341,578.14"
11-Mar-2023,Bill,"225,521.75",00.00,"567,099.89"
11-Mar-2023,Debit Card,00.00,"113,419.98","453,679.91"
12-Mar-2023,Bill,01.33,00.00,"453,681.24"
12-Mar-2023,RTGS,31.92,00.00,"453,713.16"
12-Mar-2023,NEFT,00.66,00.00,"453,713.82"
12-Mar-2023,RTGS,00.00,"113,428.46","340,285.36"
12-Mar-2023,Debit Card,761.00,00.00,"341,046.36"
12-Mar-2023,Cash,05.00,00.00,"341,051.36"
12-Mar-2023,Cheque,00.00,"56,841.89","284,209.47"
12-Mar-2023,Cheque,00.00,"56,841.89","227,367.58"
12-Mar-2023,Miscellaneous,00.00,"32,481.08","194,886.50"
12-Mar-2023,Commission,"22,286.40",00.00,"217,172.90"
12-Mar-2023,Debit Card,00.00,"43,434.58","173,738.32"
12-Mar-2023,Reversal,"190,397.06",00.00,"364,135.38"
12-Mar-2023,Purchase,00.00,"60,689.23","303,446.15"
12-Mar-2023,Miscellaneous,00.00,"303,446.15",00.00
12-Mar-2023,Commission,524.00,00.00,524.00
12-Mar-2023,Commission,00.00,87.33,436.67
12-Mar-2023,Purchase,00.00,218.34,218.34
12-Mar-2023,Commission,"1,268.00",00.00,"1,486.34"
12-Mar-2023,Cheque,00.00,185.79,"1,300.55"
12-Mar-2023,Cash,51.20,00.00,"1,351.75"
12-Mar-2023,Bill,00.00,168.97,"1,182.78"
12-Mar-2023,Bill,14.45,00.00,"1,197.23"
12-Mar-2023,Miscellaneous,56.00,00.00,"1,253.23"
12-Mar-2023,Transfer,00.00,156.65,"1,096.58"
12-Mar-2023,NEFT,00.00,182.76,913.82
12-Mar-2023,IMPS,"178,288.00",00.00,"179,201.82"
12-Mar-2023,Reversal,46.00,00.00,"179,247.82"
12-Mar-2023,Cash,100.94,00.00,"179,348.76"
12-Mar-2023,Bill,00.00,"59,782.92","119,565.84"
12-Mar-2023,Transfer,00.00,"11,956.58","107,609.26"
12-Mar-2023,Bill,00.00,"10,760.93","96,848.33"
12-Mar-2023,IMPS,00.00,"32,282.78","64,565.55"
12-Mar-2023,NEFT,"24,824.74",00.00,"89,390.29"
12-Mar-2023,RTGS,"87,719.12",00.00,"177,109.41"
12-Mar-2023,IMPS,00.00,"177,109.41",00.00
12-Mar-2023,Debit Card,"202,157.30",00.00,"202,157.30"
13-Mar-2023,Cash,"16,940.00",00.00,"219,097.30"
13-Mar-2023,Commission,00.00,"43,819.46","175,277.84"
13-Mar-2023,IMPS,06.71,00.00,"175,284.55"
13-Mar-2023,Miscellaneous,"1,375,237.50",00.00,"1,550,522.05"
13-Mar-2023,Commission,29.00,00.00,"1,550,551.05"
13-Mar-2023,Tax,"2,165.73",00.00,"1,552,716.78"
13-Mar-2023,Bill,00.00,"172,524.09","1,380,192.69"
13-Mar-2023,Cash,"2,573.10",00.00,"1,382,765.79"
13-Mar-2023,Commission,00.00,"276,553.16","1,106,212.63"
13-Mar-2023,Transfer,12.20,00.00,"1,106,224.83"
13-Mar-2023,Miscellaneous,"53,426.72",00.00,"1,159,651.55"
14-Mar-2023,Cheque,04.68,00.00,"1,159,656.23"
14-Mar-2023,RTGS,00.00,"115,965.62","1,043,690.61"
14-Mar-2023,Cash,00.00,"104,369.06","939,321.55"
14-Mar-2023,Cheque,00.00,"156,553.59","782,767.96"
14-Mar-2023,Transfer,"4,054.00",00.00,"786,821.96"
14-Mar-2023,Cheque,17.40,00.00,"786,839.36"
14-Mar-2023,Commission,06.07,00.00,"786,845.43"
14-Mar-2023,RTGS,27.60,00.00,"786,873.03"
14-Mar-2023,NEFT,00.00,"786,873.03",00.00
14-Mar-2023,Transfer,123.00,00.00,123.00
14-Mar-2023,Tax,93.08,00.00,216.08
14-Mar-2023,IMPS,35.49,00.00,251.57
14-Mar-2023,ATM,"226,285.56",00.00,"226,537.13"
14-Mar-2023,Interest,00.00,"75,512.38","151,024.75"
14-Mar-2023,Interest,"220,774.00",00.00,"371,798.75"
14-Mar-2023,Cheque,228.70,00.00,"372,027.45"
14-Mar-2023,NEFT,18.00,00.00,"372,045.45"
14-Mar-2023,Bill,"3,687.00",00.00,"375,732.45"
14-Mar-2023,RTGS,25.70,00.00,"375,758.15"
14-Mar-2023,Cash,49.80,00.00,"375,807.95"
14-Mar-2023,IMPS,00.00,"46,975.99","328,831.96"
14-Mar-2023,IMPS,00.00,"164,415.98","164,415.98"
14-Mar-2023,RTGS,203.60,00.00,"164,619.58"
14-Mar-2023,IMPS,62.30,00.00,"164,681.88"
14-Mar-2023,ATM,"24,653.50",00.00,"189,335.38"
14-Mar-2023,Purchase,"53,373.70",00.00,"242,709.08"
14-Mar-2023,ATM,00.00,"60,677.27","182,031.81"
14-Mar-2023,IMPS,18.00,00.00,"182,049.81"
14-Mar-2023,Debit Card,00.00,"22,756.23","159,293.58"
14-Mar-2023,Transfer,"3,155.47",00.00,"162,449.05"
14-Mar-2023,Cheque,221.00,00.00,"162,670.05"
14-Mar-2023,Transfer,00.00,"54,223.35","108,446.70"
14-Mar-2023,IMPS,"427,379.50",00.00,"535,826.20"
14-Mar-2023,Cash,05.00,00.00,"535,831.20"
14-Mar-2023,Cash,"276,477.00",00.00,"812,308.20"
14-Mar-2023,RTGS,00.00,"203,077.05","609,231.15"
14-Mar-2023,RTGS,22.41,00.00,"609,253.56"
14-Mar-2023,Interest,"8,675.00",00.00,"617,928.56"
14-Mar-2023,Tax,00.00,"77,241.07","540,687.49"
14-Mar-2023,Cheque,"1,355.10",00.00,"542,042.59"
14-Mar-2023,ATM,39.00,00.00,"542,081.59"
14-Mar-2023,Miscellaneous,"10,231.20",00.00,"552,312.79"
14-Mar-2023,Transfer,00.00,"55,231.28","497,081.51"
14-Mar-2023,Purchase,"1,413,863.00",00.00,"1,910,944.51"
14-Mar-2023,Bill,00.00,"955,472.26","955,472.26"
14-Mar-2023,Debit Card,00.00,"955,472.26",00.00
14-Mar-2023,Commission,03.00,00.00,03.00
14-Mar-2023,Commission,"1,274.00",00.00,"1,277.00"
14-Mar-2023,Bill,13.00,00.00,"1,290.00"
14-Mar-2023,IMPS,00.00,322.50,967.50
14-Mar-2023,Debit Card,230.81,00.00,"1,198.31"
14-Mar-2023,IMPS,"31,512.70",00.00,"32,711.01"
14-Mar-2023,Commission,00.00,"3,271.10","29,439.91"
14-Mar-2023,Reversal,00.00,"4,205.70","25,234.21"
14-Mar-2023,ATM,00.00,"12,617.11","12,617.10"
14-Mar-2023,Interest,00.00,"1,802.44","10,814.66"
14-Mar-2023,Bill,"1,929.00",00.00,"12,743.66"
14-Mar-2023,Reversal,00.00,"1,415.96","11,327.70"
14-Mar-2023,Cheque,"90,403.88",00.00,"101,731.58"
14-Mar-2023,Cheque,03.00,00.00,"101,734.58"
14-Mar-2023,Reversal,"27,180.00",00.00,"128,914.58"
15-Mar-2023,Reversal,09.36,00.00,"128,923.94"
15-Mar-2023,Reversal,00.00,"25,784.79","103,139.15"
15-Mar-2023,Bill,00.00,"51,569.58","51,569.58"
15-Mar-2023,Cash,543.00,00.00,"52,112.58"
15-Mar-2023,Debit Card,00.00,"52,112.58",00.00
15-Mar-2023,RTGS,05.62,00.00,05.62
15-Mar-2023,Debit Card,"189,496.75",00.00,"189,502.37"
15-Mar-2023,Bill,00.00,"63,167.46","126,334.91"
15-Mar-2023,NEFT,00.00,"21,055.82","105,279.09"
15-Mar-2023,Transfer,00.00,"10,527.91","94,751.18"
15-Mar-2023,RTGS,"156,585.47",00.00,"251,336.65"
15-Mar-2023,Tax,88.59,00.00,"251,425.24"
15-Mar-2023,Reversal,"1,471,825.20",00.00,"1,723,250.44"
15-Mar-2023,ATM,00.00,"191,472.27","1,531,778.17"
16-Mar-2023,Cheque,"1,740,542.75",00.00,"3,272,320.92"
16-Mar-2023,NEFT,00.00,"409,040.12","2,863,280.80"
16-Mar-2023,Tax,00.00,"954,426.93","1,908,853.87"
16-Mar-2023,Cheque,00.00,"318,142.31","1,590,711.56"
16-Mar-2023,Purchase,"640,337.75",00.00,"2,231,049.31"
16-Mar-2023,Debit Card,"26,953.90",00.00,"2,258,003.21"
16-Mar-2023,NEFT,430.30,00.00,"2,258,433.51"
16-Mar-2023,NEFT,00.00,"752,811.17","1,505,622.34"
16-Mar-2023,Reversal,00.00,"376,405.59","1,129,216.76"
16-Mar-2023,NEFT,00.00,"564,608.38","564,608.38"
16-Mar-2023,Bill,446.05,00.00,"565,054.43"
16-Mar-2023,Commission,00.00,"113,010.89","452,043.54"
16-Mar-2023,NEFT,"22,719.40",00.00,"474,762.94"
16-Mar-2023,Commission,35.95,00.00,"474,798.89"
16-Mar-2023,Purchase,00.00,"59,349.86","415,449.03"
17-Mar-2023,Debit Card,47.21,00.00,"415,496.24"
17-Mar-2023,Bill,00.00,"51,937.03","363,559.21"
17-Mar-2023,NEFT,"2,575.60",00.00,"366,134.81"
17-Mar-2023,Debit Card,02.84,00.00,"366,137.65"
17-Mar-2023,ATM,280.25,00.00,"366,417.90"
17-Mar-2023,Bill,"1,886.43",00.00,"368,304.33"
17-Mar-2023,Cheque,00.00,"184,152.17","184,152.16"
17-Mar-2023,IMPS,"27,599.10",00.00,"211,751.26"
17-Mar-2023,Cash,"1,556.00",00.00,"213,307.26"
17-Mar-2023,Tax,00.00,"53,326.82","159,980.44"
17-Mar-2023,Debit Card,32.82,00.00,"160,013.26"
17-Mar-2023,RTGS,"213,056.80",00.00,"373,070.06"
17-Mar-2023,RTGS,"15,759.00",00.00,"388,829.06"
17-Mar-2023,Cash,04.45,00.00,"388,833.51"
17-Mar-2023,IMPS,00.00,"77,766.70","311,066.81"
18-Mar-2023,Purchase,00.00,"31,106.68","279,960.13"
18-Mar-2023,Reversal,00.00,"55,992.03","223,968.10"
18-Mar-2023,Interest,06.00,00.00,"223,974.10"
18-Mar-2023,Cheque,00.00,"44,794.82","179,179.28"
18-Mar-2023,Miscellaneous,05.00,00.00,"179,184.28"
18-Mar-2023,Debit Card,00.00,"44,796.07","134,388.21"
18-Mar-2023,Miscellaneous,00.00,"67,194.11","67,194.10"
18-Mar-2023,Purchase,00.00,"7,466.01","59,728.09"
18-Mar-2023,Cheque,00.00,"29,864.05","29,864.04"
18-Mar-2023,Tax,00.00,"5,972.81","23,891.23"
18-Mar-2023,Interest,00.00,"2,986.40","20,904.83"
18-Mar-2023,RTGS,10.60,00.00,"20,915.43"
18-Mar-2023,Cash,228.80,00.00,"21,144.23"
18-Mar-2023,Reversal,47.00,00.00,"21,191.23"
18-Mar-2023,Commission,"3,193.47",00.00,"24,384.70"
18-Mar-2023,Tax,00.00,"3,048.09","21,336.61"
18-Mar-2023,IMPS,00.00,"3,556.10","17,780.51"
18-Mar-2023,Debit Card,00.00,"5,926.84","11,853.67"
18-Mar-2023,Tax,25.00,00.00,"11,878.67"
18-Mar-2023,Cheque,57.22,00.00,"11,935.89"
18-Mar-2023,Tax,00.00,"5,967.95","5,967.94"
18-Mar-2023,Interest,00.00,745.99,"5,221.95"
18-Mar-2023,Tax,00.00,"5,221.95",00.00
18-Mar-2023,Miscellaneous,58.82,00.00,58.82
18-Mar-2023,Miscellaneous,00.00,06.54,52.28
18-Mar-2023,Reversal,"1,915,781.00",00.00,"1,915,833.28"
18-Mar-2023,Transfer,02.50,00.00,"1,915,835.78"
18-Mar-2023,Interest,60.74,00.00,"1,915,896.52"
18-Mar-2023,Transfer,00.00,"212,877.39","1,703,019.13"
18-Mar-2023,Reversal,57.00,00.00,"1,703,076.13"
18-Mar-2023,Tax,490.22,00.00,"1,703,566.35"
18-Mar-2023,Transfer,00.00,"567,855.45","1,135,710.90"
18-Mar-2023,Bill,317.53,00.00,"1,136,028.43"
18-Mar-2023,Commission,00.00,"162,289.78","973,738.65"
18-Mar-2023,IMPS,"524,079.00",00.00,"1,497,817.65"
18-Mar-2023,Tax,00.00,"149,781.77","1,348,035.88"
18-Mar-2023,Reversal,00.00,"134,803.59","1,213,232.29"
18-Mar-2023,Reversal,273.61,00.00,"1,213,505.90"
18-Mar-2023,Reversal,"22,398.03",00.00,"1,235,903.93"
18-Mar-2023,Bill,"27,813.00",00.00,"1,263,716.93"
18-Mar-2023,Purchase,"2,071,591.25",00.00,"3,335,308.18"
18-Mar-2023,Miscellaneous,00.00,"333,530.82","3,001,777.36"
18-Mar-2023,Bill,00.00,"333,530.82","2,668,246.54"
18-Mar-2023,NEFT,05.70,00.00,"2,668,252.24"
18-Mar-2023,Reversal,"352,746.20",00.00,"3,020,998.44"
18-Mar-2023,IMPS,413.80,00.00,"3,021,412.24"
18-Mar-2023,Transfer,05.00,00.00,"3,021,417.24"
18-Mar-2023,Commission,440.05,00.00,"3,021,857.29"
19-Mar-2023,Miscellaneous,00.00,"1,510,928.65","1,510,928.64"
19-Mar-2023,Interest,00.00,"188,866.08","1,322,062.56"
19-Mar-2023,Miscellaneous,00.00,"132,206.26","1,189,856.30"
19-Mar-2023,Debit Card,00.00,"297,464.08","892,392.23"
19-Mar-2023,Debit Card,"569,680.20",00.00,"1,462,072.43"
19-Mar-2023,NEFT,00.00,"731,036.22","731,036.22"
19-Mar-2023,Tax,"1,376,013.75",00.00,"2,107,049.97"
19-Mar-2023,Miscellaneous,"580,307.50",00.00,"2,687,357.47"
19-Mar-2023,RTGS,00.00,"335,919.68","2,351,437.79"
19-Mar-2023,Interest,27.00,00.00,"2,351,464.79"
19-Mar-2023,Interest,"1,649,280.75",00.00,"4,000,745.54"
19-Mar-2023,NEFT,147.83,00.00,"4,000,893.37"
19-Mar-2023,Tax,00.00,"800,178.67","3,200,714.70"
19-Mar-2023,Transfer,00.00,"1,600,357.35","1,600,357.35"
19-Mar-2023,Miscellaneous,35.00,00.00,"1,600,392.35"
19-Mar-2023,Cash,"709,482.00",00.00,"2,309,874.35"
19-Mar-2023,Miscellaneous,00.00,"577,468.59","1,732,405.76"
19-Mar-2023,Commission,"208,531.00",00.00,"1,940,936.76"
19-Mar-2023,Bill,07.20,00.00,"1,940,943.96"
19-Mar-2023,Reversal,"14,628.60",00.00,"1,955,572.56"
19-Mar-2023,Cheque,00.00,"1,955,572.56",00.00
19-Mar-2023,Miscellaneous,"225,683.80",00.00,"225,683.80"
19-Mar-2023,Cheque,00.00,"37,613.97","188,069.83"
19-Mar-2023,Debit Card,02.20,00.00,"188,072.03"
19-Mar-2023,Cash,00.00,"94,036.02","94,036.02"
19-Mar-2023,Transfer,00.00,"18,807.20","75,228.82"
19-Mar-2023,Cash,220.91,00.00,"75,449.73"
19-Mar-2023,NEFT,00.00,"12,574.96","62,874.77"
19-Mar-2023,Miscellaneous,"1,646,210.00",00.00,"1,709,084.77"
19-Mar-2023,Commission,00.00,"427,271.19","1,281,813.58"
19-Mar-2023,Bill,00.00,"640,906.79","640,906.79"
19-Mar-2023,Debit Card,04.53,00.00,"640,911.32"
19-Mar-2023,ATM,"588,773.20",00.00,"1,229,684.52"
19-Mar-2023,Interest,476.00,00.00,"1,230,160.52"
19-Mar-2023,IMPS,01.00,00.00,"1,230,161.52"
19-Mar-2023,Debit Card,52.60,00.00,"1,230,214.12"
19-Mar-2023,NEFT,"1,963.95",00.00,"1,232,178.07"
19-Mar-2023,Bill,00.00,"1,232,178.07",00.00
19-Mar-2023,NEFT,46.10,00.00,46.10
19-Mar-2023,Tax,60.00,00.00,106.10
19-Mar-2023,Reversal,160.00,00.00,266.10
19-Mar-2023,Tax,04.40,00.00,270.50
19-Mar-2023,Tax,00.00,67.63,202.88
19-Mar-2023,RTGS,18.00,00.00,220.88
19-Mar-2023,ATM,"605,134.00",00.00,"605,354.88"
19-Mar-2023,Purchase,339.44,00.00,"605,694.32"
19-Mar-2023,Cheque,00.00,"605,694.32",00.00
19-Mar-2023,NEFT,"1,587.40",00.00,"1,587.40"
19-Mar-2023,NEFT,00.00,158.74,"1,428.66"
19-Mar-2023,Purchase,00.00,204.09,"1,224.57"
19-Mar-2023,ATM,00.00,136.06,"1,088.51"
19-Mar-2023,IMPS,00.00,181.42,907.09
19-Mar-2023,IMPS,04.80,00.00,911.89
19-Mar-2023,Debit Card,"19,695.00",00.00,"20,606.89"
19-Mar-2023,NEFT,"2,381.00",00.00,"22,987.89"
19-Mar-2023,Commission,00.00,"11,493.95","11,493.94"
19-Mar-2023,RTGS,02.74,00.00,"11,496.68"
19-Mar-2023,Purchase,"2,730.06",00.00,"14,226.74"
19-Mar-2023,Interest,00.00,"4,742.25","9,484.49"
19-Mar-2023,NEFT,00.00,"2,371.12","7,113.37"
19-Mar-2023,ATM,00.00,"7,113.37",00.00
19-Mar-2023,Cheque,30.00,00.00,30.00
19-Mar-2023,Cash,00.00,03.00,27.00
19-Mar-2023,NEFT,00.00,03.86,23.14
19-Mar-2023,Commission,00.00,03.31,19.83
19-Mar-2023,Miscellaneous,00.00,03.97,15.86
19-Mar-2023,Cash,364.78,00.00,380.64
19-Mar-2023,Reversal,00.00,38.06,342.58
19-Mar-2023,Commission,00.00,57.10,285.48
20-Mar-2023,Cash,16.00,00.00,301.48
20-Mar-2023,ATM,07.00,00.00,308.48
21-Mar-2023,Miscellaneous,00.00,44.07,264.41
21-Mar-2023,Commission,00.00,66.10,198.31
21-Mar-2023,Cash,09.81,00.00,208.12
21-Mar-2023,Bill,295.40,00.00,503.52
21-Mar-2023,Transfer,00.00,71.93,431.59
21-Mar-2023,Cash,00.00,215.80,215.80
21-Mar-2023,NEFT,"3,199.40",00.00,"3,415.20"
21-Mar-2023,Tax,00.00,853.80,"2,561.40"
21-Mar-2023,Cash,"48,195.19",00.00,"50,756.59"
21-Mar-2023,IMPS,"7,525.10",00.00,"58,281.69"
21-Mar-2023,Commission,00.00,"5,828.17","52,453.52"
21-Mar-2023,Transfer,00.00,"10,490.70","41,962.82"
21-Mar-2023,Miscellaneous,"2,247.32",00.00,"44,210.14"
21-Mar-2023,Cash,"1,382.00",00.00,"45,592.14"
21-Mar-2023,ATM,474.64,00.00,"46,066.78"
21-Mar-2023,Debit Card,00.00,"9,213.36","36,853.42"
21-Mar-2023,Cash,00.00,"7,370.68","29,482.74"
21-Mar-2023,Cash,"90,973.91",00.00,"120,456.65"
21-Mar-2023,NEFT,00.00,"30,114.16","90,342.49"
21-Mar-2023,Cash,00.00,"90,342.49",00.00
21-Mar-2023,Cheque,00.10,00.00,00.10
21-Mar-2023,RTGS,"1,478,578.20",00.00,"1,478,578.30"
21-Mar-2023,Miscellaneous,"29,677.00",00.00,"1,508,255.30"
21-Mar-2023,Cheque,00.00,"188,531.91","1,319,723.39"
21-Mar-2023,Transfer,54.00,00.00,"1,319,777.39"
21-Mar-2023,RTGS,"245,474.70",00.00,"1,565,252.09"
21-Mar-2023,Transfer,00.00,"521,750.70","1,043,501.39"
21-Mar-2023,Cheque,"15,506.00",00.00,"1,059,007.39"
21-Mar-2023,Transfer,00.00,"151,286.77","907,720.62"
21-Mar-2023,Bill,590.55,00.00,"908,311.17"
21-Mar-2023,Cash,28.90,00.00,"908,340.07"
21-Mar-2023,NEFT,00.00,"90,834.01","817,506.06"
21-Mar-2023,Purchase,106.00,00.00,"817,612.06"
21-Mar-2023,Transfer,00.00,"136,268.68","681,343.38"
21-Mar-2023,Commission,00.00,"97,334.77","584,008.61"
21-Mar-2023,NEFT,492.40,00.00,"584,501.01"
21-Mar-2023,Interest,15.00,00.00,"584,516.01"
21-Mar-2023,Transfer,"207,519.78",00.00,"792,035.79"
21-Mar-2023,Miscellaneous,00.00,"264,011.93","528,023.86"
21-Mar-2023,Tax,00.00,"52,802.39","475,221.47"
21-Mar-2023,RTGS,"15,638.00",00.00,"490,859.47"
21-Mar-2023,Commission,"217,052.16",00.00,"707,911.63"
21-Mar-2023,Cash,00.00,"88,488.95","619,422.68"
21-Mar-2023,Tax,"137,201.84",00.00,"756,624.52"
21-Mar-2023,IMPS,00.00,"151,324.90","605,299.62"
21-Mar-2023,Cheque,"8,941.00",00.00,"614,240.62"
22-Mar-2023,Miscellaneous,01.33,00.00,"614,241.95"
22-Mar-2023,Purchase,00.00,"61,424.20","552,817.76"
22-Mar-2023,Tax,00.00,"61,424.20","491,393.56"
22-Mar-2023,Cheque,00.00,"49,139.36","442,254.20"
22-Mar-2023,Miscellaneous,00.00,"147,418.07","294,836.13"
22-Mar-2023,ATM,"132,891.00",00.00,"427,727.13"
22-Mar-2023,IMPS,"354,946.50",00.00,"782,673.63"
22-Mar-2023,Purchase,00.00,"130,445.61","652,228.02"
22-Mar-2023,Cheque,"13,824.44",00.00,"666,052.46"
22-Mar-2023,RTGS,"1,933.00",00.00,"667,985.46"
22-Mar-2023,Debit Card,00.00,"66,798.55","601,186.91"
22-Mar-2023,Transfer,00.00,"60,118.69","541,068.22"
23-Mar-2023,Interest,00.00,"60,118.69","480,949.53"
23-Mar-2023,Miscellaneous,00.00,"240,474.77","240,474.76"
23-Mar-2023,IMPS,"14,981.38",00.00,"255,456.14"
23-Mar-2023,IMPS,00.00,"127,728.07","127,728.07"
23-Mar-2023,RTGS,00.00,"25,545.61","102,182.46"
23-Mar-2023,ATM,"222,062.00",00.00,"324,244.46"
23-Mar-2023,ATM,"79,366.44",00.00,"403,610.90"
23-Mar-2023,ATM,"163,370.41",00.00,"566,981.31"
23-Mar-2023,RTGS,00.00,"80,997.33","485,983.98"
23-Mar-2023,IMPS,48.77,00.00,"486,032.75"
23-Mar-2023,NEFT,"1,427,118.50",00.00,"1,913,151.25"
23-Mar-2023,Tax,07.59,00.00,"1,913,158.84"
23-Mar-2023,NEFT,00.00,"212,573.20","1,700,585.64"
23-Mar-2023,Tax,00.00,"188,953.96","1,511,631.68"
23-Mar-2023,IMPS,579.00,00.00,"1,512,210.68"
23-Mar-2023,Purchase,00.00,"252,035.11","1,260,175.57"
23-Mar-2023,Transfer,00.00,"126,017.56","1,134,158.01"
23-Mar-2023,Transfer,00.00,"113,415.80","1,020,742.21"
23-Mar-2023,IMPS,00.00,"204,148.44","816,593.77"
23-Mar-2023,Transfer,00.00,"163,318.75","653,275.02"
23-Mar-2023,Transfer,00.00,"108,879.17","544,395.85"
23-Mar-2023,ATM,07.00,00.00,"544,402.85"
23-Mar-2023,IMPS,02.36,00.00,"544,405.21"
23-Mar-2023,Cheque,"24,968.00",00.00,"569,373.21"
23-Mar-2023,IMPS,00.00,"284,686.61","284,686.60"
23-Mar-2023,Commission,30.68,00.00,"284,717.28"
23-Mar-2023,Reversal,00.00,"40,673.90","244,043.38"
23-Mar-2023,Cheque,00.00,"81,347.79","162,695.59"
23-Mar-2023,IMPS,49.00,00.00,"162,744.59"
23-Mar-2023,NEFT,"1,494,400.00",00.00,"1,657,144.59"
23-Mar-2023,IMPS,"161,199.00",00.00,"1,818,343.59"
23-Mar-2023,Debit Card,00.00,"303,057.27","1,515,286.33"
23-Mar-2023,Reversal,00.00,"505,095.44","1,010,190.89"
23-Mar-2023,Reversal,00.00,"202,038.18","808,152.71"
23-Mar-2023,Tax,00.00,"269,384.24","538,768.47"
23-Mar-2023,Interest,"4,617.00",00.00,"543,385.47"
23-Mar-2023,NEFT,"1,874,026.00",00.00,"2,417,411.47"
23-Mar-2023,Interest,"4,016.00",00.00,"2,421,427.47"
23-Mar-2023,Bill,"185,649.44",00.00,"2,607,076.91"
23-Mar-2023,ATM,00.00,"521,415.38","2,085,661.53"
23-Mar-2023,NEFT,"211,605.00",00.00,"2,297,266.53"
24-Mar-2023,Bill,00.00,"765,755.51","1,531,511.02"
24-Mar-2023,Purchase,00.00,"191,438.88","1,340,072.14"
24-Mar-2023,NEFT,"1,543.10",00.00,"1,341,615.24"
24-Mar-2023,Cheque,"1,264,224.00",00.00,"2,605,839.24"
24-Mar-2023,RTGS,"2,683.00",00.00,"2,608,522.24"
24-Mar-2023,Bill,00.00,"434,753.71","2,173,768.53"
24-Mar-2023,NEFT,00.00,"1,086,884.27","1,086,884.26"
24-Mar-2023,IMPS,01.00,00.00,"1,086,885.26"
24-Mar-2023,Tax,"12,350.98",00.00,"1,099,236.24"
24-Mar-2023,Tax,394.00,00.00,"1,099,630.24"
24-Mar-2023,Cheque,02.40,00.00,"1,099,632.64"
24-Mar-2023,ATM,06.47,00.00,"1,099,639.11"
24-Mar-2023,Commission,"245,186.00",00.00,"1,344,825.11"
24-Mar-2023,ATM,"810,295.50",00.00,"2,155,120.61"
24-Mar-2023,NEFT,00.00,"307,874.37","1,847,246.24"
24-Mar-2023,ATM,00.00,"205,249.58","1,641,996.66"
24-Mar-2023,Miscellaneous,"1,416,452.75",00.00,"3,058,449.41"
24-Mar-2023,RTGS,35.00,00.00,"3,058,484.41"
24-Mar-2023,Reversal,"2,258.70",00.00,"3,060,743.11"
24-Mar-2023,IMPS,00.00,"437,249.02","2,623,494.09"
24-Mar-2023,NEFT,"8,866.37",00.00,"2,632,360.46"
25-Mar-2023,RTGS,00.00,"376,051.49","2,256,308.97"
25-Mar-2023,Bill,"1,389.93",00.00,"2,257,698.90"
25-Mar-2023,ATM,00.00,"225,769.89","2,031,929.01"
25-Mar-2023,Purchase,00.00,"677,309.67","1,354,619.34"
25-Mar-2023,Tax,"207,937.00",00.00,"1,562,556.34"
25-Mar-2023,Bill,00.00,"1,562,556.34",00.00
25-Mar-2023,Purchase,324.00,00.00,324.00
25-Mar-2023,Bill,184.40,00.00,508.40
25-Mar-2023,Bill,11.10,00.00,519.50
25-Mar-2023,Commission,00.00,74.21,445.29
25-Mar-2023,Miscellaneous,00.00,63.61,381.68
25-Mar-2023,Reversal,"11,196.30",00.00,"11,577.98"
25-Mar-2023,Debit Card,"1,213.68",00.00,"12,791.66"
25-Mar-2023,RTGS,00.00,"1,421.30","11,370.36"
25-Mar-2023,Transfer,00.00,"2,842.59","8,527.77"
25-Mar-2023,Commission,00.00,"4,263.89","4,263.88"
25-Mar-2023,Debit Card,"3,439.74",00.00,"7,703.62"
25-Mar-2023,Tax,00.00,"1,925.91","5,777.72"
25-Mar-2023,NEFT,412.82,00.00,"6,190.54"
25-Mar-2023,Purchase,38.90,00.00,"6,229.44"
26-Mar-2023,Transfer,00.00,"3,114.72","3,114.72"
26-Mar-2023,Reversal,00.00,778.68,"2,336.04"
26-Mar-2023,NEFT,"1,492,398.00",00.00,"1,494,734.04"
26-Mar-2023,ATM,"27,804.70",00.00,"1,522,538.74"
26-Mar-2023,Transfer,00.00,"152,253.87","1,370,284.87"
26-Mar-2023,IMPS,"805,199.20",00.00,"2,175,484.07"
27-Mar-2023,NEFT,00.00,"217,548.41","1,957,935.66"
27-Mar-2023,RTGS,00.00,"217,548.41","1,740,387.25"
27-Mar-2023,Commission,00.00,"435,096.81","1,305,290.44"
27-Mar-2023,Tax,149.00,00.00,"1,305,439.44"
27-Mar-2023,Miscellaneous,00.00,"130,543.94","1,174,895.50"
27-Mar-2023,ATM,57.34,00.00,"1,174,952.84"
27-Mar-2023,Debit Card,00.00,"130,550.32","1,044,402.52"
27-Mar-2023,Debit Card,00.00,"522,201.26","522,201.26"
27-Mar-2023,Cash,00.00,"58,022.36","464,178.90"
27-Mar-2023,Commission,65.31,00.00,"464,244.21"
27-Mar-2023,Debit Card,00.00,"58,030.53","406,213.68"
27-Mar-2023,Bill,"984,952.20",00.00,"1,391,165.88"
27-Mar-2023,Cheque,03.09,00.00,"1,391,168.97"
27-Mar-2023,Bill,00.00,"139,116.90","1,252,052.07"
27-Mar-2023,Commission,00.00,"250,410.41","1,001,641.66"
27-Mar-2023,Bill,00.20,00.00,"1,001,641.86"
27-Mar-2023,Debit Card,489.08,00.00,"1,002,130.94"
27-Mar-2023,Reversal,00.00,"125,266.37","876,864.57"
27-Mar-2023,Reversal,"251,446.80",00.00,"1,128,311.37"
27-Mar-2023,Transfer,22.50,00.00,"1,128,333.87"
27-Mar-2023,Miscellaneous,00.00,"141,041.73","987,292.14"
27-Mar-2023,RTGS,00.00,"987,292.14",00.00
27-Mar-2023,Tax,"1,303,249.50",00.00,"1,303,249.50"
27-Mar-2023,Bill,00.00,"144,805.50","1,158,444.00"
27-Mar-2023,Cash,322.00,00.00,"1,158,766.00"
27-Mar-2023,IMPS,"98,302.00",00.00,"1,257,068.00"
27-Mar-2023,ATM,"14,414.00",00.00,"1,271,482.00"
27-Mar-2023,IMPS,00.00,"254,296.40","1,017,185.60"
27-Mar-2023,Miscellaneous,00.00,"1,017,185.60",00.00
27-Mar-2023,Cheque,25.10,00.00,25.10
28-Mar-2023,RTGS,00.00,03.59,21.51
29-Mar-2023,Debit Card,05.20,00.00,26.71
29-Mar-2023,IMPS,02.00,00.00,28.71
29-Mar-2023,Cheque,00.00,03.59,25.12
29-Mar-2023,Tax,338.00,00.00,363.12
29-Mar-2023,ATM,"370,346.20",00.00,"370,709.32"
29-Mar-2023,Commission,00.00,"123,569.77","247,139.55"
29-Mar-2023,Commission,00.00,"61,784.89","185,354.66"
29-Mar-2023,Debit Card,"3,821.75",00.00,"189,176.41"
29-Mar-2023,Purchase,00.00,"27,025.20","162,151.21"
29-Mar-2023,ATM,45.29,00.00,"162,196.50"
29-Mar-2023,NEFT,00.00,"16,219.65","145,976.85"
29-Mar-2023,Interest,63.50,00.00,"146,040.35"
29-Mar-2023,Bill,"8,472.00",00.00,"154,512.35"
29-Mar-2023,Bill,00.00,"15,451.24","139,061.12"
29-Mar-2023,Purchase,00.00,"19,865.87","119,195.25"
29-Mar-2023,Debit Card,"73,906.40",00.00,"193,101.65"
29-Mar-2023,RTGS,"11,326.80",00.00,"204,428.45"
29-Mar-2023,Interest,03.00,00.00,"204,431.45"
29-Mar-2023,NEFT,00.00,"51,107.86","153,323.59"
29-Mar-2023,RTGS,00.00,"25,553.93","127,769.66"
29-Mar-2023,Interest,06.30,00.00,"127,775.96"
29-Mar-2023,RTGS,337.81,00.00,"128,113.77"
29-Mar-2023,ATM,00.00,"42,704.59","85,409.18"
29-Mar-2023,Miscellaneous,332.90,00.00,"85,742.08"
29-Mar-2023,Interest,04.27,00.00,"85,746.35"
29-Mar-2023,Tax,00.00,"17,149.27","68,597.08"
29-Mar-2023,Interest,00.00,"13,719.42","54,877.66"
29-Mar-2023,Transfer,"9,391.57",00.00,"64,269.23"
29-Mar-2023,Cheque,01.10,00.00,"64,270.33"
30-Mar-2023,Transfer,00.00,"12,854.07","51,416.26"
30-Mar-2023,Debit Card,00.00,"12,854.07","38,562.20"
30-Mar-2023,NEFT,"562,496.00",00.00,"601,058.20"
30-Mar-2023,NEFT,"446,591.20",00.00,"1,047,649.40"
30-Mar-2023,Debit Card,"154,465.00",00.00,"1,202,114.40"
30-Mar-2023,RTGS,06.74,00.00,"1,202,121.14"
30-Mar-2023,Interest,539.00,00.00,"1,202,660.14"
30-Mar-2023,NEFT,00.00,"120,266.01","1,082,394.13"
30-Mar-2023,Commission,"99,850.50",00.00,"1,182,244.63"
30-Mar-2023,Commission,"1,428.94",00.00,"1,183,673.57"
30-Mar-2023,IMPS,00.00,"169,096.22","1,014,577.35"
30-Mar-2023,Bill,00.00,"144,939.62","869,637.73"
30-Mar-2023,RTGS,00.00,"289,879.24","579,758.49"
30-Mar-2023,Interest,215.80,00.00,"579,974.29"
30-Mar-2023,IMPS,00.00,"289,987.15","289,987.14"
30-Mar-2023,NEFT,00.00,"144,993.57","144,993.57"
30-Mar-2023,Reversal,00.00,"14,499.36","130,494.21"
30-Mar-2023,Transfer,14.31,00.00,"130,508.52"
30-Mar-2023,NEFT,00.00,"26,101.70","104,406.82"
30-Mar-2023,Debit Card,00.00,"26,101.71","78,305.12"
30-Mar-2023,Cash,00.00,"19,576.28","58,728.84"
30-Mar-2023,Reversal,"183,723.09",00.00,"242,451.93"
30-Mar-2023,Interest,00.00,"30,306.49","212,145.44"
30-Mar-2023,IMPS,00.00,"26,518.18","185,627.26"
30-Mar-2023,Purchase,"195,512.00",00.00,"381,139.26"
30-Mar-2023,Interest,00.00,"95,284.82","285,854.44"
30-Mar-2023,Tax,"1,417,601.50",00.00,"1,703,455.94"
30-Mar-2023,Commission,00.00,"1,703,455.94",00.00
30-Mar-2023,Bill,"10,477.00",00.00,"10,477.00"
30-Mar-2023,RTGS,00.00,"1,746.17","8,730.83"
30-Mar-2023,Debit Card,00.00,"1,746.17","6,984.66"
30-Mar-2023,Reversal,00.00,"1,746.17","5,238.50"
30-Mar-2023,Debit Card,00.00,654.81,"4,583.69"
30-Mar-2023,ATM,00.00,"1,145.92","3,437.77"
30-Mar-2023,IMPS,00.00,572.96,"2,864.81"
30-Mar-2023,Bill,"3,400.05",00.00,"6,264.86"
30-Mar-2023,IMPS,"1,356,513.00",00.00,"1,362,777.86"
30-Mar-2023,Purchase,00.00,"194,682.55","1,168,095.31"
30-Mar-2023,Reversal,13.40,00.00,"1,168,108.71"
30-Mar-2023,Purchase,"100,603.00",00.00,"1,268,711.71"
30-Mar-2023,Purchase,00.00,"1,268,711.71",00.00
30-Mar-2023,Transfer,"22,164.00",00.00,"22,164.00"
30-Mar-2023,IMPS,00.00,"3,166.29","18,997.71"
30-Mar-2023,Miscellaneous,00.00,"2,110.86","16,886.85"
30-Mar-2023,Reversal,00.00,"8,443.43","8,443.42"
30-Mar-2023,Transfer,158.82,00.00,"8,602.24"
30-Mar-2023,Tax,00.00,"8,602.24",00.00
30-Mar-2023,Cash,"27,373.00",00.00,"27,373.00"
30-Mar-2023,Tax,"7,242.50",00.00,"34,615.50"
30-Mar-2023,Reversal,59.30,00.00,"34,674.80"
30-Mar-2023,Reversal,"20,609.00",00.00,"55,283.80"
30-Mar-2023,IMPS,00.00,"6,910.48","48,373.32"
30-Mar-2023,Reversal,00.00,"5,374.81","42,998.51"
30-Mar-2023,RTGS,00.00,"6,142.64","36,855.87"
30-Mar-2023,Cash,00.00,"9,213.97","27,641.90"
30-Mar-2023,Purchase,00.00,"3,071.32","24,570.58"
30-Mar-2023,Interest,00.00,"3,071.32","21,499.26"
30-Mar-2023,Commission,00.00,"21,499.26",00.00
30-Mar-2023,Bill,229.80,00.00,229.80
30-Mar-2023,Bill,00.00,76.60,153.20
30-Mar-2023,Debit Card,00.00,15.32,137.88
30-Mar-2023,RTGS,00.00,34.47,103.41
30-Mar-2023,IMPS,06.00,00.00,109.41
30-Mar-2023,RTGS,05.90,00.00,115.31
30-Mar-2023,ATM,00.00,16.47,98.84
30-Mar-2023,Cheque,19.00,00.00,117.84
30-Mar-2023,NEFT,"11,872.00",00.00,"11,989.84"
30-Mar-2023,Reversal,00.00,"3,996.61","7,993.23"
30-Mar-2023,Commission,95.20,00.00,"8,088.43"
30-Mar-2023,Reversal,00.00,"2,696.14","5,392.29"
30-Mar-2023,Interest,04.15,00.00,"5,396.44"
30-Mar-2023,Reversal,00.00,"1,798.81","3,597.63"
30-Mar-2023,Reversal,"295,428.00",00.00,"299,025.63"
30-Mar-2023,Debit Card,00.00,"299,025.63",00.00
30-Mar-2023,Miscellaneous,435.00,00.00,435.00
30-Mar-2023,Cash,00.00,217.50,217.50
30-Mar-2023,ATM,"57,181.90",00.00,"57,399.40"
30-Mar-2023,Commission,23.04,00.00,"57,422.44"
30-Mar-2023,Cash,00.00,"11,484.49","45,937.95"
30-Mar-2023,Interest,63.10,00.00,"46,001.05"
30-Mar-2023,Tax,33.60,00.00,"46,034.65"
30-Mar-2023,Reversal,00.00,"46,034.65",00.00
30-Mar-2023,Commission,"168,243.44",00.00,"168,243.44"
30-Mar-2023,Commission,00.00,"42,060.86","126,182.58"
30-Mar-2023,Miscellaneous,00.00,"63,091.29","63,091.29"
30-Mar-2023,Interest,08.60,00.00,"63,099.89"
30-Mar-2023,ATM,"37,730.81",00.00,"100,830.70"
30-Mar-2023,Debit Card,"163,640.00",00.00,"264,470.70"
30-Mar-2023,Reversal,00.00,"44,078.45","220,392.25"
30-Mar-2023,Debit Card,"1,140.30",00.00,"221,532.55"
30-Mar-2023,Purchase,05.75,00.00,"221,538.30"
30-Mar-2023,Miscellaneous,00.00,"27,692.29","193,846.01"
30-Mar-2023,Miscellaneous,00.00,"96,923.01","96,923.00"
30-Mar-2023,NEFT,00.00,"10,769.22","86,153.78"
30-Mar-2023,IMPS,"1,828,076.50",00.00,"1,914,230.28"
30-Mar-2023,Tax,"3,120.60",00.00,"1,917,350.88"
30-Mar-2023,Reversal,02.59,00.00,"1,917,353.47"
30-Mar-2023,IMPS,"3,534.00",00.00,"1,920,887.47"
30-Mar-2023,Reversal,"652,615.50",00.00,"2,573,502.97"
30-Mar-2023,Commission,00.00,"857,834.32","1,715,668.65"
30-Mar-2023,ATM,00.00,"171,566.87","1,544,101.78"
30-Mar-2023,NEFT,"1,149,333.00",00.00,"2,693,434.78"
30-Mar-2023,Debit Card,"1,838.60",00.00,"2,695,273.38"
30-Mar-2023,Miscellaneous,11.07,00.00,"2,695,284.45"
30-Mar-2023,Purchase,16.60,00.00,"2,695,301.05"
30-Mar-2023,Miscellaneous,00.00,"898,433.68","1,796,867.37"
30-Mar-2023,Reversal,00.00,"199,651.93","1,597,215.44"
30-Mar-2023,Interest,431.00,00.00,"1,597,646.44"
30-Mar-2023,Debit Card,01.81,00.00,"1,597,648.25"
30-Mar-2023,Reversal,00.00,"399,412.06","1,198,236.19"
30-Mar-2023,IMPS,00.00,"119,823.62","1,078,412.57"
30-Mar-2023,Miscellaneous,"195,086.03",00.00,"1,273,498.60"
30-Mar-2023,Tax,00.00,"212,249.77","1,061,248.83"
31-Mar-2023,Tax,00.00,"353,749.61","707,499.22"
31-Mar-2023,Commission,00.00,"235,833.07","471,666.15"
31-Mar-2023,IMPS,00.00,"52,407.35","419,258.80"
31-Mar-2023,Cash,00.30,00.00,"419,259.10"
31-Mar-2023,Purchase,03.58,00.00,"419,262.68"
31-Mar-2023,Reversal,00.00,"46,584.74","372,677.94"
01-Apr-2023,Reversal,08.00,00.00,"372,685.94"
01-Apr-2023,Tax,"1,478,728.00",00.00,"1,851,413.94"
01-Apr-2023,Bill,00.00,"264,487.71","1,586,926.23"
01-Apr-2023,ATM,00.00,"528,975.41","1,057,950.82"
01-Apr-2023,RTGS,00.00,"264,487.71","793,463.12"
01-Apr-2023,Interest,"2,802.00",00.00,"796,265.12"
01-Apr-2023,Interest,00.00,"132,710.85","663,554.27"
02-Apr-2023,Miscellaneous,00.00,"110,592.38","552,961.89"
02-Apr-2023,ATM,00.00,"276,480.95","276,480.94"
02-Apr-2023,Miscellaneous,"2,127.00",00.00,"278,607.94"
02-Apr-2023,Miscellaneous,00.00,"30,956.44","247,651.50"
02-Apr-2023,Miscellaneous,00.00,"123,825.75","123,825.75"
02-Apr-2023,Debit Card,00.00,"24,765.15","99,060.60"
03-Apr-2023,IMPS,"2,901.20",00.00,"101,961.80"
03-Apr-2023,Purchase,00.00,"25,490.45","76,471.35"
03-Apr-2023,Commission,"3,646.41",00.00,"80,117.76"
03-Apr-2023,Purchase,00.30,00.00,"80,118.06"
03-Apr-2023,ATM,00.00,"26,706.02","53,412.04"
03-Apr-2023,ATM,00.00,"53,412.04",00.00
03-Apr-2023,Miscellaneous,"1,198,133.50",00.00,"1,198,133.50"
03-Apr-2023,Tax,36.00,00.00,"1,198,169.50"
03-Apr-2023,Purchase,00.00,"119,816.95","1,078,352.55"
03-Apr-2023,Transfer,00.00,"107,835.26","970,517.30"
03-Apr-2023,NEFT,"16,961.76",00.00,"987,479.06"
03-Apr-2023,Miscellaneous,"1,835.50",00.00,"989,314.56"
03-Apr-2023,RTGS,10.90,00.00,"989,325.46"
03-Apr-2023,Debit Card,"5,029.10",00.00,"994,354.56"
03-Apr-2023,Bill,00.00,"994,354.56",00.00
03-Apr-2023,Tax,"26,421.41",00.00,"26,421.41"
03-Apr-2023,Miscellaneous,"653,653.00",00.00,"680,074.41"
03-Apr-2023,RTGS,372.36,00.00,"680,446.77"
03-Apr-2023,ATM,00.00,"340,223.39","340,223.38"
03-Apr-2023,Purchase,"2,201.00",00.00,"342,424.38"
03-Apr-2023,Miscellaneous,00.00,"342,424.38",00.00
03-Apr-2023,Commission,"52,939.75",00.00,"52,939.75"
03-Apr-2023,Cash,00.00,"6,617.47","46,322.28"
04-Apr-2023,Miscellaneous,54.12,00.00,"46,376.40"
04-Apr-2023,IMPS,02.00,00.00,"46,378.40"
04-Apr-2023,Bill,00.00,"15,459.47","30,918.93"
04-Apr-2023,Commission,00.00,"4,416.99","26,501.94"
04-Apr-2023,Interest,00.00,"3,785.99","22,715.95"
04-Apr-2023,Debit Card,"3,628.80",00.00,"26,344.75"
04-Apr-2023,RTGS,449.00,00.00,"26,793.75"
04-Apr-2023,Debit Card,00.00,"3,349.22","23,444.53"
04-Apr-2023,Bill,417.90,00.00,"23,862.43"
04-Apr-2023,Miscellaneous,00.00,"11,931.22","11,931.22"
04-Apr-2023,Cash,19.00,00.00,"11,950.22"
04-Apr-2023,RTGS,00.00,"1,327.80","10,622.42"
04-Apr-2023,Cash,04.40,00.00,"10,626.82"
04-Apr-2023,Interest,00.00,"1,328.35","9,298.47"
04-Apr-2023,Bill,00.00,"4,649.24","4,649.23"
04-Apr-2023,Reversal,00.00,664.18,"3,985.05"
04-Apr-2023,Miscellaneous,00.00,"1,328.35","2,656.70"
04-Apr-2023,Cheque,"32,737.86",00.00,"35,394.56"
04-Apr-2023,Commission,07.81,00.00,"35,402.37"
04-Apr-2023,Reversal,"1,615,048.50",00.00,"1,650,450.87"
04-Apr-2023,IMPS,00.00,"165,045.09","1,485,405.78"
04-Apr-2023,Interest,00.00,"1,485,405.78",00.00
04-Apr-2023,Miscellaneous,"149,964.00",00.00,"149,964.00"
04-Apr-2023,Miscellaneous,00.00,"149,964.00",00.00
04-Apr-2023,RTGS,46.90,00.00,46.90
04-Apr-2023,NEFT,44.29,00.00,91.19
04-Apr-2023,Cash,00.00,13.03,78.16
05-Apr-2023,Miscellaneous,"233,923.81",00.00,"234,001.97"
05-Apr-2023,Interest,00.00,"117,000.99","117,000.98"
05-Apr-2023,Cash,"112,447.00",00.00,"229,447.98"
05-Apr-2023,Bill,00.00,"229,447.98",00.00
05-Apr-2023,Commission,00.00,00.00,00.00
05-Apr-2023,Debit Card,60.85,00.00,60.85
05-Apr-2023,RTGS,288.52,00.00,349.37
05-Apr-2023,Tax,00.00,43.67,305.70
05-Apr-2023,Commission,"3,171.00",00.00,"3,476.70"
05-Apr-2023,Debit Card,00.00,695.34,"2,781.36"
05-Apr-2023,Debit Card,00.00,309.04,"2,472.32"
05-Apr-2023,Interest,00.00,274.70,"2,197.62"
05-Apr-2023,NEFT,06.12,00.00,"2,203.74"
05-Apr-2023,Transfer,"3,859.00",00.00,"6,062.74"
05-Apr-2023,Interest,80.10,00.00,"6,142.84"
05-Apr-2023,Purchase,02.00,00.00,"6,144.84"
05-Apr-2023,Miscellaneous,00.00,"2,048.28","4,096.56"
05-Apr-2023,ATM,"939,730.25",00.00,"943,826.81"
05-Apr-2023,Commission,05.00,00.00,"943,831.81"
05-Apr-2023,Miscellaneous,"10,641.75",00.00,"954,473.56"
05-Apr-2023,Cash,06.20,00.00,"954,479.76"
05-Apr-2023,NEFT,62.00,00.00,"954,541.76"
05-Apr-2023,RTGS,"1,081.00",00.00,"955,622.76"
05-Apr-2023,ATM,00.00,"477,811.38","477,811.38"
06-Apr-2023,Miscellaneous,00.00,"95,562.28","382,249.10"
06-Apr-2023,Reversal,"27,527.00",00.00,"409,776.10"
06-Apr-2023,NEFT,00.00,"45,530.68","364,245.42"
06-Apr-2023,Reversal,"64,366.70",00.00,"428,612.12"
06-Apr-2023,Purchase,06.00,00.00,"428,618.12"
06-Apr-2023,Bill,"1,132,763.00",00.00,"1,561,381.12"
06-Apr-2023,ATM,"3,804.50",00.00,"1,565,185.62"
06-Apr-2023,Transfer,"1,745,384.80",00.00,"3,310,570.42"
06-Apr-2023,Commission,00.00,"413,821.30","2,896,749.12"
06-Apr-2023,IMPS,00.00,"482,791.52","2,413,957.60"
06-Apr-2023,Interest,"1,909.41",00.00,"2,415,867.01"
06-Apr-2023,Tax,"141,983.47",00.00,"2,557,850.48"
06-Apr-2023,Debit Card,394.00,00.00,"2,558,244.48"
06-Apr-2023,Reversal,00.00,"511,648.90","2,046,595.58"
06-Apr-2023,Reversal,28.00,00.00,"2,046,623.58"
06-Apr-2023,Bill,00.00,"227,402.62","1,819,220.96"
06-Apr-2023,Bill,00.00,"227,402.62","1,591,818.34"
06-Apr-2023,Debit Card,00.90,00.00,"1,591,819.24"
06-Apr-2023,Commission,00.00,"530,606.41","1,061,212.83"
06-Apr-2023,Purchase,00.00,"212,242.57","848,970.26"
06-Apr-2023,Cheque,"31,210.62",00.00,"880,180.88"
06-Apr-2023,Transfer,00.00,"125,740.13","754,440.75"
06-Apr-2023,Purchase,00.00,"188,610.19","565,830.56"
06-Apr-2023,Commission,"30,663.82",00.00,"596,494.38"
06-Apr-2023,Reversal,"562,850.50",00.00,"1,159,344.88"
06-Apr-2023,Commission,00.00,"231,868.98","927,475.90"
06-Apr-2023,Debit Card,00.00,"185,495.18","741,980.72"
06-Apr-2023,Miscellaneous,"80,369.00",00.00,"822,349.72"
06-Apr-2023,IMPS,"214,728.00",00.00,"1,037,077.72"
06-Apr-2023,RTGS,00.00,"207,415.54","829,662.18"
06-Apr-2023,Purchase,"14,672.60",00.00,"844,334.78"
06-Apr-2023,Reversal,02.21,00.00,"844,336.99"
06-Apr-2023,ATM,"886,136.00",00.00,"1,730,472.99"
06-Apr-2023,Cash,"1,170,128.25",00.00,"2,900,601.24"
06-Apr-2023,Interest,03.90,00.00,"2,900,605.14"
06-Apr-2023,Tax,00.00,"290,060.51","2,610,544.63"
06-Apr-2023,ATM,"26,122.44",00.00,"2,636,667.07"
06-Apr-2023,Commission,"9,009.80",00.00,"2,645,676.87"
06-Apr-2023,Purchase,00.00,"330,709.61","2,314,967.26"
06-Apr-2023,Cheque,"41,344.09",00.00,"2,356,311.35"
06-Apr-2023,Purchase,04.60,00.00,"2,356,315.95"
06-Apr-2023,Debit Card,00.00,"471,263.19","1,885,052.76"
06-Apr-2023,Commission,"31,246.62",00.00,"1,916,299.38"
06-Apr-2023,Commission,00.00,"638,766.46","1,277,532.92"
06-Apr-2023,NEFT,"1,624,297.50",00.00,"2,901,830.42"
06-Apr-2023,Interest,00.00,"2,901,830.42",00.00
06-Apr-2023,IMPS,39.60,00.00,39.60
06-Apr-2023,Debit Card,00.00,19.80,19.80
06-Apr-2023,Transfer,00.00,04.95,14.85
06-Apr-2023,Cash,00.00,02.48,12.38
06-Apr-2023,Reversal,51.95,00.00,64.33
06-Apr-2023,Purchase,00.00,16.08,48.25
06-Apr-2023,NEFT,"155,647.50",00.00,"155,695.75"
06-Apr-2023,RTGS,00.00,"25,949.29","129,746.46"
06-Apr-2023,Transfer,"1,112,521.00",00.00,"1,242,267.46"
06-Apr-2023,Miscellaneous,00.00,"1,242,267.46",00.00
06-Apr-2023,Cheque,35.00,00.00,35.00
06-Apr-2023,Miscellaneous,227.00,00.00,262.00
06-Apr-2023,Bill,00.00,87.33,174.67
06-Apr-2023,IMPS,00.00,19.41,155.26
06-Apr-2023,IMPS,"15,702.30",00.00,"15,857.56"
06-Apr-2023,NEFT,"1,323.00",00.00,"17,180.56"
06-Apr-2023,Transfer,02.40,00.00,"17,182.96"
06-Apr-2023,Purchase,21.86,00.00,"17,204.82"
06-Apr-2023,Cash,02.58,00.00,"17,207.40"
06-Apr-2023,Bill,06.01,00.00,"17,213.41"
06-Apr-2023,Transfer,313.70,00.00,"17,527.11"
06-Apr-2023,Cheque,00.00,"4,381.78","13,145.33"
06-Apr-2023,Tax,06.00,00.00,"13,151.33"
06-Apr-2023,Interest,00.00,"1,878.76","11,272.57"
06-Apr-2023,Reversal,00.00,"1,127.26","10,145.31"
06-Apr-2023,Cash,00.00,"2,536.33","7,608.98"
06-Apr-2023,Reversal,00.00,"7,608.98",00.00
06-Apr-2023,Interest,"159,913.78",00.00,"159,913.78"
06-Apr-2023,IMPS,00.00,"22,844.83","137,068.95"
06-Apr-2023,Interest,00.00,"15,229.88","121,839.07"
06-Apr-2023,Commission,"3,182.00",00.00,"125,021.07"
06-Apr-2023,Tax,00.00,"25,004.21","100,016.86"
06-Apr-2023,Purchase,00.00,"11,112.98","88,903.88"
06-Apr-2023,Cheque,"17,475.48",00.00,"106,379.36"
06-Apr-2023,Interest,999.49,00.00,"107,378.85"
06-Apr-2023,Interest,00.00,"26,844.71","80,534.14"
06-Apr-2023,Transfer,938.48,00.00,"81,472.62"
06-Apr-2023,Purchase,00.00,"16,294.52","65,178.10"
06-Apr-2023,Tax,00.00,"7,242.01","57,936.09"
06-Apr-2023,Debit Card,00.00,"8,276.58","49,659.51"
07-Apr-2023,Transfer,"1,800.81",00.00,"51,460.32"
07-Apr-2023,Bill,00.00,"10,292.06","41,168.26"
07-Apr-2023,NEFT,54.00,00.00,"41,222.26"
07-Apr-2023,NEFT,00.00,"41,222.26",00.00
08-Apr-2023,Commission,"17,839.70",00.00,"17,839.70"
08-Apr-2023,Transfer,370.00,00.00,"18,209.70"
08-Apr-2023,Debit Card,00.00,"3,034.95","15,174.75"
08-Apr-2023,RTGS,"15,868.00",00.00,"31,042.75"
08-Apr-2023,Tax,36.62,00.00,"31,079.37"
08-Apr-2023,Miscellaneous,00.00,"10,359.79","20,719.58"
08-Apr-2023,NEFT,480.38,00.00,"21,199.96"
08-Apr-2023,NEFT,"121,344.03",00.00,"142,543.99"
08-Apr-2023,Interest,00.00,"142,543.99",00.00
08-Apr-2023,Reversal,"619,198.00",00.00,"619,198.00"
08-Apr-2023,Tax,"13,100.05",00.00,"632,298.05"
08-Apr-2023,ATM,00.00,"105,383.01","526,915.04"
08-Apr-2023,Debit Card,00.00,"175,638.35","351,276.69"
08-Apr-2023,Bill,428.10,00.00,"351,704.79"
08-Apr-2023,Tax,445.00,00.00,"352,149.79"
08-Apr-2023,Transfer,"210,876.80",00.00,"563,026.59"
08-Apr-2023,Transfer,00.00,"187,675.53","375,351.06"
08-Apr-2023,ATM,"281,155.75",00.00,"656,506.81"
08-Apr-2023,Tax,"137,971.00",00.00,"794,477.81"
08-Apr-2023,NEFT,00.00,"132,412.97","662,064.84"
08-Apr-2023,NEFT,"1,781,699.00",00.00,"2,443,763.84"
08-Apr-2023,ATM,"22,867.90",00.00,"2,466,631.74"
08-Apr-2023,RTGS,"1,019.70",00.00,"2,467,651.44"
08-Apr-2023,Reversal,00.00,"493,530.29","1,974,121.15"
08-Apr-2023,Cheque,145.00,00.00,"1,974,266.15"
08-Apr-2023,NEFT,00.00,"394,853.23","1,579,412.92"
08-Apr-2023,Miscellaneous,00.00,"789,706.46","789,706.46"
08-Apr-2023,Tax,00.00,"157,941.29","631,765.17"
08-Apr-2023,Debit Card,00.00,"70,196.13","561,569.04"
08-Apr-2023,Bill,"3,378.00",00.00,"564,947.04"
08-Apr-2023,NEFT,00.00,"56,494.70","508,452.34"
08-Apr-2023,Bill,00.10,00.00,"508,452.44"
08-Apr-2023,Bill,00.00,"254,226.22","254,226.22"
08-Apr-2023,Purchase,00.00,"36,318.03","217,908.19"
08-Apr-2023,Bill,"174,472.70",00.00,"392,380.89"
08-Apr-2023,Tax,00.00,"56,054.41","336,326.48"
08-Apr-2023,ATM,"27,055.00",00.00,"363,381.48"
08-Apr-2023,Miscellaneous,00.00,"60,563.58","302,817.90"
08-Apr-2023,Tax,00.00,"302,817.90",00.00
09-Apr-2023,Debit Card,"870,040.25",00.00,"870,040.25"
09-Apr-2023,Interest,00.00,"174,008.05","696,032.20"
09-Apr-2023,Interest,31.00,00.00,"696,063.20"
09-Apr-2023,Miscellaneous,00.00,"77,340.36","618,722.84"
09-Apr-2023,Transfer,00.00,"103,120.47","515,602.37"
09-Apr-2023,Miscellaneous,00.00,"103,120.47","412,481.90"
09-Apr-2023,Bill,00.00,"137,493.97","274,987.93"
09-Apr-2023,Purchase,00.00,"30,554.21","244,433.72"
09-Apr-2023,Tax,393.91,00.00,"244,827.63"
09-Apr-2023,Bill,"1,293,872.00",00.00,"1,538,699.63"
09-Apr-2023,Transfer,00.00,"170,966.63","1,367,733.00"
09-Apr-2023,RTGS,"25,323.77",00.00,"1,393,056.77"
09-Apr-2023,IMPS,481.50,00.00,"1,393,538.27"
09-Apr-2023,NEFT,00.00,"278,707.65","1,114,830.62"
09-Apr-2023,ATM,00.00,"278,707.66","836,122.97"
09-Apr-2023,Cheque,00.76,00.00,"836,123.73"
09-Apr-2023,Bill,00.00,"167,224.75","668,898.98"
09-Apr-2023,Tax,00.00,"83,612.37","585,286.61"
09-Apr-2023,RTGS,"83,297.80",00.00,"668,584.41"
09-Apr-2023,Miscellaneous,00.00,"111,430.74","557,153.68"
09-Apr-2023,Reversal,06.79,00.00,"557,160.47"
09-Apr-2023,NEFT,"118,570.00",00.00,"675,730.47"
09-Apr-2023,Tax,00.00,"67,573.05","608,157.42"
09-Apr-2023,Interest,00.00,"101,359.57","506,797.85"
09-Apr-2023,Interest,615.00,00.00,"507,412.85"
09-Apr-2023,Interest,"29,750.40",00.00,"537,163.25"
09-Apr-2023,Interest,00.00,"107,432.65","429,730.60"
09-Apr-2023,RTGS,00.00,"61,390.09","368,340.51"
09-Apr-2023,Commission,"17,193.00",00.00,"385,533.51"
09-Apr-2023,Cash,00.00,"96,383.38","289,150.13"
09-Apr-2023,Debit Card,"3,315.00",00.00,"292,465.13"
09-Apr-2023,ATM,20.30,00.00,"292,485.43"
09-Apr-2023,Miscellaneous,"183,462.03",00.00,"475,947.46"
09-Apr-2023,Interest,00.00,"79,324.58","396,622.88"
09-Apr-2023,Purchase,00.00,"56,660.41","339,962.47"
09-Apr-2023,NEFT,00.00,"33,996.25","305,966.22"
09-Apr-2023,Commission,00.00,"61,193.24","244,772.98"
09-Apr-2023,Cheque,00.00,"81,590.99","163,181.99"
09-Apr-2023,Transfer,00.00,"32,636.40","130,545.59"
09-Apr-2023,IMPS,00.00,"16,318.20","114,227.39"
09-Apr-2023,Cash,"1,043.50",00.00,"115,270.89"
10-Apr-2023,Reversal,"106,209.00",00.00,"221,479.89"
10-Apr-2023,Commission,06.59,00.00,"221,486.48"
10-Apr-2023,Miscellaneous,00.00,"73,828.83","147,657.65"
10-Apr-2023,Tax,00.00,"29,531.53","118,126.12"
10-Apr-2023,IMPS,"8,398.00",00.00,"126,524.12"
10-Apr-2023,Reversal,"101,029.00",00.00,"227,553.12"
10-Apr-2023,NEFT,00.00,"37,925.52","189,627.60"
10-Apr-2023,Tax,"52,847.53",00.00,"242,475.13"
10-Apr-2023,Interest,19.67,00.00,"242,494.80"
10-Apr-2023,Miscellaneous,00.00,"242,494.80",00.00
10-Apr-2023,IMPS,"1,901,920.00",00.00,"1,901,920.00"
10-Apr-2023,RTGS,273.70,00.00,"1,902,193.70"
10-Apr-2023,Debit Card,00.00,"1,902,193.70",00.00
10-Apr-2023,Bill,29.00,00.00,29.00
10-Apr-2023,Purchase,00.00,05.80,23.20
11-Apr-2023,IMPS,91.00,00.00,114.20
11-Apr-2023,Miscellaneous,231.70,00.00,345.90
11-Apr-2023,Cash,"1,523,455.75",00.00,"1,523,801.65"
11-Apr-2023,IMPS,00.00,"380,950.41","1,142,851.24"
11-Apr-2023,Purchase,00.00,"114,285.12","1,028,566.12"
11-Apr-2023,Miscellaneous,205.30,00.00,"1,028,771.42"
11-Apr-2023,Cash,05.80,00.00,"1,028,777.22"
11-Apr-2023,Interest,37.10,00.00,"1,028,814.32"
11-Apr-2023,Cash,"142,280.00",00.00,"1,171,094.32"
11-Apr-2023,RTGS,"8,471.70",00.00,"1,179,566.02"
11-Apr-2023,Reversal,327.10,00.00,"1,179,893.12"
11-Apr-2023,Cash,"77,793.44",00.00,"1,257,686.56"
11-Apr-2023,Cash,"26,317.41",00.00,"1,284,003.97"
11-Apr-2023,IMPS,00.00,"321,000.99","963,002.98"
12-Apr-2023,Bill,"1,078,904.80",00.00,"2,041,907.78"
12-Apr-2023,Interest,00.00,"510,476.95","1,531,430.84"
12-Apr-2023,Cheque,"22,446.25",00.00,"1,553,877.09"
12-Apr-2023,Bill,"103,164.00",00.00,"1,657,041.09"
12-Apr-2023,RTGS,"185,585.00",00.00,"1,842,626.09"
12-Apr-2023,Transfer,"198,452.20",00.00,"2,041,078.29"
12-Apr-2023,Miscellaneous,00.00,"226,786.48","1,814,291.81"
12-Apr-2023,Debit Card,00.00,"907,145.91","907,145.90"
12-Apr-2023,Reversal,00.00,"181,429.18","725,716.72"
12-Apr-2023,Commission,"10,113.40",00.00,"735,830.12"
12-Apr-2023,Commission,200.88,00.00,"736,031.00"
12-Apr-2023,Reversal,00.00,"92,003.88","644,027.12"
12-Apr-2023,Cash,00.00,"322,013.56","322,013.56"
12-Apr-2023,Reversal,"1,995,448.00",00.00,"2,317,461.56"
12-Apr-2023,ATM,17.46,00.00,"2,317,479.02"
12-Apr-2023,RTGS,00.00,"579,369.76","1,738,109.26"
12-Apr-2023,Debit Card,02.00,00.00,"1,738,111.26"
12-Apr-2023,NEFT,00.00,"434,527.82","1,303,583.44"
13-Apr-2023,ATM,434.90,00.00,"1,304,018.34"
13-Apr-2023,Reversal,00.00,"217,336.39","1,086,681.95"
13-Apr-2023,ATM,00.00,"271,670.49","815,011.46"
13-Apr-2023,Debit Card,02.90,00.00,"815,014.36"
13-Apr-2023,Purchase,00.00,"135,835.73","679,178.63"
13-Apr-2023,Interest,"3,475.61",00.00,"682,654.24"
13-Apr-2023,Cash,"11,209.30",00.00,"693,863.54"
14-Apr-2023,Miscellaneous,286.00,00.00,"694,149.54"
14-Apr-2023,IMPS,02.15,00.00,"694,151.69"
15-Apr-2023,Interest,103.30,00.00,"694,254.99"
15-Apr-2023,Bill,00.00,"694,254.99",00.00
15-Apr-2023,Cheque,45.75,00.00,45.75
15-Apr-2023,Purchase,597.00,00.00,642.75
15-Apr-2023,Cash,00.00,107.13,535.62
15-Apr-2023,ATM,00.00,267.81,267.81
15-Apr-2023,Purchase,00.00,66.95,200.86
15-Apr-2023,IMPS,403.02,00.00,603.88
15-Apr-2023,Purchase,00.00,150.97,452.91
15-Apr-2023,Tax,00.00,150.97,301.94
15-Apr-2023,ATM,"32,596.00",00.00,"32,897.94"
15-Apr-2023,Miscellaneous,"1,898,793.00",00.00,"1,931,690.94"
15-Apr-2023,RTGS,429.45,00.00,"1,932,120.39"
15-Apr-2023,Cheque,00.00,"644,040.13","1,288,080.26"
15-Apr-2023,Cash,00.00,"644,040.13","644,040.13"
15-Apr-2023,Interest,00.00,"80,505.02","563,535.11"
15-Apr-2023,Reversal,07.00,00.00,"563,542.11"
15-Apr-2023,Bill,"260,266.00",00.00,"823,808.11"
15-Apr-2023,IMPS,03.40,00.00,"823,811.51"
15-Apr-2023,Reversal,00.00,"91,534.61","732,276.90"
15-Apr-2023,Transfer,"54,299.12",00.00,"786,576.02"
15-Apr-2023,Miscellaneous,08.00,00.00,"786,584.02"
15-Apr-2023,Commission,"89,866.50",00.00,"876,450.52"
15-Apr-2023,Cheque,07.00,00.00,"876,457.52"
15-Apr-2023,RTGS,00.00,"876,457.52",00.00
15-Apr-2023,Miscellaneous,271.00,00.00,271.00
15-Apr-2023,Purchase,257.60,00.00,528.60
15-Apr-2023,Interest,531.48,00.00,"1,060.08"
15-Apr-2023,IMPS,30.00,00.00,"1,090.08"
15-Apr-2023,Miscellaneous,00.00,181.68,908.40
15-Apr-2023,Purchase,00.00,908.40,00.00
15-Apr-2023,RTGS,00.42,00.00,00.42
15-Apr-2023,ATM,00.00,00.21,00.21
15-Apr-2023,RTGS,00.00,00.02,00.19
15-Apr-2023,Cheque,00.00,00.02,00.17
15-Apr-2023,Miscellaneous,00.00,00.04,00.13
15-Apr-2023,Debit Card,335.50,00.00,335.63
15-Apr-2023,RTGS,"6,475.00",00.00,"6,810.63"
15-Apr-2023,RTGS,00.00,"1,362.13","5,448.50"
15-Apr-2023,Transfer,"1,368.40",00.00,"6,816.90"
15-Apr-2023,Cash,"254,514.00",00.00,"261,330.90"
15-Apr-2023,Debit Card,154.86,00.00,"261,485.76"
15-Apr-2023,Cash,00.00,"32,685.72","228,800.04"
15-Apr-2023,Cash,00.00,"76,266.68","152,533.36"
15-Apr-2023,Debit Card,01.00,00.00,"152,534.36"
15-Apr-2023,Debit Card,"1,180,014.75",00.00,"1,332,549.11"
15-Apr-2023,Commission,"1,857,804.00",00.00,"3,190,353.11"
15-Apr-2023,ATM,75.70,00.00,"3,190,428.81"
15-Apr-2023,Purchase,00.00,"797,607.20","2,392,821.61"
15-Apr-2023,NEFT,06.00,00.00,"2,392,827.61"
15-Apr-2023,RTGS,06.04,00.00,"2,392,833.65"
15-Apr-2023,NEFT,00.00,"239,283.37","2,153,550.28"
15-Apr-2023,Purchase,00.00,"717,850.09","1,435,700.19"
15-Apr-2023,Reversal,"14,602.82",00.00,"1,450,303.01"
15-Apr-2023,Reversal,"1,093.00",00.00,"1,451,396.01"
15-Apr-2023,Interest,00.00,"725,698.01","725,698.00"
15-Apr-2023,NEFT,00.00,"120,949.67","604,748.33"
15-Apr-2023,IMPS,"2,404.14",00.00,"607,152.47"
15-Apr-2023,NEFT,00.00,"101,192.08","505,960.39"
15-Apr-2023,Interest,00.00,"101,192.08","404,768.31"
15-Apr-2023,Tax,00.00,"404,768.31",00.00
15-Apr-2023,Interest,07.40,00.00,07.40
15-Apr-2023,Cash,00.00,01.06,06.34
15-Apr-2023,Purchase,00.00,03.17,03.17
15-Apr-2023,Tax,448.65,00.00,451.82
15-Apr-2023,Debit Card,33.70,00.00,485.52
15-Apr-2023,Cheque,"191,330.40",00.00,"191,815.92"
15-Apr-2023,Cash,00.00,"31,969.32","159,846.60"
15-Apr-2023,Debit Card,00.00,"39,961.65","119,884.95"
15-Apr-2023,ATM,"10,227.00",00.00,"130,111.95"
15-Apr-2023,IMPS,"914,830.00",00.00,"1,044,941.95"
15-Apr-2023,Commission,26.00,00.00,"1,044,967.95"
15-Apr-2023,Miscellaneous,00.00,"1,044,967.95",00.00
15-Apr-2023,Tax,"16,819.00",00.00,"16,819.00"
15-Apr-2023,Cash,"2,913.83",00.00,"19,732.83"
15-Apr-2023,Debit Card,"25,777.40",00.00,"45,510.23"
15-Apr-2023,Commission,00.00,"7,585.04","37,925.19"
15-Apr-2023,Reversal,12.00,00.00,"37,937.19"
15-Apr-2023,Commission,760.70,00.00,"38,697.89"
15-Apr-2023,Transfer,02.00,00.00,"38,699.89"
15-Apr-2023,Purchase,00.00,"38,699.89",00.00
15-Apr-2023,ATM,"1,565,401.75",00.00,"1,565,401.75"
15-Apr-2023,Cheque,05.54,00.00,"1,565,407.29"
15-Apr-2023,Transfer,00.00,"521,802.43","1,043,604.86"
15-Apr-2023,Interest,00.00,"347,868.29","695,736.57"
15-Apr-2023,Bill,00.00,"173,934.14","521,802.43"
15-Apr-2023,ATM,00.00,"65,225.30","456,577.13"
15-Apr-2023,Reversal,00.00,"152,192.38","304,384.75"
15-Apr-2023,ATM,00.00,"33,820.53","270,564.22"
15-Apr-2023,ATM,05.00,00.00,"270,569.22"
15-Apr-2023,Debit Card,"323,669.50",00.00,"594,238.72"
16-Apr-2023,NEFT,00.00,"148,559.68","445,679.04"
16-Apr-2023,IMPS,00.00,"148,559.68","297,119.36"
16-Apr-2023,Bill,00.00,"29,711.94","267,407.42"
16-Apr-2023,ATM,"76,434.00",00.00,"343,841.42"
16-Apr-2023,NEFT,"1,515.10",00.00,"345,356.52"
17-Apr-2023,Miscellaneous,06.89,00.00,"345,363.41"
17-Apr-2023,RTGS,00.00,"34,536.34","310,827.07"
17-Apr-2023,Reversal,00.00,"34,536.34","276,290.73"
17-Apr-2023,Bill,00.00,"69,072.68","207,218.05"
17-Apr-2023,NEFT,00.00,"41,443.61","165,774.44"
17-Apr-2023,ATM,"577,240.80",00.00,"743,015.24"
17-Apr-2023,Commission,"3,567.60",00.00,"746,582.84"
17-Apr-2023,RTGS,05.92,00.00,"746,588.76"
17-Apr-2023,Miscellaneous,00.00,"186,647.19","559,941.57"
17-Apr-2023,Transfer,43.00,00.00,"559,984.57"
18-Apr-2023,Commission,06.00,00.00,"559,990.57"
18-Apr-2023,Commission,00.00,"279,995.29","279,995.28"
18-Apr-2023,ATM,"350,379.00",00.00,"630,374.28"
18-Apr-2023,Transfer,00.00,"70,041.59","560,332.69"
18-Apr-2023,Cheque,00.00,"62,259.19","498,073.50"
18-Apr-2023,Miscellaneous,"1,542,260.00",00.00,"2,040,333.50"
18-Apr-2023,Tax,00.00,"340,055.58","1,700,277.92"
18-Apr-2023,Debit Card,"1,840,114.00",00.00,"3,540,391.92"
18-Apr-2023,Commission,00.00,"354,039.19","3,186,352.73"
18-Apr-2023,Miscellaneous,00.00,"398,294.09","2,788,058.64"
18-Apr-2023,RTGS,00.00,"2,788,058.64",00.00
18-Apr-2023,Miscellaneous,35.80,00.00,35.80
18-Apr-2023,Purchase,19.00,00.00,54.80
18-Apr-2023,NEFT,64.00,00.00,118.80
18-Apr-2023,Miscellaneous,06.40,00.00,125.20
18-Apr-2023,NEFT,"21,199.00",00.00,"21,324.20"
18-Apr-2023,Commission,"42,741.70",00.00,"64,065.90"
18-Apr-2023,NEFT,"814,013.00",00.00,"878,078.90"
18-Apr-2023,ATM,00.00,"97,564.32","780,514.58"
18-Apr-2023,ATM,"929,451.00",00.00,"1,709,965.58"
18-Apr-2023,Interest,"166,173.10",00.00,"1,876,138.68"
19-Apr-2023,RTGS,206.00,00.00,"1,876,344.68"
19-Apr-2023,Tax,"19,713.00",00.00,"1,896,057.68"
19-Apr-2023,ATM,62.00,00.00,"1,896,119.68"
19-Apr-2023,ATM,00.00,"189,611.97","1,706,507.71"
19-Apr-2023,Cash,00.00,"284,417.95","1,422,089.76"
19-Apr-2023,ATM,04.50,00.00,"1,422,094.26"
19-Apr-2023,Cheque,00.00,"158,010.47","1,264,083.79"
19-Apr-2023,Tax,00.00,"632,041.90","632,041.90"
19-Apr-2023,Commission,"205,478.25",00.00,"837,520.15"
19-Apr-2023,Cheque,00.00,"139,586.69","697,933.46"
19-Apr-2023,Miscellaneous,04.10,00.00,"697,937.56"
19-Apr-2023,RTGS,00.00,"139,587.51","558,350.05"
19-Apr-2023,ATM,63.97,00.00,"558,414.02"
19-Apr-2023,ATM,"2,175.26",00.00,"560,589.28"
19-Apr-2023,NEFT,20.20,00.00,"560,609.48"
19-Apr-2023,RTGS,"1,169,940.50",00.00,"1,730,549.98"
19-Apr-2023,Bill,"122,209.50",00.00,"1,852,759.48"
19-Apr-2023,Tax,"1,429,134.00",00.00,"3,281,893.48"
19-Apr-2023,Interest,07.10,00.00,"3,281,900.58"
19-Apr-2023,RTGS,00.00,"468,842.94","2,813,057.64"
19-Apr-2023,Interest,"32,452.74",00.00,"2,845,510.38"
19-Apr-2023,IMPS,02.00,00.00,"2,845,512.38"
19-Apr-2023,Bill,"22,995.95",00.00,"2,868,508.33"
19-Apr-2023,Bill,"1,276,010.00",00.00,"4,144,518.33"
19-Apr-2023,Tax,00.00,"2,072,259.17","2,072,259.16"
19-Apr-2023,ATM,"12,784.00",00.00,"2,085,043.16"
19-Apr-2023,ATM,00.00,"347,507.19","1,737,535.97"
19-Apr-2023,Debit Card,02.35,00.00,"1,737,538.32"
19-Apr-2023,NEFT,29.00,00.00,"1,737,567.32"
19-Apr-2023,Transfer,39.70,00.00,"1,737,607.02"
19-Apr-2023,IMPS,00.00,"1,737,607.02",00.00
19-Apr-2023,Tax,"1,810.63",00.00,"1,810.63"
19-Apr-2023,Reversal,00.00,"1,810.63",00.00
19-Apr-2023,Bill,443.49,00.00,443.49
19-Apr-2023,Transfer,00.00,147.83,295.66
19-Apr-2023,Reversal,"248,803.44",00.00,"249,099.10"
19-Apr-2023,RTGS,00.00,"249,099.10",00.00
19-Apr-2023,Interest,293.40,00.00,293.40
19-Apr-2023,Interest,"24,492.00",00.00,"24,785.40"
19-Apr-2023,Tax,26.50,00.00,"24,811.90"
19-Apr-2023,RTGS,929.60,00.00,"25,741.50"
19-Apr-2023,Debit Card,"138,398.00",00.00,"164,139.50"
19-Apr-2023,Debit Card,00.00,"18,237.72","145,901.78"
19-Apr-2023,Debit Card,327.36,00.00,"146,229.14"
19-Apr-2023,Cheque,"15,252.50",00.00,"161,481.64"
19-Apr-2023,RTGS,"14,385.40",00.00,"175,867.04"
19-Apr-2023,Cash,"9,991.00",00.00,"185,858.04"
19-Apr-2023,Tax,00.00,"92,929.02","92,929.02"
19-Apr-2023,Reversal,00.00,"46,464.51","46,464.51"
19-Apr-2023,IMPS,00.00,"15,488.17","30,976.34"
19-Apr-2023,Miscellaneous,"1,109,537.75",00.00,"1,140,514.09"
19-Apr-2023,Interest,05.00,00.00,"1,140,519.09"
19-Apr-2023,ATM,00.00,"142,564.89","997,954.20"
19-Apr-2023,ATM,06.00,00.00,"997,960.20"
19-Apr-2023,Cash,00.00,"166,326.70","831,633.50"
19-Apr-2023,ATM,00.00,"166,326.70","665,306.80"
19-Apr-2023,Commission,00.00,"133,061.36","532,245.44"
19-Apr-2023,Commission,00.00,"133,061.36","399,184.08"
19-Apr-2023,Commission,"1,770,663.75",00.00,"2,169,847.83"
19-Apr-2023,Commission,00.00,"723,282.61","1,446,565.22"
19-Apr-2023,ATM,00.00,"482,188.41","964,376.81"
19-Apr-2023,Cash,21.21,00.00,"964,398.02"
19-Apr-2023,Interest,00.00,"137,771.15","826,626.87"
20-Apr-2023,Reversal,00.00,"165,325.37","661,301.50"
20-Apr-2023,ATM,00.00,"66,130.15","595,171.35"
20-Apr-2023,Bill,00.00,"148,792.84","446,378.51"
20-Apr-2023,Tax,"933,293.75",00.00,"1,379,672.26"
20-Apr-2023,Purchase,"124,430.44",00.00,"1,504,102.70"
20-Apr-2023,Purchase,03.00,00.00,"1,504,105.70"
20-Apr-2023,Bill,793.50,00.00,"1,504,899.20"
20-Apr-2023,Commission,"24,789.00",00.00,"1,529,688.20"
20-Apr-2023,Purchase,00.00,"254,948.03","1,274,740.17"
20-Apr-2023,NEFT,"28,719.30",00.00,"1,303,459.47"
20-Apr-2023,Miscellaneous,"30,071.00",00.00,"1,333,530.47"
20-Apr-2023,Cash,00.00,"444,510.16","889,020.31"
20-Apr-2023,Purchase,00.00,"444,510.16","444,510.16"
20-Apr-2023,ATM,00.00,"44,451.02","400,059.14"
20-Apr-2023,Interest,00.00,"57,151.31","342,907.83"
20-Apr-2023,NEFT,"19,032.00",00.00,"361,939.83"
20-Apr-2023,RTGS,00.00,"120,646.61","241,293.22"
20-Apr-2023,RTGS,35.30,00.00,"241,328.52"
21-Apr-2023,IMPS,58.00,00.00,"241,386.52"
21-Apr-2023,NEFT,281.50,00.00,"241,668.02"
21-Apr-2023,Purchase,00.00,"48,333.60","193,334.42"
21-Apr-2023,Debit Card,"3,644.19",00.00,"196,978.61"
21-Apr-2023,Commission,00.00,"65,659.54","131,319.07"
21-Apr-2023,Transfer,00.00,"13,131.91","118,187.16"
21-Apr-2023,Cheque,35.91,00.00,"118,223.07"
21-Apr-2023,RTGS,40.37,00.00,"118,263.44"
21-Apr-2023,RTGS,00.00,"19,710.57","98,552.87"
21-Apr-2023,Reversal,00.00,"12,319.11","86,233.76"
21-Apr-2023,Bill,00.00,"8,623.38","77,610.38"
21-Apr-2023,Tax,00.00,"12,935.06","64,675.32"
21-Apr-2023,ATM,364.26,00.00,"65,039.58"
21-Apr-2023,Debit Card,"212,446.30",00.00,"277,485.88"
21-Apr-2023,Miscellaneous,"119,486.06",00.00,"396,971.94"
21-Apr-2023,ATM,00.00,"396,971.94",00.00
21-Apr-2023,IMPS,01.28,00.00,01.28
21-Apr-2023,Miscellaneous,"1,789.40",00.00,"1,790.68"
21-Apr-2023,Transfer,00.00,447.67,"1,343.01"
21-Apr-2023,RTGS,00.00,268.60,"1,074.41"
21-Apr-2023,Bill,00.00,537.21,537.21
21-Apr-2023,Cheque,00.00,76.74,460.47
21-Apr-2023,Cheque,00.00,115.12,345.35
21-Apr-2023,Miscellaneous,06.00,00.00,351.35
21-Apr-2023,Debit Card,00.00,58.56,292.79
21-Apr-2023,Cash,00.00,36.60,256.19
21-Apr-2023,IMPS,"2,362.19",00.00,"2,618.38"
21-Apr-2023,NEFT,"62,730.16",00.00,"65,348.54"
21-Apr-2023,Interest,00.00,"7,260.95","58,087.59"
21-Apr-2023,RTGS,"1,872,383.00",00.00,"1,930,470.59"
21-Apr-2023,Bill,408.19,00.00,"1,930,878.78"
21-Apr-2023,Debit Card,00.00,"386,175.76","1,544,703.02"
21-Apr-2023,Cash,244.00,00.00,"1,544,947.02"
21-Apr-2023,Tax,05.60,00.00,"1,544,952.62"
21-Apr-2023,Cash,00.00,"154,495.26","1,390,457.36"
21-Apr-2023,ATM,00.00,"1,390,457.36",00.00
21-Apr-2023,Reversal,"843,713.00",00.00,"843,713.00"
21-Apr-2023,Debit Card,"1,927.63",00.00,"845,640.63"
21-Apr-2023,Miscellaneous,"23,102.00",00.00,"868,742.63"
21-Apr-2023,Cash,03.70,00.00,"868,746.33"
21-Apr-2023,Reversal,00.00,"289,582.11","579,164.22"
21-Apr-2023,Debit Card,"1,839,831.80",00.00,"2,418,996.02"
21-Apr-2023,ATM,00.00,"241,899.60","2,177,096.42"
21-Apr-2023,Purchase,05.27,00.00,"2,177,101.69"
21-Apr-2023,ATM,00.00,"362,850.28","1,814,251.41"
21-Apr-2023,IMPS,00.00,"362,850.28","1,451,401.13"
21-Apr-2023,Interest,"5,289.13",00.00,"1,456,690.26"
21-Apr-2023,Tax,00.00,"161,854.47","1,294,835.79"
21-Apr-2023,Purchase,00.00,"431,611.93","863,223.86"
21-Apr-2023,Purchase,00.00,"86,322.39","776,901.47"
21-Apr-2023,Cheque,13.10,00.00,"776,914.57"
21-Apr-2023,Reversal,55.80,00.00,"776,970.37"
21-Apr-2023,Cash,00.00,"258,990.12","517,980.25"
21-Apr-2023,IMPS,288.66,00.00,"518,268.91"
21-Apr-2023,Transfer,00.00,"86,378.15","431,890.76"
21-Apr-2023,NEFT,377.31,00.00,"432,268.07"
21-Apr-2023,Purchase,00.00,"432,268.07",00.00
21-Apr-2023,Transfer,"1,716,067.80",00.00,"1,716,067.80"
21-Apr-2023,RTGS,00.00,"214,508.48","1,501,559.32"
21-Apr-2023,Cheque,00.00,"750,779.66","750,779.66"
21-Apr-2023,IMPS,00.00,"75,077.97","675,701.69"
21-Apr-2023,Commission,00.00,"67,570.17","608,131.52"
21-Apr-2023,Commission,00.00,"152,032.88","456,098.64"
21-Apr-2023,Bill,00.00,"91,219.73","364,878.91"
21-Apr-2023,Cash,43.83,00.00,"364,922.74"
21-Apr-2023,Interest,00.00,"45,615.34","319,307.40"
21-Apr-2023,NEFT,00.00,"31,930.74","287,376.66"
21-Apr-2023,Debit Card,00.00,"28,737.67","258,638.99"
21-Apr-2023,Debit Card,00.00,"258,638.99",00.00
21-Apr-2023,Tax,30.68,00.00,30.68
21-Apr-2023,Bill,321.00,00.00,351.68
21-Apr-2023,NEFT,"1,466,450.00",00.00,"1,466,801.68"
21-Apr-2023,Miscellaneous,"594,660.00",00.00,"2,061,461.68"
21-Apr-2023,NEFT,00.96,00.00,"2,061,462.64"
21-Apr-2023,RTGS,00.00,"2,061,462.64",00.00
21-Apr-2023,RTGS,309.23,00.00,309.23
21-Apr-2023,Cheque,"1,003,471.00",00.00,"1,003,780.23"
21-Apr-2023,Transfer,00.00,"501,890.12","501,890.12"
21-Apr-2023,Transfer,00.00,"125,472.53","376,417.59"
21-Apr-2023,IMPS,00.00,"94,104.40","282,313.19"
21-Apr-2023,Transfer,"549,466.00",00.00,"831,779.19"
21-Apr-2023,IMPS,05.50,00.00,"831,784.69"
21-Apr-2023,IMPS,58.20,00.00,"831,842.89"
22-Apr-2023,Bill,32.50,00.00,"831,875.39"
22-Apr-2023,Commission,00.00,"415,937.70","415,937.70"
22-Apr-2023,NEFT,00.00,"46,215.30","369,722.40"
22-Apr-2023,Transfer,00.00,"41,080.27","328,642.13"
22-Apr-2023,Transfer,"1,834.80",00.00,"330,476.93"
22-Apr-2023,Reversal,00.00,"110,158.98","220,317.95"
22-Apr-2023,Miscellaneous,00.00,"55,079.49","165,238.46"
22-Apr-2023,Purchase,00.00,"27,539.74","137,698.72"
22-Apr-2023,IMPS,00.00,"27,539.74","110,158.98"
22-Apr-2023,ATM,00.00,"18,359.83","91,799.15"
22-Apr-2023,Cheque,00.00,"13,114.16","78,684.99"
22-Apr-2023,Commission,00.00,"8,742.78","69,942.21"
22-Apr-2023,Bill,00.00,"13,988.44","55,953.77"
22-Apr-2023,Cheque,00.00,"18,651.26","37,302.51"
22-Apr-2023,IMPS,200.20,00.00,"37,502.71"
22-Apr-2023,Interest,"12,805.00",00.00,"50,307.71"
22-Apr-2023,Interest,00.00,"8,384.62","41,923.09"
22-Apr-2023,IMPS,496.47,00.00,"42,419.56"
22-Apr-2023,NEFT,17.20,00.00,"42,436.76"
22-Apr-2023,Interest,05.00,00.00,"42,441.76"
22-Apr-2023,Miscellaneous,00.00,"42,441.76",00.00
22-Apr-2023,NEFT,"1,659.90",00.00,"1,659.90"
22-Apr-2023,Debit Card,"47,136.97",00.00,"48,796.87"
22-Apr-2023,Cheque,00.00,"48,796.87",00.00
22-Apr-2023,NEFT,442.83,00.00,442.83
22-Apr-2023,Bill,00.00,110.71,332.12
22-Apr-2023,Transfer,00.00,36.90,295.22
23-Apr-2023,RTGS,"23,595.88",00.00,"23,891.10"
23-Apr-2023,Miscellaneous,00.00,"23,891.10",00.00
23-Apr-2023,RTGS,"2,692.78",00.00,"2,692.78"
23-Apr-2023,Miscellaneous,00.00,538.56,"2,154.22"
23-Apr-2023,Interest,"361,939.50",00.00,"364,093.72"
23-Apr-2023,IMPS,00.00,"364,093.72",00.00
23-Apr-2023,Purchase,05.90,00.00,05.90
23-Apr-2023,Tax,00.00,00.74,05.16
23-Apr-2023,Transfer,00.00,02.58,02.58
23-Apr-2023,Commission,00.00,00.37,02.21
23-Apr-2023,Reversal,00.00,00.22,01.99
23-Apr-2023,Reversal,00.00,01.00,01.00
23-Apr-2023,IMPS,00.00,00.20,00.80
23-Apr-2023,Commission,00.00,00.09,00.71
23-Apr-2023,Cheque,00.00,00.18,00.53
23-Apr-2023,Miscellaneous,35.00,00.00,35.53
23-Apr-2023,Cash,"3,498.00",00.00,"3,533.53"
23-Apr-2023,Transfer,112.00,00.00,"3,645.53"
23-Apr-2023,Transfer,"26,526.00",00.00,"30,171.53"
23-Apr-2023,ATM,00.00,"6,034.31","24,137.22"
23-Apr-2023,Tax,00.00,"12,068.61","12,068.61"
23-Apr-2023,Commission,00.00,"3,017.15","9,051.46"
23-Apr-2023,NEFT,54.40,00.00,"9,105.86"
23-Apr-2023,Tax,00.00,"9,105.86",00.00
23-Apr-2023,Debit Card,"1,691,258.50",00.00,"1,691,258.50"
23-Apr-2023,Debit Card,00.00,"422,814.63","1,268,443.88"
23-Apr-2023,Bill,180.00,00.00,"1,268,623.88"
23-Apr-2023,Cash,00.00,"140,958.21","1,127,665.67"
23-Apr-2023,Interest,00.00,"161,095.10","966,570.57"
23-Apr-2023,Bill,00.00,"138,081.51","828,489.06"
23-Apr-2023,Purchase,"1,932,159.00",00.00,"2,760,648.06"
23-Apr-2023,Transfer,00.00,"920,216.02","1,840,432.04"
23-Apr-2023,Reversal,37.00,00.00,"1,840,469.04"
23-Apr-2023,NEFT,00.00,"184,046.90","1,656,422.14"
23-Apr-2023,Tax,26.60,00.00,"1,656,448.74"
23-Apr-2023,ATM,00.00,"165,644.87","1,490,803.87"
23-Apr-2023,Reversal,48.00,00.00,"1,490,851.87"
23-Apr-2023,Reversal,19.90,00.00,"1,490,871.77"
23-Apr-2023,Cash,329.00,00.00,"1,491,200.77"
23-Apr-2023,NEFT,271.97,00.00,"1,491,472.74"
24-Apr-2023,Purchase,00.00,"1,491,472.74",00.00
24-Apr-2023,Purchase,"380,622.20",00.00,"380,622.20"
24-Apr-2023,IMPS,55.60,00.00,"380,677.80"
24-Apr-2023,Tax,07.00,00.00,"380,684.80"
24-Apr-2023,Bill,"109,112.00",00.00,"489,796.80"
24-Apr-2023,NEFT,"5,179.00",00.00,"494,975.80"
24-Apr-2023,Interest,00.00,"123,743.95","371,231.85"
24-Apr-2023,ATM,32.14,00.00,"371,263.99"
24-Apr-2023,NEFT,"463,996.00",00.00,"835,259.99"
25-Apr-2023,Cash,"106,407.00",00.00,"941,666.99"
25-Apr-2023,Debit Card,"20,746.00",00.00,"962,412.99"
25-Apr-2023,Transfer,00.00,"137,487.57","824,925.42"
25-Apr-2023,Interest,"231,515.00",00.00,"1,056,440.42"
25-Apr-2023,Transfer,86.40,00.00,"1,056,526.82"
25-Apr-2023,Interest,00.00,"211,305.36","845,221.46"
25-Apr-2023,Tax,00.00,"84,522.15","760,699.31"
25-Apr-2023,Purchase,288.60,00.00,"760,987.91"
25-Apr-2023,Bill,00.00,"253,662.64","507,325.27"
25-Apr-2023,Commission,447.60,00.00,"507,772.87"
25-Apr-2023,Commission,00.00,"63,471.61","444,301.26"
25-Apr-2023,NEFT,00.00,"63,471.61","380,829.65"
25-Apr-2023,IMPS,00.00,"54,404.24","326,425.41"
25-Apr-2023,Bill,"1,879,383.00",00.00,"2,205,808.41"
25-Apr-2023,Interest,00.00,"220,580.84","1,985,227.57"
25-Apr-2023,Transfer,00.00,"992,613.79","992,613.78"
25-Apr-2023,Transfer,"21,478.00",00.00,"1,014,091.78"
26-Apr-2023,IMPS,00.00,"1,014,091.78",00.00
26-Apr-2023,Commission,08.00,00.00,08.00
26-Apr-2023,Bill,"99,344.00",00.00,"99,352.00"
26-Apr-2023,Miscellaneous,00.00,"9,935.20","89,416.80"
26-Apr-2023,Cheque,00.00,"12,773.83","76,642.97"
26-Apr-2023,Reversal,00.00,"8,515.89","68,127.08"
26-Apr-2023,Purchase,00.00,"17,031.77","51,095.31"
26-Apr-2023,Reversal,00.00,"6,386.91","44,708.40"
26-Apr-2023,Miscellaneous,00.00,"5,588.55","39,119.85"
26-Apr-2023,Miscellaneous,"6,639.10",00.00,"45,758.95"
26-Apr-2023,Debit Card,01.00,00.00,"45,759.95"
26-Apr-2023,RTGS,24.80,00.00,"45,784.75"
26-Apr-2023,Miscellaneous,00.00,"45,784.75",00.00
26-Apr-2023,Tax,125.40,00.00,125.40
26-Apr-2023,NEFT,"2,782.42",00.00,"2,907.82"
26-Apr-2023,Tax,00.00,323.09,"2,584.73"
26-Apr-2023,Debit Card,00.00,287.19,"2,297.54"
26-Apr-2023,Bill,00.00,328.22,"1,969.32"
26-Apr-2023,Interest,"20,230.00",00.00,"22,199.32"
26-Apr-2023,Debit Card,00.00,"2,466.59","19,732.73"
26-Apr-2023,IMPS,00.00,"3,288.79","16,443.94"
26-Apr-2023,Transfer,"3,650.87",00.00,"20,094.81"
26-Apr-2023,Interest,06.30,00.00,"20,101.11"
26-Apr-2023,Transfer,"2,385.35",00.00,"22,486.46"
26-Apr-2023,Bill,00.00,"2,810.81","19,675.65"
26-Apr-2023,ATM,00.00,"2,459.46","17,216.19"
26-Apr-2023,RTGS,"3,008.89",00.00,"20,225.08"
26-Apr-2023,ATM,"152,898.66",00.00,"173,123.74"
26-Apr-2023,Bill,20.45,00.00,"173,144.19"
26-Apr-2023,Transfer,00.00,"19,238.24","153,905.95"
26-Apr-2023,Purchase,00.00,"21,986.56","131,919.39"
26-Apr-2023,Miscellaneous,"245,251.00",00.00,"377,170.39"
26-Apr-2023,IMPS,00.00,"53,881.48","323,288.91"
26-Apr-2023,Purchase,"504,149.75",00.00,"827,438.66"
26-Apr-2023,Bill,"3,365.00",00.00,"830,803.66"
26-Apr-2023,NEFT,420.05,00.00,"831,223.71"
26-Apr-2023,IMPS,"135,868.62",00.00,"967,092.33"
26-Apr-2023,Debit Card,37.20,00.00,"967,129.53"
26-Apr-2023,Bill,00.00,"120,891.19","846,238.34"
26-Apr-2023,Bill,00.00,"84,623.83","761,614.51"
26-Apr-2023,Purchase,"8,239.00",00.00,"769,853.51"
26-Apr-2023,Bill,00.24,00.00,"769,853.75"
26-Apr-2023,Bill,"667,762.00",00.00,"1,437,615.75"
26-Apr-2023,Debit Card,00.00,"359,403.94","1,078,211.81"
26-Apr-2023,Cash,00.00,"359,403.94","718,807.87"
27-Apr-2023,Transfer,00.00,"119,801.31","599,006.56"
27-Apr-2023,Debit Card,00.00,"59,900.66","539,105.90"
27-Apr-2023,RTGS,00.00,"269,552.95","269,552.95"
28-Apr-2023,Interest,"1,126,438.00",00.00,"1,395,990.95"
28-Apr-2023,Tax,00.00,"348,997.74","1,046,993.21"
28-Apr-2023,Cash,00.00,"209,398.64","837,594.57"
28-Apr-2023,Reversal,"1,398.00",00.00,"838,992.57"
28-Apr-2023,Miscellaneous,"3,611.40",00.00,"842,603.97"
28-Apr-2023,Cash,00.00,"140,434.00","702,169.98"
28-Apr-2023,RTGS,10.00,00.00,"702,179.98"
28-Apr-2023,ATM,"87,882.00",00.00,"790,061.98"
28-Apr-2023,Tax,"1,350,428.00",00.00,"2,140,489.98"
28-Apr-2023,ATM,"2,430.70",00.00,"2,142,920.68"
28-Apr-2023,Transfer,00.00,"267,865.09","1,875,055.60"
28-Apr-2023,Reversal,"78,965.66",00.00,"1,954,021.26"
28-Apr-2023,NEFT,00.00,"977,010.63","977,010.63"
29-Apr-2023,Bill,"2,964.00",00.00,"979,974.63"
29-Apr-2023,IMPS,00.00,"195,994.93","783,979.70"
29-Apr-2023,Commission,00.00,"130,663.28","653,316.42"
29-Apr-2023,NEFT,00.00,"65,331.64","587,984.78"
29-Apr-2023,Cheque,264.00,00.00,"588,248.78"
29-Apr-2023,Bill,"1,727,283.50",00.00,"2,315,532.28"
29-Apr-2023,Tax,04.72,00.00,"2,315,537.00"
29-Apr-2023,Miscellaneous,00.00,"231,553.70","2,083,983.30"
29-Apr-2023,Reversal,24.30,00.00,"2,084,007.60"
29-Apr-2023,Bill,00.00,"1,042,003.80","1,042,003.80"
29-Apr-2023,RTGS,415.00,00.00,"1,042,418.80"
29-Apr-2023,Commission,"7,954.12",00.00,"1,050,372.92"
29-Apr-2023,NEFT,00.40,00.00,"1,050,373.32"
29-Apr-2023,Reversal,00.00,"131,296.67","919,076.66"
29-Apr-2023,Transfer,00.00,"131,296.67","787,779.99"
29-Apr-2023,Miscellaneous,429.00,00.00,"788,208.99"
29-Apr-2023,Miscellaneous,"186,023.00",00.00,"974,231.99"
30-Apr-2023,RTGS,00.00,"108,248.00","865,983.99"
30-Apr-2023,Bill,00.00,"288,661.33","577,322.66"
30-Apr-2023,Interest,00.00,"144,330.67","432,992.00"
30-Apr-2023,Miscellaneous,25.00,00.00,"433,017.00"
30-Apr-2023,Purchase,49.21,00.00,"433,066.21"
30-Apr-2023,Cheque,00.00,"72,177.70","360,888.51"
30-Apr-2023,NEFT,771.30,00.00,"361,659.81"
30-Apr-2023,Tax,00.00,"51,665.69","309,994.12"
30-Apr-2023,Cash,00.00,"51,665.69","258,328.43"
30-Apr-2023,Reversal,00.00,"64,582.11","193,746.32"
30-Apr-2023,Commission,"821,236.00",00.00,"1,014,982.32"
30-Apr-2023,Tax,63.38,00.00,"1,015,045.70"
30-Apr-2023,Bill,00.00,"253,761.43","761,284.27"
30-Apr-2023,Debit Card,00.00,"126,880.71","634,403.56"
30-Apr-2023,NEFT,00.00,"70,489.28","563,914.28"
30-Apr-2023,Debit Card,14.00,00.00,"563,928.28"
30-Apr-2023,Transfer,588.00,00.00,"564,516.28"
30-Apr-2023,IMPS,00.00,"188,172.09","376,344.19"
30-Apr-2023,Miscellaneous,00.00,"41,816.02","334,528.17"
30-Apr-2023,NEFT,280.00,00.00,"334,808.17"
30-Apr-2023,RTGS,01.00,00.00,"334,809.17"
30-Apr-2023,Commission,152.00,00.00,"334,961.17"
30-Apr-2023,Tax,419.35,00.00,"335,380.52"
30-Apr-2023,Reversal,00.00,"335,380.52",00.00
30-Apr-2023,ATM,72.00,00.00,72.00
30-Apr-2023,Debit Card,"29,316.70",00.00,"29,388.70"
30-Apr-2023,RTGS,"910,688.00",00.00,"940,076.70"
30-Apr-2023,Interest,00.00,"940,076.70",00.00
30-Apr-2023,Bill,13.37,00.00,13.37
30-Apr-2023,Reversal,"237,218.16",00.00,"237,231.53"
30-Apr-2023,ATM,"1,783.40",00.00,"239,014.93"
30-Apr-2023,IMPS,00.00,"34,144.99","204,869.94"
30-Apr-2023,ATM,00.00,"204,869.94",00.00
30-Apr-2023,Interest,"1,537,940.20",00.00,"1,537,940.20"
30-Apr-2023,Commission,00.00,"153,794.02","1,384,146.18"
30-Apr-2023,ATM,37.10,00.00,"1,384,183.28"
30-Apr-2023,Commission,00.00,"173,022.91","1,211,160.37"
30-Apr-2023,Cash,00.00,"605,580.19","605,580.19"
30-Apr-2023,Transfer,00.00,"201,860.06","403,720.13"
30-Apr-2023,RTGS,112.00,00.00,"403,832.13"
30-Apr-2023,Cash,"229,446.00",00.00,"633,278.13"
30-Apr-2023,Reversal,"1,628.00",00.00,"634,906.13"
30-Apr-2023,Interest,05.72,00.00,"634,911.85"
30-Apr-2023,IMPS,00.00,"79,363.98","555,547.87"
30-Apr-2023,Cheque,"606,157.50",00.00,"1,161,705.37"
30-Apr-2023,Commission,"2,002,653.20",00.00,"3,164,358.57"
30-Apr-2023,RTGS,63.00,00.00,"3,164,421.57"
30-Apr-2023,Purchase,01.00,00.00,"3,164,422.57"
01-May-2023,Cash,00.00,"527,403.76","2,637,018.81"
01-May-2023,IMPS,00.00,"329,627.35","2,307,391.46"
01-May-2023,Debit Card,00.00,"2,307,391.46",00.00
01-May-2023,Reversal,42.50,00.00,42.50
01-May-2023,Commission,259.40,00.00,301.90
01-May-2023,Purchase,00.00,30.19,271.71
01-May-2023,ATM,"197,677.62",00.00,"197,949.33"
01-May-2023,Interest,17.00,00.00,"197,966.33"
01-May-2023,ATM,00.00,"32,994.39","164,971.94"
01-May-2023,Purchase,"2,095,558.00",00.00,"2,260,529.94"
01-May-2023,IMPS,00.00,"376,754.99","1,883,774.95"
01-May-2023,Interest,00.00,"269,110.71","1,614,664.24"
01-May-2023,Purchase,00.00,"403,666.06","1,210,998.18"
01-May-2023,RTGS,00.00,"151,374.77","1,059,623.41"
01-May-2023,Transfer,"3,386.00",00.00,"1,063,009.41"
01-May-2023,Reversal,00.00,"1,063,009.41",00.00
01-May-2023,Transfer,"880,180.00",00.00,"880,180.00"
01-May-2023,Commission,00.00,"176,036.00","704,144.00"
01-May-2023,Commission,154.00,00.00,"704,298.00"
02-May-2023,NEFT,00.00,"100,614.00","603,684.00"
02-May-2023,Miscellaneous,101.85,00.00,"603,785.85"
02-May-2023,Tax,00.00,"120,757.17","483,028.68"
02-May-2023,Transfer,00.00,"60,378.59","422,650.10"
02-May-2023,Tax,"1,447.10",00.00,"424,097.20"
03-May-2023,Debit Card,"6,289.31",00.00,"430,386.51"
03-May-2023,Commission,51.00,00.00,"430,437.51"
03-May-2023,ATM,02.90,00.00,"430,440.41"
03-May-2023,Miscellaneous,04.00,00.00,"430,444.41"
03-May-2023,ATM,00.00,"107,611.10","322,833.31"
03-May-2023,Purchase,"12,801.83",00.00,"335,635.14"
03-May-2023,Bill,"9,978.00",00.00,"345,613.14"
03-May-2023,Cash,00.00,"172,806.57","172,806.57"
03-May-2023,NEFT,"15,526.00",00.00,"188,332.57"
03-May-2023,Purchase,00.00,"20,925.84","167,406.73"
03-May-2023,Bill,"46,883.25",00.00,"214,289.98"
03-May-2023,Purchase,00.00,"23,810.00","190,479.98"
03-May-2023,RTGS,"180,199.40",00.00,"370,679.38"
03-May-2023,Purchase,"251,875.40",00.00,"622,554.78"
03-May-2023,IMPS,35.00,00.00,"622,589.78"
03-May-2023,IMPS,00.00,"69,176.64","553,413.14"
03-May-2023,Cash,00.00,"276,706.57","276,706.57"
03-May-2023,NEFT,00.00,"30,745.17","245,961.40"
03-May-2023,Debit Card,00.00,"49,192.28","196,769.12"
03-May-2023,Cheque,00.00,"24,596.14","172,172.98"
03-May-2023,RTGS,44.90,00.00,"172,217.88"
03-May-2023,Purchase,00.00,"17,221.79","154,996.09"
03-May-2023,Cheque,00.00,"19,374.51","135,621.58"
03-May-2023,NEFT,01.50,00.00,"135,623.08"
03-May-2023,Bill,00.00,"22,603.85","113,019.23"
03-May-2023,IMPS,"4,755.07",00.00,"117,774.30"
03-May-2023,Cash,00.00,"11,777.43","105,996.87"
03-May-2023,Interest,22.30,00.00,"106,019.17"
03-May-2023,Commission,"3,341.50",00.00,"109,360.67"
03-May-2023,Bill,00.00,"21,872.13","87,488.54"
03-May-2023,Miscellaneous,00.00,"17,497.71","69,990.83"
03-May-2023,Miscellaneous,206.00,00.00,"70,196.83"
03-May-2023,Cash,00.00,"8,774.60","61,422.23"
03-May-2023,Purchase,00.00,"15,355.56","46,066.67"
03-May-2023,Transfer,00.00,"46,066.67",00.00
03-May-2023,ATM,"2,791.12",00.00,"2,791.12"
03-May-2023,Bill,"738,941.50",00.00,"741,732.62"
03-May-2023,Cheque,00.00,"123,622.10","618,110.52"
03-May-2023,IMPS,"2,224.20",00.00,"620,334.72"
03-May-2023,Purchase,"4,832.00",00.00,"625,166.72"
03-May-2023,IMPS,00.00,"104,194.45","520,972.27"
03-May-2023,Interest,"694,544.25",00.00,"1,215,516.52"
03-May-2023,Transfer,00.00,"607,758.26","607,758.26"
03-May-2023,Cheque,00.00,"86,822.61","520,935.65"
03-May-2023,ATM,03.42,00.00,"520,939.07"
03-May-2023,Purchase,00.00,"52,093.91","468,845.16"
03-May-2023,Commission,483.10,00.00,"469,328.26"
03-May-2023,RTGS,00.00,"78,221.38","391,106.88"
03-May-2023,Cash,00.00,"65,184.48","325,922.40"
03-May-2023,Debit Card,"1,105.48",00.00,"327,027.88"
03-May-2023,Bill,05.68,00.00,"327,033.56"
03-May-2023,Cash,00.40,00.00,"327,033.96"
03-May-2023,Cheque,00.00,"327,033.96",00.00
03-May-2023,Commission,"1,186.90",00.00,"1,186.90"
03-May-2023,ATM,"32,481.00",00.00,"33,667.90"
03-May-2023,NEFT,"55,008.84",00.00,"88,676.74"
03-May-2023,Commission,"10,971.57",00.00,"99,648.31"
04-May-2023,NEFT,00.00,"16,608.05","83,040.26"
04-May-2023,IMPS,"3,407.18",00.00,"86,447.44"
05-May-2023,Purchase,"14,033.40",00.00,"100,480.84"
05-May-2023,Cheque,23.50,00.00,"100,504.34"
05-May-2023,Miscellaneous,00.00,"14,357.76","86,146.58"
05-May-2023,Tax,00.00,"28,715.53","57,431.05"
05-May-2023,Transfer,00.00,"5,743.11","51,687.94"
05-May-2023,Reversal,"1,376,570.00",00.00,"1,428,257.94"
05-May-2023,Interest,00.00,"178,532.24","1,249,725.70"
05-May-2023,Reversal,00.00,"178,532.24","1,071,193.46"
05-May-2023,Reversal,"65,947.97",00.00,"1,137,141.43"
05-May-2023,ATM,00.00,"113,714.14","1,023,427.29"
05-May-2023,NEFT,15.00,00.00,"1,023,442.29"
05-May-2023,RTGS,"1,845.10",00.00,"1,025,287.39"
05-May-2023,Tax,00.00,"128,160.92","897,126.47"
05-May-2023,IMPS,05.00,00.00,"897,131.47"
05-May-2023,Purchase,00.00,"99,681.27","797,450.20"
05-May-2023,ATM,34.00,00.00,"797,484.20"
05-May-2023,ATM,00.00,"265,828.07","531,656.13"
05-May-2023,Interest,00.00,"106,331.23","425,324.90"
05-May-2023,IMPS,00.00,"70,887.48","354,437.42"
05-May-2023,IMPS,05.58,00.00,"354,443.00"
05-May-2023,Interest,06.00,00.00,"354,449.00"
05-May-2023,Cheque,46.00,00.00,"354,495.00"
06-May-2023,Reversal,479.00,00.00,"354,974.00"
06-May-2023,Purchase,00.00,"118,324.67","236,649.33"
06-May-2023,Bill,00.00,"78,883.11","157,766.22"
06-May-2023,ATM,00.00,"15,776.62","141,989.60"
06-May-2023,Cheque,"1,965.70",00.00,"143,955.30"
06-May-2023,Cheque,135.39,00.00,"144,090.69"
06-May-2023,Interest,00.00,"28,818.14","115,272.55"
06-May-2023,IMPS,00.00,"23,054.51","92,218.04"
06-May-2023,ATM,03.11,00.00,"92,221.15"
06-May-2023,Cash,"18,148.80",00.00,"110,369.95"
06-May-2023,NEFT,00.00,"15,767.14","94,602.81"
06-May-2023,Purchase,"2,470.80",00.00,"97,073.61"
06-May-2023,Cash,07.25,00.00,"97,080.86"
06-May-2023,Commission,44.36,00.00,"97,125.22"
06-May-2023,Tax,00.00,"13,875.03","83,250.19"
06-May-2023,Cash,"20,974.00",00.00,"104,224.19"
06-May-2023,ATM,00.00,"11,580.47","92,643.72"
06-May-2023,Purchase,"1,589,292.00",00.00,"1,681,935.72"
06-May-2023,Interest,47.00,00.00,"1,681,982.72"
06-May-2023,Bill,"29,620.70",00.00,"1,711,603.42"
06-May-2023,Commission,00.00,"855,801.71","855,801.71"
06-May-2023,Commission,398.00,00.00,"856,199.71"
07-May-2023,Bill,"216,581.34",00.00,"1,072,781.05"
07-May-2023,Cheque,00.00,"214,556.21","858,224.84"
07-May-2023,Commission,00.00,"286,074.95","572,149.89"
07-May-2023,Reversal,"486,818.00",00.00,"1,058,967.89"
07-May-2023,Interest,00.00,"352,989.30","705,978.59"
07-May-2023,Commission,00.00,"117,663.10","588,315.49"
07-May-2023,Interest,00.00,"84,045.07","504,270.42"
07-May-2023,Interest,35.80,00.00,"504,306.22"
07-May-2023,Miscellaneous,00.00,"168,102.07","336,204.15"
07-May-2023,Debit Card,00.00,"112,068.05","224,136.10"
07-May-2023,NEFT,05.00,00.00,"224,141.10"
07-May-2023,Tax,"169,011.00",00.00,"393,152.10"
08-May-2023,IMPS,"53,904.00",00.00,"447,056.10"
08-May-2023,Bill,"1,329,113.50",00.00,"1,776,169.60"
08-May-2023,Cheque,"596,233.00",00.00,"2,372,402.60"
08-May-2023,Purchase,00.00,"593,100.65","1,779,301.95"
08-May-2023,IMPS,31.00,00.00,"1,779,332.95"
08-May-2023,Miscellaneous,00.00,"254,190.42","1,525,142.53"
08-May-2023,Transfer,"117,393.53",00.00,"1,642,536.06"
08-May-2023,Cash,00.00,"164,253.61","1,478,282.45"
08-May-2023,Interest,00.00,"184,785.31","1,293,497.14"
08-May-2023,Reversal,"574,192.00",00.00,"1,867,689.14"
08-May-2023,Commission,"2,058,927.20",00.00,"3,926,616.34"
08-May-2023,Debit Card,05.00,00.00,"3,926,621.34"
08-May-2023,Tax,"103,120.00",00.00,"4,029,741.34"
08-May-2023,Tax,00.00,"805,948.27","3,223,793.07"
08-May-2023,Tax,00.00,"805,948.27","2,417,844.80"
08-May-2023,Commission,"433,412.00",00.00,"2,851,256.80"
08-May-2023,RTGS,"1,173.53",00.00,"2,852,430.33"
08-May-2023,Bill,"2,071,686.00",00.00,"4,924,116.33"
08-May-2023,Cash,"54,997.00",00.00,"4,979,113.33"
08-May-2023,Transfer,"71,357.90",00.00,"5,050,471.23"
08-May-2023,Cheque,00.00,"5,050,471.23",00.00
09-May-2023,ATM,"1,518,272.50",00.00,"1,518,272.50"
09-May-2023,NEFT,00.00,"759,136.25","759,136.25"
09-May-2023,Commission,07.50,00.00,"759,143.75"
09-May-2023,IMPS,00.00,"126,523.96","632,619.79"
09-May-2023,Debit Card,04.00,00.00,"632,623.79"
09-May-2023,IMPS,"30,454.00",00.00,"663,077.79"
09-May-2023,Interest,00.00,"221,025.93","442,051.86"
09-May-2023,Miscellaneous,00.00,"55,256.48","386,795.38"
09-May-2023,IMPS,"1,959,446.50",00.00,"2,346,241.88"
09-May-2023,Transfer,00.00,"2,346,241.88",00.00
09-May-2023,Interest,"3,225.20",00.00,"3,225.20"
09-May-2023,IMPS,"1,199,004.00",00.00,"1,202,229.20"
09-May-2023,Miscellaneous,00.00,"133,581.02","1,068,648.18"
09-May-2023,RTGS,"1,855.00",00.00,"1,070,503.18"
09-May-2023,ATM,"30,887.00",00.00,"1,101,390.18"
09-May-2023,Reversal,"1,805.20",00.00,"1,103,195.38"
09-May-2023,IMPS,00.00,"157,599.34","945,596.04"
09-May-2023,IMPS,00.00,"189,119.21","756,476.83"
09-May-2023,Transfer,42.00,00.00,"756,518.83"
09-May-2023,Tax,00.00,"151,303.77","605,215.06"
09-May-2023,Reversal,00.00,"302,607.53","302,607.53"
09-May-2023,Reversal,00.00,"43,229.65","259,377.88"
09-May-2023,RTGS,"1,709,457.00",00.00,"1,968,834.88"
09-May-2023,Interest,00.00,"218,759.43","1,750,075.45"
09-May-2023,RTGS,05.50,00.00,"1,750,080.95"
09-May-2023,Miscellaneous,00.00,"175,008.10","1,575,072.86"
09-May-2023,IMPS,"23,943.40",00.00,"1,599,016.26"
09-May-2023,Miscellaneous,"21,464.62",00.00,"1,620,480.88"
09-May-2023,Transfer,"247,419.69",00.00,"1,867,900.57"
09-May-2023,Reversal,00.00,"266,842.94","1,601,057.63"
09-May-2023,Reversal,00.00,"228,722.52","1,372,335.11"
09-May-2023,Commission,00.00,"686,167.56","686,167.56"
09-May-2023,Bill,"421,656.50",00.00,"1,107,824.06"
09-May-2023,Tax,00.00,"221,564.81","886,259.25"
09-May-2023,Interest,26.50,00.00,"886,285.75"
09-May-2023,Reversal,00.00,"88,628.58","797,657.18"
09-May-2023,Purchase,00.00,"79,765.72","717,891.46"
09-May-2023,Transfer,00.00,"358,945.73","358,945.73"
09-May-2023,Cheque,38.38,00.00,"358,984.11"
09-May-2023,IMPS,"1,291.31",00.00,"360,275.42"
09-May-2023,RTGS,00.00,"60,045.90","300,229.52"
09-May-2023,Miscellaneous,"1,877.00",00.00,"302,106.52"
09-May-2023,RTGS,"12,461.10",00.00,"314,567.62"
09-May-2023,Cash,00.00,"157,283.81","157,283.81"
09-May-2023,Transfer,00.00,"52,427.94","104,855.87"
09-May-2023,ATM,47.00,00.00,"104,902.87"
09-May-2023,Miscellaneous,"222,198.40",00.00,"327,101.27"
09-May-2023,Transfer,"238,316.84",00.00,"565,418.11"
09-May-2023,IMPS,00.00,"188,472.70","376,945.41"
09-May-2023,Transfer,00.00,"188,472.71","188,472.70"
09-May-2023,Miscellaneous,00.00,"31,412.12","157,060.58"
09-May-2023,Miscellaneous,"17,826.90",00.00,"174,887.48"
09-May-2023,IMPS,00.00,"17,488.75","157,398.73"
09-May-2023,Cash,"17,607.00",00.00,"175,005.73"
09-May-2023,RTGS,498.34,00.00,"175,504.07"
09-May-2023,Tax,00.00,"21,938.01","153,566.06"
10-May-2023,Purchase,00.00,"51,188.69","102,377.37"
10-May-2023,Tax,"15,587.00",00.00,"117,964.37"
10-May-2023,Miscellaneous,00.00,"117,964.37",00.00
10-May-2023,Commission,05.00,00.00,05.00
10-May-2023,RTGS,00.00,00.83,04.17
10-May-2023,Miscellaneous,00.00,00.52,03.65
10-May-2023,Debit Card,"3,153.00",00.00,"3,156.65"
11-May-2023,Purchase,07.42,00.00,"3,164.07"
11-May-2023,Reversal,00.00,452.01,"2,712.06"
11-May-2023,Commission,"26,280.00",00.00,"28,992.06"
11-May-2023,Cash,25.60,00.00,"29,017.66"
11-May-2023,Miscellaneous,"31,793.09",00.00,"60,810.75"
11-May-2023,Tax,00.00,"7,601.34","53,209.41"
11-May-2023,RTGS,00.00,"5,320.94","47,888.47"
11-May-2023,Purchase,00.00,"15,962.82","31,925.65"
11-May-2023,Miscellaneous,"1,575,096.75",00.00,"1,607,022.40"
11-May-2023,ATM,"24,875.10",00.00,"1,631,897.50"
11-May-2023,Tax,"80,061.80",00.00,"1,711,959.30"
11-May-2023,Bill,00.00,"855,979.65","855,979.65"
11-May-2023,NEFT,05.00,00.00,"855,984.65"
11-May-2023,Bill,"1,370,593.50",00.00,"2,226,578.15"
11-May-2023,Commission,00.00,"247,397.57","1,979,180.58"
11-May-2023,Cash,"208,817.40",00.00,"2,187,997.98"
11-May-2023,Purchase,51.20,00.00,"2,188,049.18"
11-May-2023,Bill,00.00,"729,349.73","1,458,699.45"
11-May-2023,Interest,03.00,00.00,"1,458,702.45"
11-May-2023,Transfer,"10,450.00",00.00,"1,469,152.45"
11-May-2023,Cheque,00.00,"183,644.06","1,285,508.39"
11-May-2023,Miscellaneous,00.00,"321,377.10","964,131.29"
11-May-2023,Transfer,04.00,00.00,"964,135.29"
11-May-2023,Transfer,00.00,"107,126.14","857,009.15"
11-May-2023,Debit Card,07.17,00.00,"857,016.32"
11-May-2023,Tax,00.00,"95,224.04","761,792.28"
12-May-2023,Bill,00.00,"108,827.47","652,964.81"
12-May-2023,IMPS,"9,100.00",00.00,"662,064.81"
12-May-2023,Reversal,"1,770,583.80",00.00,"2,432,648.61"
12-May-2023,Commission,242.00,00.00,"2,432,890.61"
12-May-2023,Cash,00.00,"1,216,445.31","1,216,445.30"
12-May-2023,Bill,17.40,00.00,"1,216,462.70"
12-May-2023,Transfer,00.00,"608,231.35","608,231.35"
12-May-2023,Reversal,"26,303.13",00.00,"634,534.48"
12-May-2023,IMPS,64.00,00.00,"634,598.48"
12-May-2023,Purchase,"21,220.03",00.00,"655,818.51"
12-May-2023,Cash,04.00,00.00,"655,822.51"
12-May-2023,Cash,00.00,"93,688.93","562,133.58"
12-May-2023,RTGS,134.00,00.00,"562,267.58"
12-May-2023,Commission,34.00,00.00,"562,301.58"
12-May-2023,RTGS,00.00,"70,287.70","492,013.88"
12-May-2023,NEFT,00.00,"98,402.78","393,611.10"
12-May-2023,Cheque,04.59,00.00,"393,615.69"
12-May-2023,Miscellaneous,"30,035.88",00.00,"423,651.57"
12-May-2023,Interest,00.00,"47,072.40","376,579.17"
12-May-2023,Cash,00.00,"41,842.13","334,737.04"
12-May-2023,ATM,41.25,00.00,"334,778.29"
12-May-2023,RTGS,00.00,"55,796.38","278,981.91"
12-May-2023,ATM,00.00,"55,796.38","223,185.53"
12-May-2023,Transfer,00.00,"74,395.18","148,790.35"
12-May-2023,NEFT,00.00,"18,598.79","130,191.56"
12-May-2023,Miscellaneous,00.00,"16,273.95","113,917.62"
12-May-2023,Cheque,451.20,00.00,"114,368.82"
12-May-2023,RTGS,00.00,"28,592.21","85,776.62"
12-May-2023,Purchase,00.00,"28,592.21","57,184.41"
12-May-2023,Interest,00.00,"19,061.47","38,122.94"
12-May-2023,Transfer,00.09,00.00,"38,123.03"
12-May-2023,RTGS,15.00,00.00,"38,138.03"
12-May-2023,Bill,02.00,00.00,"38,140.03"
12-May-2023,NEFT,00.00,"12,713.34","25,426.69"
12-May-2023,Reversal,00.00,"12,713.35","12,713.34"
12-May-2023,Interest,00.00,"2,118.89","10,594.45"
12-May-2023,Reversal,00.00,"2,118.89","8,475.56"
12-May-2023,Miscellaneous,"3,863.00",00.00,"12,338.56"
12-May-2023,Cheque,00.00,"2,467.71","9,870.85"
12-May-2023,IMPS,00.00,"1,974.17","7,896.68"
12-May-2023,Cheque,00.00,987.09,"6,909.60"
12-May-2023,Transfer,"29,759.40",00.00,"36,669.00"
12-May-2023,Transfer,191.90,00.00,"36,860.90"
12-May-2023,RTGS,00.00,"12,286.97","24,573.93"
12-May-2023,Commission,00.00,"3,071.74","21,502.19"
12-May-2023,Tax,45.00,00.00,"21,547.19"
12-May-2023,Commission,01.00,00.00,"21,548.19"
12-May-2023,Purchase,00.00,"10,774.10","10,774.10"
12-May-2023,Reversal,00.00,"1,539.16","9,234.94"
12-May-2023,ATM,"94,394.00",00.00,"103,628.94"
12-May-2023,RTGS,"1,883.99",00.00,"105,512.93"
12-May-2023,Debit Card,00.00,"21,102.59","84,410.34"
12-May-2023,Cheque,00.00,"10,551.29","73,859.05"
13-May-2023,Commission,00.00,"8,206.56","65,652.49"
13-May-2023,Interest,00.00,"9,378.93","56,273.56"
13-May-2023,NEFT,"311,628.50",00.00,"367,902.06"
13-May-2023,Cash,00.00,"183,951.03","183,951.03"
13-May-2023,Purchase,"138,312.80",00.00,"322,263.83"
13-May-2023,RTGS,"20,304.00",00.00,"342,567.83"
13-May-2023,Tax,00.00,"85,641.96","256,925.87"
13-May-2023,Interest,"1,329,319.20",00.00,"1,586,245.07"
13-May-2023,Cash,00.00,"176,249.45","1,409,995.62"
13-May-2023,Miscellaneous,00.00,"156,666.18","1,253,329.44"
13-May-2023,Reversal,00.00,"626,664.72","626,664.72"
13-May-2023,Cash,00.00,"62,666.47","563,998.25"
13-May-2023,Bill,00.00,"93,999.71","469,998.54"
13-May-2023,Purchase,00.00,"117,499.64","352,498.90"
13-May-2023,Transfer,00.00,"70,499.78","281,999.12"
13-May-2023,NEFT,00.00,"46,999.85","234,999.27"
13-May-2023,Reversal,00.00,"39,166.55","195,832.72"
13-May-2023,Cash,00.00,"24,479.09","171,353.63"
13-May-2023,Transfer,"8,769.90",00.00,"180,123.53"
13-May-2023,Interest,00.00,"20,013.73","160,109.80"
13-May-2023,Cash,00.00,"16,010.98","144,098.82"
13-May-2023,RTGS,00.00,"48,032.94","96,065.88"
13-May-2023,Purchase,00.00,"19,213.18","76,852.70"
13-May-2023,Cheque,60.00,00.00,"76,912.70"
13-May-2023,Reversal,"251,388.00",00.00,"328,300.70"
13-May-2023,Purchase,41.60,00.00,"328,342.30"
13-May-2023,Tax,57.00,00.00,"328,399.30"
13-May-2023,Interest,707.86,00.00,"329,107.16"
13-May-2023,ATM,"1,039.33",00.00,"330,146.49"
13-May-2023,NEFT,00.00,"110,048.83","220,097.66"
13-May-2023,Tax,00.00,"55,024.42","165,073.24"
14-May-2023,Debit Card,00.65,00.00,"165,073.89"
14-May-2023,Debit Card,"13,340.30",00.00,"178,414.19"
14-May-2023,Transfer,"391,110.80",00.00,"569,524.99"
14-May-2023,Transfer,00.00,"81,360.71","488,164.28"
14-May-2023,Commission,00.00,"244,082.14","244,082.14"
14-May-2023,RTGS,00.00,"48,816.43","195,265.71"
14-May-2023,Debit Card,377.80,00.00,"195,643.51"
15-May-2023,NEFT,00.00,"39,128.70","156,514.81"
15-May-2023,Cash,"565,311.20",00.00,"721,826.01"
15-May-2023,Commission,"881,865.00",00.00,"1,603,691.01"
15-May-2023,Tax,83.19,00.00,"1,603,774.20"
15-May-2023,RTGS,"668,666.00",00.00,"2,272,440.20"
15-May-2023,Bill,"1,063,682.00",00.00,"3,336,122.20"
15-May-2023,Miscellaneous,05.83,00.00,"3,336,128.03"
15-May-2023,Tax,00.00,00.00,"3,336,128.03"
15-May-2023,Cash,28.00,00.00,"3,336,156.03"
15-May-2023,ATM,00.00,"1,668,078.02","1,668,078.02"
15-May-2023,NEFT,00.00,"208,509.75","1,459,568.27"
15-May-2023,Tax,00.00,"208,509.75","1,251,058.52"
15-May-2023,Bill,00.00,"1,251,058.52",00.00
15-May-2023,Debit Card,298.00,00.00,298.00
15-May-2023,Purchase,00.00,59.60,238.40
15-May-2023,Purchase,00.00,29.80,208.60
15-May-2023,Cash,90.00,00.00,298.60
15-May-2023,ATM,00.00,149.30,149.30
15-May-2023,Debit Card,00.00,24.88,124.42
16-May-2023,RTGS,00.00,12.44,111.98
16-May-2023,RTGS,00.00,37.33,74.65
16-May-2023,Purchase,00.00,74.65,00.00
16-May-2023,Bill,"11,390.00",00.00,"11,390.00"
16-May-2023,Commission,03.70,00.00,"11,393.70"
16-May-2023,Tax,00.00,"2,848.43","8,545.28"
16-May-2023,Debit Card,00.00,"4,272.64","4,272.64"
16-May-2023,ATM,00.00,"4,272.64",00.00
16-May-2023,Bill,46.16,00.00,46.16
16-May-2023,Debit Card,"117,567.60",00.00,"117,613.76"
17-May-2023,IMPS,00.00,"16,801.97","100,811.79"
17-May-2023,Purchase,00.00,"33,603.93","67,207.86"
17-May-2023,Commission,504.89,00.00,"67,712.75"
17-May-2023,Cheque,08.69,00.00,"67,721.44"
17-May-2023,Debit Card,00.00,"6,772.14","60,949.30"
17-May-2023,Tax,00.00,"7,618.66","53,330.64"
17-May-2023,Transfer,00.00,"7,618.66","45,711.98"
17-May-2023,Cheque,"1,109,586.00",00.00,"1,155,297.98"
17-May-2023,Debit Card,"24,702.40",00.00,"1,180,000.38"
17-May-2023,Cheque,232.40,00.00,"1,180,232.78"
18-May-2023,Miscellaneous,00.00,"1,180,232.78",00.00
19-May-2023,Tax,64.00,00.00,64.00
19-May-2023,Purchase,"3,992.99",00.00,"4,056.99"
19-May-2023,Commission,"123,227.00",00.00,"127,283.99"
19-May-2023,Commission,00.00,"12,728.40","114,555.59"
19-May-2023,Miscellaneous,05.00,00.00,"114,560.59"
19-May-2023,Miscellaneous,00.00,"114,560.59",00.00
19-May-2023,ATM,"8,722.00",00.00,"8,722.00"
19-May-2023,Miscellaneous,457.40,00.00,"9,179.40"
19-May-2023,Commission,38.92,00.00,"9,218.32"
19-May-2023,Reversal,347.91,00.00,"9,566.23"
19-May-2023,NEFT,00.00,"3,188.74","6,377.49"
19-May-2023,IMPS,"3,725.60",00.00,"10,103.09"
19-May-2023,Bill,00.00,"10,103.09",00.00
19-May-2023,Transfer,"1,790,182.25",00.00,"1,790,182.25"
19-May-2023,ATM,00.00,"447,545.56","1,342,636.69"
19-May-2023,Miscellaneous,00.00,"223,772.78","1,118,863.91"
19-May-2023,Reversal,00.00,"111,886.39","1,006,977.52"
19-May-2023,Miscellaneous,06.70,00.00,"1,006,984.22"
19-May-2023,Reversal,00.00,"201,396.84","805,587.38"
20-May-2023,IMPS,171.98,00.00,"805,759.36"
20-May-2023,IMPS,00.00,"201,439.84","604,319.52"
20-May-2023,Tax,00.00,"120,863.90","483,455.62"
20-May-2023,RTGS,47.90,00.00,"483,503.52"
20-May-2023,ATM,58.50,00.00,"483,562.02"
21-May-2023,Commission,00.00,"161,187.34","322,374.68"
21-May-2023,Reversal,00.00,"64,474.94","257,899.74"
21-May-2023,Interest,34.10,00.00,"257,933.84"
21-May-2023,Tax,00.00,"85,977.95","171,955.89"
21-May-2023,RTGS,00.00,"28,659.32","143,296.58"
21-May-2023,Tax,00.00,"35,824.15","107,472.44"
21-May-2023,Commission,00.00,"17,912.07","89,560.37"
21-May-2023,Debit Card,62.24,00.00,"89,622.61"
21-May-2023,Purchase,00.00,"89,622.61",00.00
21-May-2023,Miscellaneous,"25,614.30",00.00,"25,614.30"
21-May-2023,NEFT,02.50,00.00,"25,616.80"
21-May-2023,Cash,00.00,"5,123.36","20,493.44"
21-May-2023,Tax,00.00,"3,415.57","17,077.87"
21-May-2023,Miscellaneous,00.00,"2,134.73","14,943.14"
21-May-2023,Debit Card,40.00,00.00,"14,983.14"
21-May-2023,Purchase,"508,629.75",00.00,"523,612.89"
21-May-2023,RTGS,"8,028.00",00.00,"531,640.89"
21-May-2023,Commission,00.00,"132,910.22","398,730.67"
21-May-2023,Transfer,"221,804.60",00.00,"620,535.27"
22-May-2023,Transfer,00.00,"310,267.64","310,267.64"
22-May-2023,Miscellaneous,00.00,"31,026.76","279,240.88"
22-May-2023,Interest,"1,944.75",00.00,"281,185.63"
22-May-2023,Interest,69.60,00.00,"281,255.23"
22-May-2023,Cash,"1,746.00",00.00,"283,001.23"
22-May-2023,Cheque,00.00,"141,500.62","141,500.62"
22-May-2023,Debit Card,00.00,"14,150.06","127,350.56"
22-May-2023,Commission,00.00,"25,470.11","101,880.45"
22-May-2023,Transfer,00.00,"11,320.05","90,560.40"
22-May-2023,IMPS,00.00,"45,280.20","45,280.20"
22-May-2023,Purchase,00.00,"45,280.20",00.00
22-May-2023,Transfer,"19,574.60",00.00,"19,574.60"
22-May-2023,Cheque,00.00,"2,174.96","17,399.64"
22-May-2023,Debit Card,04.92,00.00,"17,404.56"
22-May-2023,ATM,00.00,"3,480.91","13,923.65"
22-May-2023,Commission,287.00,00.00,"14,210.65"
22-May-2023,Cash,03.50,00.00,"14,214.15"
22-May-2023,Cash,"9,056.00",00.00,"23,270.15"
22-May-2023,Miscellaneous,752.40,00.00,"24,022.55"
22-May-2023,Commission,322.54,00.00,"24,345.09"
22-May-2023,Transfer,14.90,00.00,"24,359.99"
22-May-2023,Commission,505.00,00.00,"24,864.99"
22-May-2023,ATM,00.00,"6,216.25","18,648.74"
22-May-2023,IMPS,"21,713.00",00.00,"40,361.74"
22-May-2023,NEFT,"232,739.00",00.00,"273,100.74"
22-May-2023,Tax,"1,651,160.00",00.00,"1,924,260.74"
22-May-2023,Miscellaneous,"2,652.10",00.00,"1,926,912.84"
22-May-2023,Transfer,42.00,00.00,"1,926,954.84"
22-May-2023,Miscellaneous,00.00,"321,159.14","1,605,795.70"
22-May-2023,ATM,491.04,00.00,"1,606,286.74"
22-May-2023,Interest,"3,886.90",00.00,"1,610,173.64"
22-May-2023,Cheque,00.20,00.00,"1,610,173.84"
22-May-2023,Cheque,00.00,"268,362.31","1,341,811.53"
22-May-2023,Debit Card,00.00,"167,726.44","1,174,085.09"
22-May-2023,Tax,00.00,"167,726.44","1,006,358.65"
22-May-2023,Miscellaneous,00.00,"251,589.66","754,768.99"
22-May-2023,Reversal,34.00,00.00,"754,802.99"
22-May-2023,Transfer,"16,837.00",00.00,"771,639.99"
22-May-2023,Bill,"3,683.90",00.00,"775,323.89"
22-May-2023,Interest,42.86,00.00,"775,366.75"
22-May-2023,IMPS,03.00,00.00,"775,369.75"
22-May-2023,Miscellaneous,"1,861.51",00.00,"777,231.26"
22-May-2023,Interest,31.00,00.00,"777,262.26"
22-May-2023,Miscellaneous,00.00,"129,543.71","647,718.55"
22-May-2023,ATM,00.00,"647,718.55",00.00
22-May-2023,Miscellaneous,"28,865.49",00.00,"28,865.49"
23-May-2023,Miscellaneous,"3,399.31",00.00,"32,264.80"
23-May-2023,Purchase,00.00,"5,377.47","26,887.33"
23-May-2023,Transfer,"310,125.00",00.00,"337,012.33"
23-May-2023,Purchase,00.00,"37,445.81","299,566.52"
23-May-2023,Tax,00.00,"33,285.17","266,281.35"
23-May-2023,Reversal,00.00,"44,380.23","221,901.12"
23-May-2023,NEFT,00.00,"36,983.52","184,917.60"
23-May-2023,Debit Card,00.00,"30,819.60","154,098.00"
23-May-2023,Cheque,23.00,00.00,"154,121.00"
23-May-2023,Reversal,00.00,"25,686.83","128,434.17"
23-May-2023,ATM,"31,300.80",00.00,"159,734.97"
23-May-2023,Purchase,08.00,00.00,"159,742.97"
23-May-2023,Purchase,344.00,00.00,"160,086.97"
23-May-2023,Tax,"193,565.25",00.00,"353,652.22"
23-May-2023,Miscellaneous,"23,124.09",00.00,"376,776.31"
23-May-2023,Interest,00.00,"125,592.10","251,184.21"
23-May-2023,RTGS,00.00,"83,728.07","167,456.14"
23-May-2023,ATM,"1,159,957.00",00.00,"1,327,413.14"
23-May-2023,IMPS,"206,639.09",00.00,"1,534,052.23"
23-May-2023,Miscellaneous,01.50,00.00,"1,534,053.73"
23-May-2023,Purchase,938.70,00.00,"1,534,992.43"
23-May-2023,Purchase,00.00,"191,874.05","1,343,118.38"
23-May-2023,ATM,36.10,00.00,"1,343,154.48"
23-May-2023,Cash,"238,740.00",00.00,"1,581,894.48"
23-May-2023,Cheque,00.00,"790,947.24","790,947.24"
23-May-2023,RTGS,00.00,"79,094.72","711,852.52"
23-May-2023,Transfer,00.00,"237,284.17","474,568.35"
23-May-2023,Reversal,"289,628.50",00.00,"764,196.85"
23-May-2023,Transfer,00.00,"191,049.21","573,147.64"
23-May-2023,Transfer,00.00,"114,629.53","458,518.11"
23-May-2023,NEFT,142.16,00.00,"458,660.27"
23-May-2023,Miscellaneous,"27,254.90",00.00,"485,915.17"
23-May-2023,Reversal,14.40,00.00,"485,929.57"
23-May-2023,Commission,"1,278.00",00.00,"487,207.57"
23-May-2023,Debit Card,01.00,00.00,"487,208.57"
23-May-2023,Interest,00.00,"69,601.22","417,607.35"
23-May-2023,Interest,"51,263.28",00.00,"468,870.63"
23-May-2023,Interest,00.00,"234,435.32","234,435.32"
23-May-2023,Interest,00.00,"78,145.11","156,290.21"
23-May-2023,NEFT,"980,301.50",00.00,"1,136,591.71"
23-May-2023,NEFT,00.00,"162,370.24","974,221.47"
23-May-2023,RTGS,23.77,00.00,"974,245.24"
23-May-2023,Reversal,"14,213.20",00.00,"988,458.44"
23-May-2023,ATM,00.00,"109,828.72","878,629.72"
23-May-2023,Tax,00.00,"146,438.29","732,191.43"
23-May-2023,Commission,00.00,"732,191.43",00.00
23-May-2023,IMPS,163.60,00.00,163.60
23-May-2023,Commission,00.00,27.27,136.33
24-May-2023,Commission,"242,592.40",00.00,"242,728.73"
24-May-2023,ATM,00.00,"121,364.37","121,364.36"
24-May-2023,Purchase,00.00,"17,337.77","104,026.59"
24-May-2023,ATM,"1,967.48",00.00,"105,994.07"
24-May-2023,Miscellaneous,"120,936.78",00.00,"226,930.85"
24-May-2023,Cash,00.00,"226,930.85",00.00
24-May-2023,Cheque,151.60,00.00,151.60
24-May-2023,Cheque,00.00,151.60,00.00
24-May-2023,NEFT,54.30,00.00,54.30
24-May-2023,Interest,00.00,54.30,00.00
24-May-2023,Reversal,95.52,00.00,95.52
24-May-2023,Reversal,00.00,09.55,85.97
25-May-2023,Cheque,00.00,21.49,64.48
25-May-2023,Miscellaneous,"2,035,246.00",00.00,"2,035,310.48"
25-May-2023,Debit Card,03.40,00.00,"2,035,313.88"
25-May-2023,Commission,"56,929.90",00.00,"2,092,243.78"
25-May-2023,Interest,00.00,"418,448.76","1,673,795.02"
25-May-2023,NEFT,00.00,"278,965.84","1,394,829.18"
26-May-2023,Tax,00.00,"139,482.92","1,255,346.26"
26-May-2023,Tax,"66,881.30",00.00,"1,322,227.56"
26-May-2023,Interest,470.91,00.00,"1,322,698.47"
26-May-2023,ATM,00.00,"132,269.85","1,190,428.62"
26-May-2023,Debit Card,00.00,"595,214.31","595,214.31"
26-May-2023,Cheque,00.00,"99,202.39","496,011.93"
26-May-2023,Bill,57.70,00.00,"496,069.63"
26-May-2023,Cheque,00.00,"124,017.41","372,052.22"
26-May-2023,Cheque,00.00,"372,052.22",00.00
26-May-2023,NEFT,12.37,00.00,12.37
26-May-2023,Miscellaneous,00.00,01.24,11.13
26-May-2023,ATM,"1,843.30",00.00,"1,854.43"
26-May-2023,Commission,00.00,927.22,927.22
26-May-2023,ATM,00.00,132.46,794.76
26-May-2023,IMPS,00.00,88.31,706.45
26-May-2023,Commission,00.00,100.92,605.53
26-May-2023,RTGS,06.00,00.00,611.53
26-May-2023,Purchase,337.00,00.00,948.53
26-May-2023,Interest,00.00,135.50,813.03
26-May-2023,Debit Card,58.79,00.00,871.82
26-May-2023,ATM,30.13,00.00,901.95
26-May-2023,Tax,"1,459,025.50",00.00,"1,459,927.45"
26-May-2023,Reversal,00.00,"162,214.16","1,297,713.29"
26-May-2023,NEFT,05.60,00.00,"1,297,718.89"
26-May-2023,Bill,44.00,00.00,"1,297,762.89"
26-May-2023,Tax,270.25,00.00,"1,298,033.14"
26-May-2023,Interest,25.00,00.00,"1,298,058.14"
26-May-2023,RTGS,"228,129.00",00.00,"1,526,187.14"
26-May-2023,RTGS,830.00,00.00,"1,527,017.14"
26-May-2023,IMPS,"1,650,791.50",00.00,"3,177,808.64"
26-May-2023,ATM,691.00,00.00,"3,178,499.64"
26-May-2023,Tax,00.00,"317,849.96","2,860,649.68"
26-May-2023,ATM,00.00,"408,664.24","2,451,985.44"
26-May-2023,Debit Card,"1,578.19",00.00,"2,453,563.63"
26-May-2023,Purchase,00.00,"306,695.45","2,146,868.18"
26-May-2023,Miscellaneous,56.59,00.00,"2,146,924.77"
26-May-2023,ATM,00.00,"238,547.20","1,908,377.57"
26-May-2023,NEFT,03.00,00.00,"1,908,380.57"
26-May-2023,Interest,00.00,"190,838.06","1,717,542.51"
26-May-2023,NEFT,02.69,00.00,"1,717,545.20"
26-May-2023,Purchase,320.00,00.00,"1,717,865.20"
26-May-2023,Purchase,"199,271.06",00.00,"1,917,136.26"
26-May-2023,Debit Card,380.16,00.00,"1,917,516.42"
26-May-2023,Bill,00.00,"319,586.07","1,597,930.35"
26-May-2023,ATM,31.77,00.00,"1,597,962.12"
26-May-2023,Bill,00.00,"399,490.53","1,198,471.59"
26-May-2023,Miscellaneous,39.00,00.00,"1,198,510.59"
26-May-2023,Interest,50.36,00.00,"1,198,560.95"
26-May-2023,Reversal,03.00,00.00,"1,198,563.95"
26-May-2023,Interest,04.03,00.00,"1,198,567.98"
26-May-2023,Interest,00.00,"299,642.00","898,925.98"
27-May-2023,Bill,39.00,00.00,"898,964.98"
27-May-2023,Cash,00.00,"99,885.00","799,079.98"
27-May-2023,Cheque,00.00,"133,180.00","665,899.98"
27-May-2023,Interest,00.00,"665,899.98",00.00
27-May-2023,Reversal,"20,823.00",00.00,"20,823.00"
27-May-2023,Transfer,00.00,"4,164.60","16,658.40"
27-May-2023,Cheque,"1,539,172.00",00.00,"1,555,830.40"
27-May-2023,Interest,00.00,"777,915.20","777,915.20"
27-May-2023,Cash,00.00,"77,791.52","700,123.68"
27-May-2023,Cheque,00.00,"175,030.92","525,092.76"
27-May-2023,IMPS,"76,472.00",00.00,"601,564.76"
27-May-2023,Debit Card,00.00,"200,521.59","401,043.17"
27-May-2023,Commission,217.22,00.00,"401,260.39"
27-May-2023,Bill,"23,311.20",00.00,"424,571.59"
27-May-2023,Commission,06.40,00.00,"424,577.99"
27-May-2023,Reversal,35.50,00.00,"424,613.49"
27-May-2023,Commission,"2,604.40",00.00,"427,217.89"
27-May-2023,Interest,00.00,"427,217.89",00.00
27-May-2023,RTGS,"2,054,997.50",00.00,"2,054,997.50"
27-May-2023,RTGS,00.00,"513,749.38","1,541,248.12"
27-May-2023,Reversal,00.00,"154,124.81","1,387,123.31"
27-May-2023,Transfer,"3,424.80",00.00,"1,390,548.11"
27-May-2023,Interest,00.00,"463,516.04","927,032.07"
27-May-2023,Cheque,04.79,00.00,"927,036.86"
27-May-2023,Interest,870.14,00.00,"927,907.00"
27-May-2023,ATM,05.52,00.00,"927,912.52"
27-May-2023,Commission,194.00,00.00,"928,106.52"
27-May-2023,IMPS,00.00,"928,106.52",00.00
28-May-2023,Interest,"64,079.00",00.00,"64,079.00"
28-May-2023,Purchase,00.00,"32,039.50","32,039.50"
28-May-2023,Tax,04.69,00.00,"32,044.19"
28-May-2023,Purchase,"100,257.78",00.00,"132,301.97"
28-May-2023,RTGS,00.00,"33,075.49","99,226.48"
28-May-2023,Cash,"38,621.00",00.00,"137,847.48"
28-May-2023,Reversal,00.00,"27,569.50","110,277.98"
28-May-2023,Purchase,00.00,"110,277.98",00.00
28-May-2023,ATM,04.89,00.00,04.89
28-May-2023,Interest,00.00,01.63,03.26
28-May-2023,Commission,00.00,01.09,02.17
28-May-2023,Interest,00.00,00.72,01.45
28-May-2023,Cash,06.70,00.00,08.15
28-May-2023,Bill,00.00,01.16,06.99
28-May-2023,RTGS,03.80,00.00,10.79
28-May-2023,ATM,163.80,00.00,174.59
28-May-2023,Cash,"154,988.00",00.00,"155,162.59"
28-May-2023,Bill,00.00,"155,162.59",00.00
28-May-2023,Purchase,14.80,00.00,14.80
28-May-2023,Cash,"2,024,538.00",00.00,"2,024,552.80"
28-May-2023,Cash,"2,018,732.00",00.00,"4,043,284.80"
28-May-2023,Cash,"1,341,815.80",00.00,"5,385,100.60"
28-May-2023,Bill,"234,581.70",00.00,"5,619,682.30"
28-May-2023,Bill,00.00,"2,809,841.15","2,809,841.15"
28-May-2023,Tax,00.00,"280,984.12","2,528,857.04"
28-May-2023,NEFT,"962,986.75",00.00,"3,491,843.79"
28-May-2023,Bill,00.00,"581,973.97","2,909,869.82"
28-May-2023,Cash,00.00,"969,956.61","1,939,913.21"
28-May-2023,IMPS,461.60,00.00,"1,940,374.81"
28-May-2023,Purchase,00.00,"215,597.20","1,724,777.61"
28-May-2023,Bill,"1,808.00",00.00,"1,726,585.61"
28-May-2023,NEFT,"32,750.00",00.00,"1,759,335.61"
28-May-2023,Bill,00.00,"195,481.73","1,563,853.88"
28-May-2023,Cheque,"29,231.76",00.00,"1,593,085.64"
28-May-2023,Miscellaneous,36.40,00.00,"1,593,122.04"
28-May-2023,Transfer,"1,626.80",00.00,"1,594,748.84"
29-May-2023,Purchase,00.00,"159,474.88","1,435,273.96"
29-May-2023,Miscellaneous,00.00,"717,636.98","717,636.98"
29-May-2023,Miscellaneous,00.00,"358,818.49","358,818.49"
29-May-2023,Debit Card,"181,841.16",00.00,"540,659.65"
29-May-2023,Cheque,00.00,"135,164.91","405,494.74"
29-May-2023,Tax,466.00,00.00,"405,960.74"
29-May-2023,Bill,00.00,"40,596.07","365,364.67"
29-May-2023,Bill,00.00,"52,194.95","313,169.72"
29-May-2023,IMPS,00.00,"78,292.43","234,877.29"
29-May-2023,Miscellaneous,417.00,00.00,"235,294.29"
29-May-2023,Purchase,00.00,"117,647.15","117,647.14"
29-May-2023,ATM,914.10,00.00,"118,561.24"
29-May-2023,ATM,00.00,"39,520.41","79,040.83"
29-May-2023,Miscellaneous,00.00,"19,760.21","59,280.62"
29-May-2023,Cheque,"934,762.00",00.00,"994,042.62"
29-May-2023,Miscellaneous,"3,160.50",00.00,"997,203.12"
29-May-2023,Bill,39.30,00.00,"997,242.42"
29-May-2023,Transfer,00.00,"332,414.14","664,828.28"
29-May-2023,IMPS,00.00,"66,482.83","598,345.45"
29-May-2023,Commission,06.80,00.00,"598,352.25"
29-May-2023,IMPS,00.00,"299,176.13","299,176.12"
29-May-2023,Cheque,00.00,"99,725.37","199,450.75"
29-May-2023,Transfer,"8,385.00",00.00,"207,835.75"
29-May-2023,Miscellaneous,36.00,00.00,"207,871.75"
29-May-2023,NEFT,"6,719.00",00.00,"214,590.75"
29-May-2023,Transfer,"6,958.30",00.00,"221,549.05"
29-May-2023,Tax,"10,280.40",00.00,"231,829.45"
29-May-2023,RTGS,"177,915.20",00.00,"409,744.65"
29-May-2023,Transfer,00.00,"136,581.55","273,163.10"
29-May-2023,IMPS,00.00,"27,316.31","245,846.79"
29-May-2023,IMPS,00.00,"30,730.85","215,115.94"
29-May-2023,Commission,00.00,"107,557.97","107,557.97"
29-May-2023,Purchase,00.00,"35,852.66","71,705.31"
29-May-2023,Commission,"19,444.00",00.00,"91,149.31"
29-May-2023,Transfer,118.00,00.00,"91,267.31"
29-May-2023,Debit Card,00.00,"13,038.19","78,229.12"
29-May-2023,ATM,"182,507.00",00.00,"260,736.12"
29-May-2023,RTGS,00.40,00.00,"260,736.52"
29-May-2023,ATM,00.00,"65,184.13","195,552.39"
29-May-2023,Transfer,00.00,"195,552.39",00.00
29-May-2023,Reversal,22.00,00.00,22.00
29-May-2023,Interest,00.00,03.14,18.86
29-May-2023,NEFT,"239,288.90",00.00,"239,307.76"
29-May-2023,Commission,"177,784.91",00.00,"417,092.67"
29-May-2023,Miscellaneous,00.00,"208,546.34","208,546.34"
29-May-2023,IMPS,"1,463.04",00.00,"210,009.38"
29-May-2023,Cheque,"6,199.00",00.00,"216,208.38"
29-May-2023,NEFT,00.00,"27,026.05","189,182.33"
29-May-2023,Cheque,21.90,00.00,"189,204.23"
29-May-2023,IMPS,"2,931.83",00.00,"192,136.06"
29-May-2023,Cash,00.00,"21,348.45","170,787.61"
29-May-2023,Commission,02.48,00.00,"170,790.09"
29-May-2023,Bill,18.70,00.00,"170,808.79"
29-May-2023,Debit Card,00.00,"17,080.88","153,727.91"
29-May-2023,Purchase,01.00,00.00,"153,728.91"
29-May-2023,RTGS,10.60,00.00,"153,739.51"
29-May-2023,Debit Card,00.00,"19,217.44","134,522.07"
29-May-2023,IMPS,00.00,"19,217.44","115,304.63"
29-May-2023,Interest,"24,429.80",00.00,"139,734.43"
29-May-2023,Interest,00.00,"139,734.43",00.00
29-May-2023,Commission,02.00,00.00,02.00
29-May-2023,Cheque,00.00,01.00,01.00
29-May-2023,Bill,00.00,00.13,00.88
29-May-2023,Commission,00.00,00.18,00.70
29-May-2023,ATM,00.00,00.70,00.00
29-May-2023,Tax,01.84,00.00,01.84
29-May-2023,Commission,"2,486.00",00.00,"2,487.84"
29-May-2023,Cash,00.00,276.43,"2,211.41"
29-May-2023,Cash,"79,782.40",00.00,"81,993.81"
29-May-2023,Miscellaneous,00.00,"16,398.76","65,595.05"
29-May-2023,Cash,"122,296.56",00.00,"187,891.61"
29-May-2023,Commission,00.00,"187,891.61",00.00
29-May-2023,Commission,28.00,00.00,28.00
29-May-2023,Commission,00.00,03.50,24.50
29-May-2023,Cash,"1,375,007.50",00.00,"1,375,032.00"
29-May-2023,Reversal,"912,223.20",00.00,"2,287,255.20"
29-May-2023,RTGS,63.00,00.00,"2,287,318.20"
29-May-2023,Bill,"3,494.10",00.00,"2,290,812.30"
29-May-2023,IMPS,00.00,"763,604.10","1,527,208.20"
29-May-2023,Cheque,36.52,00.00,"1,527,244.72"
29-May-2023,Tax,"29,296.81",00.00,"1,556,541.53"
29-May-2023,Transfer,"191,320.00",00.00,"1,747,861.53"
29-May-2023,Bill,00.00,"436,965.38","1,310,896.15"
29-May-2023,RTGS,00.00,"436,965.38","873,930.77"
30-May-2023,IMPS,"20,451.90",00.00,"894,382.67"
30-May-2023,ATM,00.00,"298,127.56","596,255.11"
30-May-2023,Cheque,"172,272.50",00.00,"768,527.61"
31-May-2023,Bill,00.00,"85,391.96","683,135.65"
31-May-2023,Interest,00.00,"75,903.96","607,231.69"
31-May-2023,NEFT,00.00,"75,903.96","531,327.73"
31-May-2023,Bill,00.00,"106,265.55","425,062.18"
31-May-2023,Commission,50.30,00.00,"425,112.48"
31-May-2023,Tax,00.00,"60,730.35","364,382.13"
31-May-2023,Transfer,08.80,00.00,"364,390.93"
31-May-2023,Purchase,00.00,"72,878.19","291,512.74"
31-May-2023,Tax,"135,022.00",00.00,"426,534.74"
31-May-2023,IMPS,00.00,"426,534.74",00.00
31-May-2023,Cash,"1,696,587.75",00.00,"1,696,587.75"
31-May-2023,Cheque,00.00,"169,658.78","1,526,928.98"
31-May-2023,Tax,00.00,"190,866.12","1,336,062.86"
31-May-2023,IMPS,"31,340.17",00.00,"1,367,403.03"
31-May-2023,Commission,00.00,"136,740.30","1,230,662.73"
31-May-2023,Miscellaneous,00.00,"136,740.30","1,093,922.43"
31-May-2023,Bill,00.00,"182,320.41","911,602.02"
31-May-2023,Commission,03.30,00.00,"911,605.32"
31-May-2023,Commission,06.09,00.00,"911,611.41"
31-May-2023,Interest,340.20,00.00,"911,951.61"
31-May-2023,Cheque,"63,838.91",00.00,"975,790.52"
31-May-2023,Cash,"150,360.12",00.00,"1,126,150.64"
31-May-2023,RTGS,00.00,"187,691.77","938,458.87"
31-May-2023,Bill,"8,553.79",00.00,"947,012.66"
31-May-2023,Debit Card,"132,794.00",00.00,"1,079,806.66"
31-May-2023,Transfer,00.00,"1,079,806.66",00.00
31-May-2023,Miscellaneous,00.49,00.00,00.49
31-May-2023,Bill,00.00,00.16,00.33
31-May-2023,RTGS,00.00,00.07,00.26
31-May-2023,ATM,00.00,00.09,00.17
31-May-2023,Transfer,32.00,00.00,32.17
31-May-2023,NEFT,00.00,04.60,27.57
31-May-2023,NEFT,00.00,06.89,20.68
31-May-2023,Reversal,174.40,00.00,195.08
31-May-2023,Purchase,03.00,00.00,198.08
31-May-2023,Cheque,18.00,00.00,216.08
31-May-2023,IMPS,00.00,21.61,194.47
31-May-2023,Cash,"33,717.62",00.00,"33,912.09"
31-May-2023,Miscellaneous,00.00,"4,239.01","29,673.08"
31-May-2023,Reversal,00.00,"4,945.51","24,727.57"
31-May-2023,Debit Card,05.29,00.00,"24,732.86"
31-May-2023,Bill,00.00,"24,732.86",00.00
31-May-2023,Tax,"21,068.00",00.00,"21,068.00"
31-May-2023,Purchase,00.00,"10,534.00","10,534.00"
31-May-2023,Bill,"12,004.00",00.00,"22,538.00"
31-May-2023,Commission,25.76,00.00,"22,563.76"
31-May-2023,Commission,861.00,00.00,"23,424.76"
31-May-2023,Purchase,00.00,"5,856.19","17,568.57"
31-May-2023,ATM,"80,653.53",00.00,"98,222.10"
31-May-2023,Interest,00.00,"98,222.10",00.00
31-May-2023,Purchase,18.00,00.00,18.00
31-May-2023,Miscellaneous,07.56,00.00,25.56
31-May-2023,ATM,00.00,02.84,22.72
31-May-2023,Bill,00.00,03.25,19.47
01-Jun-2023,Bill,00.00,06.49,12.98
01-Jun-2023,Tax,00.00,12.98,00.00
01-Jun-2023,ATM,487.00,00.00,487.00
01-Jun-2023,Miscellaneous,00.00,97.40,389.60
01-Jun-2023,Interest,"1,884.47",00.00,"2,274.07"
01-Jun-2023,NEFT,00.00,568.52,"1,705.55"
01-Jun-2023,Bill,00.00,243.65,"1,461.90"
01-Jun-2023,Transfer,00.00,208.84,"1,253.06"
01-Jun-2023,Cash,"2,079,267.00",00.00,"2,080,520.06"
01-Jun-2023,Miscellaneous,00.00,"260,065.01","1,820,455.05"
01-Jun-2023,Cheque,30.70,00.00,"1,820,485.75"
01-Jun-2023,ATM,00.00,"202,276.19","1,618,209.56"
01-Jun-2023,Miscellaneous,00.00,"404,552.39","1,213,657.17"
01-Jun-2023,Commission,07.19,00.00,"1,213,664.36"
01-Jun-2023,ATM,00.00,"606,832.18","606,832.18"
01-Jun-2023,Interest,00.00,"121,366.44","485,465.74"
01-Jun-2023,Purchase,"23,322.00",00.00,"508,787.74"
01-Jun-2023,IMPS,"3,194.00",00.00,"511,981.74"
01-Jun-2023,Transfer,00.00,"511,981.74",00.00
01-Jun-2023,Reversal,"178,794.00",00.00,"178,794.00"
01-Jun-2023,ATM,"26,021.93",00.00,"204,815.93"
01-Jun-2023,Cheque,00.00,"25,601.99","179,213.94"
01-Jun-2023,Transfer,00.00,"44,803.49","134,410.46"
01-Jun-2023,Bill,00.00,"33,602.62","100,807.84"
01-Jun-2023,Interest,00.00,"100,807.84",00.00
01-Jun-2023,Miscellaneous,"1,509,068.50",00.00,"1,509,068.50"
01-Jun-2023,Cash,00.00,"150,906.85","1,358,161.65"
01-Jun-2023,NEFT,00.00,"1,358,161.65",00.00
01-Jun-2023,Commission,00.80,00.00,00.80
01-Jun-2023,Reversal,"259,940.94",00.00,"259,941.74"
01-Jun-2023,Transfer,00.00,"259,941.74",00.00
01-Jun-2023,Interest,488.15,00.00,488.15
01-Jun-2023,Reversal,00.00,69.74,418.41
01-Jun-2023,ATM,228.40,00.00,646.81
01-Jun-2023,Transfer,00.00,64.68,582.13
01-Jun-2023,Debit Card,00.00,582.13,00.00
01-Jun-2023,ATM,"22,160.12",00.00,"22,160.12"
01-Jun-2023,NEFT,00.00,"11,080.06","11,080.06"
01-Jun-2023,Purchase,35.00,00.00,"11,115.06"
01-Jun-2023,RTGS,00.00,"1,111.51","10,003.55"
01-Jun-2023,Transfer,53.20,00.00,"10,056.75"
01-Jun-2023,Commission,"136,696.50",00.00,"146,753.25"
01-Jun-2023,Commission,00.00,"14,675.33","132,077.92"
01-Jun-2023,Bill,00.00,"132,077.92",00.00
01-Jun-2023,NEFT,"59,553.70",00.00,"59,553.70"
01-Jun-2023,Purchase,"143,571.50",00.00,"203,125.20"
01-Jun-2023,Debit Card,00.00,"40,625.04","162,500.16"
01-Jun-2023,Cash,"112,043.62",00.00,"274,543.78"
01-Jun-2023,Bill,"1,618,049.00",00.00,"1,892,592.78"
01-Jun-2023,Tax,00.00,"189,259.28","1,703,333.50"
01-Jun-2023,Miscellaneous,00.00,"170,333.35","1,533,000.15"
01-Jun-2023,Interest,"1,633,320.00",00.00,"3,166,320.15"
01-Jun-2023,Reversal,05.60,00.00,"3,166,325.75"
01-Jun-2023,NEFT,"2,389.00",00.00,"3,168,714.75"
01-Jun-2023,Tax,00.00,"792,178.69","2,376,536.06"
01-Jun-2023,Cash,"22,162.30",00.00,"2,398,698.36"
01-Jun-2023,NEFT,00.00,"2,398,698.36",00.00
01-Jun-2023,Miscellaneous,41.70,00.00,41.70
01-Jun-2023,Miscellaneous,00.00,10.43,31.28
01-Jun-2023,Debit Card,10.52,00.00,41.80
01-Jun-2023,IMPS,00.00,13.93,27.87
01-Jun-2023,ATM,00.00,02.79,25.08
01-Jun-2023,ATM,00.00,05.02,20.06
01-Jun-2023,Bill,00.00,06.69,13.37
01-Jun-2023,Miscellaneous,"2,346.27",00.00,"2,359.64"
01-Jun-2023,Transfer,05.00,00.00,"2,364.64"
01-Jun-2023,IMPS,07.32,00.00,"2,371.96"
01-Jun-2023,RTGS,"745,364.00",00.00,"747,735.96"
01-Jun-2023,Debit Card,00.00,"149,547.19","598,188.77"
01-Jun-2023,IMPS,"23,512.34",00.00,"621,701.11"
01-Jun-2023,Cheque,00.00,"62,170.11","559,531.00"
01-Jun-2023,NEFT,"3,739.20",00.00,"563,270.20"
01-Jun-2023,Tax,"696,914.75",00.00,"1,260,184.95"
01-Jun-2023,Bill,00.00,"315,046.24","945,138.71"
01-Jun-2023,NEFT,03.50,00.00,"945,142.21"
01-Jun-2023,Interest,"25,228.16",00.00,"970,370.37"
02-Jun-2023,Debit Card,"234,564.72",00.00,"1,204,935.09"
02-Jun-2023,Debit Card,00.00,"200,822.52","1,004,112.58"
02-Jun-2023,Commission,00.00,"251,028.15","753,084.44"
02-Jun-2023,Debit Card,"24,132.80",00.00,"777,217.24"
02-Jun-2023,Reversal,00.00,"111,031.03","666,186.21"
02-Jun-2023,Tax,00.00,"83,273.28","582,912.93"
02-Jun-2023,Commission,"156,110.25",00.00,"739,023.18"
02-Jun-2023,Debit Card,00.00,"739,023.18",00.00
02-Jun-2023,NEFT,"143,861.50",00.00,"143,861.50"
02-Jun-2023,Miscellaneous,00.00,"28,772.30","115,089.20"
02-Jun-2023,NEFT,"1,312.85",00.00,"116,402.05"
02-Jun-2023,Miscellaneous,"8,811.00",00.00,"125,213.05"
02-Jun-2023,ATM,97.30,00.00,"125,310.35"
02-Jun-2023,NEFT,00.00,"12,531.04","112,779.32"
02-Jun-2023,RTGS,109.00,00.00,"112,888.32"
02-Jun-2023,Debit Card,00.00,"56,444.16","56,444.16"
02-Jun-2023,Commission,00.00,"8,063.45","48,380.71"
02-Jun-2023,Tax,00.00,"6,911.53","41,469.18"
02-Jun-2023,Purchase,00.00,"4,146.92","37,322.26"
02-Jun-2023,Reversal,00.00,"12,440.75","24,881.51"
02-Jun-2023,Bill,352.00,00.00,"25,233.51"
02-Jun-2023,Reversal,00.00,"3,154.19","22,079.32"
02-Jun-2023,Miscellaneous,"128,291.30",00.00,"150,370.62"
02-Jun-2023,Purchase,00.00,"50,123.54","100,247.08"
02-Jun-2023,NEFT,00.00,"16,707.85","83,539.23"
02-Jun-2023,IMPS,"2,494.71",00.00,"86,033.94"
02-Jun-2023,Miscellaneous,38.10,00.00,"86,072.04"
02-Jun-2023,NEFT,00.00,"28,690.68","57,381.36"
02-Jun-2023,Cheque,00.00,"19,127.12","38,254.24"
02-Jun-2023,Debit Card,00.00,"12,751.41","25,502.83"
02-Jun-2023,Debit Card,50.60,00.00,"25,553.43"
02-Jun-2023,IMPS,395.00,00.00,"25,948.43"
02-Jun-2023,Cash,"141,117.80",00.00,"167,066.23"
02-Jun-2023,ATM,00.00,"167,066.23",00.00
02-Jun-2023,Transfer,324.00,00.00,324.00
02-Jun-2023,Interest,"318,733.00",00.00,"319,057.00"
02-Jun-2023,Debit Card,95.80,00.00,"319,152.80"
02-Jun-2023,Transfer,08.00,00.00,"319,160.80"
02-Jun-2023,IMPS,00.00,"106,386.93","212,773.87"
02-Jun-2023,Tax,00.00,"53,193.47","159,580.40"
03-Jun-2023,ATM,00.00,"159,580.40",00.00
03-Jun-2023,Reversal,220.05,00.00,220.05
03-Jun-2023,Bill,06.94,00.00,226.99
03-Jun-2023,Cheque,00.00,113.50,113.50
03-Jun-2023,IMPS,00.00,113.50,00.00
03-Jun-2023,Bill,18.60,00.00,18.60
03-Jun-2023,Reversal,"1,081.00",00.00,"1,099.60"
03-Jun-2023,Cheque,"1,794,126.00",00.00,"1,795,225.60"
03-Jun-2023,Transfer,"216,857.22",00.00,"2,012,082.82"
03-Jun-2023,Cheque,"193,637.94",00.00,"2,205,720.76"
03-Jun-2023,Commission,00.00,"551,430.19","1,654,290.57"
03-Jun-2023,Cash,"24,871.89",00.00,"1,679,162.46"
03-Jun-2023,Bill,06.20,00.00,"1,679,168.66"
03-Jun-2023,RTGS,763.10,00.00,"1,679,931.76"
03-Jun-2023,Purchase,29.40,00.00,"1,679,961.16"
03-Jun-2023,ATM,04.00,00.00,"1,679,965.16"
03-Jun-2023,NEFT,"191,146.00",00.00,"1,871,111.16"
03-Jun-2023,Reversal,"163,224.70",00.00,"2,034,335.86"
03-Jun-2023,Miscellaneous,"482,581.00",00.00,"2,516,916.86"
03-Jun-2023,Debit Card,06.75,00.00,"2,516,923.61"
03-Jun-2023,Transfer,"10,410.04",00.00,"2,527,333.65"
03-Jun-2023,Cheque,"1,553,152.00",00.00,"4,080,485.65"
03-Jun-2023,NEFT,00.00,"510,060.71","3,570,424.94"
03-Jun-2023,ATM,00.00,"446,303.12","3,124,121.82"
03-Jun-2023,Interest,00.00,"624,824.36","2,499,297.46"
03-Jun-2023,Bill,00.00,"499,859.49","1,999,437.97"
03-Jun-2023,Purchase,00.00,"999,718.99","999,718.98"
03-Jun-2023,Reversal,03.40,00.00,"999,722.38"
03-Jun-2023,Cheque,00.00,"999,722.38",00.00
03-Jun-2023,Purchase,"80,843.00",00.00,"80,843.00"
03-Jun-2023,ATM,"424,702.20",00.00,"505,545.20"
03-Jun-2023,Debit Card,00.00,"168,515.07","337,030.13"
03-Jun-2023,RTGS,04.67,00.00,"337,034.80"
03-Jun-2023,Commission,81.70,00.00,"337,116.50"
04-Jun-2023,RTGS,"203,932.00",00.00,"541,048.50"
04-Jun-2023,RTGS,"3,243.00",00.00,"544,291.50"
04-Jun-2023,NEFT,04.00,00.00,"544,295.50"
04-Jun-2023,Reversal,254.00,00.00,"544,549.50"
04-Jun-2023,Reversal,00.00,"181,516.50","363,033.00"
04-Jun-2023,Purchase,"29,741.00",00.00,"392,774.00"
04-Jun-2023,Interest,339.60,00.00,"393,113.60"
04-Jun-2023,Debit Card,00.00,"393,113.60",00.00
04-Jun-2023,Interest,"5,954.10",00.00,"5,954.10"
04-Jun-2023,Miscellaneous,00.00,"1,190.82","4,763.28"
04-Jun-2023,Tax,00.00,793.88,"3,969.40"
04-Jun-2023,Purchase,"5,122.04",00.00,"9,091.44"
04-Jun-2023,Reversal,00.00,"1,515.24","7,576.20"
04-Jun-2023,ATM,00.00,841.80,"6,734.40"
04-Jun-2023,Transfer,366.00,00.00,"7,100.40"
04-Jun-2023,Commission,00.00,"1,183.40","5,917.00"
04-Jun-2023,Commission,"19,802.70",00.00,"25,719.70"
04-Jun-2023,Interest,00.00,"6,429.93","19,289.78"
04-Jun-2023,ATM,00.00,"4,822.45","14,467.34"
04-Jun-2023,NEFT,25.40,00.00,"14,492.74"
04-Jun-2023,NEFT,00.00,"1,449.27","13,043.47"
04-Jun-2023,Transfer,00.00,"2,173.91","10,869.56"
04-Jun-2023,Transfer,00.00,"1,086.96","9,782.60"
04-Jun-2023,Cheque,02.80,00.00,"9,785.40"
04-Jun-2023,Cheque,285.50,00.00,"10,070.90"
04-Jun-2023,Cash,00.00,"2,517.73","7,553.17"
04-Jun-2023,RTGS,00.00,755.32,"6,797.85"
04-Jun-2023,Miscellaneous,"18,802.73",00.00,"25,600.58"
04-Jun-2023,ATM,"22,030.00",00.00,"47,630.58"
04-Jun-2023,NEFT,05.34,00.00,"47,635.92"
04-Jun-2023,Commission,00.00,"15,878.64","31,757.28"
04-Jun-2023,Cash,00.00,"5,292.88","26,464.40"
04-Jun-2023,RTGS,00.00,"2,940.49","23,523.91"
04-Jun-2023,Reversal,00.00,"2,940.49","20,583.42"
04-Jun-2023,Miscellaneous,00.00,"6,861.14","13,722.28"
04-Jun-2023,Tax,00.00,"4,574.09","9,148.19"
04-Jun-2023,Debit Card,507.00,00.00,"9,655.19"
04-Jun-2023,RTGS,00.00,"9,655.19",00.00
04-Jun-2023,Tax,450.00,00.00,450.00
04-Jun-2023,Tax,124.00,00.00,574.00
04-Jun-2023,Cheque,"739,359.25",00.00,"739,933.25"
04-Jun-2023,Debit Card,00.00,"246,644.42","493,288.83"
04-Jun-2023,Purchase,00.00,"54,809.87","438,478.96"
04-Jun-2023,Miscellaneous,00.00,"87,695.79","350,783.17"
04-Jun-2023,Interest,00.00,"58,463.86","292,319.31"
04-Jun-2023,ATM,651.81,00.00,"292,971.12"
04-Jun-2023,Debit Card,137.00,00.00,"293,108.12"
04-Jun-2023,Reversal,66.00,00.00,"293,174.12"
04-Jun-2023,ATM,00.00,"58,634.82","234,539.30"
04-Jun-2023,Tax,03.60,00.00,"234,542.90"
05-Jun-2023,RTGS,00.00,"23,454.29","211,088.61"
05-Jun-2023,Cash,"5,238.00",00.00,"216,326.61"
06-Jun-2023,Transfer,"1,428.00",00.00,"217,754.61"
06-Jun-2023,Bill,00.00,"24,194.96","193,559.65"
06-Jun-2023,Reversal,00.00,"96,779.83","96,779.82"
06-Jun-2023,NEFT,00.00,"16,129.97","80,649.85"
06-Jun-2023,Cash,00.00,"11,521.41","69,128.44"
06-Jun-2023,Transfer,00.00,"11,521.41","57,607.03"
06-Jun-2023,Cheque,06.00,00.00,"57,613.03"
06-Jun-2023,Miscellaneous,00.00,"11,522.61","46,090.42"
06-Jun-2023,Cheque,00.00,"9,218.08","36,872.34"
06-Jun-2023,Reversal,00.00,"12,290.78","24,581.56"
06-Jun-2023,Miscellaneous,23.00,00.00,"24,604.56"
06-Jun-2023,Purchase,00.00,"2,733.84","21,870.72"
06-Jun-2023,Purchase,00.00,"3,124.39","18,746.33"
06-Jun-2023,Transfer,00.00,"2,343.29","16,403.04"
06-Jun-2023,Miscellaneous,"5,566.75",00.00,"21,969.79"
06-Jun-2023,Commission,03.00,00.00,"21,972.79"
06-Jun-2023,RTGS,00.00,"10,986.40","10,986.40"
06-Jun-2023,RTGS,"366,806.00",00.00,"377,792.40"
06-Jun-2023,Bill,00.00,"125,930.80","251,861.60"
06-Jun-2023,IMPS,00.00,"125,930.80","125,930.80"
06-Jun-2023,Bill,04.60,00.00,"125,935.40"
06-Jun-2023,Commission,00.00,"17,990.77","107,944.63"
06-Jun-2023,Cheque,00.00,"26,986.16","80,958.47"
06-Jun-2023,NEFT,00.00,"11,565.50","69,392.97"
06-Jun-2023,Reversal,00.00,"23,130.99","46,261.98"
07-Jun-2023,Cheque,47.94,00.00,"46,309.92"
08-Jun-2023,Cash,00.00,"23,154.96","23,154.96"
08-Jun-2023,Interest,00.00,"2,572.77","20,582.19"
08-Jun-2023,Transfer,00.00,"3,430.37","17,151.82"
08-Jun-2023,Commission,31.86,00.00,"17,183.68"
09-Jun-2023,RTGS,00.00,"17,183.68",00.00
09-Jun-2023,ATM,"1,468.00",00.00,"1,468.00"
10-Jun-2023,Debit Card,00.00,244.67,"1,223.33"
10-Jun-2023,Interest,"13,301.00",00.00,"14,524.33"
10-Jun-2023,Cheque,00.00,"1,613.81","12,910.52"
10-Jun-2023,Cheque,00.00,"1,434.50","11,476.02"
10-Jun-2023,NEFT,00.00,"5,738.01","5,738.01"
10-Jun-2023,RTGS,00.00,637.56,"5,100.45"
10-Jun-2023,Bill,00.00,"1,700.15","3,400.30"
10-Jun-2023,IMPS,00.00,377.81,"3,022.49"
10-Jun-2023,Bill,"363,718.25",00.00,"366,740.74"
10-Jun-2023,Tax,"213,287.00",00.00,"580,027.74"
10-Jun-2023,Bill,"371,491.75",00.00,"951,519.49"
10-Jun-2023,Reversal,"3,930.74",00.00,"955,450.23"
10-Jun-2023,NEFT,"51,381.16",00.00,"1,006,831.39"
10-Jun-2023,Interest,00.00,"167,805.23","839,026.16"
10-Jun-2023,Debit Card,35.00,00.00,"839,061.16"
10-Jun-2023,Miscellaneous,00.00,"119,865.88","719,195.28"
10-Jun-2023,Tax,04.00,00.00,"719,199.28"
11-Jun-2023,IMPS,00.00,"79,911.03","639,288.25"
11-Jun-2023,NEFT,00.00,"127,857.65","511,430.60"
11-Jun-2023,Miscellaneous,00.00,"102,286.12","409,144.48"
11-Jun-2023,Transfer,"2,455.65",00.00,"411,600.13"
11-Jun-2023,Interest,293.58,00.00,"411,893.71"
11-Jun-2023,Reversal,441.07,00.00,"412,334.78"
11-Jun-2023,RTGS,00.00,"51,541.85","360,792.93"
11-Jun-2023,Miscellaneous,"620,562.20",00.00,"981,355.13"
11-Jun-2023,RTGS,00.00,"109,039.46","872,315.67"
11-Jun-2023,Tax,00.00,"872,315.67",00.00
11-Jun-2023,NEFT,"29,416.60",00.00,"29,416.60"
11-Jun-2023,Reversal,"1,389,429.25",00.00,"1,418,845.85"
11-Jun-2023,Commission,"3,004.80",00.00,"1,421,850.65"
11-Jun-2023,Transfer,"7,276.00",00.00,"1,429,126.65"
12-Jun-2023,RTGS,"341,088.50",00.00,"1,770,215.15"
12-Jun-2023,Purchase,"634,232.25",00.00,"2,404,447.40"
12-Jun-2023,Cheque,"3,978.00",00.00,"2,408,425.40"
12-Jun-2023,Cash,"197,399.00",00.00,"2,605,824.40"
13-Jun-2023,Debit Card,00.00,"260,582.44","2,345,241.96"
13-Jun-2023,Cash,00.00,"260,582.44","2,084,659.52"
14-Jun-2023,RTGS,"2,497.10",00.00,"2,087,156.62"
14-Jun-2023,Reversal,"31,196.60",00.00,"2,118,353.22"
14-Jun-2023,Miscellaneous,00.00,"706,117.74","1,412,235.48"
14-Jun-2023,Purchase,00.00,"176,529.44","1,235,706.04"
14-Jun-2023,IMPS,253.03,00.00,"1,235,959.07"
14-Jun-2023,Bill,"14,088.90",00.00,"1,250,047.97"
14-Jun-2023,ATM,00.00,"208,341.33","1,041,706.64"
14-Jun-2023,RTGS,"16,744.20",00.00,"1,058,450.84"
14-Jun-2023,Interest,"3,663.00",00.00,"1,062,113.84"
14-Jun-2023,ATM,00.00,"151,730.55","910,383.29"
14-Jun-2023,Transfer,00.00,"113,797.91","796,585.38"
14-Jun-2023,Cash,00.00,"88,509.49","708,075.89"
14-Jun-2023,Commission,00.00,"70,807.59","637,268.30"
14-Jun-2023,RTGS,19.61,00.00,"637,287.91"
15-Jun-2023,ATM,00.00,"637,287.91",00.00
15-Jun-2023,Cheque,01.41,00.00,01.41
15-Jun-2023,Bill,"2,992.60",00.00,"2,994.01"
15-Jun-2023,Commission,34.50,00.00,"3,028.51"
15-Jun-2023,Cheque,00.00,757.13,"2,271.38"
15-Jun-2023,Commission,03.95,00.00,"2,275.33"
15-Jun-2023,ATM,"1,956,220.00",00.00,"1,958,495.33"
15-Jun-2023,Purchase,"218,009.00",00.00,"2,176,504.33"
15-Jun-2023,Cheque,"3,160.75",00.00,"2,179,665.08"
15-Jun-2023,Bill,"2,022.50",00.00,"2,181,687.58"
15-Jun-2023,RTGS,"793,447.00",00.00,"2,975,134.58"
15-Jun-2023,Commission,00.00,"743,783.65","2,231,350.94"
15-Jun-2023,Miscellaneous,01.50,00.00,"2,231,352.44"
15-Jun-2023,Commission,25.84,00.00,"2,231,378.28"
15-Jun-2023,Cash,153.00,00.00,"2,231,531.28"
15-Jun-2023,Bill,"184,762.00",00.00,"2,416,293.28"
15-Jun-2023,NEFT,37.00,00.00,"2,416,330.28"
15-Jun-2023,Bill,00.00,"402,721.71","2,013,608.57"
15-Jun-2023,Reversal,451.00,00.00,"2,014,059.57"
15-Jun-2023,Bill,06.40,00.00,"2,014,065.97"
15-Jun-2023,IMPS,"1,402,382.50",00.00,"3,416,448.47"
15-Jun-2023,Purchase,00.00,"427,056.06","2,989,392.41"
15-Jun-2023,Interest,"24,907.62",00.00,"3,014,300.03"
15-Jun-2023,Bill,"229,418.00",00.00,"3,243,718.03"
15-Jun-2023,NEFT,00.00,"810,929.51","2,432,788.52"
15-Jun-2023,Miscellaneous,"96,473.00",00.00,"2,529,261.52"
15-Jun-2023,Interest,"138,858.00",00.00,"2,668,119.52"
15-Jun-2023,Reversal,00.00,"266,811.95","2,401,307.57"
15-Jun-2023,Bill,"1,568.90",00.00,"2,402,876.47"
15-Jun-2023,Cash,00.00,"240,287.65","2,162,588.82"
15-Jun-2023,Tax,00.00,"720,862.94","1,441,725.88"
15-Jun-2023,Reversal,"1,136,473.80",00.00,"2,578,199.68"
15-Jun-2023,Reversal,"1,909.60",00.00,"2,580,109.28"
15-Jun-2023,Bill,"1,754.00",00.00,"2,581,863.28"
15-Jun-2023,ATM,00.00,"286,873.70","2,294,989.58"
15-Jun-2023,Purchase,00.00,"286,873.70","2,008,115.88"
15-Jun-2023,Transfer,93.00,00.00,"2,008,208.88"
15-Jun-2023,ATM,"2,404.63",00.00,"2,010,613.51"
15-Jun-2023,Miscellaneous,00.00,"223,401.50","1,787,212.01"
15-Jun-2023,Reversal,00.00,"893,606.01","893,606.00"
15-Jun-2023,Cheque,137.05,00.00,"893,743.05"
15-Jun-2023,Miscellaneous,00.00,"99,304.78","794,438.27"
15-Jun-2023,Purchase,354.30,00.00,"794,792.57"
15-Jun-2023,Bill,"36,962.30",00.00,"831,754.87"
15-Jun-2023,IMPS,00.00,"415,877.44","415,877.44"
15-Jun-2023,Commission,"19,274.60",00.00,"435,152.04"
15-Jun-2023,Purchase,00.00,"217,576.02","217,576.02"
15-Jun-2023,Cash,00.00,"43,515.20","174,060.82"
15-Jun-2023,ATM,00.00,"29,010.14","145,050.68"
15-Jun-2023,Bill,430.10,00.00,"145,480.78"
15-Jun-2023,IMPS,00.00,"145,480.78",00.00
15-Jun-2023,Purchase,"130,667.10",00.00,"130,667.10"
15-Jun-2023,RTGS,00.00,"16,333.39","114,333.71"
15-Jun-2023,Cash,00.00,"114,333.71",00.00
15-Jun-2023,Bill,05.30,00.00,05.30
15-Jun-2023,RTGS,134.50,00.00,139.80
15-Jun-2023,Commission,00.00,46.60,93.20
15-Jun-2023,IMPS,00.00,10.36,82.84
15-Jun-2023,Purchase,"438,571.00",00.00,"438,653.84"
15-Jun-2023,Transfer,"103,107.84",00.00,"541,761.68"
15-Jun-2023,Purchase,"100,423.60",00.00,"642,185.28"
15-Jun-2023,Purchase,00.00,"128,437.06","513,748.22"
15-Jun-2023,Tax,00.00,"128,437.06","385,311.16"
15-Jun-2023,NEFT,"237,838.20",00.00,"623,149.36"
15-Jun-2023,Tax,"159,507.00",00.00,"782,656.36"
16-Jun-2023,ATM,"257,730.90",00.00,"1,040,387.26"
16-Jun-2023,ATM,00.00,"130,048.41","910,338.85"
16-Jun-2023,Reversal,00.00,"130,048.41","780,290.44"
16-Jun-2023,Miscellaneous,00.00,"780,290.44",00.00
16-Jun-2023,Commission,02.61,00.00,02.61
16-Jun-2023,Purchase,00.00,00.52,02.09
16-Jun-2023,Cash,"208,223.00",00.00,"208,225.09"
16-Jun-2023,Reversal,00.00,"104,112.55","104,112.54"
16-Jun-2023,Bill,00.00,"26,028.14","78,084.40"
16-Jun-2023,Interest,"111,331.00",00.00,"189,415.40"
16-Jun-2023,ATM,00.00,"47,353.85","142,061.55"
16-Jun-2023,RTGS,00.00,"15,784.62","126,276.93"
16-Jun-2023,NEFT,00.00,"18,039.56","108,237.37"
16-Jun-2023,Cheque,00.00,"36,079.12","72,158.25"
16-Jun-2023,Bill,00.00,"10,308.32","61,849.93"
16-Jun-2023,Tax,00.00,"10,308.32","51,541.61"
16-Jun-2023,Cheque,"151,196.00",00.00,"202,737.61"
16-Jun-2023,Tax,19.70,00.00,"202,757.31"
16-Jun-2023,RTGS,"26,038.00",00.00,"228,795.31"
16-Jun-2023,Miscellaneous,"285,374.50",00.00,"514,169.81"
16-Jun-2023,Transfer,03.00,00.00,"514,172.81"
16-Jun-2023,Bill,00.00,"85,695.47","428,477.34"
16-Jun-2023,Commission,"718,723.80",00.00,"1,147,201.14"
16-Jun-2023,Bill,00.00,"127,466.79","1,019,734.35"
17-Jun-2023,RTGS,"92,545.16",00.00,"1,112,279.51"
17-Jun-2023,Reversal,"1,431,299.00",00.00,"2,543,578.51"
17-Jun-2023,NEFT,00.00,"423,929.75","2,119,648.76"
17-Jun-2023,Purchase,04.00,00.00,"2,119,652.76"
17-Jun-2023,RTGS,660.00,00.00,"2,120,312.76"
17-Jun-2023,Purchase,00.00,"1,060,156.38","1,060,156.38"
17-Jun-2023,Cash,00.00,"530,078.19","530,078.19"
17-Jun-2023,RTGS,00.00,"265,039.10","265,039.09"
17-Jun-2023,Commission,00.00,"33,129.89","231,909.20"
17-Jun-2023,RTGS,00.00,"231,909.20",00.00
17-Jun-2023,RTGS,"17,253.90",00.00,"17,253.90"
17-Jun-2023,Tax,47.30,00.00,"17,301.20"
17-Jun-2023,RTGS,00.00,"3,460.24","13,840.96"
17-Jun-2023,Tax,00.00,"4,613.65","9,227.31"
17-Jun-2023,Commission,00.00,"1,537.89","7,689.42"
17-Jun-2023,NEFT,00.00,"3,844.71","3,844.71"
17-Jun-2023,Cash,00.00,384.47,"3,460.24"
17-Jun-2023,Reversal,00.00,865.06,"2,595.18"
17-Jun-2023,NEFT,"23,085.04",00.00,"25,680.22"
17-Jun-2023,Transfer,00.00,"25,680.22",00.00
17-Jun-2023,Reversal,"6,751.00",00.00,"6,751.00"
17-Jun-2023,Miscellaneous,"94,191.00",00.00,"100,942.00"
17-Jun-2023,Reversal,00.00,"100,942.00",00.00
17-Jun-2023,Cash,"1,519.80",00.00,"1,519.80"
17-Jun-2023,Reversal,251.03,00.00,"1,770.83"
17-Jun-2023,Purchase,00.00,354.17,"1,416.66"
17-Jun-2023,Cheque,00.00,283.33,"1,133.33"
17-Jun-2023,Purchase,00.00,141.67,991.66
17-Jun-2023,Reversal,00.00,165.28,826.38
17-Jun-2023,Purchase,"1,846.00",00.00,"2,672.38"
17-Jun-2023,Purchase,"3,543.30",00.00,"6,215.68"
17-Jun-2023,IMPS,00.00,621.57,"5,594.11"
17-Jun-2023,Cheque,11.00,00.00,"5,605.11"
17-Jun-2023,RTGS,358.30,00.00,"5,963.41"
17-Jun-2023,Cash,00.00,"1,490.85","4,472.56"
17-Jun-2023,IMPS,03.20,00.00,"4,475.76"
17-Jun-2023,Transfer,"27,336.60",00.00,"31,812.36"
17-Jun-2023,Cheque,00.00,"10,604.12","21,208.24"
17-Jun-2023,Transfer,906.50,00.00,"22,114.74"
17-Jun-2023,Reversal,"31,021.12",00.00,"53,135.86"
17-Jun-2023,Transfer,00.00,"5,313.59","47,822.27"
17-Jun-2023,Interest,43.00,00.00,"47,865.27"
17-Jun-2023,ATM,00.00,"23,932.64","23,932.64"
17-Jun-2023,Reversal,00.00,"2,393.26","21,539.38"
17-Jun-2023,Reversal,"24,252.00",00.00,"45,791.38"
17-Jun-2023,Debit Card,00.00,"15,263.79","30,527.59"
17-Jun-2023,Miscellaneous,00.00,"30,527.59",00.00
17-Jun-2023,Cheque,505.90,00.00,505.90
17-Jun-2023,Transfer,00.00,168.63,337.27
17-Jun-2023,Bill,00.00,168.64,168.64
17-Jun-2023,Tax,"256,363.00",00.00,"256,531.64"
17-Jun-2023,Commission,"1,725.00",00.00,"258,256.64"
17-Jun-2023,Cash,00.00,"129,128.32","129,128.32"
17-Jun-2023,Interest,975.20,00.00,"130,103.52"
17-Jun-2023,Transfer,00.00,"21,683.92","108,419.60"
17-Jun-2023,ATM,"3,096.50",00.00,"111,516.10"
17-Jun-2023,Interest,02.60,00.00,"111,518.70"
17-Jun-2023,Commission,00.00,"55,759.35","55,759.35"
18-Jun-2023,Debit Card,00.00,"27,879.68","27,879.68"
18-Jun-2023,Transfer,"454,510.50",00.00,"482,390.18"
18-Jun-2023,Miscellaneous,00.00,"241,195.09","241,195.09"
18-Jun-2023,ATM,28.00,00.00,"241,223.09"
18-Jun-2023,NEFT,00.00,"40,203.85","201,019.24"
18-Jun-2023,Commission,00.00,"67,006.41","134,012.83"
18-Jun-2023,Reversal,"3,837.00",00.00,"137,849.83"
18-Jun-2023,Debit Card,00.00,"137,849.83",00.00
18-Jun-2023,ATM,"662,118.80",00.00,"662,118.80"
18-Jun-2023,Interest,00.00,"66,211.88","595,906.92"
18-Jun-2023,Commission,00.00,"198,635.64","397,271.28"
18-Jun-2023,Miscellaneous,"18,771.00",00.00,"416,042.28"
18-Jun-2023,Reversal,00.00,"138,680.76","277,361.52"
18-Jun-2023,Interest,"168,467.90",00.00,"445,829.42"
18-Jun-2023,Bill,"19,091.00",00.00,"464,920.42"
18-Jun-2023,Tax,15.25,00.00,"464,935.67"
18-Jun-2023,Commission,00.00,"154,978.56","309,957.11"
18-Jun-2023,IMPS,00.00,"61,991.42","247,965.69"
18-Jun-2023,Interest,07.32,00.00,"247,973.01"
18-Jun-2023,Bill,"251,190.50",00.00,"499,163.51"
18-Jun-2023,RTGS,"3,889.00",00.00,"503,052.51"
18-Jun-2023,Miscellaneous,30.24,00.00,"503,082.75"
18-Jun-2023,NEFT,08.00,00.00,"503,090.75"
19-Jun-2023,Commission,00.00,"71,870.11","431,220.64"
19-Jun-2023,Cheque,467.20,00.00,"431,687.84"
19-Jun-2023,RTGS,"201,934.10",00.00,"633,621.94"
19-Jun-2023,Tax,00.00,"316,810.97","316,810.97"
19-Jun-2023,IMPS,00.00,"45,258.71","271,552.26"
19-Jun-2023,Commission,"25,789.09",00.00,"297,341.35"
19-Jun-2023,Commission,00.00,"59,468.27","237,873.08"
19-Jun-2023,IMPS,00.00,"26,430.34","211,442.74"
19-Jun-2023,Debit Card,15.87,00.00,"211,458.61"
19-Jun-2023,Cash,"25,390.89",00.00,"236,849.50"
19-Jun-2023,Debit Card,00.00,"59,212.38","177,637.12"
19-Jun-2023,Reversal,00.00,"177,637.12",00.00
19-Jun-2023,NEFT,130.00,00.00,130.00
19-Jun-2023,Commission,02.00,00.00,132.00
19-Jun-2023,Commission,"2,282.40",00.00,"2,414.40"
19-Jun-2023,Interest,00.00,241.44,"2,172.96"
19-Jun-2023,Purchase,"12,002.00",00.00,"14,174.96"
19-Jun-2023,Cash,"11,866.00",00.00,"26,040.96"
19-Jun-2023,RTGS,00.00,"3,255.12","22,785.84"
19-Jun-2023,Tax,00.00,"22,785.84",00.00
19-Jun-2023,Reversal,"197,106.75",00.00,"197,106.75"
19-Jun-2023,Interest,"21,875.30",00.00,"218,982.05"
19-Jun-2023,Interest,00.00,"218,982.05",00.00
19-Jun-2023,Cash,"57,486.90",00.00,"57,486.90"
19-Jun-2023,Cheque,00.00,"9,581.15","47,905.75"
19-Jun-2023,Miscellaneous,"130,680.59",00.00,"178,586.34"
19-Jun-2023,Commission,"29,951.80",00.00,"208,538.14"
19-Jun-2023,Reversal,"24,128.90",00.00,"232,667.04"
19-Jun-2023,Miscellaneous,00.00,"77,555.68","155,111.36"
19-Jun-2023,ATM,00.00,"25,851.89","129,259.47"
19-Jun-2023,Tax,03.00,00.00,"129,262.47"
19-Jun-2023,Commission,00.00,"129,262.47",00.00
19-Jun-2023,Debit Card,"142,799.00",00.00,"142,799.00"
19-Jun-2023,NEFT,00.00,"47,599.67","95,199.33"
19-Jun-2023,Miscellaneous,00.00,"10,577.70","84,621.63"
19-Jun-2023,Cash,00.00,00.00,"84,621.63"
19-Jun-2023,Cash,02.00,00.00,"84,623.63"
19-Jun-2023,Miscellaneous,265.00,00.00,"84,888.63"
19-Jun-2023,Miscellaneous,"428,964.00",00.00,"513,852.63"
19-Jun-2023,RTGS,00.00,"64,231.58","449,621.05"
19-Jun-2023,IMPS,"1,805.59",00.00,"451,426.64"
20-Jun-2023,Bill,"3,955.00",00.00,"455,381.64"
20-Jun-2023,Tax,00.00,"45,538.16","409,843.48"
20-Jun-2023,Cash,63.90,00.00,"409,907.38"
20-Jun-2023,Purchase,00.00,"81,981.48","327,925.90"
20-Jun-2023,Reversal,00.00,"54,654.32","273,271.58"
20-Jun-2023,Transfer,"2,584.11",00.00,"275,855.69"
20-Jun-2023,ATM,00.00,"68,963.92","206,891.77"
20-Jun-2023,RTGS,"1,080,931.00",00.00,"1,287,822.77"
20-Jun-2023,Interest,00.00,"643,911.39","643,911.38"
20-Jun-2023,NEFT,"195,454.56",00.00,"839,365.94"
20-Jun-2023,Cash,00.00,"419,682.97","419,682.97"
20-Jun-2023,Interest,00.00,"69,947.16","349,735.81"
20-Jun-2023,IMPS,00.00,"34,973.58","314,762.23"
20-Jun-2023,Tax,00.00,"34,973.58","279,788.65"
20-Jun-2023,Debit Card,"2,694.00",00.00,"282,482.65"
21-Jun-2023,Tax,19.90,00.00,"282,502.55"
21-Jun-2023,RTGS,00.00,"35,312.82","247,189.73"
21-Jun-2023,Cheque,"410,186.00",00.00,"657,375.73"
21-Jun-2023,Transfer,07.60,00.00,"657,383.33"
21-Jun-2023,Commission,00.00,"65,738.33","591,645.00"
21-Jun-2023,Reversal,169.70,00.00,"591,814.70"
21-Jun-2023,Cheque,"1,258.40",00.00,"593,073.10"
21-Jun-2023,Purchase,00.00,00.00,"593,073.10"
21-Jun-2023,IMPS,"20,385.23",00.00,"613,458.33"
21-Jun-2023,Miscellaneous,00.00,"76,682.29","536,776.04"
21-Jun-2023,Commission,00.00,"134,194.01","402,582.03"
21-Jun-2023,NEFT,00.00,"80,516.41","322,065.62"
21-Jun-2023,Interest,"3,893.00",00.00,"325,958.62"
21-Jun-2023,Debit Card,04.00,00.00,"325,962.62"
21-Jun-2023,IMPS,"1,611,003.50",00.00,"1,936,966.12"
21-Jun-2023,Miscellaneous,00.00,"193,696.61","1,743,269.51"
21-Jun-2023,Cheque,"1,027,845.00",00.00,"2,771,114.51"
21-Jun-2023,Purchase,258.00,00.00,"2,771,372.51"
21-Jun-2023,IMPS,00.00,"395,910.36","2,375,462.15"
21-Jun-2023,IMPS,00.00,"339,351.74","2,036,110.41"
21-Jun-2023,Interest,02.03,00.00,"2,036,112.44"
21-Jun-2023,NEFT,03.03,00.00,"2,036,115.47"
21-Jun-2023,ATM,00.00,"678,705.16","1,357,410.31"
21-Jun-2023,NEFT,00.96,00.00,"1,357,411.27"
21-Jun-2023,Tax,"54,663.38",00.00,"1,412,074.65"
21-Jun-2023,Miscellaneous,05.00,00.00,"1,412,079.65"
21-Jun-2023,Reversal,00.00,"235,346.61","1,176,733.04"
21-Jun-2023,Tax,06.85,00.00,"1,176,739.89"
21-Jun-2023,ATM,06.20,00.00,"1,176,746.09"
21-Jun-2023,Cash,00.00,"130,749.57","1,045,996.52"
21-Jun-2023,NEFT,"27,458.60",00.00,"1,073,455.12"
21-Jun-2023,RTGS,41.47,00.00,"1,073,496.59"
21-Jun-2023,NEFT,"83,966.12",00.00,"1,157,462.71"
21-Jun-2023,Transfer,00.00,"144,682.84","1,012,779.87"
21-Jun-2023,Commission,03.00,00.00,"1,012,782.87"
21-Jun-2023,Miscellaneous,03.00,00.00,"1,012,785.87"
21-Jun-2023,Transfer,00.00,"144,683.70","868,102.17"
21-Jun-2023,ATM,153.00,00.00,"868,255.17"
21-Jun-2023,Interest,00.00,"434,127.59","434,127.58"
21-Jun-2023,Transfer,00.00,"54,265.95","379,861.63"
21-Jun-2023,NEFT,00.00,"54,265.95","325,595.68"
21-Jun-2023,Reversal,00.00,"162,797.84","162,797.84"
21-Jun-2023,Reversal,57.72,00.00,"162,855.56"
21-Jun-2023,Debit Card,00.00,"54,285.19","108,570.37"
21-Jun-2023,Cheque,03.04,00.00,"108,573.41"
21-Jun-2023,NEFT,00.00,"21,714.68","86,858.73"
21-Jun-2023,Commission,"233,674.00",00.00,"320,532.73"
21-Jun-2023,Cash,00.00,"32,053.27","288,479.46"
21-Jun-2023,ATM,"305,885.00",00.00,"594,364.46"
21-Jun-2023,Miscellaneous,00.00,"297,182.23","297,182.23"
21-Jun-2023,Reversal,00.00,"99,060.74","198,121.49"
21-Jun-2023,Cash,00.00,"19,812.15","178,309.34"
21-Jun-2023,Bill,00.00,"29,718.22","148,591.12"
21-Jun-2023,Tax,00.00,"37,147.78","111,443.34"
21-Jun-2023,Cheque,00.00,"111,443.34",00.00
21-Jun-2023,RTGS,"34,201.20",00.00,"34,201.20"
21-Jun-2023,Miscellaneous,"410,131.00",00.00,"444,332.20"
21-Jun-2023,Commission,13.96,00.00,"444,346.16"
21-Jun-2023,Cheque,"1,942,692.50",00.00,"2,387,038.66"
21-Jun-2023,NEFT,00.00,"265,226.52","2,121,812.14"
21-Jun-2023,Cheque,"30,212.00",00.00,"2,152,024.14"
21-Jun-2023,Interest,00.00,"1,076,012.07","1,076,012.07"
21-Jun-2023,IMPS,"1,619,455.50",00.00,"2,695,467.57"
21-Jun-2023,NEFT,00.00,"269,546.76","2,425,920.81"
21-Jun-2023,Bill,"651,209.00",00.00,"3,077,129.81"
21-Jun-2023,Cash,"488,973.00",00.00,"3,566,102.81"
21-Jun-2023,Reversal,"3,067.90",00.00,"3,569,170.71"
21-Jun-2023,IMPS,00.00,"594,861.79","2,974,308.92"
21-Jun-2023,NEFT,00.00,"991,436.31","1,982,872.61"
22-Jun-2023,Miscellaneous,00.00,"991,436.31","991,436.30"
22-Jun-2023,Purchase,40.00,00.00,"991,476.30"
22-Jun-2023,Debit Card,00.00,"99,147.63","892,328.67"
22-Jun-2023,Purchase,18.20,00.00,"892,346.87"
22-Jun-2023,Reversal,00.00,"297,448.96","594,897.91"
22-Jun-2023,Reversal,00.00,"66,099.77","528,798.14"
22-Jun-2023,Tax,"108,392.25",00.00,"637,190.39"
22-Jun-2023,Debit Card,00.00,"159,297.60","477,892.79"
22-Jun-2023,Transfer,"504,741.80",00.00,"982,634.59"
22-Jun-2023,Cheque,02.60,00.00,"982,637.19"
22-Jun-2023,Tax,00.00,"140,376.74","842,260.45"
22-Jun-2023,Cash,"5,178.80",00.00,"847,439.25"
22-Jun-2023,Purchase,00.00,"121,062.75","726,376.50"
22-Jun-2023,Cheque,"124,900.80",00.00,"851,277.30"
22-Jun-2023,IMPS,00.00,"212,819.33","638,457.98"
22-Jun-2023,Reversal,00.00,"638,457.98",00.00
22-Jun-2023,Miscellaneous,"1,185.00",00.00,"1,185.00"
22-Jun-2023,RTGS,00.00,131.67,"1,053.33"
22-Jun-2023,Tax,398.00,00.00,"1,451.33"
22-Jun-2023,Miscellaneous,01.80,00.00,"1,453.13"
22-Jun-2023,Cheque,00.00,145.31,"1,307.82"
22-Jun-2023,Bill,00.00,186.83,"1,120.99"
22-Jun-2023,Miscellaneous,08.00,00.00,"1,128.99"
22-Jun-2023,Cheque,00.00,282.25,846.74
22-Jun-2023,Cheque,00.00,141.12,705.62
22-Jun-2023,Purchase,"102,506.90",00.00,"103,212.52"
22-Jun-2023,ATM,145.18,00.00,"103,357.70"
22-Jun-2023,IMPS,00.00,"103,357.70",00.00
22-Jun-2023,Cash,"1,940,516.80",00.00,"1,940,516.80"
22-Jun-2023,Reversal,"6,885.00",00.00,"1,947,401.80"
22-Jun-2023,Transfer,04.00,00.00,"1,947,405.80"
22-Jun-2023,IMPS,02.90,00.00,"1,947,408.70"
22-Jun-2023,Reversal,02.70,00.00,"1,947,411.40"
22-Jun-2023,ATM,"996,077.50",00.00,"2,943,488.90"
22-Jun-2023,Bill,29.80,00.00,"2,943,518.70"
22-Jun-2023,Transfer,"1,507.00",00.00,"2,945,025.70"
22-Jun-2023,Bill,00.00,"368,128.21","2,576,897.49"
22-Jun-2023,Bill,00.00,"858,965.83","1,717,931.66"
22-Jun-2023,Bill,"1,537,536.20",00.00,"3,255,467.86"
22-Jun-2023,Tax,00.00,"542,577.98","2,712,889.88"
22-Jun-2023,Cheque,"128,792.00",00.00,"2,841,681.88"
22-Jun-2023,Miscellaneous,"214,048.44",00.00,"3,055,730.32"
22-Jun-2023,RTGS,00.00,"339,525.59","2,716,204.73"
22-Jun-2023,Cash,00.00,"905,401.58","1,810,803.15"
22-Jun-2023,Debit Card,00.00,"226,350.39","1,584,452.76"
22-Jun-2023,Bill,"36,271.81",00.00,"1,620,724.57"
22-Jun-2023,Miscellaneous,58.00,00.00,"1,620,782.57"
22-Jun-2023,Cash,00.00,"270,130.43","1,350,652.14"
22-Jun-2023,Interest,00.00,"135,065.21","1,215,586.93"
22-Jun-2023,Debit Card,"1,622.80",00.00,"1,217,209.73"
22-Jun-2023,Bill,09.70,00.00,"1,217,219.43"
22-Jun-2023,RTGS,"13,496.38",00.00,"1,230,715.81"
22-Jun-2023,Purchase,197.69,00.00,"1,230,913.50"
22-Jun-2023,ATM,00.00,"246,182.70","984,730.80"
22-Jun-2023,Cash,03.00,00.00,"984,733.80"
22-Jun-2023,Reversal,00.00,"328,244.60","656,489.20"
22-Jun-2023,Debit Card,00.00,"82,061.15","574,428.05"
22-Jun-2023,Bill,"116,501.90",00.00,"690,929.95"
22-Jun-2023,Cheque,03.43,00.00,"690,933.38"
22-Jun-2023,IMPS,00.00,"230,311.13","460,622.25"
22-Jun-2023,Interest,00.00,"76,770.38","383,851.88"
22-Jun-2023,Tax,00.80,00.00,"383,852.68"
22-Jun-2023,Tax,00.00,"47,981.59","335,871.10"
22-Jun-2023,Miscellaneous,00.00,"37,319.01","298,552.09"
22-Jun-2023,Tax,"2,403.41",00.00,"300,955.50"
22-Jun-2023,RTGS,226.14,00.00,"301,181.64"
22-Jun-2023,ATM,00.00,"30,118.16","271,063.48"
23-Jun-2023,IMPS,318.00,00.00,"271,381.48"
23-Jun-2023,Reversal,00.00,"54,276.30","217,105.18"
23-Jun-2023,Interest,00.00,"108,552.59","108,552.59"
23-Jun-2023,Commission,"32,690.00",00.00,"141,242.59"
23-Jun-2023,RTGS,"3,051.00",00.00,"144,293.59"
23-Jun-2023,NEFT,"32,663.00",00.00,"176,956.59"
23-Jun-2023,Transfer,485.18,00.00,"177,441.77"
23-Jun-2023,Purchase,00.00,"88,720.89","88,720.88"
23-Jun-2023,Transfer,"8,249.58",00.00,"96,970.46"
23-Jun-2023,Cash,76.00,00.00,"97,046.46"
23-Jun-2023,IMPS,00.00,"9,704.65","87,341.81"
23-Jun-2023,Reversal,738.20,00.00,"88,080.01"
23-Jun-2023,Commission,"1,373,232.00",00.00,"1,461,312.01"
23-Jun-2023,Commission,496.46,00.00,"1,461,808.47"
23-Jun-2023,Interest,00.00,"292,361.69","1,169,446.78"
23-Jun-2023,Transfer,00.00,"129,938.53","1,039,508.25"
23-Jun-2023,IMPS,27.00,00.00,"1,039,535.25"
23-Jun-2023,Commission,00.00,"259,883.81","779,651.44"
23-Jun-2023,Bill,00.00,"389,825.72","389,825.72"
23-Jun-2023,Cash,"185,565.00",00.00,"575,390.72"
23-Jun-2023,IMPS,00.00,"115,078.14","460,312.58"
23-Jun-2023,Tax,"23,085.50",00.00,"483,398.08"
23-Jun-2023,Cash,00.00,"69,056.87","414,341.21"
23-Jun-2023,Purchase,00.00,"207,170.61","207,170.60"
23-Jun-2023,IMPS,"1,404,753.00",00.00,"1,611,923.60"
23-Jun-2023,Debit Card,"4,016.17",00.00,"1,615,939.77"
23-Jun-2023,Transfer,00.00,"269,323.30","1,346,616.48"
23-Jun-2023,Debit Card,890.00,00.00,"1,347,506.48"
23-Jun-2023,Reversal,00.00,"336,876.62","1,010,629.86"
23-Jun-2023,ATM,00.00,"144,375.69","866,254.17"
23-Jun-2023,Debit Card,17.95,00.00,"866,272.12"
23-Jun-2023,Bill,00.00,"433,136.06","433,136.06"
23-Jun-2023,IMPS,00.00,"54,142.01","378,994.05"
24-Jun-2023,Cash,08.00,00.00,"379,002.05"
24-Jun-2023,Debit Card,"67,483.00",00.00,"446,485.05"
25-Jun-2023,Reversal,00.00,"74,414.18","372,070.88"
25-Jun-2023,NEFT,00.00,"46,508.86","325,562.02"
25-Jun-2023,IMPS,00.00,"54,260.34","271,301.68"
25-Jun-2023,Debit Card,00.00,"27,130.17","244,171.51"
25-Jun-2023,Tax,00.00,"48,834.30","195,337.21"
25-Jun-2023,Transfer,00.00,"21,704.13","173,633.08"
25-Jun-2023,Cheque,"178,508.00",00.00,"352,141.08"
25-Jun-2023,Miscellaneous,00.00,"50,305.87","301,835.21"
25-Jun-2023,Miscellaneous,62.60,00.00,"301,897.81"
25-Jun-2023,Miscellaneous,"66,977.00",00.00,"368,874.81"
25-Jun-2023,Transfer,00.00,"122,958.27","245,916.54"
25-Jun-2023,Cheque,"3,118.00",00.00,"249,034.54"
25-Jun-2023,Bill,00.00,"31,129.32","217,905.22"
25-Jun-2023,ATM,"2,725.80",00.00,"220,631.02"
25-Jun-2023,Commission,"22,893.00",00.00,"243,524.02"
25-Jun-2023,Bill,00.00,"60,881.01","182,643.02"
26-Jun-2023,Commission,00.00,"22,830.38","159,812.64"
26-Jun-2023,ATM,06.90,00.00,"159,819.54"
26-Jun-2023,Cash,63.91,00.00,"159,883.45"
26-Jun-2023,Bill,00.00,"17,764.83","142,118.62"
26-Jun-2023,RTGS,"32,820.00",00.00,"174,938.62"
26-Jun-2023,Transfer,43.95,00.00,"174,982.57"
26-Jun-2023,Cash,"27,641.70",00.00,"202,624.27"
26-Jun-2023,Purchase,01.84,00.00,"202,626.11"
26-Jun-2023,Cheque,00.00,"33,771.02","168,855.09"
26-Jun-2023,Commission,"1,486,964.00",00.00,"1,655,819.09"
26-Jun-2023,ATM,144.30,00.00,"1,655,963.39"
26-Jun-2023,Reversal,05.93,00.00,"1,655,969.32"
26-Jun-2023,Bill,00.00,"183,996.59","1,471,972.73"
26-Jun-2023,Interest,00.00,"210,281.82","1,261,690.91"
26-Jun-2023,Transfer,12.00,00.00,"1,261,702.91"
26-Jun-2023,Cash,"87,334.06",00.00,"1,349,036.97"
26-Jun-2023,Tax,"72,249.00",00.00,"1,421,285.97"
26-Jun-2023,Reversal,00.00,"473,761.99","947,523.98"
26-Jun-2023,Transfer,"1,619,973.80",00.00,"2,567,497.78"
26-Jun-2023,Cheque,01.20,00.00,"2,567,498.98"
26-Jun-2023,Bill,00.00,"641,874.75","1,925,624.24"
26-Jun-2023,Cheque,"202,178.60",00.00,"2,127,802.84"
26-Jun-2023,Transfer,00.00,"2,127,802.84",00.00
26-Jun-2023,Debit Card,23.00,00.00,23.00
26-Jun-2023,Miscellaneous,03.00,00.00,26.00
26-Jun-2023,RTGS,00.00,26.00,00.00
26-Jun-2023,Miscellaneous,"1,718.77",00.00,"1,718.77"
26-Jun-2023,Reversal,"2,111.00",00.00,"3,829.77"
26-Jun-2023,ATM,00.00,765.95,"3,063.82"
26-Jun-2023,Commission,50.56,00.00,"3,114.38"
26-Jun-2023,Debit Card,00.00,"3,114.38",00.00
26-Jun-2023,Miscellaneous,495.00,00.00,495.00
26-Jun-2023,ATM,00.00,165.00,330.00
26-Jun-2023,Debit Card,00.00,165.00,165.00
26-Jun-2023,ATM,27.04,00.00,192.04
26-Jun-2023,Transfer,45.57,00.00,237.61
26-Jun-2023,Purchase,00.00,118.81,118.80
26-Jun-2023,Debit Card,00.00,39.60,79.20
26-Jun-2023,ATM,00.00,07.92,71.28
26-Jun-2023,Debit Card,00.00,07.13,64.15
26-Jun-2023,ATM,00.00,10.69,53.46
26-Jun-2023,Bill,"168,105.50",00.00,"168,158.96"
27-Jun-2023,IMPS,14.80,00.00,"168,173.76"
27-Jun-2023,RTGS,"1,204,301.50",00.00,"1,372,475.26"
27-Jun-2023,Transfer,"1,579,869.25",00.00,"2,952,344.51"
27-Jun-2023,NEFT,07.20,00.00,"2,952,351.71"
27-Jun-2023,IMPS,"3,378.00",00.00,"2,955,729.71"
27-Jun-2023,RTGS,00.00,"1,477,864.86","1,477,864.86"
27-Jun-2023,Miscellaneous,"3,232.20",00.00,"1,481,097.06"
27-Jun-2023,Reversal,00.00,"148,109.71","1,332,987.35"
27-Jun-2023,Cheque,00.00,"222,164.56","1,110,822.79"
27-Jun-2023,Bill,00.00,"277,705.70","833,117.09"
27-Jun-2023,Transfer,00.00,"104,139.64","728,977.45"
27-Jun-2023,Miscellaneous,00.00,"80,997.49","647,979.96"
27-Jun-2023,Miscellaneous,"1,370.30",00.00,"649,350.26"
27-Jun-2023,Commission,00.00,"72,150.03","577,200.23"
27-Jun-2023,Purchase,00.00,"288,600.12","288,600.12"
27-Jun-2023,ATM,"1,693,368.00",00.00,"1,981,968.12"
27-Jun-2023,Cash,"646,308.00",00.00,"2,628,276.12"
27-Jun-2023,Miscellaneous,00.00,"1,314,138.06","1,314,138.06"
27-Jun-2023,Purchase,"3,248.00",00.00,"1,317,386.06"
27-Jun-2023,Transfer,00.00,"439,128.69","878,257.37"
27-Jun-2023,Tax,00.00,"439,128.69","439,128.68"
27-Jun-2023,IMPS,00.00,"62,732.67","376,396.01"
27-Jun-2023,RTGS,61.90,00.00,"376,457.91"
27-Jun-2023,Transfer,00.00,"376,457.91",00.00
27-Jun-2023,Tax,46.50,00.00,46.50
27-Jun-2023,NEFT,15.00,00.00,61.50
27-Jun-2023,Purchase,00.00,61.50,00.00
28-Jun-2023,RTGS,06.90,00.00,06.90
28-Jun-2023,IMPS,00.00,00.69,06.21
28-Jun-2023,RTGS,"15,316.16",00.00,"15,322.37"
28-Jun-2023,Cash,00.00,"1,532.24","13,790.13"
28-Jun-2023,Transfer,"29,449.00",00.00,"43,239.13"
28-Jun-2023,Cash,00.00,"14,413.04","28,826.09"
28-Jun-2023,Tax,00.00,"4,804.35","24,021.74"
28-Jun-2023,RTGS,00.00,"3,431.68","20,590.06"
28-Jun-2023,Interest,00.00,"5,147.52","15,442.55"
28-Jun-2023,ATM,00.00,"2,206.08","13,236.47"
29-Jun-2023,Miscellaneous,00.00,"3,309.12","9,927.35"
29-Jun-2023,IMPS,00.00,"1,103.04","8,824.31"
29-Jun-2023,ATM,00.00,"1,103.04","7,721.27"
29-Jun-2023,ATM,"148,806.70",00.00,"156,527.97"
29-Jun-2023,IMPS,00.00,"31,305.59","125,222.38"
29-Jun-2023,Interest,"7,854.00",00.00,"133,076.38"
29-Jun-2023,RTGS,00.00,"16,634.55","116,441.83"
29-Jun-2023,Purchase,00.00,"29,110.46","87,331.37"
29-Jun-2023,Purchase,"1,568,054.00",00.00,"1,655,385.37"
29-Jun-2023,RTGS,00.00,"165,538.54","1,489,846.83"
29-Jun-2023,Reversal,00.00,"496,615.61","993,231.22"
29-Jun-2023,ATM,00.00,"141,890.17","851,341.05"
29-Jun-2023,Miscellaneous,00.00,"121,620.15","729,720.90"
29-Jun-2023,IMPS,00.00,"145,944.18","583,776.72"
29-Jun-2023,Cash,00.00,"145,944.18","437,832.54"
29-Jun-2023,Transfer,"3,332.00",00.00,"441,164.54"
29-Jun-2023,Purchase,00.00,"220,582.27","220,582.27"
29-Jun-2023,NEFT,05.09,00.00,"220,587.36"
29-Jun-2023,Cash,00.00,"55,146.84","165,440.52"
29-Jun-2023,Tax,00.00,"23,634.36","141,806.16"
29-Jun-2023,ATM,"15,725.62",00.00,"157,531.78"
29-Jun-2023,ATM,00.00,"31,506.36","126,025.42"
29-Jun-2023,Commission,00.00,"15,753.18","110,272.24"
29-Jun-2023,Bill,00.00,"13,784.03","96,488.21"
30-Jun-2023,IMPS,00.00,"16,081.37","80,406.84"
30-Jun-2023,IMPS,00.00,"16,081.37","64,325.47"
30-Jun-2023,Tax,00.00,"21,441.82","42,883.65"
30-Jun-2023,Debit Card,00.00,"42,883.65",00.00
30-Jun-2023,ATM,02.90,00.00,02.90
30-Jun-2023,Interest,"87,249.70",00.00,"87,252.60"
30-Jun-2023,Reversal,00.00,"12,464.66","74,787.94"
30-Jun-2023,NEFT,00.00,"18,696.99","56,090.96"
30-Jun-2023,Bill,"28,025.00",00.00,"84,115.96"
30-Jun-2023,Interest,00.00,"21,028.99","63,086.97"
30-Jun-2023,RTGS,00.00,"21,028.99","42,057.98"
30-Jun-2023,ATM,00.00,"7,009.66","35,048.32"
30-Jun-2023,ATM,01.40,00.00,"35,049.72"
30-Jun-2023,Purchase,05.60,00.00,"35,055.32"
30-Jun-2023,NEFT,00.00,"11,685.11","23,370.21"
30-Jun-2023,Bill,00.00,"2,921.28","20,448.93"
30-Jun-2023,ATM,"151,922.00",00.00,"172,370.93"
30-Jun-2023,Bill,00.00,"43,092.73","129,278.20"
30-Jun-2023,ATM,00.00,"64,639.10","64,639.10"
30-Jun-2023,Cheque,00.00,"32,319.55","32,319.55"
30-Jun-2023,Interest,"1,869.00",00.00,"34,188.55"
30-Jun-2023,IMPS,153.15,00.00,"34,341.70"
30-Jun-2023,Reversal,43.00,00.00,"34,384.70"
30-Jun-2023,Cheque,00.00,"4,298.09","30,086.61"
30-Jun-2023,IMPS,00.00,"10,028.87","20,057.74"
30-Jun-2023,Cash,00.00,"20,057.74",00.00
30-Jun-2023,NEFT,"3,315.43",00.00,"3,315.43"
30-Jun-2023,Miscellaneous,499.00,00.00,"3,814.43"
30-Jun-2023,Bill,00.00,423.83,"3,390.60"
30-Jun-2023,NEFT,"290,815.20",00.00,"294,205.80"
30-Jun-2023,Commission,"2,311.27",00.00,"296,517.07"
30-Jun-2023,Tax,00.00,"296,517.07",00.00
30-Jun-2023,RTGS,"1,716,666.00",00.00,"1,716,666.00"
30-Jun-2023,Commission,00.00,"190,740.67","1,525,925.33"
30-Jun-2023,IMPS,"816,084.00",00.00,"2,342,009.33"
30-Jun-2023,NEFT,00.00,"468,401.87","1,873,607.46"
30-Jun-2023,Reversal,00.00,"208,178.61","1,665,428.85"
30-Jun-2023,Tax,00.00,"333,085.77","1,332,343.08"
30-Jun-2023,Cash,00.00,"190,334.73","1,142,008.35"
30-Jun-2023,RTGS,45.00,00.00,"1,142,053.35"
30-Jun-2023,ATM,00.00,"380,684.45","761,368.90"
30-Jun-2023,Commission,"27,120.60",00.00,"788,489.50"
30-Jun-2023,Purchase,"83,177.25",00.00,"871,666.75"
30-Jun-2023,Reversal,195.77,00.00,"871,862.52"
30-Jun-2023,Commission,00.00,"87,186.25","784,676.27"
30-Jun-2023,Cheque,00.00,"87,186.25","697,490.02"
30-Jun-2023,ATM,00.00,"697,490.02",00.00
30-Jun-2023,Reversal,"152,793.00",00.00,"152,793.00"
30-Jun-2023,RTGS,265.00,00.00,"153,058.00"
01-Jul-2023,Bill,00.00,"153,058.00",00.00
01-Jul-2023,Transfer,"549,184.00",00.00,"549,184.00"
01-Jul-2023,Interest,00.00,"78,454.86","470,729.14"
01-Jul-2023,Transfer,00.00,"156,909.71","313,819.43"
01-Jul-2023,IMPS,"31,903.80",00.00,"345,723.23"
01-Jul-2023,Debit Card,04.00,00.00,"345,727.23"
01-Jul-2023,Purchase,00.00,"43,215.90","302,511.33"
01-Jul-2023,RTGS,47.00,00.00,"302,558.33"
01-Jul-2023,Bill,00.00,"33,617.59","268,940.74"
01-Jul-2023,ATM,"4,615.00",00.00,"273,555.74"
01-Jul-2023,Debit Card,00.00,"54,711.15","218,844.59"
02-Jul-2023,Debit Card,00.00,"21,884.46","196,960.13"
02-Jul-2023,RTGS,00.00,"21,884.46","175,075.67"
02-Jul-2023,IMPS,00.00,"87,537.84","87,537.84"
02-Jul-2023,NEFT,"2,102.00",00.00,"89,639.84"
02-Jul-2023,Bill,00.00,"44,819.92","44,819.92"
02-Jul-2023,Purchase,"3,836.00",00.00,"48,655.92"
02-Jul-2023,Reversal,"32,021.50",00.00,"80,677.42"
02-Jul-2023,Bill,00.00,"40,338.71","40,338.71"
02-Jul-2023,Cash,"164,278.00",00.00,"204,616.71"
02-Jul-2023,Miscellaneous,07.00,00.00,"204,623.71"
02-Jul-2023,Cheque,00.00,"102,311.86","102,311.86"
03-Jul-2023,IMPS,"996,523.00",00.00,"1,098,834.86"
03-Jul-2023,Purchase,"14,716.00",00.00,"1,113,550.86"
03-Jul-2023,IMPS,00.00,"556,775.43","556,775.43"
03-Jul-2023,Cheque,00.00,"79,539.35","477,236.08"
03-Jul-2023,Reversal,"22,022.00",00.00,"499,258.08"
03-Jul-2023,Transfer,460.70,00.00,"499,718.78"
03-Jul-2023,Debit Card,03.23,00.00,"499,722.01"
03-Jul-2023,Transfer,00.00,"499,722.01",00.00
03-Jul-2023,Cheque,"1,986,288.80",00.00,"1,986,288.80"
03-Jul-2023,Debit Card,00.00,"198,628.88","1,787,659.92"
03-Jul-2023,ATM,00.00,"255,379.99","1,532,279.93"
03-Jul-2023,Miscellaneous,00.00,"383,069.98","1,149,209.95"
03-Jul-2023,Miscellaneous,"3,220.50",00.00,"1,152,430.45"
03-Jul-2023,RTGS,00.00,"144,053.81","1,008,376.64"
03-Jul-2023,Cheque,00.00,"336,125.55","672,251.09"
03-Jul-2023,Miscellaneous,00.00,"224,083.70","448,167.39"
03-Jul-2023,Cheque,00.00,"74,694.57","373,472.82"
03-Jul-2023,Tax,00.00,"124,490.94","248,981.88"
03-Jul-2023,Bill,57.00,00.00,"249,038.88"
03-Jul-2023,Transfer,00.00,"124,519.44","124,519.44"
03-Jul-2023,Debit Card,"24,268.00",00.00,"148,787.44"
03-Jul-2023,Bill,00.00,"24,797.91","123,989.53"
03-Jul-2023,Tax,233.40,00.00,"124,222.93"
03-Jul-2023,Transfer,00.00,"62,111.47","62,111.46"
03-Jul-2023,NEFT,"3,965.00",00.00,"66,076.46"
03-Jul-2023,RTGS,"593,514.50",00.00,"659,590.96"
03-Jul-2023,ATM,00.00,"164,897.74","494,693.22"
03-Jul-2023,Transfer,"5,910.06",00.00,"500,603.28"
03-Jul-2023,Reversal,00.00,"50,060.33","450,542.95"
03-Jul-2023,Purchase,00.00,"75,090.49","375,452.46"
03-Jul-2023,NEFT,"64,618.70",00.00,"440,071.16"
03-Jul-2023,Bill,05.80,00.00,"440,076.96"
03-Jul-2023,Commission,"1,702.00",00.00,"441,778.96"
03-Jul-2023,NEFT,00.00,"441,778.96",00.00
03-Jul-2023,Transfer,52.10,00.00,52.10
03-Jul-2023,Reversal,07.50,00.00,59.60
03-Jul-2023,Transfer,"7,098.00",00.00,"7,157.60"
03-Jul-2023,Cash,"2,778.60",00.00,"9,936.20"
03-Jul-2023,Purchase,01.20,00.00,"9,937.40"
04-Jul-2023,IMPS,"3,622.60",00.00,"13,560.00"
04-Jul-2023,Transfer,"44,577.00",00.00,"58,137.00"
04-Jul-2023,Miscellaneous,509.41,00.00,"58,646.41"
04-Jul-2023,ATM,08.82,00.00,"58,655.23"
04-Jul-2023,Reversal,04.20,00.00,"58,659.43"
04-Jul-2023,RTGS,"12,672.43",00.00,"71,331.86"
04-Jul-2023,Miscellaneous,00.00,"7,925.76","63,406.10"
04-Jul-2023,ATM,00.00,"6,340.61","57,065.49"
04-Jul-2023,Transfer,07.63,00.00,"57,073.12"
04-Jul-2023,Purchase,00.00,"6,341.46","50,731.66"
04-Jul-2023,Tax,00.00,"7,247.38","43,484.28"
04-Jul-2023,ATM,00.00,"4,831.59","38,652.69"
04-Jul-2023,RTGS,"122,349.00",00.00,"161,001.69"
04-Jul-2023,Bill,00.00,"23,000.24","138,001.45"
04-Jul-2023,Interest,"7,555.10",00.00,"145,556.55"
04-Jul-2023,Cash,00.00,"24,259.43","121,297.12"
04-Jul-2023,Interest,00.00,"24,259.42","97,037.70"
04-Jul-2023,IMPS,00.00,"48,518.85","48,518.85"
04-Jul-2023,Miscellaneous,"30,563.04",00.00,"79,081.89"
04-Jul-2023,Tax,00.00,"79,081.89",00.00
04-Jul-2023,Cash,20.08,00.00,20.08
04-Jul-2023,Commission,38.00,00.00,58.08
04-Jul-2023,Transfer,03.10,00.00,61.18
04-Jul-2023,RTGS,00.00,15.30,45.88
04-Jul-2023,Reversal,00.00,15.29,30.59
04-Jul-2023,RTGS,00.00,10.20,20.39
04-Jul-2023,NEFT,07.20,00.00,27.59
04-Jul-2023,Tax,23.20,00.00,50.79
04-Jul-2023,Tax,00.00,50.79,00.00
04-Jul-2023,Miscellaneous,392.00,00.00,392.00
05-Jul-2023,Miscellaneous,00.00,392.00,00.00
05-Jul-2023,Miscellaneous,52.10,00.00,52.10
05-Jul-2023,Transfer,00.00,13.03,39.08
05-Jul-2023,Cash,252.00,00.00,291.08
05-Jul-2023,Tax,"246,429.80",00.00,"246,720.88"
05-Jul-2023,IMPS,00.00,"246,720.88",00.00
05-Jul-2023,RTGS,02.00,00.00,02.00
05-Jul-2023,Transfer,00.00,01.00,01.00
05-Jul-2023,Cheque,00.00,00.50,00.50
05-Jul-2023,Tax,"178,967.16",00.00,"178,967.66"
05-Jul-2023,Cheque,00.00,"17,896.77","161,070.89"
05-Jul-2023,Tax,00.00,"40,267.72","120,803.17"
05-Jul-2023,IMPS,00.00,"17,257.60","103,545.57"
05-Jul-2023,Cheque,"158,151.50",00.00,"261,697.07"
05-Jul-2023,NEFT,00.00,"26,169.71","235,527.36"
05-Jul-2023,NEFT,00.00,"235,527.36",00.00
05-Jul-2023,IMPS,"230,595.90",00.00,"230,595.90"
05-Jul-2023,Tax,502.00,00.00,"231,097.90"
05-Jul-2023,Debit Card,00.00,"28,887.24","202,210.66"
05-Jul-2023,NEFT,00.00,"25,276.33","176,934.33"
05-Jul-2023,Bill,00.00,"19,659.37","157,274.96"
05-Jul-2023,Tax,00.00,"26,212.49","131,062.47"
05-Jul-2023,Reversal,02.20,00.00,"131,064.67"
05-Jul-2023,ATM,"24,823.00",00.00,"155,887.67"
05-Jul-2023,Bill,"1,725,365.50",00.00,"1,881,253.17"
05-Jul-2023,NEFT,00.00,"188,125.32","1,693,127.85"
05-Jul-2023,RTGS,227.60,00.00,"1,693,355.45"
05-Jul-2023,ATM,00.00,"211,669.43","1,481,686.02"
05-Jul-2023,ATM,"1,485,808.50",00.00,"2,967,494.52"
05-Jul-2023,Transfer,00.00,"370,936.82","2,596,557.70"
05-Jul-2023,ATM,00.00,"370,936.81","2,225,620.89"
05-Jul-2023,Purchase,00.00,"2,225,620.89",00.00
05-Jul-2023,ATM,42.50,00.00,42.50
05-Jul-2023,Debit Card,00.00,21.25,21.25
05-Jul-2023,Commission,00.00,10.63,10.62
05-Jul-2023,Transfer,00.00,01.52,09.10
05-Jul-2023,Transfer,00.00,01.52,07.58
05-Jul-2023,IMPS,00.00,01.90,05.68
05-Jul-2023,RTGS,343.29,00.00,348.97
05-Jul-2023,Cash,"3,747.10",00.00,"4,096.07"
05-Jul-2023,Commission,"100,684.00",00.00,"104,780.07"
05-Jul-2023,Transfer,00.00,"26,195.02","78,585.05"
05-Jul-2023,Miscellaneous,00.00,"78,585.05",00.00
05-Jul-2023,ATM,"4,863.80",00.00,"4,863.80"
05-Jul-2023,ATM,"3,916.56",00.00,"8,780.36"
05-Jul-2023,Cheque,00.00,"1,097.55","7,682.82"
05-Jul-2023,ATM,"90,018.80",00.00,"97,701.62"
05-Jul-2023,Miscellaneous,00.00,"19,540.32","78,161.30"
05-Jul-2023,Transfer,00.00,"26,053.77","52,107.53"
05-Jul-2023,Transfer,03.56,00.00,"52,111.09"
05-Jul-2023,Transfer,00.00,"6,513.89","45,597.20"
05-Jul-2023,Interest,05.40,00.00,"45,602.60"
05-Jul-2023,NEFT,00.00,"5,066.96","40,535.64"
05-Jul-2023,Reversal,00.00,"5,790.81","34,744.83"
06-Jul-2023,Debit Card,00.00,"3,860.54","30,884.29"
06-Jul-2023,Interest,125.55,00.00,"31,009.84"
06-Jul-2023,Transfer,00.00,"4,429.98","26,579.86"
06-Jul-2023,RTGS,"26,656.50",00.00,"53,236.36"
06-Jul-2023,NEFT,29.00,00.00,"53,265.36"
06-Jul-2023,Interest,360.00,00.00,"53,625.36"
06-Jul-2023,Commission,00.00,"17,875.12","35,750.24"
06-Jul-2023,Commission,"3,626.60",00.00,"39,376.84"
07-Jul-2023,ATM,00.00,"7,875.37","31,501.47"
07-Jul-2023,Purchase,00.00,"3,500.16","28,001.31"
07-Jul-2023,Cheque,00.00,"7,000.33","21,000.98"
07-Jul-2023,Reversal,00.00,"2,100.10","18,900.88"
07-Jul-2023,RTGS,12.34,00.00,"18,913.22"
08-Jul-2023,Purchase,220.50,00.00,"19,133.72"
08-Jul-2023,Interest,04.30,00.00,"19,138.02"
08-Jul-2023,Miscellaneous,00.00,"3,189.67","15,948.35"
08-Jul-2023,Tax,00.00,"15,948.35",00.00
08-Jul-2023,IMPS,"89,772.50",00.00,"89,772.50"
08-Jul-2023,Tax,00.00,"17,954.50","71,818.00"
08-Jul-2023,Debit Card,35.84,00.00,"71,853.84"
08-Jul-2023,IMPS,07.03,00.00,"71,860.87"
08-Jul-2023,Reversal,"14,064.00",00.00,"85,924.87"
08-Jul-2023,ATM,"11,909.82",00.00,"97,834.69"
08-Jul-2023,Commission,00.00,"48,917.35","48,917.34"
08-Jul-2023,Transfer,"1,487.96",00.00,"50,405.30"
08-Jul-2023,IMPS,00.00,"5,600.59","44,804.71"
08-Jul-2023,Tax,07.85,00.00,"44,812.56"
08-Jul-2023,NEFT,05.70,00.00,"44,818.26"
08-Jul-2023,Cheque,00.00,"14,939.42","29,878.84"
08-Jul-2023,Purchase,"2,145.70",00.00,"32,024.54"
08-Jul-2023,Interest,00.00,"5,337.42","26,687.12"
08-Jul-2023,Debit Card,"427,602.00",00.00,"454,289.12"
08-Jul-2023,Miscellaneous,00.00,"64,898.45","389,390.67"
08-Jul-2023,ATM,06.40,00.00,"389,397.07"
08-Jul-2023,Cheque,00.00,"64,899.51","324,497.56"
08-Jul-2023,Tax,00.00,"46,356.79","278,140.77"
08-Jul-2023,Miscellaneous,07.00,00.00,"278,147.77"
08-Jul-2023,Interest,50.00,00.00,"278,197.77"
08-Jul-2023,Reversal,"6,899.00",00.00,"285,096.77"
08-Jul-2023,Interest,"2,645.90",00.00,"287,742.67"
08-Jul-2023,RTGS,00.00,"71,935.67","215,807.00"
08-Jul-2023,Bill,60.40,00.00,"215,867.40"
08-Jul-2023,ATM,00.00,"23,985.27","191,882.13"
08-Jul-2023,Reversal,07.04,00.00,"191,889.17"
08-Jul-2023,Tax,"24,754.08",00.00,"216,643.25"
08-Jul-2023,Commission,00.00,"36,107.21","180,536.04"
08-Jul-2023,Bill,00.00,"25,790.86","154,745.18"
08-Jul-2023,Miscellaneous,311.73,00.00,"155,056.91"
08-Jul-2023,Commission,00.00,"155,056.91",00.00
08-Jul-2023,Purchase,"55,695.00",00.00,"55,695.00"
08-Jul-2023,Purchase,07.00,00.00,"55,702.00"
08-Jul-2023,Interest,87.09,00.00,"55,789.09"
08-Jul-2023,Transfer,"8,998.90",00.00,"64,787.99"
08-Jul-2023,Cash,"1,540.00",00.00,"66,327.99"
08-Jul-2023,Cheque,00.00,"9,475.43","56,852.56"
08-Jul-2023,ATM,00.00,"11,370.51","45,482.05"
08-Jul-2023,RTGS,"3,157.40",00.00,"48,639.45"
08-Jul-2023,NEFT,"211,216.20",00.00,"259,855.65"
08-Jul-2023,Transfer,"244,932.90",00.00,"504,788.55"
08-Jul-2023,NEFT,33.90,00.00,"504,822.45"
08-Jul-2023,Cheque,480.00,00.00,"505,302.45"
08-Jul-2023,RTGS,"25,390.59",00.00,"530,693.04"
08-Jul-2023,Tax,"3,337.07",00.00,"534,030.11"
08-Jul-2023,Cheque,"1,874,666.20",00.00,"2,408,696.31"
08-Jul-2023,Cheque,"19,638.90",00.00,"2,428,335.21"
08-Jul-2023,IMPS,707.52,00.00,"2,429,042.73"
08-Jul-2023,RTGS,"770,493.50",00.00,"3,199,536.23"
08-Jul-2023,Commission,00.00,"1,066,512.08","2,133,024.15"
08-Jul-2023,NEFT,04.29,00.00,"2,133,028.44"
08-Jul-2023,Transfer,"205,735.34",00.00,"2,338,763.78"
08-Jul-2023,Debit Card,00.00,"467,752.76","1,871,011.02"
08-Jul-2023,Tax,05.92,00.00,"1,871,016.94"
08-Jul-2023,Interest,00.00,"187,101.69","1,683,915.25"
08-Jul-2023,Purchase,00.00,"1,683,915.25",00.00
08-Jul-2023,IMPS,"2,022,355.50",00.00,"2,022,355.50"
08-Jul-2023,Miscellaneous,"198,014.40",00.00,"2,220,369.90"
08-Jul-2023,ATM,468.18,00.00,"2,220,838.08"
08-Jul-2023,Purchase,00.00,"277,604.76","1,943,233.32"
08-Jul-2023,IMPS,385.90,00.00,"1,943,619.22"
08-Jul-2023,Debit Card,00.00,"971,809.61","971,809.61"
08-Jul-2023,Tax,37.10,00.00,"971,846.71"
08-Jul-2023,Commission,00.00,"323,948.90","647,897.81"
08-Jul-2023,ATM,"23,122.00",00.00,"671,019.81"
08-Jul-2023,Purchase,"3,663.55",00.00,"674,683.36"
08-Jul-2023,Tax,00.00,"67,468.34","607,215.02"
08-Jul-2023,Bill,"159,624.84",00.00,"766,839.86"
08-Jul-2023,RTGS,00.00,"153,367.97","613,471.89"
08-Jul-2023,Reversal,33.30,00.00,"613,505.19"
08-Jul-2023,NEFT,"1,294.80",00.00,"614,799.99"
08-Jul-2023,Cash,00.00,"307,400.00","307,400.00"
08-Jul-2023,Interest,00.00,"34,155.56","273,244.44"
08-Jul-2023,Bill,332.80,00.00,"273,577.24"
09-Jul-2023,Reversal,40.00,00.00,"273,617.24"
09-Jul-2023,ATM,"4,702.20",00.00,"278,319.44"
09-Jul-2023,Miscellaneous,00.00,"69,579.86","208,739.58"
09-Jul-2023,Bill,30.70,00.00,"208,770.28"
09-Jul-2023,NEFT,"11,754.31",00.00,"220,524.59"
09-Jul-2023,Miscellaneous,00.00,"110,262.30","110,262.30"
10-Jul-2023,Transfer,00.00,"13,782.79","96,479.51"
10-Jul-2023,RTGS,00.00,"32,159.84","64,319.67"
10-Jul-2023,Cheque,58.00,00.00,"64,377.67"
10-Jul-2023,IMPS,00.00,"12,875.53","51,502.14"
11-Jul-2023,IMPS,00.00,"8,583.69","42,918.45"
11-Jul-2023,NEFT,"1,921,256.00",00.00,"1,964,174.45"
11-Jul-2023,Commission,07.98,00.00,"1,964,182.43"
11-Jul-2023,Cheque,00.00,"218,242.49","1,745,939.94"
11-Jul-2023,IMPS,22.40,00.00,"1,745,962.34"
11-Jul-2023,Commission,19.70,00.00,"1,745,982.04"
11-Jul-2023,Reversal,00.00,"193,998.00","1,551,984.04"
11-Jul-2023,RTGS,"217,267.00",00.00,"1,769,251.04"
11-Jul-2023,Interest,00.00,"353,850.21","1,415,400.83"
11-Jul-2023,Debit Card,00.00,"141,540.08","1,273,860.75"
11-Jul-2023,Reversal,00.00,"424,620.25","849,240.50"
11-Jul-2023,Reversal,"1,145.30",00.00,"850,385.80"
11-Jul-2023,NEFT,242.50,00.00,"850,628.30"
11-Jul-2023,NEFT,00.00,"170,125.66","680,502.64"
11-Jul-2023,ATM,357.80,00.00,"680,860.44"
11-Jul-2023,ATM,00.00,"75,651.16","605,209.28"
11-Jul-2023,ATM,"2,581.20",00.00,"607,790.48"
11-Jul-2023,Bill,00.00,00.00,"607,790.48"
11-Jul-2023,ATM,05.99,00.00,"607,796.47"
11-Jul-2023,Purchase,00.00,"86,828.07","520,968.40"
11-Jul-2023,Bill,00.00,"130,242.10","390,726.30"
11-Jul-2023,Debit Card,00.00,"43,414.03","347,312.27"
11-Jul-2023,Cheque,"1,813.00",00.00,"349,125.27"
11-Jul-2023,RTGS,00.00,"69,825.05","279,300.22"
11-Jul-2023,Debit Card,"1,941,202.50",00.00,"2,220,502.72"
11-Jul-2023,IMPS,"23,280.41",00.00,"2,243,783.13"
11-Jul-2023,IMPS,00.00,"320,540.45","1,923,242.68"
11-Jul-2023,Tax,00.00,"480,810.67","1,442,432.01"
11-Jul-2023,IMPS,00.00,"240,405.34","1,202,026.68"
11-Jul-2023,Purchase,00.00,"200,337.78","1,001,688.90"
11-Jul-2023,Miscellaneous,00.00,"143,098.41","858,590.49"
11-Jul-2023,Cash,04.00,00.00,"858,594.49"
11-Jul-2023,NEFT,00.00,"171,718.90","686,875.59"
11-Jul-2023,IMPS,"242,672.03",00.00,"929,547.62"
11-Jul-2023,NEFT,00.00,"154,924.60","774,623.02"
11-Jul-2023,Transfer,00.00,"387,311.51","387,311.51"
11-Jul-2023,Reversal,"1,668,740.00",00.00,"2,056,051.51"
11-Jul-2023,Debit Card,00.00,"685,350.50","1,370,701.01"
11-Jul-2023,IMPS,00.00,"195,814.43","1,174,886.58"
11-Jul-2023,IMPS,"1,032,112.80",00.00,"2,206,999.38"
11-Jul-2023,RTGS,"152,159.80",00.00,"2,359,159.18"
11-Jul-2023,Commission,00.00,"262,128.80","2,097,030.38"
11-Jul-2023,IMPS,"1,962,200.00",00.00,"4,059,230.38"
11-Jul-2023,RTGS,00.00,"405,923.04","3,653,307.34"
11-Jul-2023,Bill,00.00,"365,330.73","3,287,976.61"
12-Jul-2023,Commission,00.00,"469,710.94","2,818,265.67"
12-Jul-2023,ATM,00.00,"939,421.89","1,878,843.78"
12-Jul-2023,Transfer,07.47,00.00,"1,878,851.25"
12-Jul-2023,Transfer,"1,888,980.50",00.00,"3,767,831.75"
12-Jul-2023,Debit Card,"1,525,196.00",00.00,"5,293,027.75"
12-Jul-2023,Miscellaneous,00.00,"588,114.19","4,704,913.56"
12-Jul-2023,RTGS,01.70,00.00,"4,704,915.26"
12-Jul-2023,Cash,00.00,"940,983.05","3,763,932.21"
12-Jul-2023,Purchase,50.91,00.00,"3,763,983.12"
12-Jul-2023,Purchase,62.00,00.00,"3,764,045.12"
12-Jul-2023,Debit Card,00.00,"537,720.73","3,226,324.39"
12-Jul-2023,Debit Card,00.00,"1,075,441.46","2,150,882.93"
12-Jul-2023,Cheque,00.00,"537,720.73","1,613,162.20"
12-Jul-2023,Reversal,00.00,"403,290.55","1,209,871.65"
12-Jul-2023,IMPS,"2,844.16",00.00,"1,212,715.81"
12-Jul-2023,IMPS,33.00,00.00,"1,212,748.81"
12-Jul-2023,Tax,00.00,"134,749.87","1,077,998.94"
12-Jul-2023,Interest,00.00,"153,999.85","923,999.09"
12-Jul-2023,Transfer,00.00,"115,499.89","808,499.20"
13-Jul-2023,Tax,00.00,"89,833.24","718,665.96"
13-Jul-2023,Bill,"2,123.05",00.00,"720,789.01"
13-Jul-2023,Cheque,"1,999,802.00",00.00,"2,720,591.01"
13-Jul-2023,Transfer,383.46,00.00,"2,720,974.47"
13-Jul-2023,Tax,00.00,"2,720,974.47",00.00
13-Jul-2023,Commission,226.40,00.00,226.40
13-Jul-2023,Cash,00.00,56.60,169.80
13-Jul-2023,Miscellaneous,00.00,28.30,141.50
13-Jul-2023,Cash,"27,813.35",00.00,"27,954.85"
13-Jul-2023,Commission,00.00,"5,590.97","22,363.88"
13-Jul-2023,Interest,"1,184.80",00.00,"23,548.68"
14-Jul-2023,Cash,00.00,"11,774.34","11,774.34"
14-Jul-2023,Miscellaneous,25.80,00.00,"11,800.14"
14-Jul-2023,Commission,00.00,"3,933.38","7,866.76"
14-Jul-2023,RTGS,00.00,"2,622.25","5,244.51"
14-Jul-2023,Bill,00.00,874.09,"4,370.42"
15-Jul-2023,Bill,00.77,00.00,"4,371.19"
15-Jul-2023,NEFT,00.00,"1,092.80","3,278.39"
15-Jul-2023,Cash,"1,139.10",00.00,"4,417.49"
15-Jul-2023,Commission,63.73,00.00,"4,481.22"
16-Jul-2023,Miscellaneous,"154,992.94",00.00,"159,474.16"
16-Jul-2023,Bill,00.00,"39,868.54","119,605.62"
16-Jul-2023,Miscellaneous,00.00,"119,605.62",00.00
16-Jul-2023,Reversal,"20,487.30",00.00,"20,487.30"
16-Jul-2023,Tax,"314,242.50",00.00,"334,729.80"
16-Jul-2023,Bill,00.00,"167,364.90","167,364.90"
16-Jul-2023,Interest,00.00,"167,364.90",00.00
16-Jul-2023,Interest,428.21,00.00,428.21
16-Jul-2023,Tax,"634,653.50",00.00,"635,081.71"
16-Jul-2023,Tax,00.00,"63,508.17","571,573.54"
16-Jul-2023,ATM,00.00,"95,262.26","476,311.28"
16-Jul-2023,Reversal,00.00,"52,923.48","423,387.80"
16-Jul-2023,ATM,00.00,"105,846.95","317,540.85"
16-Jul-2023,Interest,00.00,"63,508.17","254,032.68"
16-Jul-2023,Commission,00.00,"127,016.34","127,016.34"
16-Jul-2023,Miscellaneous,173.00,00.00,"127,189.34"
16-Jul-2023,Purchase,55.00,00.00,"127,244.34"
16-Jul-2023,Purchase,00.00,"21,207.39","106,036.95"
16-Jul-2023,Reversal,00.00,"15,148.14","90,888.81"
16-Jul-2023,Transfer,00.00,"12,984.12","77,904.69"
16-Jul-2023,ATM,00.00,"77,904.69",00.00
16-Jul-2023,Transfer,04.27,00.00,04.27
16-Jul-2023,Commission,"3,050.00",00.00,"3,054.27"
16-Jul-2023,Cash,00.00,610.85,"2,443.42"
16-Jul-2023,Miscellaneous,"68,153.00",00.00,"70,596.42"
16-Jul-2023,Transfer,00.00,"7,059.64","63,536.78"
16-Jul-2023,Commission,340.40,00.00,"63,877.18"
16-Jul-2023,Reversal,"105,365.00",00.00,"169,242.18"
16-Jul-2023,Commission,00.00,"21,155.27","148,086.91"
16-Jul-2023,Tax,"3,137.50",00.00,"151,224.41"
16-Jul-2023,ATM,"229,151.80",00.00,"380,376.21"
16-Jul-2023,Cash,"1,507.00",00.00,"381,883.21"
16-Jul-2023,Commission,00.00,"47,735.40","334,147.81"
16-Jul-2023,Debit Card,"4,844.49",00.00,"338,992.30"
16-Jul-2023,Cheque,00.00,"112,997.43","225,994.87"
16-Jul-2023,RTGS,"139,245.00",00.00,"365,239.87"
16-Jul-2023,Cash,"79,803.31",00.00,"445,043.18"
16-Jul-2023,Bill,06.21,00.00,"445,049.39"
16-Jul-2023,Tax,331.87,00.00,"445,381.26"
16-Jul-2023,Purchase,00.00,"74,230.21","371,151.05"
17-Jul-2023,Debit Card,"1,502,838.00",00.00,"1,873,989.05"
17-Jul-2023,NEFT,"111,976.70",00.00,"1,985,965.75"
17-Jul-2023,Cheque,"17,691.90",00.00,"2,003,657.65"
17-Jul-2023,Interest,349.00,00.00,"2,004,006.65"
17-Jul-2023,Interest,00.00,"222,667.41","1,781,339.24"
17-Jul-2023,Bill,00.00,"356,267.85","1,425,071.39"
17-Jul-2023,IMPS,"218,413.20",00.00,"1,643,484.59"
17-Jul-2023,Cash,"1,427,845.75",00.00,"3,071,330.34"
17-Jul-2023,Debit Card,00.00,"307,133.03","2,764,197.31"
17-Jul-2023,Transfer,00.00,"921,399.10","1,842,798.21"
17-Jul-2023,IMPS,00.00,"614,266.07","1,228,532.14"
17-Jul-2023,NEFT,"2,350.99",00.00,"1,230,883.13"
17-Jul-2023,Tax,"1,773,062.50",00.00,"3,003,945.63"
17-Jul-2023,Transfer,"1,951,534.25",00.00,"4,955,479.88"
17-Jul-2023,NEFT,00.00,"4,955,479.88",00.00
17-Jul-2023,ATM,06.00,00.00,06.00
17-Jul-2023,RTGS,"1,082,657.50",00.00,"1,082,663.50"
18-Jul-2023,Debit Card,"1,006,353.25",00.00,"2,089,016.75"
18-Jul-2023,Reversal,00.00,"2,089,016.75",00.00
18-Jul-2023,Bill,20.00,00.00,20.00
18-Jul-2023,IMPS,"198,523.56",00.00,"198,543.56"
18-Jul-2023,ATM,00.00,"33,090.59","165,452.97"
18-Jul-2023,Cheque,00.00,"41,363.24","124,089.73"
18-Jul-2023,Transfer,00.00,"13,787.75","110,301.98"
18-Jul-2023,Reversal,"2,159.11",00.00,"112,461.09"
18-Jul-2023,Commission,109.00,00.00,"112,570.09"
18-Jul-2023,Tax,00.00,"112,570.09",00.00
18-Jul-2023,Bill,"2,995.01",00.00,"2,995.01"
18-Jul-2023,ATM,"1,996.00",00.00,"4,991.01"
19-Jul-2023,Reversal,367.24,00.00,"5,358.25"
19-Jul-2023,Cash,00.00,669.78,"4,688.47"
19-Jul-2023,RTGS,04.58,00.00,"4,693.05"
19-Jul-2023,Cash,"16,471.00",00.00,"21,164.05"
19-Jul-2023,ATM,00.00,"10,582.03","10,582.02"
19-Jul-2023,Cheque,00.00,"10,582.02",00.00
19-Jul-2023,Cash,"234,681.00",00.00,"234,681.00"
19-Jul-2023,Miscellaneous,00.00,"117,340.50","117,340.50"
20-Jul-2023,Miscellaneous,00.00,"39,113.50","78,227.00"
20-Jul-2023,IMPS,"207,624.00",00.00,"285,851.00"
20-Jul-2023,NEFT,"2,167.31",00.00,"288,018.31"
20-Jul-2023,IMPS,"45,436.40",00.00,"333,454.71"
20-Jul-2023,Transfer,00.00,"66,690.94","266,763.77"
20-Jul-2023,Interest,94.00,00.00,"266,857.77"
20-Jul-2023,RTGS,00.00,"133,428.89","133,428.88"
20-Jul-2023,RTGS,00.00,"133,428.88",00.00
21-Jul-2023,Tax,"91,129.00",00.00,"91,129.00"
21-Jul-2023,Transfer,00.00,"91,129.00",00.00
21-Jul-2023,RTGS,05.50,00.00,05.50
21-Jul-2023,ATM,"1,089,657.50",00.00,"1,089,663.00"
21-Jul-2023,Cheque,"2,620.30",00.00,"1,092,283.30"
21-Jul-2023,RTGS,00.00,"364,094.43","728,188.87"
21-Jul-2023,Cash,00.00,"728,188.87",00.00
21-Jul-2023,Miscellaneous,"233,607.00",00.00,"233,607.00"
21-Jul-2023,Purchase,"20,864.69",00.00,"254,471.69"
21-Jul-2023,Reversal,00.00,"50,894.34","203,577.35"
21-Jul-2023,IMPS,00.00,"67,859.12","135,718.23"
21-Jul-2023,Reversal,"202,353.90",00.00,"338,072.13"
21-Jul-2023,IMPS,00.00,"42,259.02","295,813.11"
21-Jul-2023,RTGS,03.00,00.00,"295,816.11"
21-Jul-2023,Cheque,00.00,"73,954.03","221,862.08"
21-Jul-2023,Interest,00.00,"44,372.42","177,489.66"
21-Jul-2023,Debit Card,00.00,"22,186.21","155,303.45"
21-Jul-2023,Interest,"7,999.00",00.00,"163,302.45"
21-Jul-2023,IMPS,00.00,"23,328.92","139,973.53"
21-Jul-2023,IMPS,26.29,00.00,"139,999.82"
21-Jul-2023,NEFT,00.00,"13,999.98","125,999.84"
21-Jul-2023,Transfer,00.00,"62,999.92","62,999.92"
21-Jul-2023,Bill,00.00,"20,999.97","41,999.95"
21-Jul-2023,Bill,435.96,00.00,"42,435.91"
21-Jul-2023,RTGS,00.00,"5,304.49","37,131.42"
21-Jul-2023,Bill,48.90,00.00,"37,180.32"
21-Jul-2023,NEFT,05.06,00.00,"37,185.38"
21-Jul-2023,Commission,00.00,"18,592.69","18,592.69"
21-Jul-2023,IMPS,07.00,00.00,"18,599.69"
21-Jul-2023,Tax,04.85,00.00,"18,604.54"
21-Jul-2023,Cash,"1,257.00",00.00,"19,861.54"
21-Jul-2023,RTGS,"1,865.00",00.00,"21,726.54"
21-Jul-2023,Interest,274.00,00.00,"22,000.54"
21-Jul-2023,Bill,"2,890.50",00.00,"24,891.04"
21-Jul-2023,Debit Card,"206,140.00",00.00,"231,031.04"
22-Jul-2023,Transfer,00.00,"231,031.04",00.00
22-Jul-2023,Cash,83.89,00.00,83.89
22-Jul-2023,Cash,00.00,83.89,00.00
22-Jul-2023,Debit Card,"526,574.75",00.00,"526,574.75"
22-Jul-2023,IMPS,443.30,00.00,"527,018.05"
22-Jul-2023,Cash,00.00,"75,288.29","451,729.76"
22-Jul-2023,NEFT,00.00,"45,172.98","406,556.78"
22-Jul-2023,ATM,00.00,"135,518.93","271,037.85"
22-Jul-2023,Purchase,00.00,"90,345.95","180,691.90"
22-Jul-2023,Bill,00.00,"18,069.19","162,622.71"
22-Jul-2023,ATM,00.00,"16,262.27","146,360.44"
22-Jul-2023,Bill,"2,997.00",00.00,"149,357.44"
22-Jul-2023,Commission,"245,916.00",00.00,"395,273.44"
22-Jul-2023,Debit Card,"21,374.70",00.00,"416,648.14"
22-Jul-2023,IMPS,399.28,00.00,"417,047.42"
22-Jul-2023,Miscellaneous,"151,545.00",00.00,"568,592.42"
22-Jul-2023,Purchase,"400,509.50",00.00,"969,101.92"
23-Jul-2023,Debit Card,"1,728.03",00.00,"970,829.95"
23-Jul-2023,Purchase,00.00,"323,609.98","647,219.97"
23-Jul-2023,Cheque,283.90,00.00,"647,503.87"
23-Jul-2023,RTGS,"3,185.90",00.00,"650,689.77"
23-Jul-2023,Miscellaneous,"1,951.50",00.00,"652,641.27"
23-Jul-2023,Commission,"2,039.00",00.00,"654,680.27"
23-Jul-2023,Debit Card,379.05,00.00,"655,059.32"
24-Jul-2023,IMPS,00.00,"81,882.42","573,176.90"
24-Jul-2023,Tax,00.00,"286,588.45","286,588.45"
24-Jul-2023,Miscellaneous,00.00,"31,843.16","254,745.29"
24-Jul-2023,Commission,03.00,00.00,"254,748.29"
24-Jul-2023,NEFT,00.00,"31,843.54","222,904.75"
24-Jul-2023,Miscellaneous,00.00,"74,301.58","148,603.17"
25-Jul-2023,Reversal,51.86,00.00,"148,655.03"
25-Jul-2023,Commission,00.00,"21,236.43","127,418.60"
25-Jul-2023,RTGS,00.00,"15,927.33","111,491.28"
25-Jul-2023,Transfer,00.00,"12,387.92","99,103.36"
25-Jul-2023,IMPS,00.00,"99,103.36",00.00
25-Jul-2023,RTGS,"1,621,255.00",00.00,"1,621,255.00"
25-Jul-2023,Cash,"1,766.40",00.00,"1,623,021.40"
25-Jul-2023,Bill,00.00,"405,755.35","1,217,266.05"
25-Jul-2023,Cheque,00.00,"173,895.15","1,043,370.90"
25-Jul-2023,NEFT,00.00,"149,052.99","894,317.91"
25-Jul-2023,Bill,"148,168.00",00.00,"1,042,485.91"
25-Jul-2023,ATM,00.00,"208,497.18","833,988.73"
25-Jul-2023,Interest,04.10,00.00,"833,992.83"
26-Jul-2023,Transfer,00.00,"138,998.81","694,994.02"
26-Jul-2023,Debit Card,"185,063.00",00.00,"880,057.02"
26-Jul-2023,Tax,"842,818.25",00.00,"1,722,875.27"
26-Jul-2023,Transfer,00.00,"861,437.64","861,437.64"
26-Jul-2023,Miscellaneous,00.00,"861,437.64",00.00
26-Jul-2023,Miscellaneous,"1,244,117.50",00.00,"1,244,117.50"
26-Jul-2023,Bill,00.00,"311,029.38","933,088.12"
26-Jul-2023,Purchase,00.00,"93,308.81","839,779.31"
26-Jul-2023,Purchase,"1,050,130.75",00.00,"1,889,910.06"
26-Jul-2023,IMPS,"1,404,944.50",00.00,"3,294,854.56"
26-Jul-2023,Cheque,00.00,"823,713.64","2,471,140.92"
26-Jul-2023,Commission,"195,225.20",00.00,"2,666,366.12"
26-Jul-2023,Bill,"1,265,126.00",00.00,"3,931,492.12"
26-Jul-2023,Tax,00.00,"655,248.69","3,276,243.43"
26-Jul-2023,Commission,00.00,"3,276,243.43",00.00
26-Jul-2023,IMPS,03.00,00.00,03.00
26-Jul-2023,Cash,00.00,00.33,02.67
26-Jul-2023,Commission,00.00,00.38,02.29
26-Jul-2023,Transfer,00.00,00.76,01.53
26-Jul-2023,Bill,07.37,00.00,08.90
26-Jul-2023,NEFT,124.71,00.00,133.61
26-Jul-2023,Cash,"16,778.00",00.00,"16,911.61"
26-Jul-2023,Bill,00.00,"4,227.90","12,683.71"
26-Jul-2023,Transfer,"5,040.67",00.00,"17,724.38"
26-Jul-2023,NEFT,00.00,"4,431.10","13,293.28"
26-Jul-2023,Tax,"88,488.00",00.00,"101,781.28"
26-Jul-2023,Reversal,"1,054,708.20",00.00,"1,156,489.48"
26-Jul-2023,Miscellaneous,00.00,"578,244.74","578,244.74"
26-Jul-2023,NEFT,00.00,"289,122.37","289,122.37"
26-Jul-2023,Reversal,04.90,00.00,"289,127.27"
26-Jul-2023,Transfer,30.60,00.00,"289,157.87"
26-Jul-2023,Tax,00.00,"36,144.73","253,013.14"
26-Jul-2023,Transfer,"2,567.00",00.00,"255,580.14"
26-Jul-2023,RTGS,00.00,"42,596.69","212,983.45"
26-Jul-2023,RTGS,00.00,"26,622.93","186,360.52"
26-Jul-2023,Purchase,00.00,"186,360.52",00.00
26-Jul-2023,Cheque,436.87,00.00,436.87
26-Jul-2023,Debit Card,"12,044.71",00.00,"12,481.58"
26-Jul-2023,RTGS,00.00,"1,783.08","10,698.50"
26-Jul-2023,Tax,00.00,"10,698.50",00.00
26-Jul-2023,Commission,"224,965.34",00.00,"224,965.34"
26-Jul-2023,Reversal,"1,138.20",00.00,"226,103.54"
26-Jul-2023,Tax,00.00,"22,610.35","203,493.19"
26-Jul-2023,IMPS,"1,041.80",00.00,"204,534.99"
26-Jul-2023,Cash,00.00,"20,453.50","184,081.49"
26-Jul-2023,Purchase,"2,064.60",00.00,"186,146.09"
26-Jul-2023,RTGS,"126,204.40",00.00,"312,350.49"
26-Jul-2023,Purchase,00.00,"312,350.49",00.00
26-Jul-2023,Miscellaneous,179.00,00.00,179.00
26-Jul-2023,Tax,"42,430.50",00.00,"42,609.50"
26-Jul-2023,Tax,00.00,"14,203.17","28,406.33"
26-Jul-2023,Purchase,00.00,"7,101.58","21,304.75"
26-Jul-2023,IMPS,30.71,00.00,"21,335.46"
26-Jul-2023,Purchase,"7,641.50",00.00,"28,976.96"
26-Jul-2023,Reversal,"110,561.00",00.00,"139,537.96"
26-Jul-2023,NEFT,00.30,00.00,"139,538.26"
26-Jul-2023,Debit Card,00.00,"19,934.04","119,604.22"
26-Jul-2023,Cheque,02.70,00.00,"119,606.92"
26-Jul-2023,Transfer,56.00,00.00,"119,662.92"
26-Jul-2023,Interest,00.00,"29,915.73","89,747.19"
26-Jul-2023,Cheque,"18,962.20",00.00,"108,709.39"
26-Jul-2023,Transfer,"3,172.00",00.00,"111,881.39"
26-Jul-2023,Interest,"14,659.00",00.00,"126,540.39"
26-Jul-2023,Commission,"142,455.12",00.00,"268,995.51"
26-Jul-2023,IMPS,"21,617.90",00.00,"290,613.41"
26-Jul-2023,Bill,00.00,"290,613.41",00.00
26-Jul-2023,NEFT,"2,407.00",00.00,"2,407.00"
26-Jul-2023,Purchase,"88,672.50",00.00,"91,079.50"
26-Jul-2023,ATM,00.00,"11,384.94","79,694.56"
26-Jul-2023,Transfer,00.00,"26,564.85","53,129.71"
26-Jul-2023,Cash,00.00,"5,903.30","47,226.41"
26-Jul-2023,Tax,00.00,"11,806.60","35,419.81"
26-Jul-2023,Purchase,"1,543.10",00.00,"36,962.91"
26-Jul-2023,Commission,00.00,"9,240.73","27,722.18"
26-Jul-2023,Cash,16.00,00.00,"27,738.18"
26-Jul-2023,Cheque,"25,450.00",00.00,"53,188.18"
26-Jul-2023,IMPS,"2,432.00",00.00,"55,620.18"
26-Jul-2023,Tax,"61,779.44",00.00,"117,399.62"
26-Jul-2023,Cash,00.00,"117,399.62",00.00
26-Jul-2023,IMPS,300.70,00.00,300.70
26-Jul-2023,ATM,00.00,150.35,150.35
26-Jul-2023,Tax,00.00,25.06,125.29
26-Jul-2023,Interest,00.00,12.53,112.76
26-Jul-2023,Cash,"682,096.00",00.00,"682,208.76"
26-Jul-2023,Tax,00.00,"341,104.38","341,104.38"
26-Jul-2023,Interest,00.00,"34,110.44","306,993.94"
26-Jul-2023,Tax,00.00,"30,699.39","276,294.55"
26-Jul-2023,Interest,00.00,"55,258.91","221,035.64"
26-Jul-2023,Transfer,00.00,"36,839.27","184,196.37"
26-Jul-2023,IMPS,01.00,00.00,"184,197.37"
26-Jul-2023,Bill,13.00,00.00,"184,210.37"
26-Jul-2023,Debit Card,00.00,"18,421.04","165,789.33"
26-Jul-2023,IMPS,00.00,"23,684.19","142,105.14"
26-Jul-2023,Reversal,06.10,00.00,"142,111.24"
26-Jul-2023,Debit Card,24.75,00.00,"142,135.99"
26-Jul-2023,Miscellaneous,00.00,"23,689.33","118,446.66"
26-Jul-2023,Interest,00.00,"23,689.33","94,757.33"
26-Jul-2023,ATM,01.40,00.00,"94,758.73"
26-Jul-2023,Commission,00.00,"15,793.12","78,965.61"
26-Jul-2023,Miscellaneous,00.00,"11,280.80","67,684.81"
26-Jul-2023,Miscellaneous,00.00,"16,921.20","50,763.61"
26-Jul-2023,Debit Card,"68,062.00",00.00,"118,825.61"
26-Jul-2023,ATM,00.00,"14,853.20","103,972.41"
26-Jul-2023,IMPS,"2,486.90",00.00,"106,459.31"
26-Jul-2023,Purchase,00.00,"11,828.81","94,630.50"
26-Jul-2023,Transfer,00.00,"13,518.64","81,111.86"
26-Jul-2023,Debit Card,00.00,"9,012.43","72,099.43"
26-Jul-2023,Commission,00.00,"72,099.43",00.00
26-Jul-2023,ATM,"464,173.75",00.00,"464,173.75"
26-Jul-2023,Reversal,00.00,"77,362.29","386,811.46"
26-Jul-2023,Cash,"17,948.30",00.00,"404,759.76"
26-Jul-2023,RTGS,00.00,"50,594.97","354,164.79"
26-Jul-2023,Miscellaneous,00.00,"354,164.79",00.00
26-Jul-2023,Bill,"1,915,502.50",00.00,"1,915,502.50"
26-Jul-2023,Miscellaneous,"73,578.78",00.00,"1,989,081.28"
26-Jul-2023,Miscellaneous,00.00,"248,635.16","1,740,446.12"
26-Jul-2023,Cheque,00.00,"1,740,446.12",00.00
26-Jul-2023,Bill,02.00,00.00,02.00
26-Jul-2023,Bill,31.90,00.00,33.90
26-Jul-2023,NEFT,00.00,16.95,16.95
26-Jul-2023,Cash,00.00,02.12,14.83
26-Jul-2023,Debit Card,"2,463.00",00.00,"2,477.83"
26-Jul-2023,Bill,00.00,825.94,"1,651.89"
26-Jul-2023,Reversal,00.00,275.32,"1,376.58"
26-Jul-2023,Reversal,11.00,00.00,"1,387.58"
26-Jul-2023,Debit Card,02.93,00.00,"1,390.51"
26-Jul-2023,Reversal,00.00,198.64,"1,191.87"
26-Jul-2023,Commission,04.00,00.00,"1,195.87"
26-Jul-2023,Miscellaneous,00.00,170.84,"1,025.03"
26-Jul-2023,Cheque,00.00,170.84,854.19
26-Jul-2023,Commission,"1,455.30",00.00,"2,309.49"
26-Jul-2023,IMPS,"219,286.50",00.00,"221,595.99"
26-Jul-2023,Debit Card,00.00,"31,656.57","189,939.42"
26-Jul-2023,RTGS,"887,094.00",00.00,"1,077,033.42"
26-Jul-2023,Purchase,00.00,"538,516.71","538,516.71"
26-Jul-2023,Cash,"2,059.81",00.00,"540,576.52"
26-Jul-2023,Bill,00.00,"60,064.06","480,512.46"
26-Jul-2023,Debit Card,459.10,00.00,"480,971.56"
26-Jul-2023,Bill,04.10,00.00,"480,975.66"
26-Jul-2023,NEFT,"1,802,282.00",00.00,"2,283,257.66"
26-Jul-2023,Bill,"158,280.72",00.00,"2,441,538.38"
26-Jul-2023,Reversal,00.00,"1,220,769.19","1,220,769.19"
26-Jul-2023,ATM,00.00,"152,596.15","1,068,173.04"
26-Jul-2023,Interest,00.00,"356,057.68","712,115.36"
26-Jul-2023,Reversal,51.10,00.00,"712,166.46"
26-Jul-2023,Debit Card,"252,952.80",00.00,"965,119.26"
26-Jul-2023,Transfer,00.00,"107,235.47","857,883.79"
26-Jul-2023,Miscellaneous,00.00,"214,470.95","643,412.84"
26-Jul-2023,NEFT,00.00,"71,490.32","571,922.52"
26-Jul-2023,Transfer,29.00,00.00,"571,951.52"
27-Jul-2023,Bill,08.00,00.00,"571,959.52"
27-Jul-2023,Bill,479.20,00.00,"572,438.72"
27-Jul-2023,NEFT,00.00,"57,243.87","515,194.85"
27-Jul-2023,NEFT,00.00,"128,798.71","386,396.14"
27-Jul-2023,Tax,47.10,00.00,"386,443.24"
27-Jul-2023,Commission,"387,734.00",00.00,"774,177.24"
27-Jul-2023,Cash,00.00,"129,029.54","645,147.70"
27-Jul-2023,Purchase,00.00,"92,163.96","552,983.74"
27-Jul-2023,Reversal,00.00,"55,298.37","497,685.37"
27-Jul-2023,Debit Card,02.00,00.00,"497,687.37"
28-Jul-2023,Interest,411.38,00.00,"498,098.75"
28-Jul-2023,Transfer,62.09,00.00,"498,160.84"
28-Jul-2023,Debit Card,00.00,"55,351.20","442,809.64"
28-Jul-2023,Purchase,04.59,00.00,"442,814.23"
28-Jul-2023,Purchase,108.60,00.00,"442,922.83"
28-Jul-2023,Bill,00.00,"221,461.42","221,461.42"
28-Jul-2023,NEFT,00.00,"24,606.82","196,854.60"
28-Jul-2023,Tax,00.00,"21,872.73","174,981.87"
28-Jul-2023,RTGS,"104,657.30",00.00,"279,639.17"
28-Jul-2023,Miscellaneous,"227,513.06",00.00,"507,152.23"
28-Jul-2023,Cash,00.00,"507,152.23",00.00
28-Jul-2023,NEFT,"3,767.50",00.00,"3,767.50"
28-Jul-2023,Cash,"16,093.00",00.00,"19,860.50"
28-Jul-2023,RTGS,403.40,00.00,"20,263.90"
28-Jul-2023,RTGS,"10,521.05",00.00,"30,784.95"
28-Jul-2023,Commission,00.00,"3,420.55","27,364.40"
28-Jul-2023,Interest,75.00,00.00,"27,439.40"
28-Jul-2023,Cheque,27.00,00.00,"27,466.40"
28-Jul-2023,Interest,00.00,"5,493.28","21,973.12"
28-Jul-2023,Cheque,57.10,00.00,"22,030.22"
28-Jul-2023,Transfer,00.00,"5,507.56","16,522.66"
28-Jul-2023,Bill,00.00,"3,304.53","13,218.13"
28-Jul-2023,NEFT,00.00,"13,218.13",00.00
28-Jul-2023,RTGS,251.59,00.00,251.59
28-Jul-2023,NEFT,58.50,00.00,310.09
28-Jul-2023,RTGS,"485,108.50",00.00,"485,418.59"
28-Jul-2023,Purchase,00.00,"97,083.72","388,334.87"
28-Jul-2023,Purchase,00.00,"77,666.97","310,667.90"
28-Jul-2023,Tax,503.60,00.00,"311,171.50"
28-Jul-2023,Reversal,"1,535.16",00.00,"312,706.66"
28-Jul-2023,Interest,"32,527.00",00.00,"345,233.66"
28-Jul-2023,Tax,00.00,"86,308.42","258,925.24"
28-Jul-2023,Reversal,00.00,"43,154.21","215,771.03"
28-Jul-2023,Bill,00.00,"107,885.52","107,885.52"
28-Jul-2023,RTGS,00.00,"13,485.69","94,399.83"
28-Jul-2023,IMPS,40.70,00.00,"94,440.53"
28-Jul-2023,Commission,"27,702.00",00.00,"122,142.53"
28-Jul-2023,IMPS,04.00,00.00,"122,146.53"
28-Jul-2023,Debit Card,00.00,"20,357.76","101,788.78"
29-Jul-2023,Commission,"9,869.20",00.00,"111,657.98"
29-Jul-2023,Commission,"16,340.30",00.00,"127,998.28"
29-Jul-2023,ATM,00.00,"31,999.57","95,998.71"
29-Jul-2023,RTGS,"218,424.25",00.00,"314,422.96"
29-Jul-2023,RTGS,"4,066.90",00.00,"318,489.86"
29-Jul-2023,NEFT,"20,753.80",00.00,"339,243.66"
29-Jul-2023,NEFT,00.00,"113,081.22","226,162.44"
29-Jul-2023,Cheque,00.00,"226,162.44",00.00
29-Jul-2023,RTGS,"1,109.00",00.00,"1,109.00"
29-Jul-2023,IMPS,00.00,123.22,985.78
29-Jul-2023,Cheque,00.00,985.78,00.00
29-Jul-2023,Commission,"1,623,326.20",00.00,"1,623,326.20"
29-Jul-2023,ATM,605.91,00.00,"1,623,932.11"
29-Jul-2023,Cheque,"77,759.47",00.00,"1,701,691.58"
30-Jul-2023,ATM,"3,759.28",00.00,"1,705,450.86"
30-Jul-2023,Cash,"985,857.00",00.00,"2,691,307.86"
30-Jul-2023,Bill,"19,356.90",00.00,"2,710,664.76"
30-Jul-2023,Debit Card,03.50,00.00,"2,710,668.26"
30-Jul-2023,RTGS,59.68,00.00,"2,710,727.94"
30-Jul-2023,Miscellaneous,00.00,"1,355,363.97","1,355,363.97"
30-Jul-2023,Miscellaneous,00.00,"1,355,363.97",00.00
30-Jul-2023,Cash,00.00,00.00,00.00
30-Jul-2023,Miscellaneous,02.25,00.00,02.25
31-Jul-2023,ATM,"2,711.00",00.00,"2,713.25"
31-Jul-2023,Debit Card,00.00,301.47,"2,411.78"
31-Jul-2023,Debit Card,00.00,344.54,"2,067.24"
31-Jul-2023,Commission,"1,832,866.50",00.00,"1,834,933.74"
31-Jul-2023,Purchase,00.00,"229,366.72","1,605,567.02"
31-Jul-2023,Cash,00.00,"200,695.88","1,404,871.14"
31-Jul-2023,Commission,00.00,"468,290.38","936,580.76"
31-Jul-2023,RTGS,"1,734,461.50",00.00,"2,671,042.26"
31-Jul-2023,Commission,00.00,"267,104.23","2,403,938.03"
31-Jul-2023,Bill,"2,882.60",00.00,"2,406,820.63"
31-Jul-2023,Cash,00.00,"343,831.52","2,062,989.11"
31-Jul-2023,Tax,00.00,"206,298.91","1,856,690.20"
31-Jul-2023,RTGS,269.24,00.00,"1,856,959.44"
31-Jul-2023,Interest,"3,394.30",00.00,"1,860,353.74"
31-Jul-2023,Cheque,00.00,"232,544.22","1,627,809.52"
31-Jul-2023,Debit Card,18.39,00.00,"1,627,827.91"
31-Jul-2023,Interest,"26,261.80",00.00,"1,654,089.71"
31-Jul-2023,Purchase,00.00,"413,522.43","1,240,567.28"
31-Jul-2023,Cash,00.00,"177,223.90","1,063,343.38"
31-Jul-2023,Cheque,00.00,"177,223.90","886,119.48"
31-Jul-2023,Cheque,00.00,"126,588.50","759,530.98"
31-Jul-2023,Miscellaneous,00.00,"84,392.33","675,138.65"
31-Jul-2023,Debit Card,00.00,"135,027.73","540,110.92"
31-Jul-2023,Purchase,00.00,"77,158.70","462,952.22"
31-Jul-2023,Commission,00.00,"462,952.22",00.00
31-Jul-2023,Interest,503.80,00.00,503.80
31-Jul-2023,Tax,"1,023.00",00.00,"1,526.80"
31-Jul-2023,Cheque,01.80,00.00,"1,528.60"
31-Jul-2023,Tax,00.00,305.72,"1,222.88"
31-Jul-2023,Tax,00.00,152.86,"1,070.02"
31-Jul-2023,IMPS,238.00,00.00,"1,308.02"
31-Jul-2023,IMPS,496.50,00.00,"1,804.52"
31-Jul-2023,Debit Card,00.00,257.79,"1,546.73"
31-Jul-2023,Cash,"420,553.00",00.00,"422,099.73"
31-Jul-2023,ATM,"9,956.20",00.00,"432,055.93"
31-Jul-2023,ATM,444.62,00.00,"432,500.55"
31-Jul-2023,Cheque,00.00,"61,785.79","370,714.76"
31-Jul-2023,Bill,00.00,"46,339.35","324,375.42"
31-Jul-2023,ATM,20.09,00.00,"324,395.51"
31-Jul-2023,Tax,"431,766.00",00.00,"756,161.51"
31-Jul-2023,Cheque,"3,383.20",00.00,"759,544.71"
31-Jul-2023,Commission,00.00,"94,943.09","664,601.62"
31-Jul-2023,Cheque,00.00,"73,844.62","590,757.00"
31-Jul-2023,Cheque,36.90,00.00,"590,793.90"
31-Jul-2023,Debit Card,02.00,00.00,"590,795.90"
31-Jul-2023,Tax,91.00,00.00,"590,886.90"
31-Jul-2023,Cash,05.00,00.00,"590,891.90"
31-Jul-2023,Commission,00.00,"84,413.13","506,478.77"
31-Jul-2023,Debit Card,00.00,"253,239.39","253,239.38"
31-Jul-2023,Bill,00.00,"31,654.92","221,584.46"
31-Jul-2023,Bill,17.80,00.00,"221,602.26"
31-Jul-2023,Tax,00.00,"27,700.28","193,901.98"
31-Jul-2023,Debit Card,00.00,"24,237.75","169,664.23"
31-Jul-2023,ATM,389.30,00.00,"170,053.53"
31-Jul-2023,Cheque,"17,041.00",00.00,"187,094.53"
01-Aug-2023,IMPS,00.00,"46,773.63","140,320.90"
01-Aug-2023,ATM,"115,142.20",00.00,"255,463.10"
02-Aug-2023,Tax,"883,435.00",00.00,"1,138,898.10"
02-Aug-2023,Bill,00.00,"1,138,898.10",00.00
02-Aug-2023,Transfer,54.87,00.00,54.87
02-Aug-2023,RTGS,00.00,18.29,36.58
03-Aug-2023,Purchase,00.00,07.32,29.26
03-Aug-2023,IMPS,00.00,29.26,00.00
03-Aug-2023,Miscellaneous,331.00,00.00,331.00
03-Aug-2023,NEFT,39.00,00.00,370.00
03-Aug-2023,Cheque,02.63,00.00,372.63
03-Aug-2023,Commission,"39,909.00",00.00,"40,281.63"
03-Aug-2023,Tax,456.27,00.00,"40,737.90"
03-Aug-2023,Reversal,00.00,"20,368.95","20,368.95"
03-Aug-2023,Purchase,00.00,"6,789.65","13,579.30"
03-Aug-2023,Commission,00.00,"1,939.90","11,639.40"
03-Aug-2023,Interest,"250,814.00",00.00,"262,453.40"
03-Aug-2023,Interest,07.65,00.00,"262,461.05"
03-Aug-2023,Debit Card,17.00,00.00,"262,478.05"
03-Aug-2023,RTGS,"1,087,210.80",00.00,"1,349,688.85"
03-Aug-2023,ATM,"29,852.60",00.00,"1,379,541.45"
03-Aug-2023,NEFT,"772,352.00",00.00,"2,151,893.45"
03-Aug-2023,Debit Card,00.00,"268,986.68","1,882,906.77"
03-Aug-2023,Debit Card,05.72,00.00,"1,882,912.49"
03-Aug-2023,Cheque,12.75,00.00,"1,882,925.24"
03-Aug-2023,Cheque,"2,073,763.20",00.00,"3,956,688.44"
03-Aug-2023,Purchase,00.00,"1,318,896.15","2,637,792.29"
03-Aug-2023,Reversal,00.00,"439,632.05","2,198,160.24"
03-Aug-2023,Bill,00.00,"732,720.08","1,465,440.16"
03-Aug-2023,Reversal,00.00,"146,544.02","1,318,896.14"
04-Aug-2023,Purchase,"2,527.20",00.00,"1,321,423.34"
04-Aug-2023,RTGS,00.00,"440,474.45","880,948.89"
04-Aug-2023,IMPS,425.50,00.00,"881,374.39"
04-Aug-2023,NEFT,00.00,"176,274.88","705,099.51"
04-Aug-2023,Debit Card,00.00,"100,728.50","604,371.01"
04-Aug-2023,Tax,47.00,00.00,"604,418.01"
04-Aug-2023,Transfer,00.00,"100,736.34","503,681.68"
04-Aug-2023,Debit Card,03.00,00.00,"503,684.68"
04-Aug-2023,NEFT,00.00,"71,954.95","431,729.73"
04-Aug-2023,Transfer,00.00,"86,345.95","345,383.78"
04-Aug-2023,RTGS,310.23,00.00,"345,694.01"
04-Aug-2023,NEFT,"13,493.70",00.00,"359,187.71"
04-Aug-2023,Miscellaneous,00.00,"35,918.77","323,268.94"
04-Aug-2023,Commission,00.00,"32,326.89","290,942.05"
04-Aug-2023,Reversal,"181,461.00",00.00,"472,403.05"
04-Aug-2023,Interest,"4,936.79",00.00,"477,339.84"
04-Aug-2023,Cheque,00.00,"238,669.92","238,669.92"
04-Aug-2023,NEFT,00.00,"238,669.92",00.00
05-Aug-2023,Cash,53.10,00.00,53.10
06-Aug-2023,Cash,"158,101.00",00.00,"158,154.10"
06-Aug-2023,Cash,"3,789.30",00.00,"161,943.40"
06-Aug-2023,Cash,00.00,"40,485.85","121,457.55"
06-Aug-2023,Commission,"186,480.00",00.00,"307,937.55"
06-Aug-2023,Bill,"1,184.00",00.00,"309,121.55"
06-Aug-2023,Reversal,00.00,"61,824.31","247,297.24"
06-Aug-2023,Transfer,00.00,"30,912.16","216,385.08"
06-Aug-2023,Purchase,00.00,"72,128.36","144,256.72"
06-Aug-2023,IMPS,00.00,"14,425.67","129,831.05"
06-Aug-2023,Cheque,00.00,"18,547.29","111,283.76"
06-Aug-2023,Commission,"3,597.10",00.00,"114,880.86"
06-Aug-2023,Interest,508.93,00.00,"115,389.79"
06-Aug-2023,Transfer,"3,628.00",00.00,"119,017.79"
06-Aug-2023,Reversal,88.95,00.00,"119,106.74"
06-Aug-2023,NEFT,04.00,00.00,"119,110.74"
06-Aug-2023,IMPS,51.00,00.00,"119,161.74"
06-Aug-2023,Commission,00.00,"13,240.19","105,921.55"
07-Aug-2023,Reversal,03.40,00.00,"105,924.95"
08-Aug-2023,Tax,00.00,"11,769.44","94,155.51"
08-Aug-2023,Reversal,"305,324.50",00.00,"399,480.01"
08-Aug-2023,IMPS,00.00,"99,870.00","299,610.01"
08-Aug-2023,Tax,00.00,"74,902.50","224,707.51"
08-Aug-2023,ATM,"1,125,985.80",00.00,"1,350,693.31"
08-Aug-2023,Tax,48.00,00.00,"1,350,741.31"
09-Aug-2023,Miscellaneous,391.81,00.00,"1,351,133.12"
09-Aug-2023,Commission,00.00,"168,891.64","1,182,241.48"
09-Aug-2023,Reversal,"1,090,389.00",00.00,"2,272,630.48"
09-Aug-2023,Bill,11.06,00.00,"2,272,641.54"
09-Aug-2023,IMPS,00.00,"757,547.18","1,515,094.36"
09-Aug-2023,Reversal,00.00,"1,515,094.36",00.00
10-Aug-2023,RTGS,02.20,00.00,02.20
10-Aug-2023,RTGS,00.00,00.37,01.83
10-Aug-2023,Transfer,00.00,00.18,01.65
10-Aug-2023,IMPS,00.00,00.28,01.38
10-Aug-2023,Bill,02.90,00.00,04.28
10-Aug-2023,Bill,"2,979.92",00.00,"2,984.20"
10-Aug-2023,Reversal,"142,278.00",00.00,"145,262.20"
10-Aug-2023,Bill,409.00,00.00,"145,671.20"
10-Aug-2023,Interest,03.30,00.00,"145,674.50"
10-Aug-2023,Debit Card,26.80,00.00,"145,701.30"
10-Aug-2023,Bill,56.53,00.00,"145,757.83"
10-Aug-2023,Miscellaneous,"169,128.00",00.00,"314,885.83"
10-Aug-2023,Debit Card,408.80,00.00,"315,294.63"
10-Aug-2023,Interest,00.00,"45,042.09","270,252.54"
10-Aug-2023,NEFT,00.00,"67,563.14","202,689.40"
10-Aug-2023,Miscellaneous,"5,920.00",00.00,"208,609.40"
10-Aug-2023,Cheque,00.00,"20,860.94","187,748.46"
10-Aug-2023,Debit Card,00.00,"187,748.46",00.00
10-Aug-2023,Bill,23.99,00.00,23.99
10-Aug-2023,Bill,00.00,04.80,19.19
10-Aug-2023,NEFT,03.00,00.00,22.19
10-Aug-2023,NEFT,00.00,05.55,16.64
10-Aug-2023,Reversal,00.00,16.64,00.00
10-Aug-2023,Cash,"288,382.00",00.00,"288,382.00"
10-Aug-2023,Tax,00.00,"28,838.20","259,543.80"
10-Aug-2023,NEFT,"1,738,335.50",00.00,"1,997,879.30"
10-Aug-2023,Transfer,00.00,"399,575.86","1,598,303.44"
10-Aug-2023,Cash,"2,461.00",00.00,"1,600,764.44"
10-Aug-2023,Interest,00.00,"266,794.07","1,333,970.37"
11-Aug-2023,Purchase,00.00,"190,567.20","1,143,403.17"
11-Aug-2023,Cash,"8,077.54",00.00,"1,151,480.71"
11-Aug-2023,Commission,00.00,"127,942.30","1,023,538.41"
11-Aug-2023,Cheque,00.00,"1,023,538.41",00.00
11-Aug-2023,Bill,"1,975,285.50",00.00,"1,975,285.50"
11-Aug-2023,ATM,00.00,"658,428.50","1,316,857.00"
11-Aug-2023,Bill,06.00,00.00,"1,316,863.00"
11-Aug-2023,Commission,"13,917.00",00.00,"1,330,780.00"
11-Aug-2023,NEFT,00.00,"166,347.50","1,164,432.50"
12-Aug-2023,Commission,56.00,00.00,"1,164,488.50"
12-Aug-2023,Transfer,00.00,"166,355.50","998,133.00"
12-Aug-2023,Cheque,00.00,"110,903.67","887,229.33"
12-Aug-2023,RTGS,"20,481.40",00.00,"907,710.73"
12-Aug-2023,Tax,00.00,"181,542.15","726,168.58"
12-Aug-2023,Miscellaneous,00.00,"72,616.86","653,551.72"
12-Aug-2023,Interest,00.00,"163,387.93","490,163.79"
12-Aug-2023,Cash,00.00,"54,462.64","435,701.15"
12-Aug-2023,IMPS,"16,917.80",00.00,"452,618.95"
12-Aug-2023,Cash,198.55,00.00,"452,817.50"
12-Aug-2023,Tax,00.00,"150,939.17","301,878.33"
13-Aug-2023,IMPS,893.32,00.00,"302,771.65"
13-Aug-2023,IMPS,00.00,"37,846.46","264,925.19"
13-Aug-2023,Debit Card,00.00,"37,846.46","227,078.73"
13-Aug-2023,NEFT,00.00,"25,230.97","201,847.76"
13-Aug-2023,Transfer,00.00,"25,230.97","176,616.79"
13-Aug-2023,Cash,96.44,00.00,"176,713.23"
13-Aug-2023,NEFT,00.00,"19,634.80","157,078.43"
13-Aug-2023,Cheque,00.00,"26,179.74","130,898.69"
13-Aug-2023,Transfer,00.00,"21,816.45","109,082.24"
13-Aug-2023,NEFT,01.00,00.00,"109,083.24"
13-Aug-2023,Cash,"40,512.10",00.00,"149,595.34"
13-Aug-2023,ATM,00.00,"18,699.42","130,895.92"
13-Aug-2023,Purchase,00.00,"43,631.97","87,263.95"
13-Aug-2023,Interest,00.00,"9,695.99","77,567.96"
13-Aug-2023,RTGS,"5,761.00",00.00,"83,328.96"
13-Aug-2023,Reversal,11.00,00.00,"83,339.96"
13-Aug-2023,Bill,"178,537.69",00.00,"261,877.65"
13-Aug-2023,Tax,"1,822,301.00",00.00,"2,084,178.65"
13-Aug-2023,Cheque,"109,318.90",00.00,"2,193,497.55"
13-Aug-2023,Commission,110.00,00.00,"2,193,607.55"
13-Aug-2023,Interest,"854,152.50",00.00,"3,047,760.05"
13-Aug-2023,ATM,00.00,"3,047,760.05",00.00
13-Aug-2023,Transfer,440.00,00.00,440.00
13-Aug-2023,Commission,"3,136.00",00.00,"3,576.00"
13-Aug-2023,IMPS,00.00,"1,192.00","2,384.00"
13-Aug-2023,NEFT,"1,985.50",00.00,"4,369.50"
13-Aug-2023,Interest,"922,861.00",00.00,"927,230.50"
13-Aug-2023,NEFT,"123,698.10",00.00,"1,050,928.60"
13-Aug-2023,Cash,296.10,00.00,"1,051,224.70"
13-Aug-2023,Debit Card,"26,533.10",00.00,"1,077,757.80"
13-Aug-2023,Transfer,04.36,00.00,"1,077,762.16"
13-Aug-2023,Commission,"1,311.80",00.00,"1,079,073.96"
13-Aug-2023,Commission,715.00,00.00,"1,079,788.96"
13-Aug-2023,Commission,00.00,"134,973.62","944,815.34"
13-Aug-2023,ATM,04.13,00.00,"944,819.47"
13-Aug-2023,Cash,00.00,"472,409.74","472,409.74"
13-Aug-2023,Commission,03.10,00.00,"472,412.84"
13-Aug-2023,Commission,284.60,00.00,"472,697.44"
13-Aug-2023,Transfer,00.00,"236,348.72","236,348.72"
13-Aug-2023,NEFT,113.00,00.00,"236,461.72"
13-Aug-2023,Interest,51.00,00.00,"236,512.72"
13-Aug-2023,Cash,00.00,"33,787.53","202,725.19"
13-Aug-2023,Tax,97.00,00.00,"202,822.19"
13-Aug-2023,Cheque,"2,094,493.00",00.00,"2,297,315.19"
14-Aug-2023,IMPS,00.00,"328,187.88","1,969,127.31"
14-Aug-2023,Cheque,07.00,00.00,"1,969,134.31"
15-Aug-2023,Interest,"1,760,548.00",00.00,"3,729,682.31"
15-Aug-2023,Bill,172.40,00.00,"3,729,854.71"
15-Aug-2023,ATM,34.71,00.00,"3,729,889.42"
15-Aug-2023,IMPS,00.00,"745,977.88","2,983,911.54"
15-Aug-2023,RTGS,02.00,00.00,"2,983,913.54"
16-Aug-2023,NEFT,00.00,"1,491,956.77","1,491,956.77"
16-Aug-2023,Bill,00.00,"248,659.46","1,243,297.31"
16-Aug-2023,Commission,00.00,"138,144.15","1,105,153.16"
16-Aug-2023,ATM,00.00,"1,105,153.16",00.00
16-Aug-2023,Bill,"31,028.84",00.00,"31,028.84"
16-Aug-2023,Purchase,00.00,"15,514.42","15,514.42"
16-Aug-2023,Debit Card,"177,107.40",00.00,"192,621.82"
16-Aug-2023,Debit Card,47.82,00.00,"192,669.64"
16-Aug-2023,Purchase,00.00,"19,266.96","173,402.68"
16-Aug-2023,Bill,00.00,"34,680.54","138,722.14"
16-Aug-2023,NEFT,00.00,"34,680.54","104,041.61"
16-Aug-2023,Bill,00.00,"20,808.32","83,233.29"
16-Aug-2023,NEFT,00.00,"9,248.14","73,985.15"
16-Aug-2023,ATM,00.00,"10,569.31","63,415.84"
16-Aug-2023,Interest,00.00,"63,415.84",00.00
16-Aug-2023,Bill,495.40,00.00,495.40
16-Aug-2023,RTGS,"246,093.84",00.00,"246,589.24"
16-Aug-2023,Cash,00.00,"27,398.80","219,190.44"
16-Aug-2023,Commission,00.00,"24,354.49","194,835.95"
16-Aug-2023,Cash,"28,220.09",00.00,"223,056.04"
16-Aug-2023,Miscellaneous,00.00,"111,528.02","111,528.02"
16-Aug-2023,Cheque,00.00,"55,764.01","55,764.01"
16-Aug-2023,ATM,"2,853.70",00.00,"58,617.71"
16-Aug-2023,Miscellaneous,00.00,"11,723.54","46,894.17"
16-Aug-2023,Miscellaneous,480.70,00.00,"47,374.87"
16-Aug-2023,Bill,318.60,00.00,"47,693.47"
16-Aug-2023,ATM,00.00,"23,846.74","23,846.74"
16-Aug-2023,IMPS,"1,212,924.00",00.00,"1,236,770.74"
16-Aug-2023,Transfer,20.90,00.00,"1,236,791.64"
16-Aug-2023,ATM,02.00,00.00,"1,236,793.64"
16-Aug-2023,Commission,389.60,00.00,"1,237,183.24"
16-Aug-2023,RTGS,"1,661.00",00.00,"1,238,844.24"
16-Aug-2023,Cheque,00.00,"1,238,844.24",00.00
16-Aug-2023,Tax,"31,140.88",00.00,"31,140.88"
16-Aug-2023,IMPS,"1,861,776.00",00.00,"1,892,916.88"
16-Aug-2023,Cash,"3,981.70",00.00,"1,896,898.58"
16-Aug-2023,NEFT,00.00,"948,449.29","948,449.29"
17-Aug-2023,Interest,05.00,00.00,"948,454.29"
17-Aug-2023,Cheque,00.00,"118,556.79","829,897.50"
17-Aug-2023,Reversal,00.00,"118,556.79","711,340.71"
17-Aug-2023,NEFT,"17,687.00",00.00,"729,027.71"
17-Aug-2023,Bill,09.68,00.00,"729,037.39"
17-Aug-2023,RTGS,02.90,00.00,"729,040.29"
17-Aug-2023,Commission,364.00,00.00,"729,404.29"
17-Aug-2023,Commission,31.20,00.00,"729,435.49"
17-Aug-2023,Cash,"1,346.00",00.00,"730,781.49"
17-Aug-2023,Miscellaneous,00.00,"121,796.92","608,984.57"
17-Aug-2023,Miscellaneous,"186,746.40",00.00,"795,730.97"
18-Aug-2023,Debit Card,00.00,"795,730.97",00.00
18-Aug-2023,Tax,"217,676.60",00.00,"217,676.60"
18-Aug-2023,Cheque,07.32,00.00,"217,683.92"
18-Aug-2023,Debit Card,"2,913.00",00.00,"220,596.92"
18-Aug-2023,Commission,04.70,00.00,"220,601.62"
18-Aug-2023,Reversal,31.30,00.00,"220,632.92"
18-Aug-2023,Cash,03.80,00.00,"220,636.72"
18-Aug-2023,Reversal,00.00,"27,579.59","193,057.13"
18-Aug-2023,Tax,00.00,"48,264.28","144,792.85"
18-Aug-2023,Cheque,"1,768,634.50",00.00,"1,913,427.35"
18-Aug-2023,Commission,"386,498.20",00.00,"2,299,925.55"
18-Aug-2023,Miscellaneous,00.00,"1,149,962.78","1,149,962.77"
19-Aug-2023,Commission,"3,618.19",00.00,"1,153,580.96"
19-Aug-2023,NEFT,00.00,"164,797.28","988,783.68"
19-Aug-2023,Reversal,"1,186,597.25",00.00,"2,175,380.93"
19-Aug-2023,Reversal,"14,071.00",00.00,"2,189,451.93"
19-Aug-2023,Reversal,"1,165,202.80",00.00,"3,354,654.73"
19-Aug-2023,Tax,00.00,"1,118,218.24","2,236,436.49"
19-Aug-2023,Bill,00.00,00.00,"2,236,436.49"
19-Aug-2023,IMPS,03.38,00.00,"2,236,439.87"
19-Aug-2023,Purchase,00.00,"2,236,439.87",00.00
19-Aug-2023,Commission,"1,013,099.50",00.00,"1,013,099.50"
19-Aug-2023,Commission,04.70,00.00,"1,013,104.20"
19-Aug-2023,Tax,00.00,"101,310.42","911,793.78"
20-Aug-2023,ATM,00.00,"91,179.38","820,614.40"
20-Aug-2023,IMPS,04.30,00.00,"820,618.70"
20-Aug-2023,Tax,00.00,"117,231.24","703,387.46"
20-Aug-2023,Purchase,"7,153.00",00.00,"710,540.46"
20-Aug-2023,Debit Card,"3,572.00",00.00,"714,112.46"
20-Aug-2023,Cheque,00.00,"714,112.46",00.00
20-Aug-2023,Cheque,57.00,00.00,57.00
20-Aug-2023,Debit Card,00.00,09.50,47.50
20-Aug-2023,NEFT,00.00,23.75,23.75
20-Aug-2023,Debit Card,"6,219.00",00.00,"6,242.75"
20-Aug-2023,Cash,00.00,"1,248.55","4,994.20"
20-Aug-2023,Miscellaneous,03.59,00.00,"4,997.79"
20-Aug-2023,Tax,00.00,"2,498.90","2,498.90"
20-Aug-2023,Commission,00.00,499.78,"1,999.12"
20-Aug-2023,Commission,"1,937.30",00.00,"3,936.42"
20-Aug-2023,NEFT,00.00,562.35,"3,374.07"
20-Aug-2023,Miscellaneous,00.00,337.41,"3,036.66"
20-Aug-2023,Tax,00.00,"3,036.66",00.00
20-Aug-2023,Tax,58.08,00.00,58.08
20-Aug-2023,Cash,"73,845.50",00.00,"73,903.58"
20-Aug-2023,Commission,00.00,"9,237.95","64,665.63"
20-Aug-2023,Debit Card,"751,789.50",00.00,"816,455.13"
20-Aug-2023,NEFT,04.90,00.00,"816,460.03"
20-Aug-2023,RTGS,00.00,"272,153.34","544,306.69"
20-Aug-2023,RTGS,00.00,"108,861.34","435,445.35"
20-Aug-2023,Cash,"11,688.00",00.00,"447,133.35"
20-Aug-2023,NEFT,30.00,00.00,"447,163.35"
20-Aug-2023,Commission,00.00,"223,581.68","223,581.68"
20-Aug-2023,ATM,33.29,00.00,"223,614.97"
20-Aug-2023,IMPS,00.00,"55,903.74","167,711.23"
20-Aug-2023,Transfer,00.00,"18,634.58","149,076.65"
21-Aug-2023,IMPS,"10,065.20",00.00,"159,141.85"
21-Aug-2023,Cheque,00.00,00.00,"159,141.85"
21-Aug-2023,Cash,00.00,"39,785.46","119,356.39"
21-Aug-2023,Cash,00.00,"11,935.64","107,420.75"
21-Aug-2023,Cash,00.00,"15,345.82","92,074.93"
21-Aug-2023,Miscellaneous,27.10,00.00,"92,102.03"
21-Aug-2023,Miscellaneous,00.00,"18,420.41","73,681.62"
21-Aug-2023,Miscellaneous,"27,234.14",00.00,"100,915.76"
21-Aug-2023,Commission,343.80,00.00,"101,259.56"
21-Aug-2023,RTGS,00.00,"101,259.56",00.00
21-Aug-2023,Commission,"2,621.50",00.00,"2,621.50"
21-Aug-2023,Bill,434.02,00.00,"3,055.52"
21-Aug-2023,Tax,07.00,00.00,"3,062.52"
21-Aug-2023,NEFT,00.00,437.50,"2,625.02"
21-Aug-2023,Tax,00.00,262.50,"2,362.52"
21-Aug-2023,Cheque,44.00,00.00,"2,406.52"
21-Aug-2023,Reversal,00.00,"1,203.26","1,203.26"
21-Aug-2023,Bill,00.00,171.89,"1,031.37"
22-Aug-2023,Miscellaneous,"252,266.50",00.00,"253,297.87"
22-Aug-2023,Purchase,13.00,00.00,"253,310.87"
22-Aug-2023,Cash,00.00,"31,663.86","221,647.01"
22-Aug-2023,Interest,"22,922.00",00.00,"244,569.01"
22-Aug-2023,Tax,107.00,00.00,"244,676.01"
22-Aug-2023,Interest,"21,081.33",00.00,"265,757.34"
22-Aug-2023,Miscellaneous,00.00,"88,585.78","177,171.56"
22-Aug-2023,Purchase,"19,263.00",00.00,"196,434.56"
22-Aug-2023,Bill,"28,953.00",00.00,"225,387.56"
22-Aug-2023,Cheque,"2,634.00",00.00,"228,021.56"
22-Aug-2023,RTGS,00.00,"25,335.73","202,685.83"
22-Aug-2023,Transfer,00.00,"67,561.94","135,123.89"
22-Aug-2023,ATM,22.00,00.00,"135,145.89"
22-Aug-2023,Purchase,00.00,"45,048.63","90,097.26"
22-Aug-2023,Bill,00.00,"15,016.21","75,081.05"
23-Aug-2023,Tax,00.00,"18,770.26","56,310.79"
23-Aug-2023,Bill,00.00,"18,770.26","37,540.53"
23-Aug-2023,Purchase,382.12,00.00,"37,922.65"
23-Aug-2023,ATM,"218,814.00",00.00,"256,736.65"
23-Aug-2023,Debit Card,00.00,"128,368.33","128,368.32"
23-Aug-2023,Commission,"13,531.00",00.00,"141,899.32"
23-Aug-2023,NEFT,00.00,"70,949.66","70,949.66"
23-Aug-2023,Interest,13.48,00.00,"70,963.14"
24-Aug-2023,Bill,00.00,"11,827.19","59,135.95"
24-Aug-2023,ATM,"1,952,620.50",00.00,"2,011,756.45"
24-Aug-2023,IMPS,00.00,"251,469.56","1,760,286.89"
24-Aug-2023,Transfer,00.00,"293,381.15","1,466,905.74"
24-Aug-2023,Cash,00.00,"183,363.22","1,283,542.52"
24-Aug-2023,NEFT,"2,245.89",00.00,"1,285,788.41"
24-Aug-2023,Cheque,04.00,00.00,"1,285,792.41"
24-Aug-2023,RTGS,00.00,"142,865.82","1,142,926.59"
24-Aug-2023,IMPS,"1,963,028.75",00.00,"3,105,955.34"
24-Aug-2023,Interest,"177,272.00",00.00,"3,283,227.34"
24-Aug-2023,Debit Card,00.00,"1,094,409.11","2,188,818.23"
24-Aug-2023,Tax,18.00,00.00,"2,188,836.23"
24-Aug-2023,IMPS,"961,959.80",00.00,"3,150,796.03"
24-Aug-2023,Bill,00.00,"315,079.60","2,835,716.43"
24-Aug-2023,Debit Card,26.62,00.00,"2,835,743.05"
24-Aug-2023,Cheque,00.00,"945,247.68","1,890,495.37"
24-Aug-2023,Reversal,38.10,00.00,"1,890,533.47"
24-Aug-2023,Miscellaneous,00.00,"270,076.21","1,620,457.26"
24-Aug-2023,Reversal,00.00,"270,076.21","1,350,381.05"
24-Aug-2023,ATM,"730,834.00",00.00,"2,081,215.05"
24-Aug-2023,Bill,"30,362.71",00.00,"2,111,577.76"
24-Aug-2023,Debit Card,00.00,"703,859.25","1,407,718.51"
24-Aug-2023,Debit Card,00.00,"234,619.75","1,173,098.76"
24-Aug-2023,ATM,194.20,00.00,"1,173,292.96"
24-Aug-2023,Interest,00.00,"130,365.88","1,042,927.08"
24-Aug-2023,Interest,70.00,00.00,"1,042,997.08"
24-Aug-2023,Commission,00.00,"130,374.64","912,622.44"
24-Aug-2023,Tax,00.00,"182,524.49","730,097.95"
24-Aug-2023,IMPS,00.00,"365,048.98","365,048.98"
24-Aug-2023,Cash,"157,761.19",00.00,"522,810.17"
24-Aug-2023,Reversal,00.00,"87,135.03","435,675.14"
24-Aug-2023,Interest,00.00,"62,239.31","373,435.83"
24-Aug-2023,Cash,"9,851.61",00.00,"383,287.44"
24-Aug-2023,ATM,"1,704,900.50",00.00,"2,088,187.94"
24-Aug-2023,Cash,00.00,"1,044,093.97","1,044,093.97"
24-Aug-2023,Interest,00.00,"208,818.79","835,275.18"
24-Aug-2023,Interest,00.00,"278,425.06","556,850.12"
24-Aug-2023,ATM,00.00,"278,425.06","278,425.06"
24-Aug-2023,Cash,"1,102,175.25",00.00,"1,380,600.31"
24-Aug-2023,Interest,00.00,"230,100.05","1,150,500.26"
24-Aug-2023,Reversal,"3,049.00",00.00,"1,153,549.26"
24-Aug-2023,Reversal,"2,091.00",00.00,"1,155,640.26"
24-Aug-2023,NEFT,29.00,00.00,"1,155,669.26"
24-Aug-2023,Cheque,00.00,"165,095.61","990,573.65"
24-Aug-2023,IMPS,"25,731.00",00.00,"1,016,304.65"
24-Aug-2023,Bill,00.00,"338,768.22","677,536.43"
24-Aug-2023,Cheque,"177,713.00",00.00,"855,249.43"
24-Aug-2023,Bill,"212,643.90",00.00,"1,067,893.33"
24-Aug-2023,NEFT,16.94,00.00,"1,067,910.27"
24-Aug-2023,NEFT,03.00,00.00,"1,067,913.27"
24-Aug-2023,Cash,"1,177,992.25",00.00,"2,245,905.52"
24-Aug-2023,Bill,00.00,"561,476.38","1,684,429.14"
24-Aug-2023,Reversal,03.10,00.00,"1,684,432.24"
24-Aug-2023,Commission,00.00,"187,159.14","1,497,273.10"
24-Aug-2023,RTGS,00.00,"249,545.52","1,247,727.58"
25-Aug-2023,Miscellaneous,00.00,"207,954.60","1,039,772.98"
25-Aug-2023,Miscellaneous,95.00,00.00,"1,039,867.98"
25-Aug-2023,RTGS,00.00,"148,552.57","891,315.41"
25-Aug-2023,Transfer,"19,669.72",00.00,"910,985.13"
25-Aug-2023,Bill,02.00,00.00,"910,987.13"
25-Aug-2023,Cash,00.00,"910,987.13",00.00
25-Aug-2023,RTGS,"1,652,066.00",00.00,"1,652,066.00"
25-Aug-2023,Cash,07.00,00.00,"1,652,073.00"
25-Aug-2023,Purchase,00.77,00.00,"1,652,073.77"
25-Aug-2023,Bill,"2,668.00",00.00,"1,654,741.77"
25-Aug-2023,Purchase,00.00,"1,654,741.77",00.00
25-Aug-2023,Purchase,08.00,00.00,08.00
25-Aug-2023,Bill,00.00,02.67,05.33
25-Aug-2023,Cheque,00.00,00.59,04.74
25-Aug-2023,IMPS,22.00,00.00,26.74
25-Aug-2023,Miscellaneous,00.00,03.82,22.92
25-Aug-2023,Purchase,00.00,02.29,20.63
25-Aug-2023,Transfer,00.00,02.58,18.05
25-Aug-2023,Miscellaneous,"782,450.00",00.00,"782,468.05"
25-Aug-2023,Tax,00.00,"260,822.68","521,645.37"
25-Aug-2023,NEFT,00.00,"86,940.90","434,704.48"
25-Aug-2023,Purchase,"14,063.37",00.00,"448,767.85"
25-Aug-2023,Cash,"2,074,126.00",00.00,"2,522,893.85"
25-Aug-2023,Cash,00.00,"1,261,446.93","1,261,446.92"
25-Aug-2023,IMPS,424.40,00.00,"1,261,871.32"
25-Aug-2023,Cash,00.00,"315,467.83","946,403.49"
25-Aug-2023,IMPS,00.00,"118,300.44","828,103.05"
25-Aug-2023,IMPS,"829,472.00",00.00,"1,657,575.05"
25-Aug-2023,Purchase,00.00,"236,796.44","1,420,778.61"
25-Aug-2023,RTGS,"92,444.00",00.00,"1,513,222.61"
25-Aug-2023,Cheque,03.64,00.00,"1,513,226.25"
25-Aug-2023,IMPS,00.00,"151,322.63","1,361,903.62"
25-Aug-2023,RTGS,00.00,"151,322.62","1,210,581.00"
25-Aug-2023,ATM,00.00,"605,290.50","605,290.50"
25-Aug-2023,Bill,"18,002.00",00.00,"623,292.50"
25-Aug-2023,Commission,00.00,"103,882.08","519,410.42"
25-Aug-2023,Interest,"22,648.00",00.00,"542,058.42"
25-Aug-2023,Miscellaneous,00.00,"77,436.92","464,621.50"
25-Aug-2023,Commission,00.00,"58,077.69","406,543.81"
25-Aug-2023,Tax,00.00,"50,817.98","355,725.83"
25-Aug-2023,Commission,"92,892.00",00.00,"448,617.83"
25-Aug-2023,Reversal,00.00,"64,088.26","384,529.57"
25-Aug-2023,Miscellaneous,178.78,00.00,"384,708.35"
25-Aug-2023,RTGS,"4,031.20",00.00,"388,739.55"
25-Aug-2023,IMPS,00.00,"48,592.44","340,147.11"
25-Aug-2023,ATM,00.00,"85,036.78","255,110.33"
25-Aug-2023,Cash,00.00,"255,110.33",00.00
25-Aug-2023,Cash,05.00,00.00,05.00
25-Aug-2023,Purchase,00.00,00.56,04.44
25-Aug-2023,RTGS,00.00,00.56,03.88
25-Aug-2023,Commission,00.00,03.88,00.00
25-Aug-2023,Transfer,"1,869.00",00.00,"1,869.00"
25-Aug-2023,Transfer,"28,047.56",00.00,"29,916.56"
25-Aug-2023,Tax,575.50,00.00,"30,492.06"
25-Aug-2023,Reversal,00.00,"3,388.01","27,104.05"
25-Aug-2023,Commission,00.00,"3,872.01","23,232.04"
25-Aug-2023,Miscellaneous,00.00,"23,232.04",00.00
25-Aug-2023,Cheque,"19,201.00",00.00,"19,201.00"
25-Aug-2023,Commission,00.00,"2,743.00","16,458.00"
26-Aug-2023,RTGS,00.00,"1,828.67","14,629.33"
26-Aug-2023,Interest,455.20,00.00,"15,084.53"
26-Aug-2023,ATM,00.00,"2,514.09","12,570.44"
26-Aug-2023,Bill,00.00,"1,396.72","11,173.72"
26-Aug-2023,Purchase,00.00,"1,862.29","9,311.43"
26-Aug-2023,Bill,00.00,"9,311.43",00.00
26-Aug-2023,Cheque,"805,992.80",00.00,"805,992.80"
26-Aug-2023,Reversal,"160,094.81",00.00,"966,087.61"
26-Aug-2023,Miscellaneous,"49,619.80",00.00,"1,015,707.41"
26-Aug-2023,Commission,"1,925.00",00.00,"1,017,632.41"
26-Aug-2023,Commission,"1,322,875.80",00.00,"2,340,508.21"
26-Aug-2023,Cheque,09.70,00.00,"2,340,517.91"
26-Aug-2023,Cash,"5,264.16",00.00,"2,345,782.07"
26-Aug-2023,Cash,"328,891.00",00.00,"2,674,673.07"
26-Aug-2023,Debit Card,"1,575,727.00",00.00,"4,250,400.07"
26-Aug-2023,ATM,00.00,"708,400.01","3,542,000.06"
26-Aug-2023,Miscellaneous,00.00,"354,200.01","3,187,800.05"
26-Aug-2023,Tax,33.00,00.00,"3,187,833.05"
26-Aug-2023,Interest,"2,102.00",00.00,"3,189,935.05"
26-Aug-2023,Cheque,"229,924.90",00.00,"3,419,859.95"
26-Aug-2023,RTGS,00.00,"3,419,859.95",00.00
26-Aug-2023,RTGS,472.00,00.00,472.00
26-Aug-2023,Cheque,"16,754.00",00.00,"17,226.00"
26-Aug-2023,Debit Card,"6,004.54",00.00,"23,230.54"
26-Aug-2023,Debit Card,51.36,00.00,"23,281.90"
27-Aug-2023,Transfer,00.00,"11,640.95","11,640.95"
27-Aug-2023,RTGS,42.80,00.00,"11,683.75"
27-Aug-2023,Tax,34.35,00.00,"11,718.10"
27-Aug-2023,Cheque,"29,465.20",00.00,"41,183.30"
27-Aug-2023,Debit Card,08.00,00.00,"41,191.30"
27-Aug-2023,Cheque,00.00,"5,148.91","36,042.39"
27-Aug-2023,RTGS,48.34,00.00,"36,090.73"
27-Aug-2023,Purchase,04.00,00.00,"36,094.73"
27-Aug-2023,Miscellaneous,00.00,"3,609.47","32,485.26"
27-Aug-2023,Commission,"3,270.00",00.00,"35,755.26"
27-Aug-2023,ATM,"1,803,988.00",00.00,"1,839,743.26"
27-Aug-2023,Interest,"204,531.25",00.00,"2,044,274.51"
27-Aug-2023,Cheque,00.00,"227,141.61","1,817,132.90"
27-Aug-2023,RTGS,00.00,"227,141.61","1,589,991.29"
27-Aug-2023,Transfer,00.00,"264,998.55","1,324,992.74"
27-Aug-2023,NEFT,00.00,"331,248.19","993,744.56"
27-Aug-2023,Purchase,00.00,"248,436.14","745,308.42"
27-Aug-2023,Interest,"1,781,395.80",00.00,"2,526,704.22"
27-Aug-2023,Cheque,00.00,"280,744.91","2,245,959.31"
27-Aug-2023,IMPS,"13,128.40",00.00,"2,259,087.71"
27-Aug-2023,Transfer,129.66,00.00,"2,259,217.37"
27-Aug-2023,Transfer,575.64,00.00,"2,259,793.01"
27-Aug-2023,Transfer,"8,148.57",00.00,"2,267,941.58"
27-Aug-2023,Commission,00.00,"323,991.65","1,943,949.93"
27-Aug-2023,IMPS,"15,330.00",00.00,"1,959,279.93"
27-Aug-2023,Purchase,00.00,"1,959,279.93",00.00
27-Aug-2023,ATM,05.40,00.00,05.40
27-Aug-2023,Transfer,"1,720,255.00",00.00,"1,720,260.40"
27-Aug-2023,Debit Card,00.00,"1,720,260.40",00.00
27-Aug-2023,RTGS,"187,218.00",00.00,"187,218.00"
27-Aug-2023,Commission,"20,669.91",00.00,"207,887.91"
27-Aug-2023,Commission,00.00,"207,887.91",00.00
27-Aug-2023,Debit Card,23.00,00.00,23.00
27-Aug-2023,Interest,00.00,02.88,20.12
27-Aug-2023,Bill,55.60,00.00,75.72
27-Aug-2023,Miscellaneous,00.00,10.82,64.90
27-Aug-2023,Commission,00.00,07.21,57.69
27-Aug-2023,Transfer,00.00,09.62,48.08
27-Aug-2023,Cheque,00.00,05.34,42.74
27-Aug-2023,NEFT,00.00,10.69,32.06
27-Aug-2023,Commission,00.00,06.41,25.65
27-Aug-2023,Transfer,06.20,00.00,31.85
27-Aug-2023,Purchase,09.80,00.00,41.65
27-Aug-2023,Interest,00.00,10.41,31.24
27-Aug-2023,Bill,00.00,03.12,28.12
27-Aug-2023,Cheque,08.00,00.00,36.12
27-Aug-2023,Commission,00.00,18.06,18.06
27-Aug-2023,Cash,"1,804,238.25",00.00,"1,804,256.31"
27-Aug-2023,Tax,00.00,"360,851.26","1,443,405.05"
27-Aug-2023,RTGS,00.67,00.00,"1,443,405.72"
27-Aug-2023,Bill,00.00,"240,567.62","1,202,838.10"
28-Aug-2023,IMPS,330.50,00.00,"1,203,168.60"
28-Aug-2023,Cash,00.00,"300,792.15","902,376.45"
28-Aug-2023,ATM,"2,318.00",00.00,"904,694.45"
28-Aug-2023,Debit Card,00.00,"226,173.61","678,520.84"
28-Aug-2023,Tax,"216,774.53",00.00,"895,295.37"
28-Aug-2023,ATM,"643,958.00",00.00,"1,539,253.37"
28-Aug-2023,IMPS,00.00,"219,893.34","1,319,360.03"
28-Aug-2023,Purchase,"312,279.50",00.00,"1,631,639.53"
28-Aug-2023,Tax,"2,655.70",00.00,"1,634,295.23"
28-Aug-2023,NEFT,"27,904.50",00.00,"1,662,199.73"
28-Aug-2023,Cash,01.00,00.00,"1,662,200.73"
28-Aug-2023,Cash,00.00,"831,100.37","831,100.36"
28-Aug-2023,Interest,00.00,"83,110.04","747,990.32"
28-Aug-2023,Cheque,00.00,"373,995.16","373,995.16"
28-Aug-2023,Debit Card,00.00,"186,997.58","186,997.58"
28-Aug-2023,Cash,00.00,"31,166.26","155,831.32"
28-Aug-2023,Debit Card,"151,087.70",00.00,"306,919.02"
28-Aug-2023,Bill,45.90,00.00,"306,964.92"
28-Aug-2023,Interest,00.00,"38,370.62","268,594.30"
28-Aug-2023,Cash,"161,173.06",00.00,"429,767.36"
28-Aug-2023,RTGS,31.00,00.00,"429,798.36"
28-Aug-2023,NEFT,150.49,00.00,"429,948.85"
28-Aug-2023,Bill,"69,031.70",00.00,"498,980.55"
28-Aug-2023,RTGS,00.00,"83,163.43","415,817.12"
28-Aug-2023,NEFT,00.00,"41,581.71","374,235.41"
28-Aug-2023,Transfer,00.00,"187,117.71","187,117.70"
28-Aug-2023,Bill,00.00,"23,389.71","163,727.99"
28-Aug-2023,Transfer,879.00,00.00,"164,606.99"
29-Aug-2023,NEFT,00.00,"41,151.75","123,455.24"
30-Aug-2023,Cheque,00.00,"20,575.87","102,879.37"
30-Aug-2023,Interest,"28,307.06",00.00,"131,186.43"
30-Aug-2023,IMPS,00.00,"13,118.64","118,067.79"
30-Aug-2023,Miscellaneous,00.00,"19,677.97","98,389.82"
30-Aug-2023,NEFT,00.00,"24,597.46","73,792.37"
30-Aug-2023,Bill,"3,183.70",00.00,"76,976.07"
30-Aug-2023,IMPS,"134,075.00",00.00,"211,051.07"
30-Aug-2023,Cash,00.00,"105,525.54","105,525.54"
30-Aug-2023,Reversal,00.00,"13,190.69","92,334.85"
30-Aug-2023,Reversal,"376,522.00",00.00,"468,856.85"
30-Aug-2023,Interest,"129,327.50",00.00,"598,184.35"
30-Aug-2023,ATM,142.00,00.00,"598,326.35"
30-Aug-2023,Bill,"43,007.12",00.00,"641,333.47"
30-Aug-2023,Interest,"2,215.40",00.00,"643,548.87"
30-Aug-2023,Reversal,00.00,"160,887.22","482,661.65"
30-Aug-2023,Bill,00.00,"160,887.22","321,774.43"
30-Aug-2023,Purchase,86.00,00.00,"321,860.43"
30-Aug-2023,RTGS,05.30,00.00,"321,865.73"
30-Aug-2023,Commission,00.00,"80,466.43","241,399.30"
30-Aug-2023,Cash,00.00,"40,233.22","201,166.08"
30-Aug-2023,IMPS,"1,852.10",00.00,"203,018.18"
30-Aug-2023,Transfer,00.00,"101,509.09","101,509.09"
30-Aug-2023,ATM,00.00,"11,278.79","90,230.30"
30-Aug-2023,Reversal,00.00,"22,557.58","67,672.73"
30-Aug-2023,Miscellaneous,495.36,00.00,"68,168.09"
30-Aug-2023,NEFT,00.00,"68,168.09",00.00
30-Aug-2023,Tax,"174,427.40",00.00,"174,427.40"
30-Aug-2023,Cheque,00.00,"21,803.43","152,623.98"
30-Aug-2023,Transfer,00.00,"50,874.66","101,749.32"
30-Aug-2023,Reversal,"31,635.00",00.00,"133,384.32"
30-Aug-2023,IMPS,199.27,00.00,"133,583.59"
30-Aug-2023,Cash,"1,286,398.25",00.00,"1,419,981.84"
30-Aug-2023,IMPS,00.00,"354,995.46","1,064,986.38"
30-Aug-2023,IMPS,"41,851.47",00.00,"1,106,837.85"
30-Aug-2023,Cheque,06.70,00.00,"1,106,844.55"
30-Aug-2023,Cheque,"23,851.50",00.00,"1,130,696.05"
30-Aug-2023,RTGS,00.00,"125,632.89","1,005,063.16"
30-Aug-2023,Miscellaneous,34.00,00.00,"1,005,097.16"
30-Aug-2023,IMPS,"1,109,548.50",00.00,"2,114,645.66"
30-Aug-2023,Tax,"134,252.53",00.00,"2,248,898.19"
30-Aug-2023,ATM,00.00,"321,271.17","1,927,627.02"
30-Aug-2023,Reversal,02.60,00.00,"1,927,629.62"
30-Aug-2023,Tax,"333,447.50",00.00,"2,261,077.12"
30-Aug-2023,RTGS,00.00,"452,215.42","1,808,861.70"
30-Aug-2023,Miscellaneous,"185,594.12",00.00,"1,994,455.82"
30-Aug-2023,Cheque,00.00,"284,922.26","1,709,533.56"
30-Aug-2023,Interest,09.00,00.00,"1,709,542.56"
30-Aug-2023,NEFT,41.00,00.00,"1,709,583.56"
30-Aug-2023,IMPS,"10,160.44",00.00,"1,719,744.00"
30-Aug-2023,RTGS,00.00,"171,974.40","1,547,769.60"
30-Aug-2023,Purchase,49.63,00.00,"1,547,819.23"
30-Aug-2023,Bill,108.00,00.00,"1,547,927.23"
30-Aug-2023,Tax,00.00,"193,490.90","1,354,436.33"
30-Aug-2023,Purchase,"120,339.34",00.00,"1,474,775.67"
30-Aug-2023,ATM,"88,491.00",00.00,"1,563,266.67"
30-Aug-2023,NEFT,"1,869,744.25",00.00,"3,433,010.92"
30-Aug-2023,Bill,00.00,"429,126.37","3,003,884.56"
30-Aug-2023,Commission,00.00,"375,485.57","2,628,398.99"
30-Aug-2023,Miscellaneous,197.76,00.00,"2,628,596.75"
30-Aug-2023,Miscellaneous,00.00,"525,719.35","2,102,877.40"
30-Aug-2023,IMPS,"1,942,205.00",00.00,"4,045,082.40"
30-Aug-2023,Purchase,951.44,00.00,"4,046,033.84"
30-Aug-2023,Purchase,29.90,00.00,"4,046,063.74"
30-Aug-2023,Interest,202.60,00.00,"4,046,266.34"
30-Aug-2023,NEFT,04.10,00.00,"4,046,270.44"
30-Aug-2023,Miscellaneous,"21,228.00",00.00,"4,067,498.44"
30-Aug-2023,RTGS,00.47,00.00,"4,067,498.91"
30-Aug-2023,RTGS,00.00,"4,067,498.91",00.00
30-Aug-2023,Interest,296.12,00.00,296.12
30-Aug-2023,Reversal,00.00,49.35,246.77
30-Aug-2023,Transfer,00.00,123.39,123.38
30-Aug-2023,NEFT,00.00,20.56,102.82
30-Aug-2023,Miscellaneous,41.66,00.00,144.48
30-Aug-2023,Debit Card,00.00,16.05,128.43
30-Aug-2023,Miscellaneous,00.00,64.22,64.22
30-Aug-2023,Debit Card,00.00,06.42,57.80
30-Aug-2023,Miscellaneous,119.00,00.00,176.80
30-Aug-2023,IMPS,16.77,00.00,193.57
31-Aug-2023,Miscellaneous,13.00,00.00,206.57
31-Aug-2023,RTGS,495.00,00.00,701.57
31-Aug-2023,Debit Card,02.21,00.00,703.78
31-Aug-2023,Miscellaneous,00.00,78.20,625.58
31-Aug-2023,IMPS,00.00,125.12,500.46
31-Aug-2023,IMPS,"1,583.14",00.00,"2,083.60"
31-Aug-2023,Cash,00.00,297.66,"1,785.94"
31-Aug-2023,Cheque,00.00,357.19,"1,428.75"
31-Aug-2023,Cheque,"3,164.80",00.00,"4,593.55"
31-Aug-2023,NEFT,285.00,00.00,"4,878.55"
31-Aug-2023,Transfer,00.00,542.06,"4,336.49"
31-Aug-2023,Transfer,"8,114.09",00.00,"12,450.58"
31-Aug-2023,Transfer,"1,707.00",00.00,"14,157.58"
31-Aug-2023,Bill,"237,853.41",00.00,"252,010.99"
31-Aug-2023,Interest,"3,987.29",00.00,"255,998.28"
31-Aug-2023,RTGS,00.00,"63,999.57","191,998.71"
31-Aug-2023,IMPS,"52,000.81",00.00,"243,999.52"
31-Aug-2023,Miscellaneous,00.00,"48,799.90","195,199.62"
31-Aug-2023,Tax,00.00,"19,519.96","175,679.66"
31-Aug-2023,Cash,00.00,"175,679.66",00.00
31-Aug-2023,Cash,87.01,00.00,87.01
31-Aug-2023,Commission,"560,657.00",00.00,"560,744.01"
31-Aug-2023,Tax,00.00,"140,186.00","420,558.01"
31-Aug-2023,ATM,321.70,00.00,"420,879.71"
31-Aug-2023,Miscellaneous,00.00,"420,879.71",00.00
31-Aug-2023,Miscellaneous,15.00,00.00,15.00
31-Aug-2023,Interest,"17,723.34",00.00,"17,738.34"
31-Aug-2023,Cash,"2,109.00",00.00,"19,847.34"
31-Aug-2023,RTGS,"29,732.90",00.00,"49,580.24"
31-Aug-2023,Miscellaneous,"1,002,935.20",00.00,"1,052,515.44"
31-Aug-2023,RTGS,00.00,"210,503.09","842,012.35"
31-Aug-2023,Debit Card,00.70,00.00,"842,013.05"
31-Aug-2023,Debit Card,00.00,"280,671.02","561,342.03"
31-Aug-2023,Reversal,00.00,"56,134.20","505,207.83"
31-Aug-2023,Commission,"214,457.50",00.00,"719,665.33"
31-Aug-2023,Purchase,26.00,00.00,"719,691.33"
31-Aug-2023,Cheque,00.88,00.00,"719,692.21"
31-Aug-2023,Cash,51.30,00.00,"719,743.51"
31-Aug-2023,IMPS,00.43,00.00,"719,743.94"
31-Aug-2023,Cash,00.00,"89,967.99","629,775.95"
31-Aug-2023,Interest,00.00,"62,977.60","566,798.36"
31-Aug-2023,Interest,00.00,"566,798.36",00.00
31-Aug-2023,Miscellaneous,"373,570.00",00.00,"373,570.00"
01-Sep-2023,Purchase,"8,262.46",00.00,"381,832.46"
01-Sep-2023,Bill,00.00,"63,638.74","318,193.72"
01-Sep-2023,Commission,06.00,00.00,"318,199.72"
01-Sep-2023,Transfer,00.00,"159,099.86","159,099.86"
01-Sep-2023,IMPS,03.96,00.00,"159,103.82"
01-Sep-2023,Bill,00.00,"39,775.96","119,327.86"
01-Sep-2023,Commission,"17,099.10",00.00,"136,426.96"
01-Sep-2023,NEFT,"606,008.00",00.00,"742,434.96"
02-Sep-2023,Cash,00.00,"247,478.32","494,956.64"
02-Sep-2023,Bill,00.00,"494,956.64",00.00
02-Sep-2023,Commission,42.70,00.00,42.70
02-Sep-2023,ATM,00.00,42.70,00.00
02-Sep-2023,Tax,03.87,00.00,03.87
02-Sep-2023,Miscellaneous,00.00,01.94,01.94
02-Sep-2023,Cash,00.00,00.24,01.70
02-Sep-2023,Cash,"2,247.00",00.00,"2,248.70"
02-Sep-2023,Cash,27.20,00.00,"2,275.90"
02-Sep-2023,Commission,00.00,"2,275.90",00.00
02-Sep-2023,Tax,07.00,00.00,07.00
02-Sep-2023,Debit Card,00.00,02.33,04.67
02-Sep-2023,NEFT,00.00,00.52,04.15
02-Sep-2023,Cheque,"337,290.50",00.00,"337,294.65"
02-Sep-2023,NEFT,00.00,"84,323.66","252,970.99"
02-Sep-2023,Transfer,"2,805.00",00.00,"255,775.99"
02-Sep-2023,Cheque,00.00,"85,258.66","170,517.33"
02-Sep-2023,Cash,"30,273.00",00.00,"200,790.33"
02-Sep-2023,Bill,00.00,"66,930.11","133,860.22"
02-Sep-2023,ATM,00.00,"22,310.04","111,550.18"
02-Sep-2023,ATM,"82,972.34",00.00,"194,522.52"
02-Sep-2023,Commission,"141,644.00",00.00,"336,166.52"
02-Sep-2023,Cash,"283,512.20",00.00,"619,678.72"
02-Sep-2023,Cheque,"145,731.20",00.00,"765,409.92"
02-Sep-2023,Debit Card,00.00,"127,568.32","637,841.60"
02-Sep-2023,RTGS,208.01,00.00,"638,049.61"
02-Sep-2023,NEFT,"25,184.00",00.00,"663,233.61"
02-Sep-2023,Reversal,00.00,"331,616.81","331,616.80"
02-Sep-2023,Miscellaneous,00.00,"165,808.40","165,808.40"
02-Sep-2023,Miscellaneous,317.90,00.00,"166,126.30"
02-Sep-2023,Transfer,00.00,"41,531.58","124,594.72"
03-Sep-2023,Commission,00.00,"31,148.68","93,446.04"
03-Sep-2023,Tax,00.00,"11,680.76","81,765.28"
03-Sep-2023,Interest,00.00,"16,353.06","65,412.22"
03-Sep-2023,IMPS,02.11,00.00,"65,414.33"
03-Sep-2023,Transfer,"5,197.90",00.00,"70,612.23"
03-Sep-2023,Cheque,00.00,"7,845.80","62,766.43"
03-Sep-2023,Interest,03.97,00.00,"62,770.40"
03-Sep-2023,Cash,"99,256.53",00.00,"162,026.93"
03-Sep-2023,Interest,00.00,"16,202.69","145,824.24"
03-Sep-2023,Reversal,00.00,"48,608.08","97,216.16"
04-Sep-2023,Miscellaneous,03.20,00.00,"97,219.36"
04-Sep-2023,Cheque,00.00,"12,152.42","85,066.94"
04-Sep-2023,Reversal,"415,537.00",00.00,"500,603.94"
04-Sep-2023,RTGS,00.00,"125,150.99","375,452.96"
04-Sep-2023,Purchase,35.60,00.00,"375,488.56"
04-Sep-2023,RTGS,00.00,"41,720.95","333,767.61"
04-Sep-2023,Purchase,"20,542.00",00.00,"354,309.61"
04-Sep-2023,NEFT,00.00,"88,577.40","265,732.21"
05-Sep-2023,Transfer,"2,499.70",00.00,"268,231.91"
05-Sep-2023,Tax,00.00,"67,057.98","201,173.93"
05-Sep-2023,Tax,00.00,"201,173.93",00.00
05-Sep-2023,IMPS,48.51,00.00,48.51
05-Sep-2023,Cheque,00.00,12.13,36.38
05-Sep-2023,Transfer,"17,992.00",00.00,"18,028.38"
06-Sep-2023,ATM,"182,558.25",00.00,"200,586.63"
07-Sep-2023,Tax,00.00,"25,073.33","175,513.30"
07-Sep-2023,Cash,00.00,"19,501.48","156,011.82"
07-Sep-2023,Interest,366.00,00.00,"156,377.82"
07-Sep-2023,Transfer,00.00,"19,547.23","136,830.59"
07-Sep-2023,Transfer,"1,171.60",00.00,"138,002.19"
07-Sep-2023,ATM,"1,702,926.00",00.00,"1,840,928.19"
07-Sep-2023,IMPS,00.00,"230,116.02","1,610,812.17"
07-Sep-2023,Transfer,"225,565.00",00.00,"1,836,377.17"
07-Sep-2023,Transfer,00.00,"306,062.86","1,530,314.31"
07-Sep-2023,Bill,573.08,00.00,"1,530,887.39"
07-Sep-2023,Debit Card,00.00,"255,147.90","1,275,739.49"
07-Sep-2023,Reversal,"1,272,147.00",00.00,"2,547,886.49"
08-Sep-2023,Cheque,"1,163,271.00",00.00,"3,711,157.49"
08-Sep-2023,Debit Card,245.00,00.00,"3,711,402.49"
08-Sep-2023,Commission,"194,060.00",00.00,"3,905,462.49"
08-Sep-2023,Cash,"77,662.00",00.00,"3,983,124.49"
08-Sep-2023,Bill,00.00,"497,890.56","3,485,233.93"
08-Sep-2023,Cash,05.00,00.00,"3,485,238.93"
08-Sep-2023,Reversal,57.20,00.00,"3,485,296.13"
08-Sep-2023,NEFT,"39,137.00",00.00,"3,524,433.13"
08-Sep-2023,Purchase,"12,717.20",00.00,"3,537,150.33"
08-Sep-2023,NEFT,15.00,00.00,"3,537,165.33"
08-Sep-2023,Debit Card,13.87,00.00,"3,537,179.20"
08-Sep-2023,Debit Card,00.00,"884,294.80","2,652,884.40"
08-Sep-2023,Miscellaneous,"251,579.97",00.00,"2,904,464.37"
08-Sep-2023,Commission,00.00,"290,446.44","2,614,017.93"
08-Sep-2023,IMPS,"4,026.32",00.00,"2,618,044.25"
08-Sep-2023,Purchase,01.00,00.00,"2,618,045.25"
08-Sep-2023,RTGS,00.00,"290,893.92","2,327,151.33"
08-Sep-2023,IMPS,00.00,"1,163,575.67","1,163,575.66"
08-Sep-2023,IMPS,"12,053.03",00.00,"1,175,628.69"
08-Sep-2023,Debit Card,00.00,"293,907.17","881,721.52"
08-Sep-2023,Commission,"1,667,301.75",00.00,"2,549,023.27"
08-Sep-2023,Debit Card,00.00,"364,146.18","2,184,877.09"
09-Sep-2023,Transfer,00.00,"546,219.27","1,638,657.82"
09-Sep-2023,IMPS,"23,831.83",00.00,"1,662,489.65"
09-Sep-2023,ATM,00.00,"554,163.22","1,108,326.43"
09-Sep-2023,Debit Card,05.30,00.00,"1,108,331.73"
09-Sep-2023,Purchase,03.00,00.00,"1,108,334.73"
09-Sep-2023,Tax,292.61,00.00,"1,108,627.34"
09-Sep-2023,Debit Card,14.40,00.00,"1,108,641.74"
09-Sep-2023,Miscellaneous,00.00,"138,580.22","970,061.52"
09-Sep-2023,Reversal,"1,504,369.25",00.00,"2,474,430.77"
09-Sep-2023,RTGS,06.31,00.00,"2,474,437.08"
09-Sep-2023,Purchase,138.00,00.00,"2,474,575.08"
09-Sep-2023,Reversal,"76,551.60",00.00,"2,551,126.68"
09-Sep-2023,ATM,"1,174,260.00",00.00,"3,725,386.68"
09-Sep-2023,ATM,"256,326.75",00.00,"3,981,713.43"
09-Sep-2023,IMPS,00.00,"796,342.69","3,185,370.74"
09-Sep-2023,Cheque,00.00,"455,052.96","2,730,317.78"
09-Sep-2023,Commission,"285,719.20",00.00,"3,016,036.98"
09-Sep-2023,Cheque,00.00,"335,115.22","2,680,921.76"
09-Sep-2023,ATM,04.80,00.00,"2,680,926.56"
09-Sep-2023,Cheque,07.00,00.00,"2,680,933.56"
09-Sep-2023,Cheque,137.24,00.00,"2,681,070.80"
09-Sep-2023,Purchase,05.89,00.00,"2,681,076.69"
09-Sep-2023,Interest,07.30,00.00,"2,681,083.99"
09-Sep-2023,Cash,38.00,00.00,"2,681,121.99"
09-Sep-2023,NEFT,06.80,00.00,"2,681,128.79"
09-Sep-2023,Purchase,"2,950.54",00.00,"2,684,079.33"
09-Sep-2023,IMPS,00.00,"671,019.83","2,013,059.50"
09-Sep-2023,NEFT,05.00,00.00,"2,013,064.50"
09-Sep-2023,Cheque,00.00,"503,266.13","1,509,798.38"
09-Sep-2023,Purchase,"69,588.20",00.00,"1,579,386.58"
09-Sep-2023,NEFT,"669,182.00",00.00,"2,248,568.58"
09-Sep-2023,Cash,"969,796.00",00.00,"3,218,364.58"
09-Sep-2023,Reversal,00.00,"804,591.15","2,413,773.44"
09-Sep-2023,RTGS,00.00,"268,197.05","2,145,576.39"
09-Sep-2023,RTGS,57.90,00.00,"2,145,634.29"
09-Sep-2023,Cash,"1,896,638.00",00.00,"4,042,272.29"
09-Sep-2023,Cash,00.00,"4,042,272.29",00.00
09-Sep-2023,RTGS,"61,011.00",00.00,"61,011.00"
09-Sep-2023,Reversal,00.00,"8,715.86","52,295.14"
09-Sep-2023,Purchase,772.00,00.00,"53,067.14"
09-Sep-2023,NEFT,"128,577.16",00.00,"181,644.30"
09-Sep-2023,Bill,00.00,"45,411.08","136,233.22"
10-Sep-2023,Cheque,"1,613,879.00",00.00,"1,750,112.22"
10-Sep-2023,Tax,00.00,"875,056.11","875,056.11"
10-Sep-2023,RTGS,00.00,"145,842.69","729,213.42"
10-Sep-2023,Reversal,04.45,00.00,"729,217.87"
10-Sep-2023,Interest,00.00,"729,217.87",00.00
10-Sep-2023,Bill,"17,392.00",00.00,"17,392.00"
10-Sep-2023,Tax,00.00,"8,696.00","8,696.00"
10-Sep-2023,ATM,"4,079.36",00.00,"12,775.36"
10-Sep-2023,Debit Card,"3,247.70",00.00,"16,023.06"
10-Sep-2023,Purchase,26.49,00.00,"16,049.55"
10-Sep-2023,Transfer,00.00,"2,006.19","14,043.36"
10-Sep-2023,RTGS,"105,920.50",00.00,"119,963.86"
10-Sep-2023,Purchase,59.70,00.00,"120,023.56"
10-Sep-2023,Tax,"105,392.69",00.00,"225,416.25"
10-Sep-2023,Cash,"1,503,189.00",00.00,"1,728,605.25"
10-Sep-2023,RTGS,00.00,"345,721.05","1,382,884.20"
10-Sep-2023,Commission,00.00,"1,382,884.20",00.00
10-Sep-2023,Bill,"2,725.90",00.00,"2,725.90"
10-Sep-2023,Transfer,00.00,908.63,"1,817.27"
10-Sep-2023,ATM,795.00,00.00,"2,612.27"
10-Sep-2023,Reversal,"205,589.75",00.00,"208,202.02"
11-Sep-2023,Transfer,00.00,"104,101.01","104,101.01"
11-Sep-2023,Miscellaneous,00.00,"14,871.57","89,229.44"
11-Sep-2023,Debit Card,00.00,"11,153.68","78,075.76"
11-Sep-2023,IMPS,00.00,"8,675.08","69,400.68"
11-Sep-2023,Commission,00.00,"17,350.17","52,050.51"
11-Sep-2023,Bill,04.00,00.00,"52,054.51"
11-Sep-2023,NEFT,00.00,"8,675.75","43,378.76"
11-Sep-2023,Reversal,00.00,"8,675.75","34,703.01"
11-Sep-2023,Debit Card,342.10,00.00,"35,045.11"
11-Sep-2023,ATM,"20,574.52",00.00,"55,619.63"
12-Sep-2023,Transfer,"56,155.38",00.00,"111,775.01"
12-Sep-2023,Purchase,413.00,00.00,"112,188.01"
12-Sep-2023,IMPS,00.00,"11,218.80","100,969.21"
12-Sep-2023,NEFT,00.00,"16,828.20","84,141.01"
12-Sep-2023,ATM,00.00,"14,023.50","70,117.51"
12-Sep-2023,Tax,00.00,"35,058.76","35,058.75"
12-Sep-2023,Reversal,00.00,"5,843.13","29,215.62"
12-Sep-2023,ATM,397.20,00.00,"29,612.82"
12-Sep-2023,ATM,"820,881.00",00.00,"850,493.82"
12-Sep-2023,ATM,00.00,"106,311.73","744,182.09"
12-Sep-2023,Purchase,"13,861.00",00.00,"758,043.09"
12-Sep-2023,Interest,02.46,00.00,"758,045.55"
12-Sep-2023,Interest,00.00,"379,022.78","379,022.78"
12-Sep-2023,Miscellaneous,06.16,00.00,"379,028.94"
12-Sep-2023,NEFT,"2,515.50",00.00,"381,544.44"
12-Sep-2023,IMPS,00.00,"95,386.11","286,158.33"
12-Sep-2023,Cheque,"141,511.00",00.00,"427,669.33"
12-Sep-2023,RTGS,00.00,"61,095.62","366,573.71"
12-Sep-2023,ATM,00.00,"40,730.41","325,843.30"
12-Sep-2023,Reversal,274.00,00.00,"326,117.30"
12-Sep-2023,Commission,56.66,00.00,"326,173.96"
12-Sep-2023,IMPS,00.00,"36,241.55","289,932.41"
12-Sep-2023,Bill,00.00,"96,644.14","193,288.27"
12-Sep-2023,Cheque,00.00,"24,161.03","169,127.24"
12-Sep-2023,ATM,"1,169.00",00.00,"170,296.24"
12-Sep-2023,Interest,00.00,"17,029.62","153,266.62"
12-Sep-2023,Debit Card,00.00,"21,895.23","131,371.39"
12-Sep-2023,Transfer,200.90,00.00,"131,572.29"
13-Sep-2023,Interest,00.00,"26,314.46","105,257.83"
13-Sep-2023,Reversal,00.00,"21,051.57","84,206.26"
13-Sep-2023,Cash,00.00,"28,068.75","56,137.51"
13-Sep-2023,IMPS,00.00,"6,237.50","49,900.01"
13-Sep-2023,RTGS,00.00,"12,475.00","37,425.01"
13-Sep-2023,Tax,00.00,"18,712.51","18,712.50"
13-Sep-2023,Purchase,"8,997.10",00.00,"27,709.60"
13-Sep-2023,Cash,00.00,"9,236.53","18,473.07"
13-Sep-2023,Reversal,"1,313,470.00",00.00,"1,331,943.07"
13-Sep-2023,Reversal,00.00,"166,492.88","1,165,450.19"
13-Sep-2023,Purchase,00.00,"1,165,450.19",00.00
13-Sep-2023,Debit Card,"2,757.40",00.00,"2,757.40"
13-Sep-2023,Transfer,00.00,344.68,"2,412.72"
13-Sep-2023,Cheque,00.00,"2,412.72",00.00
13-Sep-2023,Reversal,"1,489,818.00",00.00,"1,489,818.00"
13-Sep-2023,Miscellaneous,06.00,00.00,"1,489,824.00"
13-Sep-2023,Cheque,00.00,"186,228.00","1,303,596.00"
13-Sep-2023,Commission,713.00,00.00,"1,304,309.00"
13-Sep-2023,Miscellaneous,"1,530.10",00.00,"1,305,839.10"
13-Sep-2023,Reversal,"106,849.00",00.00,"1,412,688.10"
13-Sep-2023,Cheque,"1,513.30",00.00,"1,414,201.40"
13-Sep-2023,ATM,00.00,"157,133.49","1,257,067.91"
13-Sep-2023,Interest,00.00,"1,257,067.91",00.00
13-Sep-2023,RTGS,55.00,00.00,55.00
13-Sep-2023,ATM,00.00,55.00,00.00
13-Sep-2023,Cash,"110,249.00",00.00,"110,249.00"
13-Sep-2023,Transfer,00.00,"12,249.89","97,999.11"
13-Sep-2023,Transfer,38.00,00.00,"98,037.11"
14-Sep-2023,IMPS,754.70,00.00,"98,791.81"
14-Sep-2023,IMPS,"215,607.10",00.00,"314,398.91"
14-Sep-2023,Cheque,00.00,"52,399.82","261,999.09"
14-Sep-2023,ATM,00.00,"37,428.44","224,570.65"
14-Sep-2023,Bill,"875,808.00",00.00,"1,100,378.65"
14-Sep-2023,Interest,00.00,"220,075.73","880,302.92"
14-Sep-2023,ATM,00.00,"220,075.73","660,227.19"
14-Sep-2023,RTGS,509.68,00.00,"660,736.87"
14-Sep-2023,Tax,00.00,"110,122.81","550,614.06"
14-Sep-2023,Debit Card,00.00,"110,122.81","440,491.25"
15-Sep-2023,Cheque,00.00,"44,049.13","396,442.12"
15-Sep-2023,Bill,00.00,"79,288.42","317,153.70"
15-Sep-2023,Tax,04.90,00.00,"317,158.60"
15-Sep-2023,Cheque,"959,185.80",00.00,"1,276,344.40"
15-Sep-2023,IMPS,00.00,"425,448.13","850,896.27"
15-Sep-2023,NEFT,00.00,"121,556.61","729,339.66"
15-Sep-2023,ATM,"3,591.10",00.00,"732,930.76"
15-Sep-2023,Purchase,359.60,00.00,"733,290.36"
16-Sep-2023,Debit Card,"6,846.00",00.00,"740,136.36"
16-Sep-2023,Cash,00.00,"74,013.64","666,122.72"
16-Sep-2023,ATM,00.00,"74,013.64","592,109.08"
16-Sep-2023,Commission,07.00,00.00,"592,116.08"
16-Sep-2023,Purchase,21.72,00.00,"592,137.80"
16-Sep-2023,Interest,00.00,"74,017.23","518,120.58"
16-Sep-2023,ATM,"23,695.00",00.00,"541,815.58"
16-Sep-2023,Tax,277.00,00.00,"542,092.58"
16-Sep-2023,Miscellaneous,"3,688.39",00.00,"545,780.97"
16-Sep-2023,RTGS,00.00,"545,780.97",00.00
16-Sep-2023,Cheque,"1,165,826.00",00.00,"1,165,826.00"
16-Sep-2023,Reversal,"973,406.00",00.00,"2,139,232.00"
16-Sep-2023,Miscellaneous,"778,659.50",00.00,"2,917,891.50"
16-Sep-2023,RTGS,"223,016.40",00.00,"3,140,907.90"
16-Sep-2023,IMPS,00.00,"1,570,453.95","1,570,453.95"
16-Sep-2023,Reversal,166.74,00.00,"1,570,620.69"
16-Sep-2023,Cash,476.00,00.00,"1,571,096.69"
16-Sep-2023,Cheque,"3,467.76",00.00,"1,574,564.45"
16-Sep-2023,Tax,"796,152.00",00.00,"2,370,716.45"
16-Sep-2023,Debit Card,00.00,"1,185,358.23","1,185,358.23"
16-Sep-2023,ATM,"65,735.00",00.00,"1,251,093.23"
16-Sep-2023,IMPS,"2,972.00",00.00,"1,254,065.23"
16-Sep-2023,RTGS,"15,313.50",00.00,"1,269,378.73"
16-Sep-2023,Commission,"1,327,255.00",00.00,"2,596,633.73"
17-Sep-2023,Tax,00.00,"324,579.22","2,272,054.51"
17-Sep-2023,Bill,00.00,"284,006.81","1,988,047.70"
17-Sep-2023,IMPS,00.00,"662,682.57","1,325,365.13"
17-Sep-2023,Miscellaneous,00.00,"1,325,365.13",00.00
17-Sep-2023,Debit Card,"1,911,119.50",00.00,"1,911,119.50"
17-Sep-2023,NEFT,00.00,"477,779.88","1,433,339.62"
17-Sep-2023,Bill,00.00,"286,667.92","1,146,671.70"
18-Sep-2023,IMPS,00.00,"382,223.90","764,447.80"
18-Sep-2023,ATM,07.69,00.00,"764,455.49"
18-Sep-2023,Reversal,00.00,"152,891.10","611,564.39"
18-Sep-2023,Reversal,167.09,00.00,"611,731.48"
18-Sep-2023,Commission,00.00,"87,390.21","524,341.27"
18-Sep-2023,Tax,00.00,"58,260.14","466,081.13"
18-Sep-2023,Interest,"116,277.20",00.00,"582,358.33"
18-Sep-2023,NEFT,"256,969.90",00.00,"839,328.23"
18-Sep-2023,Tax,"11,783.00",00.00,"851,111.23"
18-Sep-2023,Bill,00.00,"283,703.74","567,407.49"
18-Sep-2023,Tax,"25,248.90",00.00,"592,656.39"
18-Sep-2023,ATM,18.05,00.00,"592,674.44"
18-Sep-2023,Cash,48.80,00.00,"592,723.24"
18-Sep-2023,ATM,00.00,"74,090.41","518,632.84"
18-Sep-2023,NEFT,00.00,"172,877.61","345,755.23"
18-Sep-2023,Miscellaneous,03.29,00.00,"345,758.52"
18-Sep-2023,Debit Card,00.00,"172,879.26","172,879.26"
19-Sep-2023,Reversal,00.00,"34,575.85","138,303.41"
19-Sep-2023,IMPS,"1,792,030.25",00.00,"1,930,333.66"
19-Sep-2023,Tax,"10,970.00",00.00,"1,941,303.66"
19-Sep-2023,Reversal,110.10,00.00,"1,941,413.76"
19-Sep-2023,ATM,00.00,"277,344.82","1,664,068.94"
19-Sep-2023,Bill,00.00,"184,896.55","1,479,172.39"
19-Sep-2023,RTGS,00.00,"147,917.24","1,331,255.15"
19-Sep-2023,IMPS,00.00,"332,813.79","998,441.36"
19-Sep-2023,Debit Card,00.00,"249,610.34","748,831.02"
19-Sep-2023,ATM,393.30,00.00,"749,224.32"
19-Sep-2023,Bill,"1,081.64",00.00,"750,305.96"
19-Sep-2023,IMPS,00.00,"250,101.99","500,203.97"
19-Sep-2023,Purchase,00.00,"62,525.50","437,678.47"
19-Sep-2023,Miscellaneous,00.00,"62,525.50","375,152.97"
19-Sep-2023,Transfer,00.00,"125,050.99","250,101.98"
19-Sep-2023,ATM,00.00,"41,683.66","208,418.32"
19-Sep-2023,Commission,00.00,"26,052.29","182,366.03"
19-Sep-2023,Cheque,00.00,"91,183.02","91,183.02"
19-Sep-2023,Reversal,00.00,"10,131.45","81,051.57"
19-Sep-2023,Cash,"613,255.75",00.00,"694,307.32"
19-Sep-2023,ATM,"130,119.69",00.00,"824,427.01"
19-Sep-2023,Bill,00.00,"412,213.51","412,213.50"
19-Sep-2023,Miscellaneous,00.00,"51,526.69","360,686.81"
19-Sep-2023,Miscellaneous,"2,950.90",00.00,"363,637.71"
19-Sep-2023,Purchase,00.00,"40,404.19","323,233.52"
19-Sep-2023,Commission,00.00,"35,914.84","287,318.68"
19-Sep-2023,IMPS,00.00,"95,772.89","191,545.79"
19-Sep-2023,Commission,00.00,"191,545.79",00.00
19-Sep-2023,RTGS,"179,082.40",00.00,"179,082.40"
19-Sep-2023,Transfer,00.00,"25,583.20","153,499.20"
20-Sep-2023,Commission,"2,128.00",00.00,"155,627.20"
20-Sep-2023,Commission,00.00,"77,813.60","77,813.60"
20-Sep-2023,NEFT,00.00,"8,645.96","69,167.64"
20-Sep-2023,Tax,"12,546.80",00.00,"81,714.44"
20-Sep-2023,IMPS,01.20,00.00,"81,715.64"
20-Sep-2023,Bill,00.00,"13,619.27","68,096.37"
20-Sep-2023,Miscellaneous,00.00,"22,698.79","45,397.58"
20-Sep-2023,ATM,00.20,00.00,"45,397.78"
20-Sep-2023,Purchase,"25,312.30",00.00,"70,710.08"
20-Sep-2023,Purchase,00.00,"23,570.03","47,140.05"
20-Sep-2023,Debit Card,00.00,"7,856.68","39,283.38"
20-Sep-2023,Debit Card,00.00,"19,641.69","19,641.69"
20-Sep-2023,NEFT,26.80,00.00,"19,668.49"
20-Sep-2023,Transfer,00.00,"2,185.39","17,483.10"
20-Sep-2023,IMPS,00.00,"3,496.62","13,986.48"
20-Sep-2023,Cheque,02.24,00.00,"13,988.72"
20-Sep-2023,Debit Card,"189,897.00",00.00,"203,885.72"
20-Sep-2023,Miscellaneous,24.00,00.00,"203,909.72"
20-Sep-2023,Bill,00.00,"29,129.96","174,779.76"
20-Sep-2023,Commission,"183,936.00",00.00,"358,715.76"
21-Sep-2023,Miscellaneous,978.00,00.00,"359,693.76"
21-Sep-2023,RTGS,00.00,"71,938.75","287,755.01"
21-Sep-2023,Commission,"25,606.00",00.00,"313,361.01"
21-Sep-2023,Transfer,00.00,"44,765.86","268,595.15"
21-Sep-2023,Cheque,"1,093.00",00.00,"269,688.15"
21-Sep-2023,ATM,04.00,00.00,"269,692.15"
21-Sep-2023,IMPS,00.00,"67,423.04","202,269.11"
21-Sep-2023,Tax,00.00,"202,269.11",00.00
21-Sep-2023,ATM,16.41,00.00,16.41
21-Sep-2023,Reversal,07.95,00.00,24.36
21-Sep-2023,Purchase,00.00,02.44,21.92
21-Sep-2023,Bill,"1,426,443.20",00.00,"1,426,465.12"
21-Sep-2023,Reversal,00.00,"356,616.28","1,069,848.84"
21-Sep-2023,Interest,07.42,00.00,"1,069,856.26"
21-Sep-2023,ATM,59.70,00.00,"1,069,915.96"
21-Sep-2023,Miscellaneous,00.00,"534,957.98","534,957.98"
21-Sep-2023,RTGS,00.00,"106,991.60","427,966.38"
21-Sep-2023,Debit Card,"1,574,699.75",00.00,"2,002,666.13"
21-Sep-2023,Debit Card,00.00,"222,518.46","1,780,147.67"
21-Sep-2023,Tax,00.81,00.00,"1,780,148.48"
21-Sep-2023,IMPS,"161,469.38",00.00,"1,941,617.86"
21-Sep-2023,Debit Card,00.00,"647,205.95","1,294,411.91"
21-Sep-2023,RTGS,00.00,"1,294,411.91",00.00
21-Sep-2023,Cheque,"2,479.90",00.00,"2,479.90"
21-Sep-2023,Cheque,"15,107.80",00.00,"17,587.70"
21-Sep-2023,Bill,"17,885.00",00.00,"35,472.70"
21-Sep-2023,Cash,"236,330.94",00.00,"271,803.64"
21-Sep-2023,NEFT,00.00,"27,180.36","244,623.28"
21-Sep-2023,Interest,00.00,"34,946.18","209,677.10"
21-Sep-2023,NEFT,"12,424.60",00.00,"222,101.70"
21-Sep-2023,RTGS,04.58,00.00,"222,106.28"
21-Sep-2023,Commission,00.00,"22,210.63","199,895.65"
21-Sep-2023,Commission,93.00,00.00,"199,988.65"
21-Sep-2023,Interest,"251,190.97",00.00,"451,179.62"
21-Sep-2023,NEFT,00.00,"90,235.92","360,943.70"
21-Sep-2023,Commission,00.00,"72,188.74","288,754.96"
21-Sep-2023,IMPS,00.00,"144,377.48","144,377.48"
21-Sep-2023,NEFT,"9,319.70",00.00,"153,697.18"
22-Sep-2023,Reversal,00.00,"25,616.20","128,080.98"
22-Sep-2023,Miscellaneous,00.00,"128,080.98",00.00
22-Sep-2023,Bill,25.00,00.00,25.00
22-Sep-2023,NEFT,00.00,03.57,21.43
22-Sep-2023,ATM,"489,219.50",00.00,"489,240.93"
22-Sep-2023,Interest,00.00,"244,620.47","244,620.46"
22-Sep-2023,Tax,00.00,"81,540.15","163,080.31"
22-Sep-2023,Bill,00.00,"40,770.08","122,310.23"
22-Sep-2023,Bill,00.00,"24,462.05","97,848.18"
22-Sep-2023,Reversal,317.00,00.00,"98,165.18"
22-Sep-2023,Interest,373.58,00.00,"98,538.76"
22-Sep-2023,NEFT,00.00,"14,076.97","84,461.79"
22-Sep-2023,Bill,00.00,"28,153.93","56,307.86"
22-Sep-2023,Miscellaneous,"25,851.14",00.00,"82,159.00"
22-Sep-2023,Interest,"8,303.00",00.00,"90,462.00"
22-Sep-2023,Commission,"155,895.00",00.00,"246,357.00"
22-Sep-2023,Reversal,"2,834.00",00.00,"249,191.00"
22-Sep-2023,Reversal,02.40,00.00,"249,193.40"
22-Sep-2023,Interest,00.00,"124,596.70","124,596.70"
22-Sep-2023,Miscellaneous,"4,673.15",00.00,"129,269.85"
22-Sep-2023,NEFT,"1,609,392.00",00.00,"1,738,661.85"
22-Sep-2023,RTGS,00.00,"434,665.46","1,303,996.39"
22-Sep-2023,Purchase,328.00,00.00,"1,304,324.39"
22-Sep-2023,Reversal,02.86,00.00,"1,304,327.25"
22-Sep-2023,Cheque,00.00,"434,775.75","869,551.50"
22-Sep-2023,Interest,"138,406.28",00.00,"1,007,957.78"
22-Sep-2023,ATM,00.00,"201,591.56","806,366.22"
22-Sep-2023,Reversal,"135,578.00",00.00,"941,944.22"
23-Sep-2023,IMPS,02.00,00.00,"941,946.22"
23-Sep-2023,Tax,910.00,00.00,"942,856.22"
23-Sep-2023,RTGS,00.00,"314,285.41","628,570.81"
23-Sep-2023,Reversal,00.00,"209,523.60","419,047.21"
23-Sep-2023,Reversal,"1,127.30",00.00,"420,174.51"
23-Sep-2023,Cash,"2,377.30",00.00,"422,551.81"
23-Sep-2023,ATM,00.00,"422,551.81",00.00
23-Sep-2023,Commission,"1,059,797.80",00.00,"1,059,797.80"
23-Sep-2023,Cheque,00.00,"264,949.45","794,848.35"
23-Sep-2023,Debit Card,00.00,"99,356.04","695,492.31"
23-Sep-2023,Debit Card,00.00,"695,492.31",00.00
23-Sep-2023,ATM,"149,064.75",00.00,"149,064.75"
23-Sep-2023,Debit Card,"1,127.00",00.00,"150,191.75"
23-Sep-2023,Debit Card,"19,370.00",00.00,"169,561.75"
23-Sep-2023,Transfer,"181,574.00",00.00,"351,135.75"
23-Sep-2023,Tax,"14,763.47",00.00,"365,899.22"
23-Sep-2023,Transfer,00.00,"182,949.61","182,949.61"
23-Sep-2023,Bill,00.00,"20,327.73","162,621.88"
23-Sep-2023,Cash,00.00,"32,524.38","130,097.50"
23-Sep-2023,RTGS,00.00,"26,019.50","104,078.00"
23-Sep-2023,Debit Card,00.00,"52,039.00","52,039.00"
23-Sep-2023,ATM,00.00,"5,203.90","46,835.10"
23-Sep-2023,Transfer,"6,842.60",00.00,"53,677.70"
23-Sep-2023,Commission,00.00,"13,419.43","40,258.27"
23-Sep-2023,Reversal,"214,400.90",00.00,"254,659.17"
23-Sep-2023,NEFT,"105,984.91",00.00,"360,644.08"
23-Sep-2023,IMPS,00.00,"40,071.56","320,572.52"
23-Sep-2023,Bill,00.00,"320,572.52",00.00
23-Sep-2023,ATM,32.97,00.00,32.97
23-Sep-2023,RTGS,00.00,10.99,21.98
23-Sep-2023,Miscellaneous,"3,260.80",00.00,"3,282.78"
23-Sep-2023,Interest,"3,660.00",00.00,"6,942.78"
23-Sep-2023,Commission,"1,822,621.50",00.00,"1,829,564.28"
23-Sep-2023,Cash,05.90,00.00,"1,829,570.18"
23-Sep-2023,NEFT,"448,391.00",00.00,"2,277,961.18"
23-Sep-2023,Interest,00.00,"1,138,980.59","1,138,980.59"
23-Sep-2023,Transfer,101.18,00.00,"1,139,081.77"
23-Sep-2023,Reversal,00.00,"227,816.35","911,265.42"
23-Sep-2023,Reversal,00.00,"101,251.71","810,013.71"
24-Sep-2023,Debit Card,"688,365.75",00.00,"1,498,379.46"
24-Sep-2023,Cheque,00.00,"1,498,379.46",00.00
24-Sep-2023,Purchase,"734,931.25",00.00,"734,931.25"
24-Sep-2023,Miscellaneous,00.00,"146,986.25","587,945.00"
24-Sep-2023,ATM,00.00,"58,794.50","529,150.50"
24-Sep-2023,Purchase,00.00,"88,191.75","440,958.75"
24-Sep-2023,Purchase,"1,471,254.00",00.00,"1,912,212.75"
24-Sep-2023,Miscellaneous,00.00,"956,106.38","956,106.38"
24-Sep-2023,Debit Card,00.00,"136,586.63","819,519.75"
24-Sep-2023,Debit Card,00.00,"273,173.25","546,346.50"
25-Sep-2023,Purchase,00.00,"546,346.50",00.00
25-Sep-2023,Cheque,"29,821.80",00.00,"29,821.80"
25-Sep-2023,Interest,49.00,00.00,"29,870.80"
25-Sep-2023,Miscellaneous,918.00,00.00,"30,788.80"
25-Sep-2023,Reversal,00.00,"7,697.20","23,091.60"
25-Sep-2023,Tax,00.00,"4,618.32","18,473.28"
25-Sep-2023,Miscellaneous,00.00,"1,847.33","16,625.95"
25-Sep-2023,Miscellaneous,00.00,"1,847.33","14,778.62"
25-Sep-2023,Purchase,00.00,"1,847.33","12,931.29"
25-Sep-2023,Commission,"3,796.60",00.00,"16,727.89"
25-Sep-2023,Debit Card,00.00,"5,575.96","11,151.93"
25-Sep-2023,Bill,00.00,"11,151.93",00.00
25-Sep-2023,Interest,479.40,00.00,479.40
25-Sep-2023,Interest,494.00,00.00,973.40
25-Sep-2023,Transfer,00.00,108.16,865.24
25-Sep-2023,IMPS,"298,741.50",00.00,"299,606.74"
25-Sep-2023,Interest,"24,287.10",00.00,"323,893.84"
25-Sep-2023,RTGS,444.00,00.00,"324,337.84"
25-Sep-2023,Bill,42.00,00.00,"324,379.84"
25-Sep-2023,Debit Card,00.00,"324,379.84",00.00
25-Sep-2023,Miscellaneous,"15,839.00",00.00,"15,839.00"
25-Sep-2023,ATM,00.00,"7,919.50","7,919.50"
25-Sep-2023,Debit Card,00.00,791.95,"7,127.55"
25-Sep-2023,Commission,00.00,"7,127.55",00.00
25-Sep-2023,Commission,38.00,00.00,38.00
25-Sep-2023,Commission,00.00,12.67,25.33
25-Sep-2023,RTGS,312.00,00.00,337.33
25-Sep-2023,Bill,06.00,00.00,343.33
25-Sep-2023,Commission,00.00,343.33,00.00
25-Sep-2023,NEFT,"1,508,320.00",00.00,"1,508,320.00"
25-Sep-2023,Cash,08.40,00.00,"1,508,328.40"
25-Sep-2023,Commission,"1,522.82",00.00,"1,509,851.22"
25-Sep-2023,RTGS,00.00,"1,509,851.22",00.00
25-Sep-2023,RTGS,27.00,00.00,27.00
25-Sep-2023,Cash,00.00,03.86,23.14
25-Sep-2023,Cheque,05.01,00.00,28.15
25-Sep-2023,Tax,"3,944.30",00.00,"3,972.45"
25-Sep-2023,Cash,00.00,662.08,"3,310.38"
25-Sep-2023,Transfer,05.70,00.00,"3,316.08"
25-Sep-2023,Cheque,00.00,663.22,"2,652.86"
25-Sep-2023,Miscellaneous,00.63,00.00,"2,653.49"
25-Sep-2023,Interest,00.00,"2,653.49",00.00
25-Sep-2023,NEFT,40.60,00.00,40.60
25-Sep-2023,Miscellaneous,"1,198,258.50",00.00,"1,198,299.10"
25-Sep-2023,ATM,00.00,"399,433.03","798,866.07"
25-Sep-2023,IMPS,363.71,00.00,"799,229.78"
25-Sep-2023,Cash,00.00,"799,229.78",00.00
25-Sep-2023,Interest,"206,538.00",00.00,"206,538.00"
25-Sep-2023,Cash,00.00,"20,653.80","185,884.20"
26-Sep-2023,Reversal,"30,797.00",00.00,"216,681.20"
26-Sep-2023,ATM,38.83,00.00,"216,720.03"
26-Sep-2023,Transfer,00.00,"30,960.00","185,760.03"
26-Sep-2023,Purchase,"648,800.00",00.00,"834,560.03"
26-Sep-2023,Cheque,00.00,"104,320.00","730,240.03"
26-Sep-2023,Purchase,"2,073,373.80",00.00,"2,803,613.83"
26-Sep-2023,Cheque,"101,476.00",00.00,"2,905,089.83"
26-Sep-2023,Purchase,00.00,"968,363.28","1,936,726.55"
26-Sep-2023,RTGS,33.00,00.00,"1,936,759.55"
26-Sep-2023,Tax,00.00,"193,675.96","1,743,083.60"
26-Sep-2023,Transfer,00.00,"435,770.90","1,307,312.70"
26-Sep-2023,Tax,00.00,"261,462.54","1,045,850.16"
26-Sep-2023,Commission,02.26,00.00,"1,045,852.42"
26-Sep-2023,ATM,21.30,00.00,"1,045,873.72"
26-Sep-2023,Tax,120.00,00.00,"1,045,993.72"
26-Sep-2023,Debit Card,05.44,00.00,"1,045,999.16"
26-Sep-2023,RTGS,00.00,"130,749.90","915,249.26"
26-Sep-2023,ATM,00.00,"915,249.26",00.00
26-Sep-2023,NEFT,490.40,00.00,490.40
26-Sep-2023,ATM,00.00,245.20,245.20
26-Sep-2023,Cheque,"62,437.75",00.00,"62,682.95"
27-Sep-2023,Commission,"10,771.00",00.00,"73,453.95"
27-Sep-2023,ATM,"1,209,360.00",00.00,"1,282,813.95"
27-Sep-2023,ATM,00.00,"427,604.65","855,209.30"
27-Sep-2023,Miscellaneous,00.00,"142,534.88","712,674.42"
27-Sep-2023,Interest,00.00,00.00,"712,674.42"
27-Sep-2023,Debit Card,00.00,"79,186.05","633,488.37"
27-Sep-2023,Interest,00.00,"63,348.84","570,139.53"
27-Sep-2023,Purchase,49.94,00.00,"570,189.47"
27-Sep-2023,Commission,00.00,"114,037.89","456,151.58"
27-Sep-2023,Commission,00.00,"76,025.26","380,126.32"
27-Sep-2023,ATM,14.00,00.00,"380,140.32"
27-Sep-2023,Debit Card,00.00,"190,070.16","190,070.16"
27-Sep-2023,Cash,00.00,"23,758.77","166,311.39"
27-Sep-2023,NEFT,"199,164.00",00.00,"365,475.39"
27-Sep-2023,NEFT,06.00,00.00,"365,481.39"
27-Sep-2023,ATM,02.60,00.00,"365,483.99"
27-Sep-2023,Transfer,00.00,"91,371.00","274,112.99"
27-Sep-2023,Tax,461.40,00.00,"274,574.39"
27-Sep-2023,Purchase,"233,883.00",00.00,"508,457.39"
27-Sep-2023,Commission,00.00,"63,557.17","444,900.22"
28-Sep-2023,Bill,278.00,00.00,"445,178.22"
28-Sep-2023,Bill,00.00,"445,178.22",00.00
28-Sep-2023,Transfer,42.00,00.00,42.00
28-Sep-2023,NEFT,04.40,00.00,46.40
28-Sep-2023,IMPS,00.00,04.64,41.76
28-Sep-2023,RTGS,"155,786.00",00.00,"155,827.76"
28-Sep-2023,ATM,00.00,"22,261.11","133,566.65"
28-Sep-2023,Interest,00.00,"22,261.11","111,305.54"
28-Sep-2023,Miscellaneous,"134,510.80",00.00,"245,816.34"
28-Sep-2023,IMPS,"14,868.20",00.00,"260,684.54"
28-Sep-2023,IMPS,00.00,"130,342.27","130,342.27"
28-Sep-2023,IMPS,00.00,"32,585.57","97,756.70"
28-Sep-2023,Debit Card,"1,205,697.75",00.00,"1,303,454.45"
28-Sep-2023,Miscellaneous,00.00,"144,828.27","1,158,626.18"
28-Sep-2023,ATM,00.00,"115,862.62","1,042,763.56"
28-Sep-2023,Transfer,00.00,"521,381.78","521,381.78"
28-Sep-2023,NEFT,00.00,"260,690.89","260,690.89"
28-Sep-2023,Commission,47.40,00.00,"260,738.29"
28-Sep-2023,Transfer,"200,581.28",00.00,"461,319.57"
28-Sep-2023,Transfer,"242,591.50",00.00,"703,911.07"
28-Sep-2023,Reversal,"150,153.00",00.00,"854,064.07"
28-Sep-2023,Debit Card,00.00,"427,032.04","427,032.04"
28-Sep-2023,Commission,00.00,"213,516.02","213,516.02"
28-Sep-2023,Cheque,00.00,"53,379.01","160,137.01"
28-Sep-2023,Commission,00.00,"20,017.13","140,119.88"
28-Sep-2023,Interest,186.00,00.00,"140,305.88"
28-Sep-2023,Miscellaneous,00.00,"28,061.18","112,244.70"
28-Sep-2023,NEFT,00.00,"16,034.96","96,209.74"
28-Sep-2023,IMPS,"21,909.00",00.00,"118,118.74"
28-Sep-2023,IMPS,00.00,"29,529.69","88,589.06"
28-Sep-2023,Tax,00.00,"9,843.23","78,745.83"
28-Sep-2023,RTGS,"3,198.50",00.00,"81,944.33"
28-Sep-2023,Miscellaneous,144.55,00.00,"82,088.88"
28-Sep-2023,Cheque,"23,686.20",00.00,"105,775.08"
28-Sep-2023,Cash,00.00,"26,443.77","79,331.31"
28-Sep-2023,RTGS,00.00,"26,443.77","52,887.54"
28-Sep-2023,RTGS,415.60,00.00,"53,303.14"
28-Sep-2023,Cheque,00.00,"17,767.71","35,535.43"
28-Sep-2023,Purchase,52.00,00.00,"35,587.43"
28-Sep-2023,Transfer,00.00,"4,448.43","31,139.00"
28-Sep-2023,NEFT,00.00,"7,784.75","23,354.25"
28-Sep-2023,Miscellaneous,00.00,"5,838.56","17,515.69"
28-Sep-2023,Interest,00.00,"1,946.19","15,569.50"
28-Sep-2023,Miscellaneous,"2,510.40",00.00,"18,079.90"
28-Sep-2023,Tax,00.00,"6,026.63","12,053.27"
28-Sep-2023,Debit Card,00.00,"12,053.27",00.00
28-Sep-2023,Purchase,"4,011.00",00.00,"4,011.00"
28-Sep-2023,Reversal,06.75,00.00,"4,017.75"
28-Sep-2023,Tax,43.10,00.00,"4,060.85"
28-Sep-2023,Interest,00.00,451.21,"3,609.64"
28-Sep-2023,Interest,00.00,721.93,"2,887.71"
28-Sep-2023,Purchase,"29,351.30",00.00,"32,239.01"
28-Sep-2023,IMPS,146.00,00.00,"32,385.01"
28-Sep-2023,Bill,04.00,00.00,"32,389.01"
28-Sep-2023,Transfer,42.00,00.00,"32,431.01"
28-Sep-2023,Cash,"358,591.00",00.00,"391,022.01"
28-Sep-2023,NEFT,"13,610.00",00.00,"404,632.01"
28-Sep-2023,ATM,00.00,"134,877.34","269,754.67"
28-Sep-2023,IMPS,"9,352.63",00.00,"279,107.30"
28-Sep-2023,Debit Card,34.00,00.00,"279,141.30"
28-Sep-2023,NEFT,49.02,00.00,"279,190.32"
28-Sep-2023,Interest,00.00,"279,190.32",00.00
28-Sep-2023,Purchase,"88,089.00",00.00,"88,089.00"
28-Sep-2023,ATM,"202,862.60",00.00,"290,951.60"
28-Sep-2023,Purchase,00.00,"32,327.96","258,623.64"
28-Sep-2023,Debit Card,00.00,"258,623.64",00.00
28-Sep-2023,Tax,02.50,00.00,02.50
28-Sep-2023,Cheque,00.00,01.25,01.25
28-Sep-2023,RTGS,04.72,00.00,05.97
28-Sep-2023,Debit Card,51.52,00.00,57.49
28-Sep-2023,Reversal,"1,674,737.25",00.00,"1,674,794.74"
28-Sep-2023,Cheque,"3,874.00",00.00,"1,678,668.74"
28-Sep-2023,Transfer,"1,285,534.80",00.00,"2,964,203.54"
29-Sep-2023,Reversal,00.00,"423,457.65","2,540,745.89"
29-Sep-2023,NEFT,"31,569.80",00.00,"2,572,315.69"
29-Sep-2023,Interest,"24,799.00",00.00,"2,597,114.69"
29-Sep-2023,ATM,08.00,00.00,"2,597,122.69"
29-Sep-2023,Purchase,510.26,00.00,"2,597,632.95"
29-Sep-2023,Cheque,00.00,"2,597,632.95",00.00
29-Sep-2023,ATM,01.84,00.00,01.84
29-Sep-2023,Bill,"122,460.60",00.00,"122,462.44"
29-Sep-2023,Tax,01.52,00.00,"122,463.96"
29-Sep-2023,Commission,"230,315.28",00.00,"352,779.24"
29-Sep-2023,Reversal,00.00,"70,555.85","282,223.39"
29-Sep-2023,Transfer,00.00,"70,555.85","211,667.54"
29-Sep-2023,Miscellaneous,"189,357.50",00.00,"401,025.04"
29-Sep-2023,Bill,00.00,"100,256.26","300,768.78"
29-Sep-2023,Reversal,03.35,00.00,"300,772.13"
29-Sep-2023,Purchase,00.00,"50,128.69","250,643.44"
29-Sep-2023,IMPS,00.00,"83,547.81","167,095.63"
29-Sep-2023,Debit Card,00.00,"16,709.56","150,386.07"
29-Sep-2023,Purchase,00.00,"21,483.72","128,902.35"
29-Sep-2023,Bill,00.00,"32,225.59","96,676.76"
29-Sep-2023,Interest,00.00,"10,741.86","85,934.90"
29-Sep-2023,Miscellaneous,00.00,"28,644.97","57,289.93"
29-Sep-2023,Interest,35.62,00.00,"57,325.55"
29-Sep-2023,Cheque,00.00,"57,325.55",00.00
29-Sep-2023,Tax,"189,127.80",00.00,"189,127.80"
29-Sep-2023,Bill,02.40,00.00,"189,130.20"
29-Sep-2023,Reversal,00.00,"189,130.20",00.00
29-Sep-2023,Transfer,"126,723.80",00.00,"126,723.80"
29-Sep-2023,Cash,00.00,"63,361.90","63,361.90"
29-Sep-2023,Reversal,00.00,"15,840.48","47,521.42"
29-Sep-2023,Tax,59.83,00.00,"47,581.25"
29-Sep-2023,Miscellaneous,00.00,"6,797.32","40,783.93"
29-Sep-2023,Reversal,00.00,"40,783.93",00.00
29-Sep-2023,Bill,"10,460.20",00.00,"10,460.20"
29-Sep-2023,IMPS,00.00,"1,743.37","8,716.83"
29-Sep-2023,RTGS,00.00,"1,452.81","7,264.02"
29-Sep-2023,Commission,"711,023.50",00.00,"718,287.52"
29-Sep-2023,Purchase,07.00,00.00,"718,294.52"
29-Sep-2023,Interest,49.80,00.00,"718,344.32"
29-Sep-2023,Miscellaneous,00.00,"239,448.11","478,896.21"
29-Sep-2023,Cash,"2,008,170.50",00.00,"2,487,066.71"
29-Sep-2023,Commission,00.00,"355,295.24","2,131,771.47"
29-Sep-2023,Commission,00.00,"532,942.87","1,598,828.60"
29-Sep-2023,Purchase,03.30,00.00,"1,598,831.90"
29-Sep-2023,Reversal,433.20,00.00,"1,599,265.10"
29-Sep-2023,NEFT,00.00,"1,599,265.10",00.00
29-Sep-2023,NEFT,"1,754,223.00",00.00,"1,754,223.00"
29-Sep-2023,NEFT,"1,594,050.75",00.00,"3,348,273.75"
29-Sep-2023,Reversal,00.00,"478,324.82","2,869,948.93"
29-Sep-2023,ATM,00.00,"1,434,974.47","1,434,974.46"
29-Sep-2023,Debit Card,"203,871.00",00.00,"1,638,845.46"
29-Sep-2023,Transfer,"7,378.34",00.00,"1,646,223.80"
29-Sep-2023,Transfer,26.00,00.00,"1,646,249.80"
29-Sep-2023,Bill,"8,767.90",00.00,"1,655,017.70"
29-Sep-2023,Miscellaneous,"6,413.00",00.00,"1,661,430.70"
29-Sep-2023,IMPS,"1,242,888.80",00.00,"2,904,319.50"
29-Sep-2023,NEFT,295.00,00.00,"2,904,614.50"
29-Sep-2023,Miscellaneous,00.00,"2,904,614.50",00.00
29-Sep-2023,Purchase,"2,472.50",00.00,"2,472.50"
29-Sep-2023,Commission,"31,896.40",00.00,"34,368.90"
29-Sep-2023,Tax,134.77,00.00,"34,503.67"
29-Sep-2023,IMPS,"1,497.00",00.00,"36,000.67"
29-Sep-2023,Purchase,"1,916.20",00.00,"37,916.87"
29-Sep-2023,Tax,02.50,00.00,"37,919.37"
29-Sep-2023,Interest,811.00,00.00,"38,730.37"
29-Sep-2023,RTGS,324.10,00.00,"39,054.47"
29-Sep-2023,Bill,"1,484,134.00",00.00,"1,523,188.47"
29-Sep-2023,NEFT,00.00,"169,243.16","1,353,945.31"
29-Sep-2023,Interest,00.00,"150,438.37","1,203,506.94"
29-Sep-2023,Tax,00.00,"300,876.74","902,630.20"
29-Sep-2023,ATM,00.00,"451,315.10","451,315.10"
29-Sep-2023,IMPS,00.00,"56,414.39","394,900.71"
29-Sep-2023,Bill,00.00,"78,980.14","315,920.57"
29-Sep-2023,Bill,37.00,00.00,"315,957.57"
30-Sep-2023,Transfer,00.00,"105,319.19","210,638.38"
30-Sep-2023,Commission,00.00,"52,659.60","157,978.78"
30-Sep-2023,ATM,30.33,00.00,"158,009.11"
30-Sep-2023,Commission,00.00,"31,601.82","126,407.29"
30-Sep-2023,IMPS,01.38,00.00,"126,408.67"
30-Sep-2023,NEFT,"242,267.34",00.00,"368,676.01"
30-Sep-2023,Tax,00.00,"92,169.00","276,507.01"
30-Sep-2023,Debit Card,00.00,"34,563.38","241,943.63"
30-Sep-2023,Interest,"176,186.20",00.00,"418,129.83"
30-Sep-2023,NEFT,00.00,"418,129.83",00.00
30-Sep-2023,IMPS,285.78,00.00,285.78
30-Sep-2023,IMPS,127.00,00.00,412.78
30-Sep-2023,Cash,"925,437.00",00.00,"925,849.78"
30-Sep-2023,Transfer,02.00,00.00,"925,851.78"
30-Sep-2023,Commission,"699,118.00",00.00,"1,624,969.78"
30-Sep-2023,IMPS,03.00,00.00,"1,624,972.78"
30-Sep-2023,Miscellaneous,00.00,"232,138.97","1,392,833.81"
30-Sep-2023,Tax,00.63,00.00,"1,392,834.44"
30-Sep-2023,Tax,00.00,"1,392,834.44",00.00
30-Sep-2023,Cheque,"116,695.20",00.00,"116,695.20"
30-Sep-2023,Cash,"618,035.00",00.00,"734,730.20"
30-Sep-2023,Debit Card,13.00,00.00,"734,743.20"
30-Sep-2023,Debit Card,"4,039.38",00.00,"738,782.58"
30-Sep-2023,Tax,335.30,00.00,"739,117.88"
30-Sep-2023,ATM,00.00,"739,117.88",00.00
30-Sep-2023,NEFT,"132,199.00",00.00,"132,199.00"
30-Sep-2023,Cheque,00.00,"33,049.75","99,149.25"
30-Sep-2023,ATM,36.30,00.00,"99,185.55"
30-Sep-2023,Cash,18.00,00.00,"99,203.55"
30-Sep-2023,Purchase,00.00,"14,171.94","85,031.61"
30-Sep-2023,Debit Card,00.00,"42,515.81","42,515.80"
30-Sep-2023,Reversal,00.00,"10,628.95","31,886.85"
30-Sep-2023,NEFT,00.00,"31,886.85",00.00
30-Sep-2023,RTGS,"26,639.00",00.00,"26,639.00"
30-Sep-2023,Bill,46.33,00.00,"26,685.33"
30-Sep-2023,Reversal,03.00,00.00,"26,688.33"
30-Sep-2023,Interest,91.00,00.00,"26,779.33"
30-Sep-2023,IMPS,06.00,00.00,"26,785.33"
30-Sep-2023,Cash,07.69,00.00,"26,793.02"
30-Sep-2023,Commission,"13,618.00",00.00,"40,411.02"
30-Sep-2023,Cheque,00.00,"40,411.02",00.00
30-Sep-2023,ATM,"23,067.09",00.00,"23,067.09"
30-Sep-2023,Cash,"38,347.50",00.00,"61,414.59"
30-Sep-2023,Commission,"237,541.00",00.00,"298,955.59"
30-Sep-2023,Transfer,00.00,"298,955.59",00.00
30-Sep-2023,Miscellaneous,"2,905.61",00.00,"2,905.61"
30-Sep-2023,Miscellaneous,00.00,363.20,"2,542.41"
30-Sep-2023,Tax,"3,556.20",00.00,"6,098.61"
30-Sep-2023,Commission,"1,747,616.00",00.00,"1,753,714.61"
30-Sep-2023,IMPS,"4,145.18",00.00,"1,757,859.79"
30-Sep-2023,ATM,00.00,"878,929.90","878,929.90"
30-Sep-2023,Commission,"102,026.20",00.00,"980,956.10"
30-Sep-2023,Debit Card,84.75,00.00,"981,040.85"
30-Sep-2023,Miscellaneous,"4,728.00",00.00,"985,768.85"
30-Sep-2023,Reversal,00.00,"492,884.43","492,884.42"
30-Sep-2023,Transfer,00.00,"246,442.21","246,442.21"
01-Oct-2023,Transfer,00.00,"82,147.40","164,294.81"
01-Oct-2023,NEFT,00.00,"54,764.94","109,529.87"
01-Oct-2023,Bill,00.00,"21,905.97","87,623.90"
01-Oct-2023,Reversal,"3,473.98",00.00,"91,097.88"
01-Oct-2023,Cheque,357.90,00.00,"91,455.78"
01-Oct-2023,IMPS,"3,597.60",00.00,"95,053.38"
01-Oct-2023,Bill,00.00,"9,505.34","85,548.04"
01-Oct-2023,Cash,00.00,"9,505.34","76,042.70"
01-Oct-2023,IMPS,00.00,"19,010.68","57,032.02"
01-Oct-2023,IMPS,"160,730.97",00.00,"217,762.99"
01-Oct-2023,Commission,02.77,00.00,"217,765.76"
01-Oct-2023,IMPS,"1,142,301.00",00.00,"1,360,066.76"
01-Oct-2023,IMPS,00.00,"194,295.25","1,165,771.51"
02-Oct-2023,Debit Card,00.00,"116,577.15","1,049,194.36"
02-Oct-2023,Commission,02.30,00.00,"1,049,196.66"
02-Oct-2023,Reversal,00.00,"104,919.67","944,276.99"
02-Oct-2023,Reversal,05.99,00.00,"944,282.98"
02-Oct-2023,RTGS,00.00,"104,920.33","839,362.65"
02-Oct-2023,Cheque,"1,128,227.50",00.00,"1,967,590.15"
03-Oct-2023,Reversal,00.00,"196,759.02","1,770,831.14"
03-Oct-2023,RTGS,"197,077.60",00.00,"1,967,908.74"
03-Oct-2023,Commission,06.00,00.00,"1,967,914.74"
03-Oct-2023,RTGS,00.00,"327,985.79","1,639,928.95"
03-Oct-2023,Bill,00.00,"327,985.79","1,311,943.16"
03-Oct-2023,Commission,63.90,00.00,"1,312,007.06"
03-Oct-2023,Bill,"3,549.70",00.00,"1,315,556.76"
03-Oct-2023,Reversal,00.00,"1,315,556.76",00.00
03-Oct-2023,ATM,485.00,00.00,485.00
03-Oct-2023,IMPS,"27,208.00",00.00,"27,693.00"
03-Oct-2023,Miscellaneous,00.00,"3,077.00","24,616.00"
03-Oct-2023,Tax,00.00,"6,154.00","18,462.00"
03-Oct-2023,Cheque,00.00,"2,051.33","16,410.67"
03-Oct-2023,Bill,"87,534.00",00.00,"103,944.67"
03-Oct-2023,Transfer,00.00,"10,394.47","93,550.20"
03-Oct-2023,Cheque,00.00,"93,550.20",00.00
03-Oct-2023,RTGS,03.40,00.00,03.40
03-Oct-2023,Transfer,00.00,00.85,02.55
03-Oct-2023,RTGS,"1,317.45",00.00,"1,320.00"
03-Oct-2023,Reversal,"998,858.50",00.00,"1,000,178.50"
03-Oct-2023,Miscellaneous,00.00,"125,022.31","875,156.19"
03-Oct-2023,Transfer,00.00,"875,156.19",00.00
03-Oct-2023,Debit Card,03.80,00.00,03.80
04-Oct-2023,Tax,"2,945.59",00.00,"2,949.39"
04-Oct-2023,Miscellaneous,00.00,421.34,"2,528.05"
04-Oct-2023,Reversal,12.50,00.00,"2,540.55"
04-Oct-2023,RTGS,00.00,635.14,"1,905.41"
04-Oct-2023,Interest,"184,992.00",00.00,"186,897.41"
04-Oct-2023,Debit Card,00.00,"18,689.74","168,207.67"
04-Oct-2023,Transfer,00.00,"33,641.53","134,566.14"
04-Oct-2023,Reversal,104.00,00.00,"134,670.14"
04-Oct-2023,Transfer,00.00,"14,963.35","119,706.79"
04-Oct-2023,ATM,"65,995.00",00.00,"185,701.79"
05-Oct-2023,RTGS,"664,197.00",00.00,"849,898.79"
05-Oct-2023,IMPS,00.00,"283,299.60","566,599.19"
05-Oct-2023,Debit Card,00.00,"94,433.20","472,165.99"
05-Oct-2023,Miscellaneous,00.00,"59,020.75","413,145.24"
05-Oct-2023,Interest,442.27,00.00,"413,587.51"
05-Oct-2023,Debit Card,00.00,"413,587.51",00.00
05-Oct-2023,Bill,"1,503.53",00.00,"1,503.53"
05-Oct-2023,Debit Card,00.00,167.06,"1,336.47"
06-Oct-2023,Commission,20.00,00.00,"1,356.47"
06-Oct-2023,Commission,00.00,678.24,678.24
06-Oct-2023,IMPS,00.00,169.56,508.68
07-Oct-2023,Interest,00.00,101.74,406.94
07-Oct-2023,Reversal,"549,062.00",00.00,"549,468.94"
07-Oct-2023,ATM,14.00,00.00,"549,482.94"
07-Oct-2023,ATM,"26,865.00",00.00,"576,347.94"
07-Oct-2023,Interest,00.00,"96,057.99","480,289.95"
07-Oct-2023,Reversal,00.00,"48,029.00","432,260.96"
07-Oct-2023,Tax,00.00,"43,226.10","389,034.86"
07-Oct-2023,Tax,"1,157,154.50",00.00,"1,546,189.36"
07-Oct-2023,ATM,"2,912.00",00.00,"1,549,101.36"
07-Oct-2023,Miscellaneous,"207,991.50",00.00,"1,757,092.86"
07-Oct-2023,Bill,01.30,00.00,"1,757,094.16"
07-Oct-2023,Miscellaneous,00.00,"219,636.77","1,537,457.39"
07-Oct-2023,IMPS,00.00,"256,242.90","1,281,214.49"
07-Oct-2023,Transfer,45.20,00.00,"1,281,259.69"
08-Oct-2023,Cheque,05.50,00.00,"1,281,265.19"
08-Oct-2023,Commission,00.00,"640,632.60","640,632.60"
09-Oct-2023,Cash,03.10,00.00,"640,635.70"
09-Oct-2023,Cheque,"28,725.00",00.00,"669,360.70"
09-Oct-2023,Cheque,00.00,"111,560.12","557,800.58"
09-Oct-2023,Transfer,00.00,"69,725.07","488,075.51"
09-Oct-2023,Purchase,03.52,00.00,"488,079.03"
09-Oct-2023,Reversal,00.00,"97,615.81","390,463.22"
09-Oct-2023,Cash,"196,400.10",00.00,"586,863.32"
09-Oct-2023,Interest,00.00,"146,715.83","440,147.49"
09-Oct-2023,Cash,00.00,"62,878.21","377,269.28"
09-Oct-2023,Cash,00.00,"188,634.64","188,634.64"
09-Oct-2023,Tax,00.00,"37,726.93","150,907.71"
10-Oct-2023,Transfer,61.00,00.00,"150,968.71"
10-Oct-2023,ATM,"237,731.16",00.00,"388,699.87"
10-Oct-2023,IMPS,00.00,"64,783.31","323,916.56"
10-Oct-2023,IMPS,00.00,"46,273.79","277,642.77"
10-Oct-2023,Purchase,03.00,00.00,"277,645.77"
10-Oct-2023,Interest,06.58,00.00,"277,652.35"
10-Oct-2023,RTGS,00.00,"39,664.62","237,987.73"
10-Oct-2023,Tax,00.00,"26,443.08","211,544.65"
10-Oct-2023,Interest,04.00,00.00,"211,548.65"
10-Oct-2023,Cash,00.00,"21,154.87","190,393.78"
10-Oct-2023,Cash,26.30,00.00,"190,420.08"
10-Oct-2023,Tax,"74,674.00",00.00,"265,094.08"
10-Oct-2023,Tax,"237,391.30",00.00,"502,485.38"
10-Oct-2023,Transfer,00.00,"71,783.63","430,701.75"
10-Oct-2023,Miscellaneous,00.00,"107,675.44","323,026.31"
10-Oct-2023,RTGS,00.00,"64,605.26","258,421.05"
10-Oct-2023,NEFT,00.00,"25,842.11","232,578.94"
11-Oct-2023,IMPS,00.00,"23,257.89","209,321.05"
11-Oct-2023,Purchase,00.00,"23,257.89","186,063.16"
11-Oct-2023,Tax,"21,677.00",00.00,"207,740.16"
11-Oct-2023,Commission,05.03,00.00,"207,745.19"
11-Oct-2023,IMPS,"3,579.45",00.00,"211,324.64"
11-Oct-2023,Reversal,00.00,"23,480.52","187,844.12"
11-Oct-2023,Miscellaneous,"23,596.60",00.00,"211,440.72"
11-Oct-2023,Commission,00.00,"21,144.07","190,296.65"
11-Oct-2023,Interest,02.40,00.00,"190,299.05"
11-Oct-2023,IMPS,00.00,"190,299.05",00.00
11-Oct-2023,Tax,08.00,00.00,08.00
11-Oct-2023,Miscellaneous,"241,492.80",00.00,"241,500.80"
11-Oct-2023,Interest,00.00,"30,187.60","211,313.20"
11-Oct-2023,RTGS,00.00,"30,187.60","181,125.60"
11-Oct-2023,Cheque,00.00,"22,640.70","158,484.90"
11-Oct-2023,Miscellaneous,00.00,"26,414.15","132,070.75"
11-Oct-2023,IMPS,51.70,00.00,"132,122.45"
11-Oct-2023,Bill,00.70,00.00,"132,123.15"
11-Oct-2023,ATM,"1,039.19",00.00,"133,162.34"
11-Oct-2023,Cheque,00.00,"133,162.34",00.00
11-Oct-2023,Interest,"2,597.00",00.00,"2,597.00"
11-Oct-2023,ATM,00.00,288.56,"2,308.44"
11-Oct-2023,Debit Card,00.00,329.78,"1,978.66"
11-Oct-2023,RTGS,00.00,197.87,"1,780.79"
11-Oct-2023,ATM,"124,491.00",00.00,"126,271.79"
11-Oct-2023,RTGS,"21,229.00",00.00,"147,500.79"
11-Oct-2023,IMPS,"3,554.00",00.00,"151,054.79"
11-Oct-2023,Interest,147.00,00.00,"151,201.79"
11-Oct-2023,Cheque,00.00,"75,600.90","75,600.90"
11-Oct-2023,Commission,04.00,00.00,"75,604.90"
11-Oct-2023,Purchase,00.00,"7,560.49","68,044.41"
11-Oct-2023,Cash,283.90,00.00,"68,328.31"
11-Oct-2023,Interest,04.50,00.00,"68,332.81"
11-Oct-2023,NEFT,00.00,"13,666.56","54,666.25"
12-Oct-2023,Cheque,21.70,00.00,"54,687.95"
12-Oct-2023,Purchase,06.00,00.00,"54,693.95"
12-Oct-2023,Tax,00.00,"27,346.98","27,346.98"
12-Oct-2023,ATM,00.00,"27,346.98",00.00
12-Oct-2023,ATM,"94,727.72",00.00,"94,727.72"
12-Oct-2023,Debit Card,02.00,00.00,"94,729.72"
12-Oct-2023,Cash,00.00,"15,788.29","78,941.43"
12-Oct-2023,Tax,41.60,00.00,"78,983.03"
12-Oct-2023,Reversal,"214,448.80",00.00,"293,431.83"
13-Oct-2023,RTGS,434.56,00.00,"293,866.39"
13-Oct-2023,Tax,00.00,"29,386.64","264,479.75"
13-Oct-2023,Interest,00.00,"132,239.88","132,239.88"
13-Oct-2023,Transfer,00.00,"16,529.99","115,709.90"
13-Oct-2023,Cheque,00.00,"12,856.66","102,853.24"
13-Oct-2023,Debit Card,00.00,"25,713.31","77,139.93"
13-Oct-2023,Cash,00.00,"15,427.99","61,711.94"
13-Oct-2023,NEFT,00.00,"8,815.99","52,895.95"
13-Oct-2023,Tax,00.00,"26,447.98","26,447.98"
13-Oct-2023,Bill,"1,371,084.00",00.00,"1,397,531.98"
13-Oct-2023,Commission,"196,137.75",00.00,"1,593,669.73"
14-Oct-2023,NEFT,"1,456.90",00.00,"1,595,126.63"
14-Oct-2023,Cheque,00.00,"199,390.83","1,395,735.80"
14-Oct-2023,Miscellaneous,00.00,"174,466.98","1,221,268.82"
14-Oct-2023,Interest,187.70,00.00,"1,221,456.52"
14-Oct-2023,NEFT,00.00,"244,291.30","977,165.22"
14-Oct-2023,Purchase,229.45,00.00,"977,394.67"
14-Oct-2023,Debit Card,06.00,00.00,"977,400.67"
14-Oct-2023,Debit Card,00.00,"97,740.07","879,660.60"
14-Oct-2023,Purchase,"163,786.00",00.00,"1,043,446.60"
14-Oct-2023,ATM,00.00,"347,815.53","695,631.07"
14-Oct-2023,Debit Card,00.00,"347,815.54","347,815.54"
14-Oct-2023,Reversal,16.40,00.00,"347,831.94"
14-Oct-2023,Transfer,04.68,00.00,"347,836.62"
14-Oct-2023,Interest,"244,352.10",00.00,"592,188.72"
14-Oct-2023,ATM,06.00,00.00,"592,194.72"
14-Oct-2023,Commission,00.00,"197,398.24","394,796.48"
14-Oct-2023,Purchase,00.00,"131,598.83","263,197.65"
14-Oct-2023,Interest,"73,403.40",00.00,"336,601.05"
14-Oct-2023,Cash,33.00,00.00,"336,634.05"
14-Oct-2023,Purchase,01.13,00.00,"336,635.18"
14-Oct-2023,Interest,00.00,"67,327.04","269,308.14"
14-Oct-2023,ATM,00.00,"26,930.81","242,377.33"
14-Oct-2023,Cheque,00.00,"26,930.81","215,446.52"
14-Oct-2023,Miscellaneous,167.50,00.00,"215,614.02"
14-Oct-2023,NEFT,00.00,"71,871.34","143,742.68"
14-Oct-2023,ATM,349.80,00.00,"144,092.48"
14-Oct-2023,Cash,00.00,"48,030.83","96,061.65"
14-Oct-2023,Purchase,"657,179.00",00.00,"753,240.65"
14-Oct-2023,NEFT,"1,101,454.75",00.00,"1,854,695.40"
14-Oct-2023,Debit Card,"12,069.56",00.00,"1,866,764.96"
14-Oct-2023,Cheque,"1,324,644.00",00.00,"3,191,408.96"
14-Oct-2023,Transfer,00.00,"3,191,408.96",00.00
14-Oct-2023,Transfer,"173,148.22",00.00,"173,148.22"
14-Oct-2023,Cash,05.81,00.00,"173,154.03"
14-Oct-2023,IMPS,307.00,00.00,"173,461.03"
14-Oct-2023,Miscellaneous,00.00,"43,365.26","130,095.77"
14-Oct-2023,IMPS,00.00,"16,261.97","113,833.80"
14-Oct-2023,Reversal,00.00,"56,916.90","56,916.90"
14-Oct-2023,Miscellaneous,"5,773.00",00.00,"62,689.90"
14-Oct-2023,Reversal,"139,491.50",00.00,"202,181.40"
14-Oct-2023,ATM,00.00,"202,181.40",00.00
14-Oct-2023,IMPS,"29,204.50",00.00,"29,204.50"
14-Oct-2023,RTGS,33.00,00.00,"29,237.50"
14-Oct-2023,Debit Card,00.00,"2,923.75","26,313.75"
14-Oct-2023,Debit Card,00.00,"26,313.75",00.00
14-Oct-2023,Debit Card,02.50,00.00,02.50
14-Oct-2023,Interest,02.71,00.00,05.21
14-Oct-2023,IMPS,00.00,01.74,03.47
14-Oct-2023,Interest,00.00,01.74,01.74
14-Oct-2023,Cash,464.50,00.00,466.24
14-Oct-2023,Cash,00.00,93.25,372.99
14-Oct-2023,Interest,"62,391.62",00.00,"62,764.61"
14-Oct-2023,Debit Card,"27,847.51",00.00,"90,612.12"
14-Oct-2023,Commission,00.00,"9,061.21","81,550.91"
14-Oct-2023,Purchase,"67,475.00",00.00,"149,025.91"
14-Oct-2023,Commission,00.00,"14,902.59","134,123.32"
14-Oct-2023,Purchase,00.00,"14,902.59","119,220.73"
14-Oct-2023,Cheque,00.00,"14,902.59","104,318.14"
14-Oct-2023,Miscellaneous,00.00,"52,159.07","52,159.07"
14-Oct-2023,Tax,00.00,"10,431.81","41,727.26"
14-Oct-2023,Reversal,"2,929.00",00.00,"44,656.26"
14-Oct-2023,Debit Card,"2,296.76",00.00,"46,953.02"
14-Oct-2023,Commission,"1,300.49",00.00,"48,253.51"
14-Oct-2023,Tax,"1,751.00",00.00,"50,004.51"
14-Oct-2023,Reversal,00.00,"12,501.13","37,503.38"
14-Oct-2023,Debit Card,00.00,"5,357.63","32,145.75"
14-Oct-2023,Debit Card,05.90,00.00,"32,151.65"
14-Oct-2023,Reversal,00.00,"10,717.22","21,434.43"
14-Oct-2023,ATM,00.00,"4,286.89","17,147.54"
14-Oct-2023,RTGS,425.90,00.00,"17,573.44"
14-Oct-2023,NEFT,639.90,00.00,"18,213.34"
14-Oct-2023,Bill,"1,897,460.00",00.00,"1,915,673.34"
14-Oct-2023,IMPS,00.00,"957,836.67","957,836.67"
14-Oct-2023,Bill,"3,858.00",00.00,"961,694.67"
14-Oct-2023,Cash,00.00,"240,423.67","721,271.00"
14-Oct-2023,Commission,00.00,"180,317.75","540,953.25"
14-Oct-2023,IMPS,78.00,00.00,"541,031.25"
14-Oct-2023,RTGS,"170,134.10",00.00,"711,165.35"
14-Oct-2023,Miscellaneous,00.00,"101,595.05","609,570.30"
14-Oct-2023,Tax,00.00,"76,196.29","533,374.01"
14-Oct-2023,Purchase,00.00,"59,263.78","474,110.23"
14-Oct-2023,Reversal,"27,650.18",00.00,"501,760.41"
14-Oct-2023,ATM,00.00,"83,626.74","418,133.68"
14-Oct-2023,Cheque,00.00,"59,733.38","358,400.30"
14-Oct-2023,Tax,00.00,"179,200.15","179,200.15"
14-Oct-2023,Cheque,00.00,"29,866.69","149,333.46"
14-Oct-2023,Reversal,61.85,00.00,"149,395.31"
14-Oct-2023,Debit Card,06.00,00.00,"149,401.31"
14-Oct-2023,Bill,"113,825.47",00.00,"263,226.78"
14-Oct-2023,Cash,"215,908.00",00.00,"479,134.78"
14-Oct-2023,Cash,00.00,"479,134.78",00.00
14-Oct-2023,Purchase,"23,403.20",00.00,"23,403.20"
14-Oct-2023,Commission,00.00,"2,340.32","21,062.88"
14-Oct-2023,RTGS,"1,704.90",00.00,"22,767.78"
14-Oct-2023,Bill,30.00,00.00,"22,797.78"
14-Oct-2023,IMPS,00.00,"2,849.72","19,948.06"
14-Oct-2023,Commission,"335,121.75",00.00,"355,069.81"
14-Oct-2023,Transfer,00.00,"118,356.60","236,713.21"
14-Oct-2023,Debit Card,"3,808.36",00.00,"240,521.57"
14-Oct-2023,NEFT,00.00,"24,052.16","216,469.41"
14-Oct-2023,Tax,"1,782.00",00.00,"218,251.41"
14-Oct-2023,Cheque,00.00,"218,251.41",00.00
14-Oct-2023,Reversal,"3,202.00",00.00,"3,202.00"
14-Oct-2023,Debit Card,06.82,00.00,"3,208.82"
14-Oct-2023,Bill,03.50,00.00,"3,212.32"
14-Oct-2023,Interest,00.00,401.54,"2,810.78"
14-Oct-2023,Bill,"13,675.00",00.00,"16,485.78"
14-Oct-2023,Tax,00.00,"16,485.78",00.00
14-Oct-2023,IMPS,"2,773.90",00.00,"2,773.90"
14-Oct-2023,RTGS,00.00,346.74,"2,427.16"
14-Oct-2023,Purchase,00.00,269.68,"2,157.48"
14-Oct-2023,Purchase,36.10,00.00,"2,193.58"
14-Oct-2023,Interest,00.00,219.36,"1,974.22"
14-Oct-2023,Reversal,06.72,00.00,"1,980.94"
14-Oct-2023,Purchase,"61,315.00",00.00,"63,295.94"
14-Oct-2023,NEFT,00.00,"21,098.65","42,197.29"
14-Oct-2023,ATM,"2,080,272.80",00.00,"2,122,470.09"
14-Oct-2023,Interest,00.00,"353,745.02","1,768,725.08"
14-Oct-2023,Reversal,00.00,"252,675.01","1,516,050.07"
14-Oct-2023,Bill,00.00,"252,675.01","1,263,375.06"
14-Oct-2023,NEFT,365.00,00.00,"1,263,740.06"
14-Oct-2023,Miscellaneous,00.00,"180,534.29","1,083,205.77"
14-Oct-2023,Bill,34.00,00.00,"1,083,239.77"
14-Oct-2023,Transfer,"191,508.00",00.00,"1,274,747.77"
14-Oct-2023,Transfer,00.00,"127,474.78","1,147,272.99"
14-Oct-2023,Reversal,"1,485.00",00.00,"1,148,757.99"
14-Oct-2023,NEFT,00.00,"127,639.78","1,021,118.21"
14-Oct-2023,Miscellaneous,05.26,00.00,"1,021,123.47"
14-Oct-2023,RTGS,06.83,00.00,"1,021,130.30"
14-Oct-2023,Commission,02.80,00.00,"1,021,133.10"
14-Oct-2023,Transfer,59.06,00.00,"1,021,192.16"
14-Oct-2023,Reversal,00.00,"1,021,192.16",00.00
14-Oct-2023,RTGS,"12,648.40",00.00,"12,648.40"
14-Oct-2023,Cash,00.00,"1,405.38","11,243.02"
14-Oct-2023,RTGS,00.00,"1,249.22","9,993.80"
14-Oct-2023,NEFT,00.00,"4,996.90","4,996.90"
15-Oct-2023,Commission,06.78,00.00,"5,003.68"
15-Oct-2023,Cash,00.00,"1,000.74","4,002.94"
15-Oct-2023,Transfer,"1,958.00",00.00,"5,960.94"
15-Oct-2023,IMPS,00.00,"5,960.94",00.00
15-Oct-2023,Commission,"1,490.00",00.00,"1,490.00"
15-Oct-2023,Transfer,00.00,496.67,993.33
15-Oct-2023,IMPS,00.00,165.56,827.78
15-Oct-2023,Purchase,00.00,206.95,620.84
15-Oct-2023,Cheque,00.00,155.21,465.63
15-Oct-2023,Debit Card,00.00,66.52,399.11
15-Oct-2023,Debit Card,00.00,49.89,349.22
15-Oct-2023,Transfer,00.00,49.89,299.33
16-Oct-2023,RTGS,00.00,99.78,199.55
16-Oct-2023,RTGS,403.00,00.00,602.55
16-Oct-2023,ATM,00.00,301.28,301.27
16-Oct-2023,Cheque,"32,556.00",00.00,"32,857.27"
16-Oct-2023,ATM,"114,023.50",00.00,"146,880.77"
16-Oct-2023,RTGS,00.00,"14,688.08","132,192.69"
16-Oct-2023,IMPS,00.00,"33,048.17","99,144.52"
16-Oct-2023,Tax,00.00,"33,048.17","66,096.35"
16-Oct-2023,Transfer,"2,055.50",00.00,"68,151.85"
16-Oct-2023,Debit Card,00.00,"34,075.93","34,075.93"
16-Oct-2023,RTGS,00.99,00.00,"34,076.92"
16-Oct-2023,ATM,00.00,"3,407.69","30,669.23"
16-Oct-2023,Bill,01.00,00.00,"30,670.23"
16-Oct-2023,NEFT,300.43,00.00,"30,970.66"
17-Oct-2023,Purchase,00.00,"6,194.13","24,776.53"
17-Oct-2023,RTGS,00.00,"4,955.31","19,821.22"
17-Oct-2023,IMPS,00.00,"19,821.22",00.00
17-Oct-2023,NEFT,717.44,00.00,717.44
17-Oct-2023,Commission,"254,133.30",00.00,"254,850.74"
17-Oct-2023,Interest,00.00,"50,970.15","203,880.59"
18-Oct-2023,Tax,00.00,"203,880.59",00.00
18-Oct-2023,RTGS,"62,077.50",00.00,"62,077.50"
18-Oct-2023,ATM,00.00,"20,692.50","41,385.00"
18-Oct-2023,Interest,00.00,"4,598.33","36,786.67"
18-Oct-2023,Bill,00.00,"3,678.67","33,108.00"
18-Oct-2023,Tax,495.60,00.00,"33,603.60"
18-Oct-2023,Debit Card,"1,303,824.25",00.00,"1,337,427.85"
18-Oct-2023,Bill,00.00,"148,603.09","1,188,824.76"
18-Oct-2023,ATM,00.00,"132,091.64","1,056,733.12"
18-Oct-2023,RTGS,00.00,"1,056,733.12",00.00
18-Oct-2023,Commission,"80,342.00",00.00,"80,342.00"
18-Oct-2023,Debit Card,00.00,"11,477.43","68,864.57"
18-Oct-2023,Debit Card,00.00,"11,477.43","57,387.14"
18-Oct-2023,Debit Card,00.00,"6,376.35","51,010.79"
18-Oct-2023,Interest,111.00,00.00,"51,121.79"
18-Oct-2023,Debit Card,"3,730.00",00.00,"54,851.79"
18-Oct-2023,ATM,"91,466.47",00.00,"146,318.26"
18-Oct-2023,Commission,"1,074,474.00",00.00,"1,220,792.26"
18-Oct-2023,ATM,00.00,"305,198.07","915,594.20"
18-Oct-2023,Cash,01.20,00.00,"915,595.40"
18-Oct-2023,Tax,00.00,"228,898.85","686,696.55"
18-Oct-2023,Miscellaneous,270.18,00.00,"686,966.73"
18-Oct-2023,Transfer,"295,772.25",00.00,"982,738.98"
18-Oct-2023,Interest,224.65,00.00,"982,963.63"
18-Oct-2023,Miscellaneous,"28,929.40",00.00,"1,011,893.03"
18-Oct-2023,Debit Card,390.77,00.00,"1,012,283.80"
18-Oct-2023,RTGS,00.00,"253,070.95","759,212.85"
18-Oct-2023,Commission,"3,233.02",00.00,"762,445.87"
18-Oct-2023,Cheque,01.67,00.00,"762,447.54"
18-Oct-2023,Cash,"198,055.00",00.00,"960,502.54"
18-Oct-2023,Bill,"1,033.04",00.00,"961,535.58"
18-Oct-2023,ATM,41.40,00.00,"961,576.98"
18-Oct-2023,Transfer,06.90,00.00,"961,583.88"
18-Oct-2023,Tax,00.00,"320,527.96","641,055.92"
18-Oct-2023,Transfer,00.00,"106,842.65","534,213.27"
18-Oct-2023,Purchase,00.00,"106,842.65","427,370.62"
18-Oct-2023,Cash,14.09,00.00,"427,384.71"
18-Oct-2023,NEFT,"1,410,576.50",00.00,"1,837,961.21"
18-Oct-2023,Bill,00.00,"229,745.15","1,608,216.06"
18-Oct-2023,RTGS,61.10,00.00,"1,608,277.16"
18-Oct-2023,Transfer,"258,685.00",00.00,"1,866,962.16"
18-Oct-2023,Bill,00.00,"266,708.88","1,600,253.28"
18-Oct-2023,NEFT,"1,227,339.20",00.00,"2,827,592.48"
18-Oct-2023,NEFT,00.00,"2,827,592.48",00.00
18-Oct-2023,Cheque,44.50,00.00,44.50
18-Oct-2023,RTGS,00.00,06.36,38.14
18-Oct-2023,Cheque,260.00,00.00,298.14
19-Oct-2023,Interest,00.00,298.14,00.00
19-Oct-2023,Transfer,13.14,00.00,13.14
19-Oct-2023,Purchase,"2,274.00",00.00,"2,287.14"
19-Oct-2023,Cheque,00.00,"1,143.57","1,143.57"
19-Oct-2023,Miscellaneous,"90,667.00",00.00,"91,810.57"
19-Oct-2023,Interest,00.00,"30,603.52","61,207.05"
19-Oct-2023,Cheque,00.00,"20,402.35","40,804.70"
19-Oct-2023,Purchase,00.00,"5,829.24","34,975.46"
19-Oct-2023,RTGS,00.00,"4,371.93","30,603.53"
19-Oct-2023,IMPS,"2,937.00",00.00,"33,540.53"
19-Oct-2023,ATM,00.00,"4,791.50","28,749.03"
19-Oct-2023,Bill,871.50,00.00,"29,620.53"
19-Oct-2023,Purchase,00.00,"3,291.17","26,329.36"
19-Oct-2023,IMPS,"152,204.59",00.00,"178,533.95"
19-Oct-2023,Bill,"1,491.79",00.00,"180,025.74"
19-Oct-2023,Interest,00.00,"22,503.22","157,522.52"
19-Oct-2023,RTGS,00.00,"39,380.63","118,141.89"
19-Oct-2023,RTGS,"31,823.87",00.00,"149,965.76"
19-Oct-2023,Interest,00.00,"16,662.86","133,302.90"
19-Oct-2023,Debit Card,"3,140.96",00.00,"136,443.86"
19-Oct-2023,RTGS,00.00,"34,110.97","102,332.89"
19-Oct-2023,Miscellaneous,00.00,"11,370.32","90,962.57"
19-Oct-2023,Bill,00.00,"90,962.57",00.00
19-Oct-2023,RTGS,"199,496.00",00.00,"199,496.00"
19-Oct-2023,Interest,00.00,"66,498.67","132,997.33"
19-Oct-2023,Debit Card,42.70,00.00,"133,040.03"
19-Oct-2023,NEFT,00.00,"26,608.01","106,432.02"
19-Oct-2023,ATM,00.00,"35,477.34","70,954.68"
19-Oct-2023,IMPS,284.80,00.00,"71,239.48"
19-Oct-2023,Miscellaneous,"964,208.80",00.00,"1,035,448.28"
19-Oct-2023,Debit Card,"1,653,694.50",00.00,"2,689,142.78"
19-Oct-2023,Cheque,52.40,00.00,"2,689,195.18"
19-Oct-2023,RTGS,00.00,"2,689,195.18",00.00
19-Oct-2023,IMPS,"197,648.47",00.00,"197,648.47"
19-Oct-2023,Purchase,00.00,"49,412.12","148,236.35"
19-Oct-2023,Tax,00.00,"24,706.06","123,530.29"
19-Oct-2023,Transfer,00.00,"15,441.29","108,089.00"
19-Oct-2023,Transfer,00.00,"12,009.89","96,079.11"
19-Oct-2023,NEFT,00.45,00.00,"96,079.56"
19-Oct-2023,Miscellaneous,00.00,"24,019.89","72,059.67"
19-Oct-2023,Cheque,"3,156.00",00.00,"75,215.67"
19-Oct-2023,RTGS,221.00,00.00,"75,436.67"
19-Oct-2023,ATM,00.00,"7,543.67","67,893.00"
19-Oct-2023,Tax,467.42,00.00,"68,360.42"
19-Oct-2023,Purchase,00.00,"13,672.08","54,688.34"
19-Oct-2023,Miscellaneous,474.16,00.00,"55,162.50"
19-Oct-2023,RTGS,00.00,"6,895.31","48,267.19"
19-Oct-2023,Commission,00.00,"5,363.02","42,904.17"
19-Oct-2023,IMPS,00.00,"8,580.83","34,323.34"
19-Oct-2023,Reversal,00.00,"17,161.67","17,161.67"
19-Oct-2023,IMPS,00.00,"2,860.28","14,301.39"
19-Oct-2023,Cash,00.00,"2,043.06","12,258.33"
19-Oct-2023,IMPS,00.00,"2,451.67","9,806.66"
19-Oct-2023,Transfer,"1,512,514.80",00.00,"1,522,321.46"
19-Oct-2023,Cash,00.00,"152,232.15","1,370,089.31"
19-Oct-2023,Bill,00.00,"342,522.33","1,027,566.98"
19-Oct-2023,NEFT,313.03,00.00,"1,027,880.01"
19-Oct-2023,Cash,"2,467.00",00.00,"1,030,347.01"
19-Oct-2023,NEFT,"3,952.30",00.00,"1,034,299.31"
19-Oct-2023,RTGS,00.00,"517,149.66","517,149.66"
19-Oct-2023,Miscellaneous,00.00,"57,461.07","459,688.59"
20-Oct-2023,Purchase,00.00,"76,614.77","383,073.82"
20-Oct-2023,Transfer,00.00,"383,073.82",00.00
20-Oct-2023,RTGS,"236,311.80",00.00,"236,311.80"
20-Oct-2023,Debit Card,00.00,"26,256.87","210,054.93"
20-Oct-2023,Transfer,00.00,"26,256.87","183,798.06"
20-Oct-2023,Purchase,01.00,00.00,"183,799.06"
20-Oct-2023,Commission,180.66,00.00,"183,979.72"
20-Oct-2023,NEFT,00.00,"18,397.97","165,581.75"
20-Oct-2023,Cheque,00.00,"165,581.75",00.00
20-Oct-2023,IMPS,05.65,00.00,05.65
20-Oct-2023,Miscellaneous,60.30,00.00,65.95
20-Oct-2023,NEFT,"4,683.59",00.00,"4,749.54"
20-Oct-2023,Transfer,"1,624,993.75",00.00,"1,629,743.29"
21-Oct-2023,Reversal,"13,105.12",00.00,"1,642,848.41"
21-Oct-2023,IMPS,675.10,00.00,"1,643,523.51"
21-Oct-2023,RTGS,00.00,"547,841.17","1,095,682.34"
21-Oct-2023,Tax,00.00,"109,568.23","986,114.11"
21-Oct-2023,Miscellaneous,00.00,"140,873.44","845,240.67"
21-Oct-2023,Tax,00.00,"845,240.67",00.00
21-Oct-2023,Purchase,"2,534.90",00.00,"2,534.90"
21-Oct-2023,Miscellaneous,00.00,"1,267.45","1,267.45"
21-Oct-2023,IMPS,08.00,00.00,"1,275.45"
21-Oct-2023,RTGS,00.00,141.72,"1,133.73"
21-Oct-2023,Commission,270.00,00.00,"1,403.73"
21-Oct-2023,IMPS,"971,866.80",00.00,"973,270.53"
21-Oct-2023,Cash,00.65,00.00,"973,271.18"
21-Oct-2023,Bill,"60,910.00",00.00,"1,034,181.18"
21-Oct-2023,Reversal,"23,229.28",00.00,"1,057,410.46"
21-Oct-2023,RTGS,277.70,00.00,"1,057,688.16"
21-Oct-2023,NEFT,"2,247.80",00.00,"1,059,935.96"
21-Oct-2023,Commission,"257,442.40",00.00,"1,317,378.36"
21-Oct-2023,Miscellaneous,"27,762.00",00.00,"1,345,140.36"
21-Oct-2023,Purchase,00.00,"168,142.55","1,176,997.82"
21-Oct-2023,Tax,02.00,00.00,"1,176,999.82"
21-Oct-2023,Transfer,00.00,"196,166.64","980,833.18"
21-Oct-2023,RTGS,00.00,"980,833.18",00.00
21-Oct-2023,Interest,07.00,00.00,07.00
21-Oct-2023,ATM,00.00,02.33,04.67
21-Oct-2023,Cheque,00.00,01.56,03.11
21-Oct-2023,Tax,"16,430.80",00.00,"16,433.91"
21-Oct-2023,Reversal,"2,193.70",00.00,"18,627.61"
21-Oct-2023,Miscellaneous,"31,057.00",00.00,"49,684.61"
21-Oct-2023,ATM,00.00,"16,561.54","33,123.07"
21-Oct-2023,Reversal,00.00,"4,731.87","28,391.20"
21-Oct-2023,Reversal,00.00,"5,678.24","22,712.96"
21-Oct-2023,Miscellaneous,00.00,"2,523.66","20,189.30"
21-Oct-2023,Cash,00.00,"2,523.66","17,665.64"
21-Oct-2023,Debit Card,00.00,"17,665.64",00.00
21-Oct-2023,ATM,"141,013.59",00.00,"141,013.59"
21-Oct-2023,Bill,00.00,"15,668.18","125,345.41"
21-Oct-2023,Transfer,962.32,00.00,"126,307.73"
21-Oct-2023,Interest,00.00,"21,051.29","105,256.44"
21-Oct-2023,RTGS,00.00,"13,157.06","92,099.38"
21-Oct-2023,RTGS,20.70,00.00,"92,120.08"
21-Oct-2023,ATM,00.00,"13,160.01","78,960.07"
21-Oct-2023,Tax,00.00,"26,320.02","52,640.05"
21-Oct-2023,Interest,443.80,00.00,"53,083.85"
21-Oct-2023,IMPS,612.00,00.00,"53,695.85"
21-Oct-2023,IMPS,00.00,"17,898.62","35,797.23"
21-Oct-2023,Debit Card,"10,457.00",00.00,"46,254.23"
22-Oct-2023,ATM,00.00,"15,418.08","30,836.15"
22-Oct-2023,Cheque,00.00,"6,167.23","24,668.92"
22-Oct-2023,Reversal,"1,916.30",00.00,"26,585.22"
22-Oct-2023,Miscellaneous,00.00,"13,292.61","13,292.61"
22-Oct-2023,Commission,"3,466.40",00.00,"16,759.01"
22-Oct-2023,Cheque,01.40,00.00,"16,760.41"
22-Oct-2023,Cash,00.00,"4,190.10","12,570.31"
22-Oct-2023,NEFT,32.00,00.00,"12,602.31"
22-Oct-2023,ATM,00.00,"12,602.31",00.00
22-Oct-2023,Cash,"1,099.00",00.00,"1,099.00"
22-Oct-2023,IMPS,00.00,"1,099.00",00.00
22-Oct-2023,Commission,"158,091.00",00.00,"158,091.00"
22-Oct-2023,Transfer,"106,367.00",00.00,"264,458.00"
22-Oct-2023,Reversal,00.00,"44,076.33","220,381.67"
22-Oct-2023,Bill,00.00,"110,190.84","110,190.84"
22-Oct-2023,Purchase,00.00,"110,190.84",00.00
22-Oct-2023,Tax,"11,543.00",00.00,"11,543.00"
22-Oct-2023,Debit Card,00.00,"1,154.30","10,388.70"
22-Oct-2023,Tax,00.00,"2,597.18","7,791.52"
22-Oct-2023,NEFT,"143,656.12",00.00,"151,447.64"
22-Oct-2023,IMPS,02.40,00.00,"151,450.04"
22-Oct-2023,IMPS,336.00,00.00,"151,786.04"
22-Oct-2023,Tax,12.58,00.00,"151,798.62"
22-Oct-2023,Commission,01.10,00.00,"151,799.72"
22-Oct-2023,Debit Card,00.00,"25,299.95","126,499.77"
22-Oct-2023,Cash,07.19,00.00,"126,506.96"
22-Oct-2023,ATM,00.00,"18,072.42","108,434.54"
22-Oct-2023,Interest,185.97,00.00,"108,620.51"
22-Oct-2023,Reversal,00.00,"15,517.22","93,103.29"
22-Oct-2023,Transfer,00.00,"9,310.33","83,792.96"
22-Oct-2023,Purchase,"74,912.20",00.00,"158,705.16"
22-Oct-2023,Miscellaneous,00.00,"79,352.58","79,352.58"
22-Oct-2023,IMPS,224.00,00.00,"79,576.58"
22-Oct-2023,RTGS,489.00,00.00,"80,065.58"
22-Oct-2023,RTGS,00.00,"20,016.40","60,049.18"
22-Oct-2023,Reversal,00.00,"10,008.20","50,040.98"
22-Oct-2023,Transfer,32.37,00.00,"50,073.35"
22-Oct-2023,Commission,00.00,"10,014.67","40,058.68"
22-Oct-2023,Cash,00.00,"13,352.89","26,705.79"
22-Oct-2023,ATM,00.00,"2,967.31","23,738.48"
23-Oct-2023,NEFT,00.00,"2,637.61","21,100.87"
23-Oct-2023,Commission,00.00,"21,100.87",00.00
23-Oct-2023,IMPS,"1,718.00",00.00,"1,718.00"
23-Oct-2023,RTGS,"929,635.00",00.00,"931,353.00"
23-Oct-2023,IMPS,00.00,"232,838.25","698,514.75"
23-Oct-2023,Miscellaneous,00.00,"232,838.25","465,676.50"
23-Oct-2023,Interest,00.00,"232,838.25","232,838.25"
23-Oct-2023,Debit Card,00.00,"232,838.25",00.00
23-Oct-2023,NEFT,05.50,00.00,05.50
23-Oct-2023,IMPS,00.00,01.10,04.40
23-Oct-2023,Reversal,"1,533,199.00",00.00,"1,533,203.40"
23-Oct-2023,Bill,04.35,00.00,"1,533,207.75"
23-Oct-2023,Commission,00.00,"1,533,207.75",00.00
23-Oct-2023,Commission,"21,609.31",00.00,"21,609.31"
23-Oct-2023,NEFT,00.00,"7,203.10","14,406.21"
23-Oct-2023,Cash,09.00,00.00,"14,415.21"
23-Oct-2023,Interest,"17,229.75",00.00,"31,644.96"
23-Oct-2023,Transfer,"19,543.60",00.00,"51,188.56"
24-Oct-2023,IMPS,00.00,"8,531.43","42,657.13"
24-Oct-2023,Tax,"172,842.00",00.00,"215,499.13"
24-Oct-2023,Purchase,00.00,"30,785.59","184,713.54"
24-Oct-2023,Cheque,94.00,00.00,"184,807.54"
24-Oct-2023,Reversal,00.00,"36,961.51","147,846.03"
24-Oct-2023,Transfer,00.00,"147,846.03",00.00
24-Oct-2023,Purchase,"233,807.00",00.00,"233,807.00"
24-Oct-2023,Cheque,121.37,00.00,"233,928.37"
24-Oct-2023,Cash,00.00,"46,785.67","187,142.70"
24-Oct-2023,IMPS,00.00,"20,793.63","166,349.07"
24-Oct-2023,Reversal,00.00,"27,724.85","138,624.22"
24-Oct-2023,Tax,00.00,"15,402.69","123,221.53"
24-Oct-2023,Commission,"245,091.78",00.00,"368,313.31"
24-Oct-2023,Debit Card,07.49,00.00,"368,320.80"
24-Oct-2023,Tax,01.10,00.00,"368,321.90"
24-Oct-2023,ATM,00.00,"92,080.48","276,241.43"
24-Oct-2023,Commission,00.00,"138,120.72","138,120.72"
24-Oct-2023,Cash,182.00,00.00,"138,302.72"
24-Oct-2023,Purchase,00.00,"69,151.36","69,151.36"
24-Oct-2023,Interest,"23,477.20",00.00,"92,628.56"
24-Oct-2023,RTGS,00.00,"92,628.56",00.00
24-Oct-2023,IMPS,"16,697.09",00.00,"16,697.09"
24-Oct-2023,NEFT,"1,840.00",00.00,"18,537.09"
24-Oct-2023,Debit Card,01.30,00.00,"18,538.39"
24-Oct-2023,Tax,00.00,"2,648.34","15,890.05"
24-Oct-2023,Miscellaneous,06.17,00.00,"15,896.22"
24-Oct-2023,IMPS,00.00,"2,649.37","13,246.85"
24-Oct-2023,Interest,312.85,00.00,"13,559.70"
24-Oct-2023,Tax,"2,213.21",00.00,"15,772.91"
24-Oct-2023,NEFT,61.88,00.00,"15,834.79"
24-Oct-2023,Cheque,00.00,"5,278.26","10,556.53"
24-Oct-2023,Reversal,679.00,00.00,"11,235.53"
24-Oct-2023,IMPS,00.00,"3,745.18","7,490.35"
24-Oct-2023,IMPS,00.00,832.26,"6,658.09"
24-Oct-2023,RTGS,"142,487.34",00.00,"149,145.43"
24-Oct-2023,IMPS,00.00,"21,306.49","127,838.94"
24-Oct-2023,ATM,00.00,"63,919.47","63,919.47"
24-Oct-2023,Transfer,"2,973.30",00.00,"66,892.77"
24-Oct-2023,Bill,00.00,"16,723.19","50,169.58"
24-Oct-2023,Commission,05.00,00.00,"50,174.58"
24-Oct-2023,IMPS,03.89,00.00,"50,178.47"
24-Oct-2023,Debit Card,00.00,"6,272.31","43,906.16"
24-Oct-2023,NEFT,00.00,"6,272.31","37,633.85"
24-Oct-2023,Cash,"383,438.50",00.00,"421,072.35"
24-Oct-2023,IMPS,00.00,"210,536.18","210,536.18"
24-Oct-2023,Interest,"953,000.00",00.00,"1,163,536.18"
24-Oct-2023,Cheque,00.00,"193,922.70","969,613.48"
24-Oct-2023,IMPS,00.00,"107,734.83","861,878.65"
24-Oct-2023,Purchase,"9,171.20",00.00,"871,049.85"
24-Oct-2023,IMPS,04.50,00.00,"871,054.35"
24-Oct-2023,IMPS,00.00,"217,763.59","653,290.76"
24-Oct-2023,Debit Card,00.00,"72,587.86","580,702.90"
24-Oct-2023,Purchase,396.00,00.00,"581,098.90"
24-Oct-2023,Reversal,00.00,"581,098.90",00.00
24-Oct-2023,Bill,98.57,00.00,98.57
24-Oct-2023,Cash,"3,355.50",00.00,"3,454.07"
24-Oct-2023,Miscellaneous,60.80,00.00,"3,514.87"
24-Oct-2023,Miscellaneous,"2,056,393.00",00.00,"2,059,907.87"
24-Oct-2023,Interest,"116,706.00",00.00,"2,176,613.87"
24-Oct-2023,Transfer,00.00,"435,322.77","1,741,291.10"
25-Oct-2023,Purchase,392.00,00.00,"1,741,683.10"
25-Oct-2023,NEFT,00.00,"217,710.39","1,523,972.71"
25-Oct-2023,Interest,317.10,00.00,"1,524,289.81"
25-Oct-2023,Miscellaneous,"1,462.29",00.00,"1,525,752.10"
25-Oct-2023,Miscellaneous,"2,026.20",00.00,"1,527,778.30"
25-Oct-2023,IMPS,"24,851.98",00.00,"1,552,630.28"
25-Oct-2023,Cash,374.40,00.00,"1,553,004.68"
26-Oct-2023,Bill,00.00,"1,553,004.68",00.00
26-Oct-2023,ATM,"259,085.03",00.00,"259,085.03"
26-Oct-2023,Commission,00.00,"28,787.23","230,297.80"
26-Oct-2023,IMPS,289.80,00.00,"230,587.60"
26-Oct-2023,NEFT,"7,554.70",00.00,"238,142.30"
26-Oct-2023,Cheque,731.50,00.00,"238,873.80"
26-Oct-2023,Cheque,"1,966,005.00",00.00,"2,204,878.80"
26-Oct-2023,Commission,"150,947.10",00.00,"2,355,825.90"
26-Oct-2023,Commission,00.00,"1,177,912.95","1,177,912.95"
27-Oct-2023,Interest,00.00,"196,318.83","981,594.12"
27-Oct-2023,Interest,01.00,00.00,"981,595.12"
27-Oct-2023,NEFT,07.90,00.00,"981,603.02"
27-Oct-2023,Miscellaneous,00.00,"196,320.60","785,282.42"
27-Oct-2023,ATM,"3,130.00",00.00,"788,412.42"
27-Oct-2023,Cheque,00.00,"87,601.38","700,811.04"
27-Oct-2023,Bill,00.00,"140,162.21","560,648.83"
27-Oct-2023,Miscellaneous,00.00,"186,882.94","373,765.89"
27-Oct-2023,Tax,00.00,"37,376.59","336,389.30"
27-Oct-2023,Bill,"1,088,502.00",00.00,"1,424,891.30"
27-Oct-2023,Reversal,00.00,"1,424,891.30",00.00
27-Oct-2023,Commission,80.30,00.00,80.30
27-Oct-2023,IMPS,00.00,26.77,53.53
27-Oct-2023,Cash,00.00,05.35,48.18
27-Oct-2023,Tax,"2,483.00",00.00,"2,531.18"
27-Oct-2023,NEFT,"66,378.31",00.00,"68,909.49"
27-Oct-2023,Tax,41.00,00.00,"68,950.49"
27-Oct-2023,Transfer,"193,260.00",00.00,"262,210.49"
27-Oct-2023,Tax,00.00,"87,403.50","174,806.99"
27-Oct-2023,Commission,00.00,"17,480.70","157,326.29"
27-Oct-2023,Reversal,00.00,"15,732.63","141,593.66"
27-Oct-2023,RTGS,00.00,"141,593.66",00.00
27-Oct-2023,Debit Card,25.81,00.00,25.81
27-Oct-2023,Purchase,01.80,00.00,27.61
27-Oct-2023,Bill,05.11,00.00,32.72
27-Oct-2023,Cheque,00.00,08.18,24.54
27-Oct-2023,IMPS,00.00,08.18,16.36
27-Oct-2023,IMPS,226.13,00.00,242.49
27-Oct-2023,IMPS,153.00,00.00,395.49
27-Oct-2023,Commission,00.00,131.83,263.66
27-Oct-2023,IMPS,531.60,00.00,795.26
27-Oct-2023,Bill,"2,215.25",00.00,"3,010.51"
27-Oct-2023,Commission,00.00,"3,010.51",00.00
27-Oct-2023,Miscellaneous,431.30,00.00,431.30
27-Oct-2023,Transfer,00.00,431.30,00.00
27-Oct-2023,Commission,"1,470,106.00",00.00,"1,470,106.00"
27-Oct-2023,Bill,00.00,"735,053.00","735,053.00"
27-Oct-2023,IMPS,00.00,"81,672.56","653,380.44"
27-Oct-2023,Transfer,00.00,"130,676.09","522,704.35"
27-Oct-2023,Interest,"210,378.60",00.00,"733,082.95"
27-Oct-2023,Bill,"546,124.00",00.00,"1,279,206.95"
27-Oct-2023,Debit Card,00.00,"182,743.85","1,096,463.10"
27-Oct-2023,Reversal,00.00,"121,829.23","974,633.87"
27-Oct-2023,Debit Card,"3,804.80",00.00,"978,438.67"
27-Oct-2023,Tax,00.00,"244,609.67","733,829.00"
27-Oct-2023,Debit Card,00.00,"183,457.25","550,371.75"
27-Oct-2023,Miscellaneous,379.00,00.00,"550,750.75"
27-Oct-2023,NEFT,00.00,"61,194.53","489,556.22"
27-Oct-2023,Commission,00.00,"48,955.62","440,600.60"
27-Oct-2023,IMPS,00.00,"55,075.08","385,525.52"
27-Oct-2023,RTGS,00.00,"38,552.55","346,972.97"
27-Oct-2023,IMPS,"1,270,598.00",00.00,"1,617,570.97"
27-Oct-2023,Miscellaneous,00.00,"404,392.74","1,213,178.23"
27-Oct-2023,Purchase,00.00,"202,196.37","1,010,981.86"
27-Oct-2023,IMPS,10.91,00.00,"1,010,992.77"
27-Oct-2023,Reversal,00.00,"112,332.53","898,660.24"
27-Oct-2023,NEFT,446.30,00.00,"899,106.54"
27-Oct-2023,Bill,"24,476.90",00.00,"923,583.44"
27-Oct-2023,Purchase,00.00,"307,861.15","615,722.29"
27-Oct-2023,Bill,29.60,00.00,"615,751.89"
27-Oct-2023,Reversal,00.00,"102,625.32","513,126.58"
27-Oct-2023,ATM,00.00,"102,625.32","410,501.26"
27-Oct-2023,Bill,00.00,"410,501.26",00.00
27-Oct-2023,Purchase,"156,886.50",00.00,"156,886.50"
27-Oct-2023,ATM,"9,717.97",00.00,"166,604.47"
27-Oct-2023,Cheque,00.00,"55,534.82","111,069.65"
27-Oct-2023,Cheque,00.00,"18,511.61","92,558.04"
27-Oct-2023,Tax,"1,004,018.00",00.00,"1,096,576.04"
27-Oct-2023,RTGS,00.00,"121,841.78","974,734.26"
27-Oct-2023,Reversal,00.00,"194,946.85","779,787.41"
27-Oct-2023,NEFT,00.00,"77,978.74","701,808.67"
27-Oct-2023,IMPS,735.00,00.00,"702,543.67"
27-Oct-2023,Debit Card,"1,187,812.25",00.00,"1,890,355.92"
27-Oct-2023,IMPS,00.00,"1,890,355.92",00.00
27-Oct-2023,Cash,"6,609.50",00.00,"6,609.50"
27-Oct-2023,Debit Card,00.00,734.39,"5,875.11"
27-Oct-2023,Tax,00.00,"5,875.11",00.00
27-Oct-2023,Commission,"261,130.10",00.00,"261,130.10"
27-Oct-2023,IMPS,00.00,"43,521.68","217,608.42"
27-Oct-2023,Commission,"18,178.00",00.00,"235,786.42"
27-Oct-2023,Tax,162.80,00.00,"235,949.22"
27-Oct-2023,Transfer,33.16,00.00,"235,982.38"
27-Oct-2023,Transfer,00.00,"39,330.40","196,651.98"
27-Oct-2023,Debit Card,"42,835.70",00.00,"239,487.68"
27-Oct-2023,Commission,"2,212.59",00.00,"241,700.27"
27-Oct-2023,NEFT,00.00,"24,170.03","217,530.24"
27-Oct-2023,Reversal,00.00,"72,510.08","145,020.16"
27-Oct-2023,RTGS,42.70,00.00,"145,062.86"
27-Oct-2023,Commission,03.50,00.00,"145,066.36"
27-Oct-2023,Debit Card,"31,000.00",00.00,"176,066.36"
27-Oct-2023,Bill,"500,717.80",00.00,"676,784.16"
27-Oct-2023,Transfer,"11,158.44",00.00,"687,942.60"
27-Oct-2023,RTGS,00.00,"76,438.07","611,504.53"
27-Oct-2023,Reversal,"1,101.62",00.00,"612,606.15"
27-Oct-2023,NEFT,00.00,"612,606.15",00.00
27-Oct-2023,IMPS,33.00,00.00,33.00
27-Oct-2023,Commission,00.00,33.00,00.00
27-Oct-2023,Miscellaneous,"1,016.12",00.00,"1,016.12"
27-Oct-2023,ATM,165.00,00.00,"1,181.12"
27-Oct-2023,ATM,04.03,00.00,"1,185.15"
27-Oct-2023,Purchase,"20,883.89",00.00,"22,069.04"
27-Oct-2023,RTGS,00.00,"5,517.26","16,551.78"
27-Oct-2023,ATM,"1,401,895.00",00.00,"1,418,446.78"
27-Oct-2023,Bill,00.00,"709,223.39","709,223.39"
27-Oct-2023,Miscellaneous,297.00,00.00,"709,520.39"
27-Oct-2023,Reversal,"22,642.00",00.00,"732,162.39"
27-Oct-2023,Debit Card,61.70,00.00,"732,224.09"
27-Oct-2023,Purchase,50.00,00.00,"732,274.09"
27-Oct-2023,Transfer,00.00,"732,274.09",00.00
27-Oct-2023,ATM,"20,672.64",00.00,"20,672.64"
27-Oct-2023,Purchase,00.00,"2,067.26","18,605.38"
27-Oct-2023,Bill,"1,756.70",00.00,"20,362.08"
27-Oct-2023,Cheque,00.00,"2,908.87","17,453.21"
27-Oct-2023,Interest,00.00,"17,453.21",00.00
27-Oct-2023,Reversal,"2,519.00",00.00,"2,519.00"
27-Oct-2023,Debit Card,"89,918.70",00.00,"92,437.70"
27-Oct-2023,NEFT,"52,569.00",00.00,"145,006.70"
27-Oct-2023,Cash,00.00,"14,500.67","130,506.03"
27-Oct-2023,Cash,"234,406.00",00.00,"364,912.03"
27-Oct-2023,Transfer,237.00,00.00,"365,149.03"
27-Oct-2023,Cheque,01.00,00.00,"365,150.03"
27-Oct-2023,Cash,336.80,00.00,"365,486.83"
27-Oct-2023,ATM,00.00,"36,548.68","328,938.15"
27-Oct-2023,Debit Card,07.00,00.00,"328,945.15"
27-Oct-2023,Reversal,00.00,"41,118.14","287,827.01"
27-Oct-2023,Tax,00.00,"57,565.40","230,261.61"
27-Oct-2023,ATM,56.50,00.00,"230,318.11"
27-Oct-2023,Commission,"2,468.80",00.00,"232,786.91"
27-Oct-2023,ATM,00.00,"116,393.46","116,393.46"
27-Oct-2023,ATM,00.00,"116,393.46",00.00
27-Oct-2023,Debit Card,"4,043.27",00.00,"4,043.27"
27-Oct-2023,ATM,269.00,00.00,"4,312.27"
27-Oct-2023,Bill,00.00,"1,078.07","3,234.20"
27-Oct-2023,Commission,16.00,00.00,"3,250.20"
27-Oct-2023,Purchase,00.00,650.04,"2,600.16"
28-Oct-2023,Debit Card,233.50,00.00,"2,833.66"
28-Oct-2023,Reversal,00.00,"2,833.66",00.00
28-Oct-2023,Purchase,"399,190.00",00.00,"399,190.00"
28-Oct-2023,Reversal,"1,797,778.00",00.00,"2,196,968.00"
28-Oct-2023,Debit Card,22.60,00.00,"2,196,990.60"
28-Oct-2023,Bill,00.00,"2,196,990.60",00.00
28-Oct-2023,Cheque,07.98,00.00,07.98
28-Oct-2023,IMPS,31.11,00.00,39.09
28-Oct-2023,Cash,"230,006.31",00.00,"230,045.40"
28-Oct-2023,Interest,"1,215,994.00",00.00,"1,446,039.40"
28-Oct-2023,ATM,00.00,"482,013.13","964,026.27"
28-Oct-2023,Transfer,02.07,00.00,"964,028.34"
28-Oct-2023,Miscellaneous,00.00,"107,114.26","856,914.08"
28-Oct-2023,Debit Card,00.00,"428,457.04","428,457.04"
29-Oct-2023,Tax,237.00,00.00,"428,694.04"
29-Oct-2023,Tax,"2,092,362.75",00.00,"2,521,056.79"
29-Oct-2023,NEFT,"31,866.00",00.00,"2,552,922.79"
29-Oct-2023,Commission,00.00,"425,487.13","2,127,435.66"
29-Oct-2023,ATM,00.00,"303,919.38","1,823,516.28"
29-Oct-2023,ATM,00.00,"607,838.76","1,215,677.52"
29-Oct-2023,Reversal,"3,611.70",00.00,"1,219,289.22"
29-Oct-2023,Commission,00.00,"1,219,289.22",00.00
29-Oct-2023,NEFT,"180,573.60",00.00,"180,573.60"
29-Oct-2023,Transfer,00.00,"45,143.40","135,430.20"
29-Oct-2023,Tax,06.00,00.00,"135,436.20"
29-Oct-2023,NEFT,00.00,"67,718.10","67,718.10"
29-Oct-2023,Tax,00.00,00.00,"67,718.10"
29-Oct-2023,Bill,00.00,"16,929.53","50,788.58"
29-Oct-2023,Purchase,150.70,00.00,"50,939.28"
29-Oct-2023,Cash,00.00,"7,277.04","43,662.24"
29-Oct-2023,Interest,07.75,00.00,"43,669.99"
29-Oct-2023,Transfer,00.00,"43,669.99",00.00
29-Oct-2023,Interest,"224,246.60",00.00,"224,246.60"
29-Oct-2023,Purchase,00.00,"28,030.83","196,215.78"
29-Oct-2023,Debit Card,"10,728.72",00.00,"206,944.50"
29-Oct-2023,IMPS,00.00,"29,563.50","177,381.00"
29-Oct-2023,Tax,"11,900.00",00.00,"189,281.00"
29-Oct-2023,Cheque,55.00,00.00,"189,336.00"
29-Oct-2023,Debit Card,00.00,"21,037.33","168,298.67"
29-Oct-2023,Cash,00.00,"168,298.67",00.00
29-Oct-2023,Miscellaneous,53.00,00.00,53.00
29-Oct-2023,Cash,"30,442.30",00.00,"30,495.30"
29-Oct-2023,NEFT,"2,953.60",00.00,"33,448.90"
29-Oct-2023,Transfer,00.00,"5,574.82","27,874.08"
29-Oct-2023,IMPS,00.00,"4,645.68","23,228.40"
29-Oct-2023,Cheque,"2,074,101.20",00.00,"2,097,329.60"
29-Oct-2023,Reversal,00.00,"1,048,664.80","1,048,664.80"
29-Oct-2023,Purchase,02.00,00.00,"1,048,666.80"
29-Oct-2023,Miscellaneous,00.00,"104,866.68","943,800.12"
30-Oct-2023,Interest,05.08,00.00,"943,805.20"
30-Oct-2023,ATM,00.00,"134,829.31","808,975.89"
31-Oct-2023,IMPS,00.00,"101,121.99","707,853.90"
31-Oct-2023,Reversal,05.10,00.00,"707,859.00"
31-Oct-2023,Transfer,04.40,00.00,"707,863.40"
31-Oct-2023,RTGS,06.50,00.00,"707,869.90"
31-Oct-2023,Bill,00.00,"353,934.95","353,934.95"
31-Oct-2023,Bill,06.00,00.00,"353,940.95"
31-Oct-2023,Interest,"4,039.90",00.00,"357,980.85"
31-Oct-2023,Transfer,"22,626.25",00.00,"380,607.10"
31-Oct-2023,Cash,"302,267.80",00.00,"682,874.90"
31-Oct-2023,Interest,00.00,"113,812.48","569,062.42"
01-Nov-2023,Tax,00.00,"189,687.47","379,374.95"
01-Nov-2023,Reversal,00.00,"126,458.32","252,916.63"
02-Nov-2023,IMPS,12.10,00.00,"252,928.73"
02-Nov-2023,ATM,00.80,00.00,"252,929.53"
02-Nov-2023,Reversal,"12,137.00",00.00,"265,066.53"
02-Nov-2023,NEFT,"27,924.00",00.00,"292,990.53"
02-Nov-2023,IMPS,132.40,00.00,"293,122.93"
02-Nov-2023,Commission,"146,316.90",00.00,"439,439.83"
02-Nov-2023,Debit Card,00.00,"146,479.94","292,959.89"
02-Nov-2023,Debit Card,00.00,"29,295.99","263,663.90"
02-Nov-2023,Tax,00.00,"87,887.97","175,775.93"
02-Nov-2023,Transfer,00.00,"19,530.66","156,245.27"
02-Nov-2023,Commission,"888,618.25",00.00,"1,044,863.52"
02-Nov-2023,Tax,00.00,"348,287.84","696,575.68"
02-Nov-2023,Interest,00.00,"77,397.30","619,178.38"
02-Nov-2023,Debit Card,00.91,00.00,"619,179.29"
02-Nov-2023,Commission,316.00,00.00,"619,495.29"
02-Nov-2023,Tax,00.00,"88,499.33","530,995.96"
02-Nov-2023,Bill,00.00,"106,199.19","424,796.77"
02-Nov-2023,Commission,00.00,"212,398.39","212,398.38"
02-Nov-2023,Purchase,135.30,00.00,"212,533.68"
02-Nov-2023,ATM,00.00,"53,133.42","159,400.26"
02-Nov-2023,IMPS,"53,514.00",00.00,"212,914.26"
02-Nov-2023,Reversal,"3,929.00",00.00,"216,843.26"
02-Nov-2023,ATM,"2,050,099.25",00.00,"2,266,942.51"
02-Nov-2023,Transfer,00.00,"377,823.75","1,889,118.76"
03-Nov-2023,Bill,00.00,"1,889,118.76",00.00
03-Nov-2023,RTGS,02.00,00.00,02.00
03-Nov-2023,NEFT,00.00,00.50,01.50
03-Nov-2023,Cheque,"26,565.62",00.00,"26,567.12"
03-Nov-2023,ATM,00.00,"13,283.56","13,283.56"
03-Nov-2023,Interest,301.30,00.00,"13,584.86"
03-Nov-2023,Debit Card,00.50,00.00,"13,585.36"
03-Nov-2023,Cheque,00.00,"1,698.17","11,887.19"
03-Nov-2023,IMPS,00.00,"1,698.17","10,189.02"
03-Nov-2023,ATM,"30,370.00",00.00,"40,559.02"
03-Nov-2023,RTGS,00.00,"5,069.88","35,489.14"
03-Nov-2023,Commission,00.00,"5,914.86","29,574.28"
03-Nov-2023,Purchase,00.00,"3,286.03","26,288.25"
03-Nov-2023,Cash,"180,279.94",00.00,"206,568.19"
03-Nov-2023,Tax,"235,807.91",00.00,"442,376.10"
03-Nov-2023,Miscellaneous,503.97,00.00,"442,880.07"
04-Nov-2023,Tax,00.00,"44,288.01","398,592.06"
04-Nov-2023,Cash,"234,071.30",00.00,"632,663.36"
04-Nov-2023,Interest,"26,671.00",00.00,"659,334.36"
04-Nov-2023,Debit Card,00.00,"94,190.62","565,143.74"
04-Nov-2023,Reversal,00.00,"80,734.82","484,408.92"
04-Nov-2023,Transfer,02.30,00.00,"484,411.22"
04-Nov-2023,ATM,"3,008.60",00.00,"487,419.82"
04-Nov-2023,Miscellaneous,467.00,00.00,"487,886.82"
04-Nov-2023,Interest,17.61,00.00,"487,904.43"
04-Nov-2023,Tax,00.00,"162,634.81","325,269.62"
04-Nov-2023,Cheque,00.00,"54,211.60","271,058.02"
04-Nov-2023,Miscellaneous,"2,588.00",00.00,"273,646.02"
04-Nov-2023,Miscellaneous,"14,997.59",00.00,"288,643.61"
04-Nov-2023,Interest,00.00,"48,107.27","240,536.34"
04-Nov-2023,ATM,00.00,"240,536.34",00.00
04-Nov-2023,Tax,"161,742.60",00.00,"161,742.60"
04-Nov-2023,Reversal,"201,659.10",00.00,"363,401.70"
04-Nov-2023,Transfer,00.00,"72,680.34","290,721.36"
04-Nov-2023,Interest,"250,145.78",00.00,"540,867.14"
04-Nov-2023,Bill,00.00,"270,433.57","270,433.57"
04-Nov-2023,Commission,00.00,"270,433.57",00.00
04-Nov-2023,ATM,299.00,00.00,299.00
04-Nov-2023,Bill,"2,912.00",00.00,"3,211.00"
04-Nov-2023,Cheque,00.00,802.75,"2,408.25"
04-Nov-2023,Interest,"13,331.84",00.00,"15,740.09"
04-Nov-2023,Purchase,"3,235.00",00.00,"18,975.09"
04-Nov-2023,Debit Card,33.31,00.00,"19,008.40"
04-Nov-2023,RTGS,04.15,00.00,"19,012.55"
04-Nov-2023,Interest,05.80,00.00,"19,018.35"
04-Nov-2023,ATM,00.00,"3,169.73","15,848.62"
04-Nov-2023,Cash,"20,514.00",00.00,"36,362.62"
05-Nov-2023,Debit Card,00.00,"4,545.33","31,817.29"
05-Nov-2023,NEFT,"1,979,877.00",00.00,"2,011,694.29"
05-Nov-2023,Interest,61.10,00.00,"2,011,755.39"
05-Nov-2023,Miscellaneous,"3,480.18",00.00,"2,015,235.57"
05-Nov-2023,Cash,00.00,"287,890.80","1,727,344.77"
05-Nov-2023,Debit Card,448.00,00.00,"1,727,792.77"
05-Nov-2023,Interest,"1,724,077.50",00.00,"3,451,870.27"
05-Nov-2023,Miscellaneous,05.83,00.00,"3,451,876.10"
05-Nov-2023,NEFT,04.50,00.00,"3,451,880.60"
05-Nov-2023,Bill,00.00,"575,313.43","2,876,567.17"
05-Nov-2023,ATM,00.00,"1,438,283.59","1,438,283.58"
05-Nov-2023,Cheque,07.00,00.00,"1,438,290.58"
05-Nov-2023,ATM,"5,149.00",00.00,"1,443,439.58"
05-Nov-2023,Miscellaneous,"7,081.96",00.00,"1,450,521.54"
05-Nov-2023,Debit Card,"9,011.05",00.00,"1,459,532.59"
05-Nov-2023,Commission,"2,531.70",00.00,"1,462,064.29"
05-Nov-2023,Debit Card,"211,273.62",00.00,"1,673,337.91"
05-Nov-2023,Cheque,00.00,"836,668.96","836,668.96"
05-Nov-2023,Reversal,00.00,"418,334.48","418,334.48"
05-Nov-2023,Commission,"19,463.00",00.00,"437,797.48"
05-Nov-2023,NEFT,00.00,"87,559.50","350,237.98"
05-Nov-2023,Transfer,"182,848.00",00.00,"533,085.98"
05-Nov-2023,Reversal,"220,459.00",00.00,"753,544.98"
05-Nov-2023,Commission,00.00,"75,354.50","678,190.48"
05-Nov-2023,Purchase,00.00,"84,773.81","593,416.67"
05-Nov-2023,IMPS,"9,362.86",00.00,"602,779.53"
05-Nov-2023,Miscellaneous,00.00,"150,694.88","452,084.65"
05-Nov-2023,Bill,"1,116,684.00",00.00,"1,568,768.65"
05-Nov-2023,Transfer,16.20,00.00,"1,568,784.85"
05-Nov-2023,Tax,00.00,"261,464.14","1,307,320.71"
05-Nov-2023,Reversal,"196,749.94",00.00,"1,504,070.65"
05-Nov-2023,Transfer,"323,631.25",00.00,"1,827,701.90"
05-Nov-2023,Purchase,"1,629.00",00.00,"1,829,330.90"
05-Nov-2023,NEFT,"227,456.00",00.00,"2,056,786.90"
05-Nov-2023,Reversal,"1,666,922.00",00.00,"3,723,708.90"
05-Nov-2023,Cheque,02.25,00.00,"3,723,711.15"
05-Nov-2023,ATM,00.00,"413,745.68","3,309,965.47"
05-Nov-2023,Cash,66.54,00.00,"3,310,032.01"
05-Nov-2023,Cheque,"1,983.00",00.00,"3,312,015.01"
05-Nov-2023,Interest,00.00,"662,403.00","2,649,612.01"
05-Nov-2023,Bill,200.00,00.00,"2,649,812.01"
06-Nov-2023,Transfer,00.00,"264,981.20","2,384,830.81"
06-Nov-2023,ATM,"16,753.00",00.00,"2,401,583.81"
06-Nov-2023,NEFT,00.00,"300,197.98","2,101,385.83"
06-Nov-2023,Interest,00.00,"300,197.98","1,801,187.85"
06-Nov-2023,Transfer,939.80,00.00,"1,802,127.65"
06-Nov-2023,Commission,06.00,00.00,"1,802,133.65"
06-Nov-2023,Bill,"688,891.20",00.00,"2,491,024.85"
06-Nov-2023,ATM,00.00,"276,780.54","2,214,244.31"
06-Nov-2023,Miscellaneous,00.00,"246,027.15","1,968,217.16"
06-Nov-2023,Miscellaneous,00.00,"218,690.80","1,749,526.36"
06-Nov-2023,NEFT,00.00,"1,749,526.36",00.00
06-Nov-2023,Miscellaneous,24.00,00.00,24.00
06-Nov-2023,RTGS,"200,995.00",00.00,"201,019.00"
06-Nov-2023,Bill,00.00,"33,503.17","167,515.83"
06-Nov-2023,RTGS,"19,344.50",00.00,"186,860.33"
06-Nov-2023,IMPS,"23,757.00",00.00,"210,617.33"
06-Nov-2023,Interest,232.40,00.00,"210,849.73"
06-Nov-2023,ATM,03.70,00.00,"210,853.43"
06-Nov-2023,Tax,257.29,00.00,"211,110.72"
06-Nov-2023,ATM,00.00,"23,456.75","187,653.97"
06-Nov-2023,Cheque,"1,973,538.00",00.00,"2,161,191.97"
06-Nov-2023,ATM,00.00,"1,080,595.99","1,080,595.99"
06-Nov-2023,NEFT,119.99,00.00,"1,080,715.98"
06-Nov-2023,Miscellaneous,283.94,00.00,"1,080,999.92"
06-Nov-2023,NEFT,264.00,00.00,"1,081,263.92"
06-Nov-2023,RTGS,00.00,"540,631.96","540,631.96"
06-Nov-2023,Transfer,"3,512.77",00.00,"544,144.73"
06-Nov-2023,NEFT,02.00,00.00,"544,146.73"
06-Nov-2023,IMPS,00.00,"181,382.24","362,764.49"
06-Nov-2023,Commission,00.00,"362,764.49",00.00
06-Nov-2023,Cash,"2,139.00",00.00,"2,139.00"
06-Nov-2023,Purchase,00.00,"1,069.50","1,069.50"
06-Nov-2023,Tax,00.00,356.50,713.00
06-Nov-2023,Cash,04.30,00.00,717.30
06-Nov-2023,IMPS,"250,654.03",00.00,"251,371.33"
06-Nov-2023,ATM,00.00,"25,137.13","226,234.20"
06-Nov-2023,Miscellaneous,02.00,00.00,"226,236.20"
06-Nov-2023,Purchase,53.10,00.00,"226,289.30"
06-Nov-2023,Purchase,494.41,00.00,"226,783.71"
06-Nov-2023,Tax,00.00,"37,797.29","188,986.42"
06-Nov-2023,IMPS,00.00,"31,497.74","157,488.68"
06-Nov-2023,Reversal,00.00,"26,248.11","131,240.57"
06-Nov-2023,Reversal,07.50,00.00,"131,248.07"
06-Nov-2023,ATM,"208,025.00",00.00,"339,273.07"
06-Nov-2023,Transfer,00.00,"339,273.07",00.00
06-Nov-2023,Transfer,04.77,00.00,04.77
06-Nov-2023,IMPS,"85,559.00",00.00,"85,563.77"
06-Nov-2023,Debit Card,00.00,"8,556.38","77,007.39"
06-Nov-2023,Reversal,"238,822.80",00.00,"315,830.19"
06-Nov-2023,Transfer,00.00,"157,915.10","157,915.10"
06-Nov-2023,Transfer,00.00,"78,957.55","78,957.55"
06-Nov-2023,Interest,00.00,"13,159.59","65,797.96"
06-Nov-2023,Interest,00.00,"8,224.75","57,573.22"
06-Nov-2023,Transfer,"2,260.00",00.00,"59,833.22"
06-Nov-2023,Miscellaneous,"161,516.00",00.00,"221,349.22"
06-Nov-2023,Cheque,00.00,"221,349.22",00.00
06-Nov-2023,Debit Card,"2,604.00",00.00,"2,604.00"
06-Nov-2023,IMPS,"26,544.40",00.00,"29,148.40"
06-Nov-2023,RTGS,02.60,00.00,"29,151.00"
06-Nov-2023,RTGS,"13,345.00",00.00,"42,496.00"
06-Nov-2023,Tax,"3,443.40",00.00,"45,939.40"
06-Nov-2023,Bill,89.30,00.00,"46,028.70"
06-Nov-2023,Tax,396.00,00.00,"46,424.70"
07-Nov-2023,Reversal,"142,691.90",00.00,"189,116.60"
07-Nov-2023,Cash,00.00,"63,038.87","126,077.73"
07-Nov-2023,Purchase,37.60,00.00,"126,115.33"
07-Nov-2023,Debit Card,00.00,"42,038.44","84,076.89"
07-Nov-2023,RTGS,00.00,"9,341.88","74,735.01"
07-Nov-2023,Purchase,01.30,00.00,"74,736.31"
07-Nov-2023,Transfer,00.00,"37,368.16","37,368.16"
07-Nov-2023,Debit Card,00.00,"12,456.05","24,912.11"
07-Nov-2023,Debit Card,00.00,"4,152.02","20,760.09"
07-Nov-2023,Reversal,"7,641.00",00.00,"28,401.09"
08-Nov-2023,Cash,00.00,"3,155.68","25,245.41"
08-Nov-2023,IMPS,00.00,"12,622.71","12,622.70"
08-Nov-2023,Miscellaneous,"13,590.50",00.00,"26,213.20"
08-Nov-2023,IMPS,00.00,"8,737.73","17,475.47"
08-Nov-2023,Reversal,00.00,"2,912.58","14,562.89"
08-Nov-2023,ATM,"30,365.27",00.00,"44,928.16"
08-Nov-2023,Tax,00.00,"14,976.05","29,952.11"
09-Nov-2023,IMPS,00.00,"9,984.04","19,968.07"
09-Nov-2023,ATM,99.63,00.00,"20,067.70"
10-Nov-2023,RTGS,00.00,"5,016.93","15,050.78"
10-Nov-2023,Cash,"4,664.30",00.00,"19,715.08"
10-Nov-2023,Cash,00.00,"2,816.44","16,898.64"
10-Nov-2023,Miscellaneous,04.80,00.00,"16,903.44"
10-Nov-2023,Commission,00.00,"16,903.44",00.00
10-Nov-2023,Tax,132.00,00.00,132.00
10-Nov-2023,Bill,00.00,13.20,118.80
10-Nov-2023,NEFT,00.00,23.76,95.04
10-Nov-2023,Debit Card,00.00,19.01,76.03
10-Nov-2023,RTGS,00.00,38.02,38.02
10-Nov-2023,Debit Card,00.00,04.75,33.27
10-Nov-2023,NEFT,45.00,00.00,78.27
10-Nov-2023,IMPS,00.00,07.83,70.44
10-Nov-2023,Cash,00.00,17.61,52.83
10-Nov-2023,Commission,"20,536.20",00.00,"20,589.03"
10-Nov-2023,IMPS,52.76,00.00,"20,641.79"
10-Nov-2023,Cash,00.00,"4,128.36","16,513.43"
10-Nov-2023,ATM,00.00,"1,834.83","14,678.60"
10-Nov-2023,RTGS,153.00,00.00,"14,831.60"
10-Nov-2023,Cheque,00.00,"2,118.80","12,712.80"
10-Nov-2023,Cash,01.00,00.00,"12,713.80"
10-Nov-2023,RTGS,"2,564.80",00.00,"15,278.60"
10-Nov-2023,Cash,00.00,"3,055.72","12,222.88"
10-Nov-2023,IMPS,00.00,"2,037.15","10,185.73"
10-Nov-2023,RTGS,00.00,"2,546.43","7,639.30"
10-Nov-2023,Reversal,"4,039.00",00.00,"11,678.30"
10-Nov-2023,ATM,00.00,"5,839.15","5,839.15"
10-Nov-2023,Transfer,00.00,"1,459.79","4,379.36"
10-Nov-2023,Interest,"296,169.25",00.00,"300,548.61"
10-Nov-2023,Commission,156.80,00.00,"300,705.41"
10-Nov-2023,Miscellaneous,44.30,00.00,"300,749.71"
10-Nov-2023,Cash,00.00,"75,187.43","225,562.28"
10-Nov-2023,Tax,42.00,00.00,"225,604.28"
10-Nov-2023,Reversal,00.00,"56,401.07","169,203.21"
10-Nov-2023,Commission,00.00,"33,840.64","135,362.57"
10-Nov-2023,Commission,"190,928.00",00.00,"326,290.57"
10-Nov-2023,Purchase,00.00,"108,763.52","217,527.05"
10-Nov-2023,RTGS,00.00,"21,752.71","195,774.34"
10-Nov-2023,Cash,19.00,00.00,"195,793.34"
10-Nov-2023,Miscellaneous,"1,968,330.00",00.00,"2,164,123.34"
10-Nov-2023,Reversal,"3,936.00",00.00,"2,168,059.34"
10-Nov-2023,Transfer,00.00,"722,686.45","1,445,372.89"
10-Nov-2023,Bill,"3,362.50",00.00,"1,448,735.39"
10-Nov-2023,Purchase,"92,524.69",00.00,"1,541,260.08"
10-Nov-2023,Cheque,00.00,"192,657.51","1,348,602.57"
10-Nov-2023,Commission,00.00,"337,150.64","1,011,451.93"
10-Nov-2023,Commission,92.00,00.00,"1,011,543.93"
10-Nov-2023,Tax,00.00,"168,590.66","842,953.28"
10-Nov-2023,Reversal,09.30,00.00,"842,962.58"
10-Nov-2023,ATM,62.30,00.00,"843,024.88"
10-Nov-2023,RTGS,00.00,"93,669.43","749,355.45"
10-Nov-2023,Cash,00.00,"83,261.72","666,093.73"
10-Nov-2023,Reversal,60.01,00.00,"666,153.74"
10-Nov-2023,Cash,38.00,00.00,"666,191.74"
10-Nov-2023,Tax,00.00,"666,191.74",00.00
10-Nov-2023,Cash,04.00,00.00,04.00
10-Nov-2023,Miscellaneous,"11,474.47",00.00,"11,478.47"
10-Nov-2023,Interest,00.00,"3,826.16","7,652.31"
10-Nov-2023,Cash,29.90,00.00,"7,682.21"
10-Nov-2023,Debit Card,00.00,"1,280.37","6,401.84"
10-Nov-2023,Commission,00.00,800.23,"5,601.61"
10-Nov-2023,ATM,00.00,560.16,"5,041.45"
10-Nov-2023,RTGS,"1,052,975.00",00.00,"1,058,016.45"
10-Nov-2023,RTGS,00.00,"352,672.15","705,344.30"
10-Nov-2023,Purchase,"252,384.53",00.00,"957,728.83"
10-Nov-2023,Cheque,00.00,"957,728.83",00.00
10-Nov-2023,Tax,"1,945,986.00",00.00,"1,945,986.00"
10-Nov-2023,IMPS,"24,989.00",00.00,"1,970,975.00"
11-Nov-2023,Miscellaneous,"2,361.00",00.00,"1,973,336.00"
11-Nov-2023,ATM,56.90,00.00,"1,973,392.90"
11-Nov-2023,NEFT,174.20,00.00,"1,973,567.10"
11-Nov-2023,Debit Card,00.00,"197,356.71","1,776,210.39"
11-Nov-2023,NEFT,00.00,"253,744.34","1,522,466.05"
11-Nov-2023,Reversal,00.00,"380,616.51","1,141,849.54"
11-Nov-2023,Interest,"173,569.00",00.00,"1,315,418.54"
11-Nov-2023,Debit Card,"28,683.00",00.00,"1,344,101.54"
11-Nov-2023,Bill,02.04,00.00,"1,344,103.58"
11-Nov-2023,Reversal,00.00,"448,034.53","896,069.05"
11-Nov-2023,Cheque,"169,159.30",00.00,"1,065,228.35"
11-Nov-2023,Debit Card,"14,599.90",00.00,"1,079,828.25"
11-Nov-2023,NEFT,00.00,"359,942.75","719,885.50"
11-Nov-2023,ATM,"3,380.10",00.00,"723,265.60"
11-Nov-2023,Cash,23.63,00.00,"723,289.23"
11-Nov-2023,Commission,00.00,"103,327.03","619,962.20"
11-Nov-2023,Cash,50.04,00.00,"620,012.24"
11-Nov-2023,Tax,00.00,"310,006.12","310,006.12"
11-Nov-2023,IMPS,00.00,"38,750.77","271,255.36"
11-Nov-2023,Cash,112.00,00.00,"271,367.36"
11-Nov-2023,Purchase,55.23,00.00,"271,422.59"
11-Nov-2023,NEFT,501.50,00.00,"271,924.09"
11-Nov-2023,Tax,"261,778.00",00.00,"533,702.09"
11-Nov-2023,Miscellaneous,00.00,"533,702.09",00.00
11-Nov-2023,Cheque,"866,329.00",00.00,"866,329.00"
11-Nov-2023,Bill,06.64,00.00,"866,335.64"
11-Nov-2023,Tax,01.60,00.00,"866,337.24"
11-Nov-2023,Cheque,00.00,"96,259.69","770,077.55"
11-Nov-2023,Tax,00.00,"77,007.76","693,069.80"
11-Nov-2023,Purchase,00.00,"86,633.73","606,436.08"
11-Nov-2023,Commission,"3,069.00",00.00,"609,505.08"
11-Nov-2023,NEFT,02.90,00.00,"609,507.98"
11-Nov-2023,Interest,00.00,"304,753.99","304,753.99"
11-Nov-2023,Interest,00.00,"33,861.55","270,892.44"
11-Nov-2023,Miscellaneous,00.00,"30,099.16","240,793.28"
11-Nov-2023,Purchase,00.00,"120,396.64","120,396.64"
11-Nov-2023,NEFT,712.25,00.00,"121,108.89"
11-Nov-2023,Commission,00.00,"30,277.22","90,831.67"
11-Nov-2023,NEFT,00.00,"90,831.67",00.00
11-Nov-2023,Reversal,"5,187.00",00.00,"5,187.00"
11-Nov-2023,Commission,00.00,"1,729.00","3,458.00"
11-Nov-2023,IMPS,00.00,384.22,"3,073.78"
11-Nov-2023,IMPS,00.00,384.22,"2,689.56"
11-Nov-2023,Purchase,169.00,00.00,"2,858.56"
11-Nov-2023,IMPS,22.58,00.00,"2,881.14"
12-Nov-2023,Miscellaneous,"49,633.25",00.00,"52,514.39"
12-Nov-2023,Miscellaneous,00.00,"7,502.06","45,012.33"
12-Nov-2023,Transfer,00.00,"5,626.54","39,385.79"
12-Nov-2023,Tax,00.00,"9,846.45","29,539.34"
12-Nov-2023,Cheque,"3,573.00",00.00,"33,112.34"
12-Nov-2023,ATM,"1,127.00",00.00,"34,239.34"
12-Nov-2023,Transfer,"2,658.83",00.00,"36,898.17"
12-Nov-2023,Transfer,"1,355,214.25",00.00,"1,392,112.42"
12-Nov-2023,NEFT,00.00,"139,211.24","1,252,901.18"
12-Nov-2023,Tax,"15,471.00",00.00,"1,268,372.18"
12-Nov-2023,NEFT,35.82,00.00,"1,268,408.00"
12-Nov-2023,IMPS,00.00,"126,840.80","1,141,567.20"
12-Nov-2023,Commission,"3,207.00",00.00,"1,144,774.20"
12-Nov-2023,ATM,00.00,"114,477.42","1,030,296.78"
13-Nov-2023,Transfer,"24,366.00",00.00,"1,054,662.78"
13-Nov-2023,Reversal,00.00,"210,932.56","843,730.22"
13-Nov-2023,ATM,"1,732.70",00.00,"845,462.92"
13-Nov-2023,Reversal,00.00,"105,682.87","739,780.06"
13-Nov-2023,Cash,05.30,00.00,"739,785.36"
13-Nov-2023,Interest,00.00,"184,946.34","554,839.02"
13-Nov-2023,Tax,00.00,"110,967.80","443,871.22"
13-Nov-2023,NEFT,00.00,"73,978.54","369,892.68"
13-Nov-2023,Transfer,00.00,"73,978.54","295,914.14"
13-Nov-2023,RTGS,24.00,00.00,"295,938.14"
13-Nov-2023,Purchase,59.00,00.00,"295,997.14"
13-Nov-2023,Transfer,"3,263.00",00.00,"299,260.14"
13-Nov-2023,RTGS,"17,573.71",00.00,"316,833.85"
13-Nov-2023,NEFT,00.00,"52,805.64","264,028.21"
13-Nov-2023,Miscellaneous,"29,009.36",00.00,"293,037.57"
13-Nov-2023,Cash,"10,106.00",00.00,"303,143.57"
13-Nov-2023,Interest,476.00,00.00,"303,619.57"
13-Nov-2023,Reversal,00.00,"75,904.89","227,714.68"
13-Nov-2023,ATM,"3,342.94",00.00,"231,057.62"
13-Nov-2023,Commission,00.00,"46,211.52","184,846.10"
13-Nov-2023,Interest,07.40,00.00,"184,853.50"
13-Nov-2023,Purchase,00.00,"61,617.83","123,235.67"
13-Nov-2023,NEFT,00.00,"61,617.84","61,617.84"
13-Nov-2023,Cheque,00.00,"12,323.57","49,294.27"
13-Nov-2023,Transfer,00.00,"9,858.85","39,435.42"
13-Nov-2023,Debit Card,00.00,"7,887.08","31,548.34"
13-Nov-2023,Cash,06.20,00.00,"31,554.54"
13-Nov-2023,NEFT,"20,907.00",00.00,"52,461.54"
13-Nov-2023,Commission,"26,000.00",00.00,"78,461.54"
13-Nov-2023,NEFT,00.00,"39,230.77","39,230.77"
13-Nov-2023,Purchase,00.00,"6,538.46","32,692.31"
13-Nov-2023,Miscellaneous,03.72,00.00,"32,696.03"
13-Nov-2023,Transfer,47.00,00.00,"32,743.03"
13-Nov-2023,Reversal,00.00,"16,371.52","16,371.52"
13-Nov-2023,Interest,00.00,"2,046.44","14,325.08"
13-Nov-2023,Interest,04.00,00.00,"14,329.08"
13-Nov-2023,Cash,00.00,"3,582.27","10,746.81"
13-Nov-2023,Tax,"7,988.00",00.00,"18,734.81"
13-Nov-2023,Commission,"149,183.00",00.00,"167,917.81"
13-Nov-2023,Reversal,00.00,"41,979.45","125,938.36"
13-Nov-2023,NEFT,"17,544.66",00.00,"143,483.02"
13-Nov-2023,Tax,"2,032,050.25",00.00,"2,175,533.27"
13-Nov-2023,Commission,00.00,"241,725.92","1,933,807.35"
13-Nov-2023,Tax,302.10,00.00,"1,934,109.45"
13-Nov-2023,Tax,00.00,"967,054.73","967,054.72"
13-Nov-2023,Miscellaneous,00.00,"107,450.52","859,604.20"
13-Nov-2023,RTGS,00.00,"859,604.20",00.00
13-Nov-2023,Miscellaneous,218.00,00.00,218.00
13-Nov-2023,NEFT,08.00,00.00,226.00
13-Nov-2023,Purchase,"29,244.38",00.00,"29,470.38"
13-Nov-2023,Tax,00.00,"5,894.08","23,576.30"
13-Nov-2023,Commission,"1,073,238.00",00.00,"1,096,814.30"
13-Nov-2023,Commission,00.00,"121,868.26","974,946.04"
13-Nov-2023,Tax,00.00,"243,736.51","731,209.53"
13-Nov-2023,Cheque,00.00,"731,209.53",00.00
13-Nov-2023,Tax,56.83,00.00,56.83
13-Nov-2023,Debit Card,"985,686.50",00.00,"985,743.33"
13-Nov-2023,Tax,00.20,00.00,"985,743.53"
13-Nov-2023,Purchase,00.00,"246,435.88","739,307.65"
13-Nov-2023,ATM,126.12,00.00,"739,433.77"
13-Nov-2023,IMPS,00.00,"123,238.96","616,194.81"
13-Nov-2023,Interest,00.00,"88,027.83","528,166.98"
13-Nov-2023,Purchase,420.00,00.00,"528,586.98"
13-Nov-2023,Purchase,00.00,"88,097.83","440,489.15"
13-Nov-2023,Reversal,00.00,"73,414.86","367,074.29"
13-Nov-2023,RTGS,48.10,00.00,"367,122.39"
13-Nov-2023,Reversal,00.00,"91,780.60","275,341.79"
13-Nov-2023,Cheque,00.00,"27,534.18","247,807.61"
13-Nov-2023,Debit Card,02.00,00.00,"247,809.61"
13-Nov-2023,ATM,47.20,00.00,"247,856.81"
13-Nov-2023,Miscellaneous,"1,940,945.00",00.00,"2,188,801.81"
13-Nov-2023,Purchase,380.68,00.00,"2,189,182.49"
13-Nov-2023,Transfer,00.00,"1,094,591.25","1,094,591.25"
13-Nov-2023,Tax,00.00,"136,823.91","957,767.34"
13-Nov-2023,Cash,00.00,"119,720.92","838,046.42"
13-Nov-2023,Transfer,00.00,"279,348.81","558,697.61"
13-Nov-2023,ATM,00.00,"79,813.94","478,883.67"
13-Nov-2023,Cash,00.00,"53,209.30","425,674.37"
13-Nov-2023,Bill,632.00,00.00,"426,306.37"
13-Nov-2023,Commission,315.41,00.00,"426,621.78"
13-Nov-2023,Cheque,142.21,00.00,"426,763.99"
13-Nov-2023,ATM,50.36,00.00,"426,814.35"
14-Nov-2023,Debit Card,00.00,"47,423.82","379,390.53"
14-Nov-2023,Tax,"149,166.00",00.00,"528,556.53"
14-Nov-2023,Reversal,00.00,"105,711.31","422,845.22"
14-Nov-2023,Commission,00.00,"84,569.04","338,276.18"
14-Nov-2023,ATM,"18,018.95",00.00,"356,295.13"
15-Nov-2023,Tax,00.00,"71,259.03","285,036.10"
15-Nov-2023,Debit Card,"94,485.81",00.00,"379,521.91"
15-Nov-2023,NEFT,00.00,"189,760.96","189,760.96"
15-Nov-2023,IMPS,00.00,"47,440.24","142,320.72"
15-Nov-2023,Debit Card,00.00,"142,320.72",00.00
15-Nov-2023,Bill,"1,053,386.00",00.00,"1,053,386.00"
15-Nov-2023,Cash,00.00,"263,346.50","790,039.50"
15-Nov-2023,Purchase,25.94,00.00,"790,065.44"
15-Nov-2023,Commission,00.00,"87,785.05","702,280.39"
15-Nov-2023,NEFT,503.78,00.00,"702,784.17"
16-Nov-2023,IMPS,381.99,00.00,"703,166.16"
16-Nov-2023,IMPS,00.00,"234,388.72","468,777.44"
16-Nov-2023,Tax,00.00,"52,086.38","416,691.06"
16-Nov-2023,NEFT,00.00,"208,345.53","208,345.53"
16-Nov-2023,Debit Card,"139,907.90",00.00,"348,253.43"
17-Nov-2023,Commission,"8,631.00",00.00,"356,884.43"
17-Nov-2023,Cheque,"21,412.00",00.00,"378,296.43"
17-Nov-2023,Miscellaneous,00.00,"378,296.43",00.00
17-Nov-2023,Debit Card,"90,716.28",00.00,"90,716.28"
17-Nov-2023,Cheque,"17,467.80",00.00,"108,184.08"
17-Nov-2023,Interest,24.20,00.00,"108,208.28"
17-Nov-2023,Reversal,00.00,"12,023.14","96,185.14"
17-Nov-2023,Cash,00.00,"24,046.29","72,138.86"
17-Nov-2023,ATM,00.00,"7,213.89","64,924.97"
17-Nov-2023,Tax,00.00,"7,213.89","57,711.08"
17-Nov-2023,Commission,00.00,"9,618.51","48,092.57"
18-Nov-2023,Purchase,06.00,00.00,"48,098.57"
18-Nov-2023,Cash,"202,573.00",00.00,"250,671.57"
18-Nov-2023,Debit Card,24.40,00.00,"250,695.97"
18-Nov-2023,Interest,"71,025.00",00.00,"321,720.97"
18-Nov-2023,Commission,"323,307.00",00.00,"645,027.97"
18-Nov-2023,RTGS,00.00,"129,005.59","516,022.38"
18-Nov-2023,Miscellaneous,"3,667.49",00.00,"519,689.87"
18-Nov-2023,Commission,00.00,"51,968.99","467,720.88"
18-Nov-2023,Commission,31.00,00.00,"467,751.88"
18-Nov-2023,Purchase,04.70,00.00,"467,756.58"
18-Nov-2023,Reversal,"25,888.20",00.00,"493,644.78"
18-Nov-2023,IMPS,00.00,"98,728.96","394,915.82"
18-Nov-2023,Cheque,"1,766,417.00",00.00,"2,161,332.82"
18-Nov-2023,Cash,02.17,00.00,"2,161,334.99"
18-Nov-2023,RTGS,"66,615.80",00.00,"2,227,950.79"
18-Nov-2023,Transfer,381.80,00.00,"2,228,332.59"
18-Nov-2023,IMPS,00.00,"247,592.51","1,980,740.08"
18-Nov-2023,Transfer,"3,714.42",00.00,"1,984,454.50"
18-Nov-2023,ATM,412.00,00.00,"1,984,866.50"
18-Nov-2023,Purchase,00.00,"283,552.36","1,701,314.14"
18-Nov-2023,NEFT,00.00,"425,328.54","1,275,985.60"
18-Nov-2023,Cheque,00.00,"318,996.40","956,989.20"
18-Nov-2023,ATM,00.00,"119,623.65","837,365.55"
18-Nov-2023,Transfer,"3,709.00",00.00,"841,074.55"
18-Nov-2023,Reversal,"2,572.00",00.00,"843,646.55"
18-Nov-2023,Purchase,00.00,"93,738.51","749,908.04"
18-Nov-2023,Tax,00.00,"83,323.12","666,584.92"
18-Nov-2023,Cash,"677,582.00",00.00,"1,344,166.92"
19-Nov-2023,Reversal,00.00,"1,344,166.92",00.00
19-Nov-2023,Miscellaneous,"3,246.90",00.00,"3,246.90"
19-Nov-2023,NEFT,00.00,541.15,"2,705.75"
19-Nov-2023,NEFT,00.00,541.15,"2,164.60"
19-Nov-2023,IMPS,00.00,360.77,"1,803.83"
19-Nov-2023,Cheque,00.00,180.38,"1,623.45"
19-Nov-2023,Miscellaneous,00.00,231.92,"1,391.53"
19-Nov-2023,Debit Card,11.10,00.00,"1,402.63"
19-Nov-2023,NEFT,"80,976.41",00.00,"82,379.04"
19-Nov-2023,Purchase,192.53,00.00,"82,571.57"
19-Nov-2023,Cheque,00.00,"8,257.16","74,314.41"
19-Nov-2023,Reversal,00.00,"8,257.16","66,057.25"
19-Nov-2023,Miscellaneous,00.00,"7,339.69","58,717.56"
19-Nov-2023,Miscellaneous,06.10,00.00,"58,723.66"
19-Nov-2023,Debit Card,923.57,00.00,"59,647.23"
19-Nov-2023,IMPS,12.80,00.00,"59,660.03"
19-Nov-2023,Cash,"2,036,137.00",00.00,"2,095,797.03"
19-Nov-2023,Interest,"119,668.40",00.00,"2,215,465.43"
19-Nov-2023,NEFT,03.40,00.00,"2,215,468.83"
19-Nov-2023,Reversal,00.00,"369,244.81","1,846,224.02"
19-Nov-2023,Debit Card,461.60,00.00,"1,846,685.62"
19-Nov-2023,RTGS,00.00,"615,561.87","1,231,123.75"
19-Nov-2023,Purchase,00.00,"175,874.82","1,055,248.93"
19-Nov-2023,Interest,00.00,"150,749.85","904,499.08"
19-Nov-2023,IMPS,00.00,"904,499.08",00.00
19-Nov-2023,Bill,07.07,00.00,07.07
19-Nov-2023,Tax,"3,663.00",00.00,"3,670.07"
19-Nov-2023,Interest,"19,182.00",00.00,"22,852.07"
19-Nov-2023,Bill,00.00,"5,713.02","17,139.05"
19-Nov-2023,Purchase,04.50,00.00,"17,143.55"
19-Nov-2023,Purchase,"114,614.00",00.00,"131,757.55"
19-Nov-2023,RTGS,00.00,"13,175.76","118,581.79"
19-Nov-2023,IMPS,"24,574.00",00.00,"143,155.79"
19-Nov-2023,Purchase,"117,937.88",00.00,"261,093.67"
19-Nov-2023,RTGS,03.00,00.00,"261,096.67"
19-Nov-2023,Debit Card,00.00,"26,109.67","234,987.00"
19-Nov-2023,IMPS,"2,029,944.00",00.00,"2,264,931.00"
19-Nov-2023,Cheque,00.00,"1,132,465.50","1,132,465.50"
19-Nov-2023,Miscellaneous,02.00,00.00,"1,132,467.50"
19-Nov-2023,Commission,"232,135.00",00.00,"1,364,602.50"
19-Nov-2023,Cheque,05.00,00.00,"1,364,607.50"
19-Nov-2023,ATM,00.00,"682,303.75","682,303.75"
19-Nov-2023,Transfer,00.00,"227,434.58","454,869.17"
19-Nov-2023,Transfer,00.00,"45,486.92","409,382.25"
19-Nov-2023,RTGS,13.59,00.00,"409,395.84"
19-Nov-2023,NEFT,"167,106.00",00.00,"576,501.84"
19-Nov-2023,Interest,06.61,00.00,"576,508.45"
19-Nov-2023,NEFT,00.00,"115,301.69","461,206.76"
19-Nov-2023,NEFT,29.70,00.00,"461,236.46"
19-Nov-2023,IMPS,"887,163.00",00.00,"1,348,399.46"
19-Nov-2023,Miscellaneous,00.00,"674,199.73","674,199.73"
19-Nov-2023,Purchase,00.00,"224,733.24","449,466.49"
19-Nov-2023,RTGS,00.00,"49,940.72","399,525.77"
19-Nov-2023,Bill,00.00,"39,952.58","359,573.19"
19-Nov-2023,NEFT,01.00,00.00,"359,574.19"
20-Nov-2023,Bill,00.00,"44,946.77","314,627.42"
20-Nov-2023,Transfer,00.00,"104,875.81","209,751.61"
20-Nov-2023,Cheque,341.00,00.00,"210,092.61"
20-Nov-2023,ATM,"23,757.00",00.00,"233,849.61"
20-Nov-2023,Transfer,00.00,"29,231.20","204,618.41"
20-Nov-2023,Cheque,00.00,"102,309.21","102,309.20"
20-Nov-2023,Reversal,00.00,"25,577.30","76,731.90"
20-Nov-2023,Cheque,"1,714,375.80",00.00,"1,791,107.70"
20-Nov-2023,Transfer,229.80,00.00,"1,791,337.50"
20-Nov-2023,Interest,00.00,"597,112.50","1,194,225.00"
20-Nov-2023,Reversal,00.00,"149,278.13","1,044,946.88"
20-Nov-2023,Reversal,01.00,00.00,"1,044,947.88"
20-Nov-2023,NEFT,"147,607.10",00.00,"1,192,554.98"
20-Nov-2023,NEFT,44.40,00.00,"1,192,599.38"
20-Nov-2023,Transfer,00.00,"1,192,599.38",00.00
20-Nov-2023,Interest,54.20,00.00,54.20
20-Nov-2023,Purchase,10.06,00.00,64.26
20-Nov-2023,Reversal,57.50,00.00,121.76
20-Nov-2023,ATM,40.19,00.00,161.95
20-Nov-2023,IMPS,00.00,20.24,141.71
20-Nov-2023,Cheque,"250,433.80",00.00,"250,575.51"
20-Nov-2023,Debit Card,"184,382.80",00.00,"434,958.31"
20-Nov-2023,NEFT,07.70,00.00,"434,966.01"
20-Nov-2023,Cash,710.70,00.00,"435,676.71"
20-Nov-2023,Miscellaneous,"3,624.10",00.00,"439,300.81"
20-Nov-2023,IMPS,00.00,"439,300.81",00.00
20-Nov-2023,Transfer,44.00,00.00,44.00
20-Nov-2023,NEFT,"247,302.80",00.00,"247,346.80"
20-Nov-2023,Interest,294.87,00.00,"247,641.67"
20-Nov-2023,Debit Card,04.00,00.00,"247,645.67"
20-Nov-2023,Debit Card,00.00,"27,516.19","220,129.48"
20-Nov-2023,IMPS,"2,089,817.75",00.00,"2,309,947.23"
20-Nov-2023,Miscellaneous,"3,531.60",00.00,"2,313,478.83"
20-Nov-2023,Debit Card,"1,540,735.20",00.00,"3,854,214.03"
20-Nov-2023,IMPS,00.00,"770,842.81","3,083,371.22"
20-Nov-2023,Purchase,15.00,00.00,"3,083,386.22"
20-Nov-2023,Purchase,18.00,00.00,"3,083,404.22"
20-Nov-2023,Cheque,"1,774,914.25",00.00,"4,858,318.47"
20-Nov-2023,NEFT,07.21,00.00,"4,858,325.68"
20-Nov-2023,Transfer,00.00,"607,290.71","4,251,034.97"
20-Nov-2023,Purchase,"2,334.00",00.00,"4,253,368.97"
20-Nov-2023,Tax,00.00,"2,126,684.49","2,126,684.48"
20-Nov-2023,Purchase,00.00,"303,812.07","1,822,872.41"
20-Nov-2023,NEFT,00.00,"303,812.07","1,519,060.34"
20-Nov-2023,NEFT,89.10,00.00,"1,519,149.44"
20-Nov-2023,Reversal,"1,056,424.00",00.00,"2,575,573.44"
20-Nov-2023,Interest,04.47,00.00,"2,575,577.91"
20-Nov-2023,ATM,00.00,"1,287,788.96","1,287,788.96"
20-Nov-2023,Cheque,00.00,"160,973.62","1,126,815.34"
20-Nov-2023,RTGS,53.00,00.00,"1,126,868.34"
20-Nov-2023,NEFT,"13,551.83",00.00,"1,140,420.17"
21-Nov-2023,Miscellaneous,"24,555.09",00.00,"1,164,975.26"
21-Nov-2023,Commission,05.00,00.00,"1,164,980.26"
21-Nov-2023,Tax,00.00,"166,425.75","998,554.51"
21-Nov-2023,Interest,00.00,"199,710.90","798,843.61"
21-Nov-2023,Reversal,00.00,"399,421.81","399,421.80"
21-Nov-2023,Debit Card,22.30,00.00,"399,444.10"
21-Nov-2023,IMPS,34.71,00.00,"399,478.81"
21-Nov-2023,Cash,"4,046.60",00.00,"403,525.41"
21-Nov-2023,Transfer,00.00,"201,762.71","201,762.70"
21-Nov-2023,NEFT,00.00,"67,254.23","134,508.47"
21-Nov-2023,Miscellaneous,"176,670.53",00.00,"311,179.00"
21-Nov-2023,Interest,"155,655.00",00.00,"466,834.00"
21-Nov-2023,IMPS,"2,069,618.00",00.00,"2,536,452.00"
21-Nov-2023,Cash,00.00,"362,350.29","2,174,101.71"
21-Nov-2023,Cash,02.00,00.00,"2,174,103.71"
21-Nov-2023,Transfer,00.00,"217,410.37","1,956,693.34"
21-Nov-2023,Purchase,285.00,00.00,"1,956,978.34"
21-Nov-2023,Debit Card,00.00,"244,622.29","1,712,356.05"
21-Nov-2023,IMPS,"6,887.40",00.00,"1,719,243.45"
21-Nov-2023,RTGS,"116,524.00",00.00,"1,835,767.45"
21-Nov-2023,Debit Card,00.00,"1,835,767.45",00.00
21-Nov-2023,Transfer,32.26,00.00,32.26
21-Nov-2023,Transfer,03.00,00.00,35.26
21-Nov-2023,Cash,00.00,35.26,00.00
21-Nov-2023,Purchase,03.25,00.00,03.25
21-Nov-2023,Transfer,00.00,00.54,02.71
21-Nov-2023,Miscellaneous,"4,789.00",00.00,"4,791.71"
21-Nov-2023,Miscellaneous,00.00,"1,597.24","3,194.47"
21-Nov-2023,Transfer,08.00,00.00,"3,202.47"
21-Nov-2023,ATM,00.00,800.62,"2,401.85"
21-Nov-2023,Bill,"6,403.55",00.00,"8,805.40"
21-Nov-2023,ATM,00.00,"2,201.35","6,604.05"
21-Nov-2023,Cash,"3,886.09",00.00,"10,490.14"
21-Nov-2023,Reversal,00.00,"1,498.59","8,991.55"
21-Nov-2023,Commission,39.59,00.00,"9,031.14"
21-Nov-2023,Cash,61.00,00.00,"9,092.14"
21-Nov-2023,Reversal,00.00,"1,010.24","8,081.90"
21-Nov-2023,Purchase,"18,299.40",00.00,"26,381.30"
21-Nov-2023,Debit Card,00.00,"3,768.76","22,612.54"
21-Nov-2023,IMPS,"2,828.05",00.00,"25,440.59"
21-Nov-2023,Reversal,07.66,00.00,"25,448.25"
22-Nov-2023,Reversal,00.00,"2,544.83","22,903.42"
22-Nov-2023,RTGS,00.00,"22,903.42",00.00
22-Nov-2023,ATM,07.90,00.00,07.90
23-Nov-2023,Debit Card,07.00,00.00,14.90
23-Nov-2023,Commission,"3,405.00",00.00,"3,419.90"
23-Nov-2023,Bill,00.00,488.56,"2,931.34"
24-Nov-2023,Reversal,57.70,00.00,"2,989.04"
24-Nov-2023,Commission,00.00,"2,989.04",00.00
24-Nov-2023,RTGS,45.30,00.00,45.30
25-Nov-2023,Bill,00.00,04.53,40.77
25-Nov-2023,NEFT,"17,552.10",00.00,"17,592.87"
25-Nov-2023,ATM,00.00,"4,398.22","13,194.65"
25-Nov-2023,Cheque,00.00,"1,884.95","11,309.70"
25-Nov-2023,Cash,"16,727.30",00.00,"28,037.00"
25-Nov-2023,Debit Card,00.00,"4,672.83","23,364.17"
25-Nov-2023,NEFT,"12,893.00",00.00,"36,257.17"
25-Nov-2023,ATM,00.00,"12,085.72","24,171.45"
25-Nov-2023,Debit Card,02.97,00.00,"24,174.42"
25-Nov-2023,Cash,00.23,00.00,"24,174.65"
25-Nov-2023,Reversal,00.00,"12,087.33","12,087.32"
25-Nov-2023,Purchase,00.00,"1,343.04","10,744.28"
25-Nov-2023,Transfer,"3,006.24",00.00,"13,750.52"
25-Nov-2023,Interest,00.00,"13,750.52",00.00
25-Nov-2023,Tax,"9,326.00",00.00,"9,326.00"
25-Nov-2023,Debit Card,00.00,"1,036.22","8,289.78"
25-Nov-2023,IMPS,00.00,"2,072.45","6,217.34"
25-Nov-2023,Miscellaneous,00.00,"3,108.67","3,108.67"
25-Nov-2023,ATM,00.00,"3,108.67",00.00
25-Nov-2023,Reversal,"8,712.80",00.00,"8,712.80"
26-Nov-2023,IMPS,00.00,"8,712.80",00.00
26-Nov-2023,Bill,05.80,00.00,05.80
26-Nov-2023,Tax,00.00,01.45,04.35
26-Nov-2023,IMPS,00.00,00.87,03.48
26-Nov-2023,Bill,00.00,00.87,02.61
26-Nov-2023,IMPS,"25,016.00",00.00,"25,018.61"
26-Nov-2023,IMPS,00.00,"6,254.65","18,763.96"
26-Nov-2023,Reversal,00.00,"6,254.65","12,509.31"
26-Nov-2023,RTGS,"18,149.00",00.00,"30,658.31"
26-Nov-2023,Interest,00.00,"15,329.16","15,329.16"
26-Nov-2023,Debit Card,00.00,"5,109.72","10,219.44"
26-Nov-2023,NEFT,00.00,"1,021.94","9,197.50"
26-Nov-2023,Bill,448.00,00.00,"9,645.50"
26-Nov-2023,IMPS,00.00,"9,645.50",00.00
26-Nov-2023,Miscellaneous,262.30,00.00,262.30
26-Nov-2023,RTGS,00.00,131.15,131.15
26-Nov-2023,Bill,00.00,26.23,104.92
26-Nov-2023,Purchase,00.00,10.49,94.43
26-Nov-2023,NEFT,"612,187.00",00.00,"612,281.43"
26-Nov-2023,Bill,"9,880.40",00.00,"622,161.83"
26-Nov-2023,IMPS,59.52,00.00,"622,221.35"
26-Nov-2023,Reversal,00.00,"103,703.56","518,517.79"
26-Nov-2023,Tax,01.60,00.00,"518,519.39"
27-Nov-2023,Transfer,"1,760,499.50",00.00,"2,279,018.89"
27-Nov-2023,RTGS,12.80,00.00,"2,279,031.69"
27-Nov-2023,Bill,00.00,"455,806.34","1,823,225.35"
27-Nov-2023,IMPS,00.00,"260,460.76","1,562,764.59"
27-Nov-2023,NEFT,00.21,00.00,"1,562,764.80"
27-Nov-2023,Transfer,00.00,"223,252.11","1,339,512.69"
27-Nov-2023,ATM,00.00,"167,439.09","1,172,073.60"
27-Nov-2023,Purchase,"793,011.80",00.00,"1,965,085.40"
27-Nov-2023,Transfer,00.00,"655,028.47","1,310,056.93"
28-Nov-2023,Commission,"21,036.90",00.00,"1,331,093.83"
28-Nov-2023,Commission,"1,394,355.00",00.00,"2,725,448.83"
28-Nov-2023,Cheque,00.00,"272,544.88","2,452,903.95"
28-Nov-2023,IMPS,"162,792.60",00.00,"2,615,696.55"
28-Nov-2023,Transfer,00.00,"653,924.14","1,961,772.41"
28-Nov-2023,Commission,43.50,00.00,"1,961,815.91"
28-Nov-2023,Reversal,972.00,00.00,"1,962,787.91"
28-Nov-2023,IMPS,00.00,"327,131.32","1,635,656.59"
28-Nov-2023,Tax,391.05,00.00,"1,636,047.64"
28-Nov-2023,NEFT,00.00,"545,349.21","1,090,698.43"
28-Nov-2023,IMPS,00.00,"109,069.84","981,628.59"
28-Nov-2023,Cash,00.00,"981,628.59",00.00
28-Nov-2023,Debit Card,"1,415,074.00",00.00,"1,415,074.00"
28-Nov-2023,RTGS,"123,574.50",00.00,"1,538,648.50"
28-Nov-2023,Debit Card,00.00,"512,882.83","1,025,765.67"
28-Nov-2023,Miscellaneous,00.00,"341,921.89","683,843.78"
28-Nov-2023,RTGS,"27,076.00",00.00,"710,919.78"
29-Nov-2023,IMPS,420.30,00.00,"711,340.08"
29-Nov-2023,NEFT,"27,901.80",00.00,"739,241.88"
29-Nov-2023,Miscellaneous,00.00,"246,413.96","492,827.92"
29-Nov-2023,NEFT,00.00,"82,137.99","410,689.93"
29-Nov-2023,Cheque,00.00,"68,448.32","342,241.61"
29-Nov-2023,Cheque,00.00,"342,241.61",00.00
29-Nov-2023,ATM,"5,209.20",00.00,"5,209.20"
29-Nov-2023,Interest,"89,461.41",00.00,"94,670.61"
29-Nov-2023,Bill,"31,594.62",00.00,"126,265.23"
29-Nov-2023,NEFT,07.00,00.00,"126,272.23"
29-Nov-2023,Transfer,00.00,"15,784.03","110,488.20"
29-Nov-2023,Purchase,"4,756.00",00.00,"115,244.20"
29-Nov-2023,Miscellaneous,00.00,"19,207.37","96,036.83"
29-Nov-2023,Interest,00.00,"13,719.55","82,317.28"
29-Nov-2023,Bill,11.01,00.00,"82,328.29"
30-Nov-2023,NEFT,"147,665.00",00.00,"229,993.29"
30-Nov-2023,Reversal,00.00,"32,856.18","197,137.11"
30-Nov-2023,Reversal,00.00,"28,162.44","168,974.67"
30-Nov-2023,Interest,447.80,00.00,"169,422.47"
30-Nov-2023,Purchase,400.71,00.00,"169,823.18"
30-Nov-2023,RTGS,00.00,"33,964.64","135,858.54"
30-Nov-2023,IMPS,126.55,00.00,"135,985.09"
30-Nov-2023,Miscellaneous,00.00,"22,664.18","113,320.91"
30-Nov-2023,Debit Card,"6,670.91",00.00,"119,991.82"
30-Nov-2023,IMPS,00.00,"39,997.27","79,994.55"
30-Nov-2023,Debit Card,"237,561.00",00.00,"317,555.55"
30-Nov-2023,RTGS,00.00,"158,777.78","158,777.78"
30-Nov-2023,Reversal,00.00,"79,388.89","79,388.89"
30-Nov-2023,Cash,00.00,"15,877.78","63,511.11"
30-Nov-2023,RTGS,"1,082.00",00.00,"64,593.11"
30-Nov-2023,IMPS,00.00,"8,074.14","56,518.97"
30-Nov-2023,Tax,00.00,"11,303.79","45,215.18"
30-Nov-2023,NEFT,00.00,"6,459.31","38,755.87"
30-Nov-2023,Cheque,00.00,"4,306.21","34,449.66"
30-Nov-2023,Transfer,"31,643.10",00.00,"66,092.76"
30-Nov-2023,Purchase,"96,160.25",00.00,"162,253.01"
30-Nov-2023,Commission,00.00,"18,028.11","144,224.90"
30-Nov-2023,Commission,"13,441.00",00.00,"157,665.90"
30-Nov-2023,Miscellaneous,00.00,"26,277.65","131,388.25"
30-Nov-2023,RTGS,"1,908,547.00",00.00,"2,039,935.25"
30-Nov-2023,Cash,60.00,00.00,"2,039,995.25"
01-Dec-2023,Cheque,05.50,00.00,"2,040,000.75"
02-Dec-2023,Debit Card,00.00,"204,000.08","1,836,000.68"
02-Dec-2023,Interest,00.00,"262,285.81","1,573,714.87"
02-Dec-2023,Commission,"1,454.00",00.00,"1,575,168.87"
02-Dec-2023,Cash,40.60,00.00,"1,575,209.47"
02-Dec-2023,Cash,55.72,00.00,"1,575,265.19"
02-Dec-2023,Cash,00.00,"787,632.60","787,632.60"
02-Dec-2023,Cash,00.00,"157,526.52","630,106.08"
02-Dec-2023,Reversal,00.00,"630,106.08",00.00
02-Dec-2023,Debit Card,44.06,00.00,44.06
02-Dec-2023,Reversal,00.00,08.81,35.25
02-Dec-2023,Miscellaneous,00.00,03.53,31.72
02-Dec-2023,Purchase,00.00,15.86,15.86
02-Dec-2023,Purchase,00.00,01.59,14.27
02-Dec-2023,RTGS,00.00,14.27,00.00
02-Dec-2023,Bill,"1,303,577.00",00.00,"1,303,577.00"
02-Dec-2023,NEFT,00.00,"144,841.89","1,158,735.11"
02-Dec-2023,IMPS,00.00,"1,158,735.11",00.00
02-Dec-2023,Tax,61.60,00.00,61.60
02-Dec-2023,Miscellaneous,00.00,07.70,53.90
03-Dec-2023,Interest,00.00,13.48,40.42
03-Dec-2023,NEFT,00.00,10.11,30.32
03-Dec-2023,Transfer,"207,925.00",00.00,"207,955.32"
03-Dec-2023,Debit Card,"709,711.00",00.00,"917,666.32"
03-Dec-2023,Cash,00.00,"91,766.63","825,899.69"
03-Dec-2023,RTGS,00.97,00.00,"825,900.66"
04-Dec-2023,Cheque,00.00,"412,950.33","412,950.33"
04-Dec-2023,Interest,00.00,"206,475.17","206,475.16"
04-Dec-2023,Tax,11.00,00.00,"206,486.16"
04-Dec-2023,Transfer,00.00,"25,810.77","180,675.39"
04-Dec-2023,Purchase,336.00,00.00,"181,011.39"
04-Dec-2023,Interest,00.00,"25,858.77","155,152.62"
04-Dec-2023,Tax,00.00,"17,239.18","137,913.44"
04-Dec-2023,Cash,00.00,"45,971.15","91,942.29"
04-Dec-2023,NEFT,"4,035.78",00.00,"95,978.07"
04-Dec-2023,Bill,"3,398.41",00.00,"99,376.48"
04-Dec-2023,Cash,"1,691.90",00.00,"101,068.38"
04-Dec-2023,NEFT,"2,174.30",00.00,"103,242.68"
04-Dec-2023,Transfer,00.00,"17,207.11","86,035.57"
04-Dec-2023,NEFT,47.00,00.00,"86,082.57"
04-Dec-2023,Interest,00.00,"86,082.57",00.00
04-Dec-2023,Cash,"28,425.56",00.00,"28,425.56"
04-Dec-2023,Commission,"22,288.53",00.00,"50,714.09"
04-Dec-2023,Transfer,00.00,"6,339.26","44,374.83"
04-Dec-2023,NEFT,00.00,"6,339.26","38,035.57"
04-Dec-2023,Interest,00.00,"5,433.65","32,601.92"
04-Dec-2023,Cash,00.00,"4,075.24","28,526.68"
04-Dec-2023,Commission,"8,367.80",00.00,"36,894.48"
04-Dec-2023,Cash,00.00,"7,378.90","29,515.58"
04-Dec-2023,Interest,00.00,"5,903.12","23,612.46"
04-Dec-2023,ATM,485.84,00.00,"24,098.30"
04-Dec-2023,Interest,"16,775.50",00.00,"40,873.80"
04-Dec-2023,Tax,"9,350.10",00.00,"50,223.90"
04-Dec-2023,Bill,00.00,"5,580.43","44,643.47"
04-Dec-2023,Debit Card,00.00,"8,928.69","35,714.78"
04-Dec-2023,Tax,61.00,00.00,"35,775.78"
04-Dec-2023,Miscellaneous,00.00,"3,577.58","32,198.20"
04-Dec-2023,ATM,00.00,"6,439.64","25,758.56"
04-Dec-2023,Purchase,"1,035,472.25",00.00,"1,061,230.81"
05-Dec-2023,Tax,00.00,"530,615.41","530,615.40"
05-Dec-2023,Cash,00.00,"75,802.20","454,813.20"
06-Dec-2023,Debit Card,00.00,"90,962.64","363,850.56"
06-Dec-2023,Tax,00.00,"90,962.64","272,887.92"
06-Dec-2023,RTGS,00.00,"30,320.88","242,567.04"
06-Dec-2023,Tax,00.00,"121,283.52","121,283.52"
06-Dec-2023,Bill,04.00,00.00,"121,287.52"
06-Dec-2023,Transfer,06.85,00.00,"121,294.37"
06-Dec-2023,Cheque,00.00,"15,161.80","106,132.57"
06-Dec-2023,RTGS,"173,250.47",00.00,"279,383.04"
06-Dec-2023,Commission,"2,085.46",00.00,"281,468.50"
06-Dec-2023,Reversal,00.00,"281,468.50",00.00
06-Dec-2023,Debit Card,178.90,00.00,178.90
06-Dec-2023,ATM,00.00,44.73,134.18
06-Dec-2023,ATM,"3,907.00",00.00,"4,041.18"
06-Dec-2023,Transfer,"110,947.53",00.00,"114,988.71"
06-Dec-2023,RTGS,00.00,"14,373.59","100,615.12"
06-Dec-2023,ATM,00.00,"16,769.19","83,845.93"
06-Dec-2023,Cash,01.30,00.00,"83,847.23"
06-Dec-2023,Commission,00.00,"11,978.18","71,869.05"
06-Dec-2023,Interest,"1,825,737.00",00.00,"1,897,606.05"
06-Dec-2023,RTGS,264.10,00.00,"1,897,870.15"
06-Dec-2023,Cash,789.50,00.00,"1,898,659.65"
06-Dec-2023,NEFT,"1,743,362.20",00.00,"3,642,021.85"
06-Dec-2023,Bill,"8,036.30",00.00,"3,650,058.15"
06-Dec-2023,Cheque,00.00,"456,257.27","3,193,800.88"
06-Dec-2023,Cheque,59.68,00.00,"3,193,860.56"
06-Dec-2023,Reversal,00.00,"798,465.14","2,395,395.42"
06-Dec-2023,Bill,00.00,"798,465.14","1,596,930.28"
06-Dec-2023,Purchase,"1,470,418.75",00.00,"3,067,349.03"
06-Dec-2023,Commission,425.00,00.00,"3,067,774.03"
06-Dec-2023,Tax,00.00,"306,777.40","2,760,996.63"
06-Dec-2023,IMPS,379.80,00.00,"2,761,376.43"
06-Dec-2023,Interest,32.00,00.00,"2,761,408.43"
06-Dec-2023,Transfer,34.09,00.00,"2,761,442.52"
06-Dec-2023,Purchase,"1,419,787.20",00.00,"4,181,229.72"
06-Dec-2023,IMPS,00.00,"696,871.62","3,484,358.10"
06-Dec-2023,Reversal,920.00,00.00,"3,485,278.10"
07-Dec-2023,Cash,00.00,"871,319.53","2,613,958.58"
07-Dec-2023,Purchase,00.00,"261,395.86","2,352,562.72"
07-Dec-2023,Transfer,00.00,"261,395.86","2,091,166.86"
07-Dec-2023,IMPS,109.00,00.00,"2,091,275.86"
07-Dec-2023,Commission,60.70,00.00,"2,091,336.56"
07-Dec-2023,Tax,00.00,"418,267.31","1,673,069.25"
07-Dec-2023,Commission,00.00,"1,673,069.25",00.00
07-Dec-2023,Debit Card,"1,385,182.80",00.00,"1,385,182.80"
08-Dec-2023,IMPS,00.00,"277,036.56","1,108,146.24"
08-Dec-2023,NEFT,00.00,"369,382.08","738,764.16"
08-Dec-2023,Cheque,37.00,00.00,"738,801.16"
08-Dec-2023,Debit Card,37.50,00.00,"738,838.66"
08-Dec-2023,ATM,00.00,"147,767.73","591,070.93"
08-Dec-2023,Cash,00.00,"98,511.82","492,559.11"
08-Dec-2023,Debit Card,"7,118.50",00.00,"499,677.61"
08-Dec-2023,Cheque,426.50,00.00,"500,104.11"
08-Dec-2023,Cheque,"3,826.70",00.00,"503,930.81"
08-Dec-2023,Purchase,"11,770.41",00.00,"515,701.22"
08-Dec-2023,NEFT,00.00,"515,701.22",00.00
08-Dec-2023,Bill,"2,360.00",00.00,"2,360.00"
08-Dec-2023,IMPS,25.74,00.00,"2,385.74"
08-Dec-2023,Miscellaneous,00.00,477.15,"1,908.59"
08-Dec-2023,Tax,00.00,190.86,"1,717.73"
08-Dec-2023,Miscellaneous,07.00,00.00,"1,724.73"
08-Dec-2023,Debit Card,00.00,191.64,"1,533.09"
08-Dec-2023,NEFT,00.00,511.03,"1,022.06"
08-Dec-2023,Purchase,00.00,170.34,851.72
08-Dec-2023,RTGS,00.00,94.64,757.08
08-Dec-2023,RTGS,"1,363,203.50",00.00,"1,363,960.58"
08-Dec-2023,Transfer,00.00,"272,792.12","1,091,168.46"
08-Dec-2023,Transfer,"71,890.00",00.00,"1,163,058.46"
08-Dec-2023,Cheque,"30,633.00",00.00,"1,193,691.46"
08-Dec-2023,Bill,00.00,"170,527.35","1,023,164.11"
08-Dec-2023,Interest,50.99,00.00,"1,023,215.10"
08-Dec-2023,Debit Card,00.00,"102,321.51","920,893.59"
08-Dec-2023,Commission,00.00,"184,178.72","736,714.87"
08-Dec-2023,Cheque,"35,635.00",00.00,"772,349.87"
08-Dec-2023,NEFT,00.00,"154,469.97","617,879.90"
08-Dec-2023,Miscellaneous,"1,865.00",00.00,"619,744.90"
08-Dec-2023,Debit Card,00.00,"77,468.11","542,276.79"
08-Dec-2023,Bill,"1,915,220.50",00.00,"2,457,497.29"
08-Dec-2023,IMPS,00.00,"819,165.76","1,638,331.53"
08-Dec-2023,Purchase,04.00,00.00,"1,638,335.53"
08-Dec-2023,Commission,"129,737.22",00.00,"1,768,072.75"
08-Dec-2023,Miscellaneous,00.00,"1,768,072.75",00.00
09-Dec-2023,Reversal,"1,475.00",00.00,"1,475.00"
09-Dec-2023,Interest,186.00,00.00,"1,661.00"
09-Dec-2023,Transfer,507.10,00.00,"2,168.10"
09-Dec-2023,RTGS,03.60,00.00,"2,171.70"
09-Dec-2023,Commission,00.00,723.90,"1,447.80"
10-Dec-2023,Purchase,00.00,"1,447.80",00.00
10-Dec-2023,Cheque,04.00,00.00,04.00
10-Dec-2023,NEFT,00.00,00.40,03.60
10-Dec-2023,Debit Card,"16,906.00",00.00,"16,909.60"
10-Dec-2023,Bill,00.00,"1,878.84","15,030.76"
10-Dec-2023,Commission,06.00,00.00,"15,036.76"
10-Dec-2023,Miscellaneous,00.00,"3,007.35","12,029.41"
10-Dec-2023,Cheque,10.44,00.00,"12,039.85"
10-Dec-2023,Transfer,"108,615.25",00.00,"120,655.10"
10-Dec-2023,NEFT,00.00,"120,655.10",00.00
10-Dec-2023,Debit Card,"151,243.00",00.00,"151,243.00"
11-Dec-2023,Tax,00.00,"30,248.60","120,994.40"
11-Dec-2023,ATM,"1,833,573.00",00.00,"1,954,567.40"
11-Dec-2023,Transfer,00.00,"195,456.74","1,759,110.66"
11-Dec-2023,Miscellaneous,00.00,"879,555.33","879,555.33"
12-Dec-2023,IMPS,527.80,00.00,"880,083.13"
13-Dec-2023,ATM,00.00,"110,010.39","770,072.74"
13-Dec-2023,Purchase,00.00,"385,036.37","385,036.37"
13-Dec-2023,NEFT,00.00,"42,781.82","342,254.55"
13-Dec-2023,NEFT,00.00,"42,781.82","299,472.73"
13-Dec-2023,Cash,00.00,"59,894.55","239,578.18"
13-Dec-2023,Cheque,26.00,00.00,"239,604.18"
13-Dec-2023,Bill,"51,510.00",00.00,"291,114.18"
13-Dec-2023,Transfer,00.00,"145,557.09","145,557.09"
13-Dec-2023,Tax,486.29,00.00,"146,043.38"
13-Dec-2023,Transfer,00.00,"146,043.38",00.00
13-Dec-2023,Cash,08.00,00.00,08.00
13-Dec-2023,Transfer,"22,360.10",00.00,"22,368.10"
13-Dec-2023,IMPS,00.00,"11,184.05","11,184.05"
13-Dec-2023,Cheque,09.00,00.00,"11,193.05"
13-Dec-2023,Cash,00.00,"1,865.51","9,327.54"
13-Dec-2023,Reversal,22.50,00.00,"9,350.04"
13-Dec-2023,Cheque,"503,708.00",00.00,"513,058.04"
13-Dec-2023,ATM,70.00,00.00,"513,128.04"
13-Dec-2023,RTGS,00.00,"102,625.61","410,502.43"
13-Dec-2023,ATM,00.00,"102,625.61","307,876.82"
13-Dec-2023,NEFT,324.85,00.00,"308,201.67"
13-Dec-2023,Transfer,00.00,"102,733.89","205,467.78"
13-Dec-2023,Miscellaneous,"288,984.50",00.00,"494,452.28"
13-Dec-2023,Commission,00.00,"123,613.07","370,839.21"
13-Dec-2023,Cash,00.00,"370,839.21",00.00
13-Dec-2023,Transfer,"313,069.75",00.00,"313,069.75"
13-Dec-2023,Miscellaneous,00.00,"313,069.75",00.00
13-Dec-2023,Cash,"1,166.40",00.00,"1,166.40"
13-Dec-2023,Commission,00.00,"1,166.40",00.00
13-Dec-2023,IMPS,01.00,00.00,01.00
13-Dec-2023,Debit Card,00.00,00.20,00.80
13-Dec-2023,Cheque,"13,924.30",00.00,"13,925.10"
13-Dec-2023,Miscellaneous,00.00,"1,392.51","12,532.59"
13-Dec-2023,NEFT,89.20,00.00,"12,621.79"
13-Dec-2023,NEFT,06.01,00.00,"12,627.80"
13-Dec-2023,Purchase,00.00,"4,209.27","8,418.53"
13-Dec-2023,Miscellaneous,00.00,"1,052.32","7,366.21"
13-Dec-2023,Tax,166.00,00.00,"7,532.21"
13-Dec-2023,NEFT,04.50,00.00,"7,536.71"
13-Dec-2023,Transfer,"1,795,452.20",00.00,"1,802,988.91"
13-Dec-2023,Debit Card,"3,963.75",00.00,"1,806,952.66"
14-Dec-2023,Cash,00.00,"180,695.27","1,626,257.39"
14-Dec-2023,ATM,00.00,"203,282.17","1,422,975.22"
14-Dec-2023,Purchase,"1,254.81",00.00,"1,424,230.03"
14-Dec-2023,Bill,00.00,"712,115.02","712,115.02"
14-Dec-2023,Miscellaneous,"20,521.70",00.00,"732,636.72"
14-Dec-2023,Bill,00.00,"81,404.08","651,232.64"
14-Dec-2023,Cash,"82,828.30",00.00,"734,060.94"
14-Dec-2023,Tax,"466,036.00",00.00,"1,200,096.94"
14-Dec-2023,Commission,00.00,"300,024.24","900,072.70"
14-Dec-2023,Reversal,00.00,"150,012.12","750,060.58"
14-Dec-2023,Commission,00.00,"107,151.51","642,909.07"
14-Dec-2023,NEFT,"26,347.88",00.00,"669,256.95"
14-Dec-2023,ATM,66.00,00.00,"669,322.95"
14-Dec-2023,Reversal,53.67,00.00,"669,376.62"
14-Dec-2023,NEFT,"2,831.00",00.00,"672,207.62"
14-Dec-2023,Bill,563.96,00.00,"672,771.58"
14-Dec-2023,NEFT,"82,949.75",00.00,"755,721.33"
14-Dec-2023,Purchase,"28,164.00",00.00,"783,885.33"
14-Dec-2023,Miscellaneous,00.00,"87,098.37","696,786.96"
14-Dec-2023,Purchase,330.00,00.00,"697,116.96"
14-Dec-2023,Reversal,00.00,"348,558.48","348,558.48"
15-Dec-2023,Transfer,00.00,"69,711.70","278,846.78"
15-Dec-2023,Bill,00.00,"139,423.39","139,423.39"
15-Dec-2023,Debit Card,"801,248.00",00.00,"940,671.39"
15-Dec-2023,Reversal,"1,767,819.80",00.00,"2,708,491.19"
15-Dec-2023,Tax,43.50,00.00,"2,708,534.69"
15-Dec-2023,Interest,00.00,"386,933.53","2,321,601.16"
15-Dec-2023,ATM,00.00,"2,321,601.16",00.00
15-Dec-2023,Tax,"9,356.98",00.00,"9,356.98"
15-Dec-2023,ATM,"9,353.45",00.00,"18,710.43"
15-Dec-2023,Cheque,504.00,00.00,"19,214.43"
15-Dec-2023,Tax,00.00,"2,134.94","17,079.49"
15-Dec-2023,Commission,00.00,"17,079.49",00.00
15-Dec-2023,ATM,"488,631.50",00.00,"488,631.50"
15-Dec-2023,NEFT,07.90,00.00,"488,639.40"
15-Dec-2023,IMPS,"240,736.10",00.00,"729,375.50"
15-Dec-2023,IMPS,00.00,"182,343.88","547,031.62"
15-Dec-2023,Commission,"6,010.80",00.00,"553,042.42"
15-Dec-2023,NEFT,474.10,00.00,"553,516.52"
15-Dec-2023,Cheque,00.00,"69,189.57","484,326.96"
15-Dec-2023,Purchase,07.73,00.00,"484,334.69"
15-Dec-2023,Cheque,00.00,"484,334.69",00.00
15-Dec-2023,Commission,"7,069.50",00.00,"7,069.50"
15-Dec-2023,RTGS,63.07,00.00,"7,132.57"
15-Dec-2023,Debit Card,"101,897.30",00.00,"109,029.87"
15-Dec-2023,Purchase,00.00,"36,343.29","72,686.58"
15-Dec-2023,Debit Card,425.00,00.00,"73,111.58"
15-Dec-2023,NEFT,33.18,00.00,"73,144.76"
15-Dec-2023,Miscellaneous,00.00,"14,628.95","58,515.81"
15-Dec-2023,Bill,46.00,00.00,"58,561.81"
15-Dec-2023,Transfer,"26,992.10",00.00,"85,553.91"
15-Dec-2023,Transfer,20.00,00.00,"85,573.91"
15-Dec-2023,Cash,48.77,00.00,"85,622.68"
15-Dec-2023,NEFT,00.00,"9,513.63","76,109.05"
15-Dec-2023,Reversal,"218,184.78",00.00,"294,293.83"
15-Dec-2023,RTGS,49.00,00.00,"294,342.83"
15-Dec-2023,Transfer,00.00,"73,585.71","220,757.12"
15-Dec-2023,IMPS,00.00,"55,189.28","165,567.84"
15-Dec-2023,Tax,"148,837.20",00.00,"314,405.04"
15-Dec-2023,Miscellaneous,"6,372.50",00.00,"320,777.54"
15-Dec-2023,Commission,00.00,"320,777.54",00.00
15-Dec-2023,ATM,37.80,00.00,37.80
15-Dec-2023,Miscellaneous,"10,506.69",00.00,"10,544.49"
15-Dec-2023,Debit Card,00.00,"2,108.90","8,435.59"
15-Dec-2023,Miscellaneous,00.00,843.56,"7,592.03"
15-Dec-2023,Debit Card,76.63,00.00,"7,668.66"
15-Dec-2023,Reversal,03.70,00.00,"7,672.36"
15-Dec-2023,IMPS,"45,147.00",00.00,"52,819.36"
15-Dec-2023,Debit Card,"6,100.00",00.00,"58,919.36"
15-Dec-2023,Commission,00.00,"14,729.84","44,189.52"
15-Dec-2023,Cheque,"1,953,170.00",00.00,"1,997,359.52"
15-Dec-2023,Cheque,"173,508.00",00.00,"2,170,867.52"
15-Dec-2023,NEFT,04.90,00.00,"2,170,872.42"
15-Dec-2023,Reversal,05.00,00.00,"2,170,877.42"
15-Dec-2023,Miscellaneous,00.00,"271,359.68","1,899,517.74"
15-Dec-2023,Purchase,00.30,00.00,"1,899,518.04"
15-Dec-2023,Bill,51.82,00.00,"1,899,569.86"
15-Dec-2023,Bill,"4,503.51",00.00,"1,904,073.37"
15-Dec-2023,Debit Card,04.40,00.00,"1,904,077.77"
15-Dec-2023,ATM,"3,735.00",00.00,"1,907,812.77"
15-Dec-2023,Interest,01.00,00.00,"1,907,813.77"
15-Dec-2023,Transfer,"99,703.44",00.00,"2,007,517.21"
16-Dec-2023,Cash,00.00,"200,751.72","1,806,765.49"
16-Dec-2023,Debit Card,"1,759,685.00",00.00,"3,566,450.49"
16-Dec-2023,Bill,00.00,"445,806.31","3,120,644.18"
16-Dec-2023,Tax,00.00,"624,128.84","2,496,515.34"
16-Dec-2023,RTGS,"10,379.47",00.00,"2,506,894.81"
16-Dec-2023,Interest,53.00,00.00,"2,506,947.81"
16-Dec-2023,Cash,"81,911.47",00.00,"2,588,859.28"
16-Dec-2023,Transfer,"138,058.20",00.00,"2,726,917.48"
16-Dec-2023,Cheque,00.00,"302,990.83","2,423,926.65"
16-Dec-2023,Transfer,00.00,"269,325.18","2,154,601.47"
16-Dec-2023,Commission,"1,290.00",00.00,"2,155,891.47"
16-Dec-2023,Cheque,00.00,"269,486.43","1,886,405.04"
16-Dec-2023,Cash,"20,149.07",00.00,"1,906,554.11"
16-Dec-2023,ATM,00.00,"476,638.53","1,429,915.58"
16-Dec-2023,Purchase,00.00,"285,983.12","1,143,932.46"
16-Dec-2023,Tax,"8,222.00",00.00,"1,152,154.46"
16-Dec-2023,Debit Card,04.00,00.00,"1,152,158.46"
17-Dec-2023,NEFT,00.00,"164,594.07","987,564.39"
17-Dec-2023,Transfer,03.50,00.00,"987,567.89"
17-Dec-2023,NEFT,00.00,"98,756.79","888,811.10"
17-Dec-2023,Bill,"172,586.25",00.00,"1,061,397.35"
17-Dec-2023,IMPS,317.00,00.00,"1,061,714.35"
17-Dec-2023,Bill,00.00,"1,061,714.35",00.00
17-Dec-2023,Cheque,00.30,00.00,00.30
17-Dec-2023,Reversal,"11,857.70",00.00,"11,858.00"
17-Dec-2023,NEFT,06.30,00.00,"11,864.30"
17-Dec-2023,Cash,00.00,"5,932.15","5,932.15"
17-Dec-2023,Miscellaneous,00.00,"1,977.38","3,954.77"
17-Dec-2023,Debit Card,00.00,564.97,"3,389.80"
17-Dec-2023,Debit Card,"2,226.00",00.00,"5,615.80"
17-Dec-2023,Cash,00.00,701.98,"4,913.82"
17-Dec-2023,RTGS,38.73,00.00,"4,952.55"
17-Dec-2023,Commission,00.00,"4,952.55",00.00
17-Dec-2023,Bill,"31,830.50",00.00,"31,830.50"
17-Dec-2023,IMPS,"201,176.09",00.00,"233,006.59"
17-Dec-2023,Miscellaneous,00.00,"25,889.62","207,116.97"
17-Dec-2023,ATM,"674,678.25",00.00,"881,795.22"
17-Dec-2023,Interest,00.00,"220,448.81","661,346.42"
17-Dec-2023,Reversal,00.00,"132,269.28","529,077.14"
17-Dec-2023,Cash,00.00,"52,907.71","476,169.43"
17-Dec-2023,Interest,00.00,"119,042.36","357,127.07"
17-Dec-2023,Debit Card,"27,123.30",00.00,"384,250.37"
17-Dec-2023,RTGS,00.00,"42,694.49","341,555.88"
17-Dec-2023,RTGS,00.00,"68,311.18","273,244.70"
17-Dec-2023,Debit Card,"1,294,300.20",00.00,"1,567,544.90"
18-Dec-2023,Tax,00.00,"313,508.98","1,254,035.92"
18-Dec-2023,Cash,219.00,00.00,"1,254,254.92"
18-Dec-2023,Tax,00.00,"418,084.97","836,169.95"
18-Dec-2023,Reversal,52.47,00.00,"836,222.42"
18-Dec-2023,Miscellaneous,00.00,"418,111.21","418,111.21"
18-Dec-2023,Tax,00.00,"104,527.80","313,583.41"
18-Dec-2023,Transfer,00.00,"31,358.34","282,225.07"
18-Dec-2023,Interest,00.00,"141,112.54","141,112.54"
18-Dec-2023,Tax,00.00,"28,222.51","112,890.03"
18-Dec-2023,Cash,00.00,"112,890.03",00.00
18-Dec-2023,IMPS,00.90,00.00,00.90
18-Dec-2023,Cash,00.00,00.10,00.80
18-Dec-2023,Cash,00.00,00.11,00.69
18-Dec-2023,Debit Card,00.00,00.35,00.34
18-Dec-2023,Debit Card,00.00,00.11,00.23
18-Dec-2023,Reversal,00.00,00.03,00.20
18-Dec-2023,Commission,"193,129.00",00.00,"193,129.20"
18-Dec-2023,Tax,00.00,"96,564.60","96,564.60"
18-Dec-2023,Interest,09.00,00.00,"96,573.60"
18-Dec-2023,Miscellaneous,00.00,"10,730.40","85,843.20"
18-Dec-2023,Debit Card,"120,622.60",00.00,"206,465.80"
18-Dec-2023,ATM,00.00,"29,495.11","176,970.69"
18-Dec-2023,Reversal,00.00,"17,697.07","159,273.62"
18-Dec-2023,Commission,00.00,"26,545.60","132,728.02"
18-Dec-2023,Debit Card,358.60,00.00,"133,086.62"
18-Dec-2023,ATM,00.00,"22,181.10","110,905.52"
18-Dec-2023,NEFT,185.56,00.00,"111,091.08"
18-Dec-2023,IMPS,39.91,00.00,"111,130.99"
18-Dec-2023,Transfer,"218,965.38",00.00,"330,096.37"
18-Dec-2023,Purchase,"2,001.80",00.00,"332,098.17"
18-Dec-2023,NEFT,04.00,00.00,"332,102.17"
18-Dec-2023,Miscellaneous,"2,538.00",00.00,"334,640.17"
18-Dec-2023,NEFT,"12,214.80",00.00,"346,854.97"
18-Dec-2023,NEFT,03.97,00.00,"346,858.94"
18-Dec-2023,Reversal,00.00,"346,858.94",00.00
19-Dec-2023,Tax,"53,106.90",00.00,"53,106.90"
19-Dec-2023,Cheque,"10,570.00",00.00,"63,676.90"
19-Dec-2023,Miscellaneous,00.00,"12,735.38","50,941.52"
19-Dec-2023,Commission,00.00,"5,660.17","45,281.35"
19-Dec-2023,Transfer,06.57,00.00,"45,287.92"
20-Dec-2023,Reversal,00.00,"5,660.99","39,626.93"
20-Dec-2023,IMPS,222.50,00.00,"39,849.43"
20-Dec-2023,Purchase,04.00,00.00,"39,853.43"
20-Dec-2023,NEFT,53.23,00.00,"39,906.66"
20-Dec-2023,Interest,"1,499,287.00",00.00,"1,539,193.66"
20-Dec-2023,Tax,00.00,"256,532.28","1,282,661.38"
20-Dec-2023,Cheque,"2,603.60",00.00,"1,285,264.98"
20-Dec-2023,Transfer,365.00,00.00,"1,285,629.98"
20-Dec-2023,Miscellaneous,"2,737.10",00.00,"1,288,367.08"
20-Dec-2023,NEFT,04.10,00.00,"1,288,371.18"
20-Dec-2023,RTGS,"3,004.00",00.00,"1,291,375.18"
20-Dec-2023,Tax,00.00,00.00,"1,291,375.18"
20-Dec-2023,Purchase,00.00,"1,291,375.18",00.00
20-Dec-2023,Cheque,"350,961.00",00.00,"350,961.00"
20-Dec-2023,Debit Card,00.00,"70,192.20","280,768.80"
20-Dec-2023,Transfer,00.00,"31,196.53","249,572.27"
20-Dec-2023,Interest,00.00,"31,196.53","218,375.74"
20-Dec-2023,Transfer,"1,371.00",00.00,"219,746.74"
20-Dec-2023,Cash,"137,867.00",00.00,"357,613.74"
20-Dec-2023,Tax,"1,126,793.25",00.00,"1,484,406.99"
20-Dec-2023,Cash,00.00,"212,058.14","1,272,348.85"
20-Dec-2023,Interest,"230,647.00",00.00,"1,502,995.85"
20-Dec-2023,Cheque,00.00,"187,874.48","1,315,121.37"
20-Dec-2023,Bill,00.00,"164,390.17","1,150,731.20"
20-Dec-2023,Tax,61.90,00.00,"1,150,793.10"
20-Dec-2023,Commission,"933,641.80",00.00,"2,084,434.90"
20-Dec-2023,Miscellaneous,"5,309.70",00.00,"2,089,744.60"
20-Dec-2023,RTGS,"811,823.25",00.00,"2,901,567.85"
20-Dec-2023,Cash,"4,665.00",00.00,"2,906,232.85"
20-Dec-2023,Bill,00.00,"484,372.14","2,421,860.71"
20-Dec-2023,NEFT,"1,325,674.00",00.00,"3,747,534.71"
20-Dec-2023,IMPS,00.00,"374,753.47","3,372,781.24"
20-Dec-2023,Bill,"1,817.00",00.00,"3,374,598.24"
20-Dec-2023,NEFT,00.00,"374,955.36","2,999,642.88"
20-Dec-2023,NEFT,00.00,"1,499,821.44","1,499,821.44"
20-Dec-2023,NEFT,00.00,"166,646.83","1,333,174.61"
20-Dec-2023,Miscellaneous,00.00,"133,317.46","1,199,857.15"
20-Dec-2023,Interest,00.00,"599,928.58","599,928.57"
20-Dec-2023,RTGS,00.00,"149,982.14","449,946.43"
20-Dec-2023,IMPS,00.00,"149,982.14","299,964.29"
20-Dec-2023,IMPS,314.00,00.00,"300,278.29"
20-Dec-2023,Transfer,00.00,"100,092.76","200,185.53"
20-Dec-2023,Bill,"287,003.50",00.00,"487,189.03"
20-Dec-2023,Tax,00.00,"121,797.26","365,391.77"
20-Dec-2023,Purchase,"132,901.00",00.00,"498,292.77"
20-Dec-2023,Bill,00.00,"498,292.77",00.00
20-Dec-2023,Bill,80.20,00.00,80.20
20-Dec-2023,Tax,491.33,00.00,571.53
20-Dec-2023,NEFT,"296,688.00",00.00,"297,259.53"
20-Dec-2023,Debit Card,00.00,"49,543.26","247,716.28"
20-Dec-2023,RTGS,00.00,"123,858.14","123,858.14"
20-Dec-2023,Purchase,"1,709,857.25",00.00,"1,833,715.39"
20-Dec-2023,Cheque,"2,059,867.00",00.00,"3,893,582.39"
20-Dec-2023,Commission,"1,692,623.00",00.00,"5,586,205.39"
20-Dec-2023,Interest,"2,998.21",00.00,"5,589,203.60"
20-Dec-2023,Commission,190.48,00.00,"5,589,394.08"
20-Dec-2023,Interest,00.00,"558,939.41","5,030,454.67"
20-Dec-2023,Miscellaneous,96.10,00.00,"5,030,550.77"
20-Dec-2023,Interest,00.00,"838,425.13","4,192,125.64"
20-Dec-2023,Reversal,00.99,00.00,"4,192,126.63"
20-Dec-2023,Interest,07.00,00.00,"4,192,133.63"
20-Dec-2023,NEFT,02.40,00.00,"4,192,136.03"
20-Dec-2023,IMPS,00.00,"419,213.60","3,772,922.43"
20-Dec-2023,RTGS,"4,626.20",00.00,"3,777,548.63"
20-Dec-2023,Bill,00.00,"1,259,182.88","2,518,365.75"
20-Dec-2023,Commission,00.00,"2,518,365.75",00.00
21-Dec-2023,IMPS,"2,304.18",00.00,"2,304.18"
21-Dec-2023,Cheque,04.60,00.00,"2,308.78"
21-Dec-2023,Interest,00.00,"2,308.78",00.00
21-Dec-2023,Cheque,"152,347.30",00.00,"152,347.30"
21-Dec-2023,Cheque,402.72,00.00,"152,750.02"
21-Dec-2023,Bill,00.00,"76,375.01","76,375.01"
21-Dec-2023,Interest,00.00,"19,093.75","57,281.26"
21-Dec-2023,Bill,00.00,"11,456.25","45,825.01"
21-Dec-2023,Interest,00.00,"45,825.01",00.00
21-Dec-2023,Tax,350.00,00.00,350.00
21-Dec-2023,Reversal,00.00,58.33,291.67
21-Dec-2023,Bill,"31,517.00",00.00,"31,808.67"
21-Dec-2023,Reversal,00.00,"3,976.08","27,832.59"
21-Dec-2023,Cash,00.00,"4,638.77","23,193.82"
21-Dec-2023,RTGS,00.00,"2,319.38","20,874.44"
21-Dec-2023,IMPS,"32,044.80",00.00,"52,919.24"
21-Dec-2023,NEFT,00.00,"52,919.24",00.00
21-Dec-2023,Purchase,"54,423.00",00.00,"54,423.00"
21-Dec-2023,Commission,00.00,"7,774.71","46,648.29"
21-Dec-2023,Purchase,00.00,"46,648.29",00.00
21-Dec-2023,Miscellaneous,"10,899.10",00.00,"10,899.10"
21-Dec-2023,IMPS,"1,481,276.20",00.00,"1,492,175.30"
21-Dec-2023,ATM,00.00,"1,492,175.30",00.00
21-Dec-2023,ATM,"32,164.90",00.00,"32,164.90"
21-Dec-2023,Reversal,00.00,"4,020.61","28,144.29"
22-Dec-2023,Interest,10.33,00.00,"28,154.62"
22-Dec-2023,Interest,06.40,00.00,"28,161.02"
22-Dec-2023,Commission,00.00,"4,693.50","23,467.52"
22-Dec-2023,Bill,00.00,"4,693.50","18,774.02"
23-Dec-2023,Cheque,00.00,"6,258.01","12,516.01"
23-Dec-2023,Tax,06.28,00.00,"12,522.29"
23-Dec-2023,Commission,"3,556.87",00.00,"16,079.16"
23-Dec-2023,Bill,00.00,"2,297.02","13,782.14"
23-Dec-2023,Purchase,"1,690,245.00",00.00,"1,704,027.14"
23-Dec-2023,Transfer,466.40,00.00,"1,704,493.54"
23-Dec-2023,Cash,00.00,"213,061.69","1,491,431.85"
23-Dec-2023,Bill,13.70,00.00,"1,491,445.55"
23-Dec-2023,Purchase,00.00,"745,722.78","745,722.78"
23-Dec-2023,Miscellaneous,275.92,00.00,"745,998.70"
23-Dec-2023,Commission,00.00,"186,499.68","559,499.02"
23-Dec-2023,Bill,"97,657.00",00.00,"657,156.02"
23-Dec-2023,Purchase,00.00,"93,879.43","563,276.59"
23-Dec-2023,NEFT,00.00,"56,327.66","506,948.93"
23-Dec-2023,Reversal,00.00,"63,368.62","443,580.31"
23-Dec-2023,Reversal,00.00,"44,358.03","399,222.28"
23-Dec-2023,Transfer,26.00,00.00,"399,248.28"
23-Dec-2023,Debit Card,00.00,"39,924.83","359,323.45"
23-Dec-2023,IMPS,"709,195.75",00.00,"1,068,519.20"
23-Dec-2023,Bill,511.40,00.00,"1,069,030.60"
23-Dec-2023,Purchase,00.00,"213,806.12","855,224.48"
23-Dec-2023,NEFT,"639,499.00",00.00,"1,494,723.48"
23-Dec-2023,Interest,00.00,"498,241.16","996,482.32"
23-Dec-2023,RTGS,00.00,"332,160.77","664,321.55"
23-Dec-2023,Miscellaneous,00.00,"132,864.31","531,457.24"
23-Dec-2023,Interest,38.60,00.00,"531,495.84"
23-Dec-2023,Purchase,00.00,"531,495.84",00.00
23-Dec-2023,NEFT,06.00,00.00,06.00
23-Dec-2023,Interest,"526,839.25",00.00,"526,845.25"
23-Dec-2023,ATM,00.00,"105,369.05","421,476.20"
23-Dec-2023,Reversal,01.00,00.00,"421,477.20"
23-Dec-2023,Miscellaneous,02.60,00.00,"421,479.80"
24-Dec-2023,Reversal,00.00,"421,479.80",00.00
24-Dec-2023,Bill,60.00,00.00,60.00
24-Dec-2023,Transfer,00.00,06.00,54.00
24-Dec-2023,Tax,243.50,00.00,297.50
24-Dec-2023,NEFT,18.00,00.00,315.50
24-Dec-2023,Cash,603.98,00.00,919.48
24-Dec-2023,Purchase,"8,772.20",00.00,"9,691.68"
24-Dec-2023,Reversal,182.80,00.00,"9,874.48"
25-Dec-2023,Miscellaneous,474.00,00.00,"10,348.48"
25-Dec-2023,Bill,00.00,"10,348.48",00.00
25-Dec-2023,Cash,06.20,00.00,06.20
25-Dec-2023,Cheque,"184,740.40",00.00,"184,746.60"
25-Dec-2023,Reversal,"104,643.20",00.00,"289,389.80"
25-Dec-2023,Purchase,00.00,"48,231.63","241,158.17"
26-Dec-2023,Transfer,"316,240.75",00.00,"557,398.92"
26-Dec-2023,ATM,"2,362.81",00.00,"559,761.73"
26-Dec-2023,NEFT,144.00,00.00,"559,905.73"
26-Dec-2023,Miscellaneous,00.00,"55,990.57","503,915.16"
26-Dec-2023,Reversal,25.00,00.00,"503,940.16"
26-Dec-2023,Debit Card,00.00,"71,991.45","431,948.71"
26-Dec-2023,NEFT,"1,372.00",00.00,"433,320.71"
26-Dec-2023,IMPS,00.00,"54,165.09","379,155.62"
26-Dec-2023,Transfer,"1,252.00",00.00,"380,407.62"
26-Dec-2023,Debit Card,00.00,"95,101.91","285,305.71"
26-Dec-2023,IMPS,00.00,"57,061.14","228,244.57"
26-Dec-2023,ATM,46.10,00.00,"228,290.67"
26-Dec-2023,Bill,00.00,"228,290.67",00.00
27-Dec-2023,Purchase,"267,471.50",00.00,"267,471.50"
27-Dec-2023,Bill,00.00,"133,735.75","133,735.75"
27-Dec-2023,Miscellaneous,00.00,"22,289.29","111,446.46"
27-Dec-2023,IMPS,00.00,"18,574.41","92,872.05"
27-Dec-2023,Transfer,03.20,00.00,"92,875.25"
27-Dec-2023,Interest,00.00,"30,958.42","61,916.83"
27-Dec-2023,Cheque,219.31,00.00,"62,136.14"
27-Dec-2023,Cheque,01.30,00.00,"62,137.44"
27-Dec-2023,IMPS,05.00,00.00,"62,142.44"
28-Dec-2023,Debit Card,00.00,"7,767.81","54,374.64"
28-Dec-2023,Interest,283.00,00.00,"54,657.64"
28-Dec-2023,ATM,"32,037.00",00.00,"86,694.64"
29-Dec-2023,Purchase,00.00,"8,669.46","78,025.18"
29-Dec-2023,Purchase,159.50,00.00,"78,184.68"
30-Dec-2023,RTGS,"16,913.40",00.00,"95,098.08"
30-Dec-2023,Debit Card,"1,887.00",00.00,"96,985.08"
30-Dec-2023,Reversal,"1,775,228.00",00.00,"1,872,213.08"
30-Dec-2023,Purchase,00.00,"267,459.01","1,604,754.07"
30-Dec-2023,IMPS,00.00,"178,306.01","1,426,448.06"
30-Dec-2023,Miscellaneous,"1,873,257.00",00.00,"3,299,705.06"
30-Dec-2023,Tax,00.00,"824,926.27","2,474,778.80"
30-Dec-2023,Miscellaneous,00.00,"247,477.88","2,227,300.92"
30-Dec-2023,Interest,"1,366,608.00",00.00,"3,593,908.92"
30-Dec-2023,Interest,00.00,"399,323.21","3,194,585.71"
30-Dec-2023,Bill,00.00,"399,323.21","2,795,262.50"
30-Dec-2023,RTGS,"149,424.16",00.00,"2,944,686.66"
30-Dec-2023,Bill,00.00,"327,187.41","2,617,499.25"
31-Dec-2023,ATM,"3,594.00",00.00,"2,621,093.25"
31-Dec-2023,Purchase,00.00,"1,310,546.63","1,310,546.62"
31-Dec-2023,NEFT,"958,980.20",00.00,"2,269,526.82"
31-Dec-2023,NEFT,00.00,"283,690.85","1,985,835.97"
31-Dec-2023,Debit Card,"20,818.03",00.00,"2,006,654.00"
31-Dec-2023,RTGS,"23,112.62",00.00,"2,029,766.62"
31-Dec-2023,ATM,00.00,"338,294.44","1,691,472.18"
31-Dec-2023,Bill,55.80,00.00,"1,691,527.98"
31-Dec-2023,Reversal,00.00,"211,441.00","1,480,086.98"
31-Dec-2023,Bill,00.00,"493,362.33","986,724.65"
31-Dec-2023,IMPS,00.00,"164,454.11","822,270.54"
31-Dec-2023,Commission,00.00,"82,227.05","740,043.49"
31-Dec-2023,Reversal,"5,196.00",00.00,"745,239.49"
31-Dec-2023,IMPS,"93,629.50",00.00,"838,868.99"
31-Dec-2023,Reversal,00.00,"83,886.90","754,982.09"
31-Dec-2023,Interest,00.00,"83,886.90","671,095.19"
31-Dec-2023,Cheque,00.00,"111,849.20","559,245.99"
31-Dec-2023,RTGS,"207,263.00",00.00,"766,508.99"
31-Dec-2023,Cheque,00.00,"766,508.99",00.00
31-Dec-2023,IMPS,"3,169.60",00.00,"3,169.60"
31-Dec-2023,Tax,00.00,"1,584.80","1,584.80"
31-Dec-2023,Tax,00.00,264.13,"1,320.67"
31-Dec-2023,ATM,507.98,00.00,"1,828.65"
31-Dec-2023,Purchase,00.00,203.18,"1,625.47"
31-Dec-2023,NEFT,"24,062.01",00.00,"25,687.48"
31-Dec-2023,Cheque,00.00,00.00,"25,687.48"
31-Dec-2023,Tax,51.01,00.00,"25,738.49"
31-Dec-2023,Debit Card,"25,549.00",00.00,"51,287.49"
31-Dec-2023,Bill,00.00,"8,547.92","42,739.58"
31-Dec-2023,Reversal,00.00,"21,369.79","21,369.79"
31-Dec-2023,Miscellaneous,00.00,"2,136.98","19,232.81"
31-Dec-2023,Miscellaneous,00.00,"9,616.41","9,616.41"
31-Dec-2023,Transfer,"1,542,214.80",00.00,"1,551,831.21"
31-Dec-2023,Bill,00.00,"221,690.17","1,330,141.04"
31-Dec-2023,Bill,00.00,"665,070.52","665,070.52"
31-Dec-2023,Tax,00.00,"66,507.05","598,563.47"
31-Dec-2023,Reversal,"2,511.00",00.00,"601,074.47"
31-Dec-2023,Commission,00.00,"200,358.16","400,716.31"
31-Dec-2023,Debit Card,00.00,"100,179.08","300,537.23"
31-Dec-2023,Transfer,12.00,00.00,"300,549.23"
31-Dec-2023,ATM,03.00,00.00,"300,552.23"
31-Dec-2023,RTGS,00.00,"60,110.45","240,441.78"
31-Dec-2023,RTGS,00.00,"30,055.22","210,386.56"
31-Dec-2023,Bill,00.00,"52,596.64","157,789.92"
31-Dec-2023,Cheque,00.00,"19,723.74","138,066.18"
31-Dec-2023,RTGS,00.00,"138,066.18",00.00
31-Dec-2023,ATM,"2,544.45",00.00,"2,544.45"
31-Dec-2023,Cheque,00.00,282.72,"2,261.73"
31-Dec-2023,Transfer,00.00,251.30,"2,010.43"
31-Dec-2023,IMPS,"19,045.30",00.00,"21,055.73"
31-Dec-2023,IMPS,00.00,"2,339.53","18,716.20"
31-Dec-2023,Transfer,35.00,00.00,"18,751.20"
31-Dec-2023,Reversal,"1,265,958.00",00.00,"1,284,709.20"
31-Dec-2023,NEFT,286.07,00.00,"1,284,995.27"
31-Dec-2023,Tax,"631,691.20",00.00,"1,916,686.47"
31-Dec-2023,Commission,"423,989.00",00.00,"2,340,675.47"
31-Dec-2023,Commission,00.00,"468,135.09","1,872,540.38"
31-Dec-2023,Cheque,24.10,00.00,"1,872,564.48"
31-Dec-2023,IMPS,00.00,"312,094.08","1,560,470.40"
31-Dec-2023,Cheque,00.00,"780,235.20","780,235.20"
31-Dec-2023,NEFT,00.00,"260,078.40","520,156.80"
31-Dec-2023,Bill,00.00,"86,692.80","433,464.00"
31-Dec-2023,IMPS,01.00,00.00,"433,465.00"
31-Dec-2023,Transfer,00.00,"86,693.00","346,772.00"
31-Dec-2023,ATM,"20,625.50",00.00,"367,397.50"
31-Dec-2023,Miscellaneous,00.00,"73,479.50","293,918.00"
31-Dec-2023,Miscellaneous,00.00,"97,972.67","195,945.33"
31-Dec-2023,ATM,63.00,00.00,"196,008.33"
31-Dec-2023,Tax,00.00,"24,501.04","171,507.29"
31-Dec-2023,IMPS,00.00,"34,301.46","137,205.83"
31-Dec-2023,NEFT,524.20,00.00,"137,730.03"
31-Dec-2023,Reversal,00.00,"45,910.01","91,820.02"
31-Dec-2023,Debit Card,21.00,00.00,"91,841.02"
31-Dec-2023,IMPS,"170,330.31",00.00,"262,171.33"
31-Dec-2023,Reversal,38.10,00.00,"262,209.43"
31-Dec-2023,NEFT,169.71,00.00,"262,379.14"
31-Dec-2023,Cash,"158,758.97",00.00,"421,138.11"
31-Dec-2023,RTGS,00.00,"70,189.69","350,948.42"
31-Dec-2023,Reversal,"17,961.96",00.00,"368,910.38"
31-Dec-2023,Bill,"74,218.88",00.00,"443,129.26"
31-Dec-2023,Interest,00.00,"73,854.88","369,274.38"
31-Dec-2023,Reversal,359.00,00.00,"369,633.38"
31-Dec-2023,Transfer,00.00,"73,926.68","295,706.70"
31-Dec-2023,Debit Card,00.00,"49,284.45","246,422.25"
31-Dec-2023,Cash,"18,265.00",00.00,"264,687.25"
31-Dec-2023,Cash,00.00,"37,812.46","226,874.79"
31-Dec-2023,Tax,00.00,"22,687.48","204,187.31"
31-Dec-2023,Miscellaneous,"170,113.60",00.00,"374,300.91"
31-Dec-2023,IMPS,00.00,"46,787.61","327,513.30"
31-Dec-2023,RTGS,00.00,"163,756.65","163,756.65"
31-Dec-2023,Bill,00.00,"16,375.67","147,380.98"
31-Dec-2023,Debit Card,"1,582.40",00.00,"148,963.38"
31-Dec-2023,Purchase,00.00,"24,827.23","124,136.15"
31-Dec-2023,Purchase,05.80,00.00,"124,141.95"
31-Dec-2023,RTGS,"3,935.00",00.00,"128,076.95"
31-Dec-2023,Tax,00.00,"18,296.71","109,780.24"
31-Dec-2023,Bill,00.00,"27,445.06","82,335.18"
31-Dec-2023,Cash,"720,596.50",00.00,"802,931.68"
31-Dec-2023,Debit Card,00.00,"133,821.95","669,109.73"
31-Dec-2023,Tax,"2,771.65",00.00,"671,881.38"
31-Dec-2023,Debit Card,00.00,"83,985.17","587,896.21"
31-Dec-2023,Interest,03.00,00.00,"587,899.21"
31-Dec-2023,IMPS,"190,462.00",00.00,"778,361.21"
31-Dec-2023,Miscellaneous,00.00,"97,295.15","681,066.06"
31-Dec-2023,Cash,97.00,00.00,"681,163.06"
31-Dec-2023,Miscellaneous,00.00,"97,309.01","583,854.05"
31-Dec-2023,ATM,00.00,"64,872.67","518,981.38"
31-Dec-2023,RTGS,"2,524.13",00.00,"521,505.51"
31-Dec-2023,Interest,00.00,"86,917.59","434,587.92"
31-Dec-2023,Cheque,00.00,"434,587.92",00.00
31-Dec-2023,Tax,29.70,00.00,29.70
31-Dec-2023,Transfer,"3,541.00",00.00,"3,570.70"
31-Dec-2023,Miscellaneous,03.43,00.00,"3,574.13"
31-Dec-2023,Reversal,00.00,"3,574.13",00.00
31-Dec-2023,Reversal,"1,434,136.25",00.00,"1,434,136.25"
31-Dec-2023,Purchase,39.90,00.00,"1,434,176.15"
31-Dec-2023,Cheque,00.00,"179,272.02","1,254,904.13"
31-Dec-2023,Commission,00.00,"209,150.69","1,045,753.44"
31-Dec-2023,Miscellaneous,"2,809.40",00.00,"1,048,562.84"
31-Dec-2023,Bill,00.00,"104,856.28","943,706.56"
31-Dec-2023,Purchase,02.80,00.00,"943,709.36"
31-Dec-2023,Transfer,341.40,00.00,"944,050.76"
01-Jan-2024,NEFT,00.00,"314,683.59","629,367.17"
01-Jan-2024,Debit Card,00.00,"157,341.79","472,025.38"
01-Jan-2024,Cheque,"9,491.43",00.00,"481,516.81"
01-Jan-2024,RTGS,00.00,"120,379.20","361,137.61"
01-Jan-2024,Cheque,01.00,00.00,"361,138.61"
01-Jan-2024,Purchase,00.00,"90,284.65","270,853.96"
01-Jan-2024,Reversal,04.21,00.00,"270,858.17"
01-Jan-2024,Bill,00.00,"270,858.17",00.00
01-Jan-2024,Reversal,"3,566.20",00.00,"3,566.20"
01-Jan-2024,Tax,00.00,445.78,"3,120.42"
01-Jan-2024,Debit Card,00.00,780.11,"2,340.32"
01-Jan-2024,Reversal,00.00,260.04,"2,080.28"
01-Jan-2024,Cheque,56.00,00.00,"2,136.28"
01-Jan-2024,Miscellaneous,"1,120,465.00",00.00,"1,122,601.28"
01-Jan-2024,Commission,00.00,"140,325.16","982,276.12"
01-Jan-2024,Cheque,00.00,"491,138.06","491,138.06"
01-Jan-2024,IMPS,"7,973.00",00.00,"499,111.06"
01-Jan-2024,Miscellaneous,62.48,00.00,"499,173.54"
01-Jan-2024,Interest,"675,687.75",00.00,"1,174,861.29"
01-Jan-2024,Cheque,00.00,"234,972.26","939,889.03"
01-Jan-2024,NEFT,"251,309.25",00.00,"1,191,198.28"
01-Jan-2024,Debit Card,"11,948.10",00.00,"1,203,146.38"
01-Jan-2024,RTGS,00.00,"601,573.19","601,573.19"
01-Jan-2024,Cheque,00.00,"200,524.40","401,048.79"
01-Jan-2024,Tax,120.00,00.00,"401,168.79"
01-Jan-2024,Miscellaneous,"113,106.25",00.00,"514,275.04"
01-Jan-2024,Purchase,00.00,"51,427.50","462,847.54"
01-Jan-2024,NEFT,00.00,"46,284.75","416,562.79"
01-Jan-2024,NEFT,00.00,"104,140.70","312,422.09"
01-Jan-2024,Tax,"3,529.90",00.00,"315,951.99"
01-Jan-2024,ATM,"22,268.00",00.00,"338,219.99"
01-Jan-2024,RTGS,00.00,"37,580.00","300,639.99"
01-Jan-2024,Cheque,00.00,"30,064.00","270,575.99"
01-Jan-2024,Commission,00.00,"33,822.00","236,753.99"
01-Jan-2024,Tax,126.00,00.00,"236,879.99"
01-Jan-2024,Debit Card,127.86,00.00,"237,007.85"
01-Jan-2024,Reversal,00.00,"47,401.57","189,606.28"
01-Jan-2024,RTGS,00.00,"47,401.57","142,204.71"
01-Jan-2024,Commission,15.00,00.00,"142,219.71"
01-Jan-2024,RTGS,26.00,00.00,"142,245.71"
01-Jan-2024,Miscellaneous,00.00,"15,805.08","126,440.63"
01-Jan-2024,Cheque,00.00,"12,644.06","113,796.57"
01-Jan-2024,Cash,"676,346.00",00.00,"790,142.57"
01-Jan-2024,Cash,00.00,"112,877.51","677,265.06"
01-Jan-2024,ATM,00.00,"169,316.27","507,948.80"
02-Jan-2024,Tax,17.82,00.00,"507,966.62"
02-Jan-2024,Transfer,"222,589.59",00.00,"730,556.21"
02-Jan-2024,RTGS,00.00,"73,055.62","657,500.59"
02-Jan-2024,Transfer,00.00,"109,583.43","547,917.16"
02-Jan-2024,Purchase,83.00,00.00,"548,000.16"
02-Jan-2024,Debit Card,336.00,00.00,"548,336.16"
02-Jan-2024,Debit Card,00.00,"91,389.36","456,946.80"
02-Jan-2024,RTGS,135.50,00.00,"457,082.30"
02-Jan-2024,Bill,"139,931.90",00.00,"597,014.20"
02-Jan-2024,Miscellaneous,"2,544.85",00.00,"599,559.05"
02-Jan-2024,ATM,00.00,"119,911.81","479,647.24"
02-Jan-2024,ATM,00.00,"53,294.14","426,353.10"
02-Jan-2024,Cheque,385.00,00.00,"426,738.10"
02-Jan-2024,Tax,"1,987,973.80",00.00,"2,414,711.90"
02-Jan-2024,Purchase,00.00,"344,958.84","2,069,753.06"
02-Jan-2024,Cash,00.00,"258,719.13","1,811,033.93"
02-Jan-2024,Commission,"4,190.33",00.00,"1,815,224.26"
02-Jan-2024,Debit Card,"1,403,384.80",00.00,"3,218,609.06"
02-Jan-2024,Purchase,132.00,00.00,"3,218,741.06"
02-Jan-2024,Interest,00.00,"3,218,741.06",00.00
02-Jan-2024,Miscellaneous,03.38,00.00,03.38
02-Jan-2024,Cheque,00.00,01.69,01.69
02-Jan-2024,NEFT,"4,292.52",00.00,"4,294.21"
02-Jan-2024,Tax,00.00,613.46,"3,680.75"
02-Jan-2024,ATM,"11,587.00",00.00,"15,267.75"
02-Jan-2024,Cheque,00.00,"2,544.63","12,723.12"
02-Jan-2024,Bill,00.00,"12,723.12",00.00
02-Jan-2024,Cheque,"85,298.53",00.00,"85,298.53"
02-Jan-2024,Tax,00.00,"85,298.53",00.00
02-Jan-2024,Bill,"14,732.30",00.00,"14,732.30"
02-Jan-2024,Cheque,03.08,00.00,"14,735.38"
02-Jan-2024,RTGS,00.00,"1,637.26","13,098.12"
02-Jan-2024,Reversal,"1,581,185.00",00.00,"1,594,283.12"
02-Jan-2024,Interest,00.00,"797,141.56","797,141.56"
02-Jan-2024,Reversal,00.00,"99,642.70","697,498.86"
02-Jan-2024,Reversal,00.00,"139,499.77","557,999.09"
02-Jan-2024,Reversal,00.00,"55,799.91","502,199.18"
02-Jan-2024,Interest,00.00,"125,549.80","376,649.38"
02-Jan-2024,Transfer,00.00,"37,664.94","338,984.44"
02-Jan-2024,Cheque,00.00,"48,426.35","290,558.09"
02-Jan-2024,ATM,00.00,"145,279.05","145,279.05"
02-Jan-2024,NEFT,03.70,00.00,"145,282.75"
02-Jan-2024,Transfer,00.00,"48,427.58","96,855.17"
02-Jan-2024,Debit Card,00.00,"24,213.79","72,641.38"
02-Jan-2024,Tax,"1,378.10",00.00,"74,019.48"
02-Jan-2024,ATM,"110,420.00",00.00,"184,439.48"
02-Jan-2024,Cash,00.00,"30,739.91","153,699.57"
02-Jan-2024,Transfer,"19,286.00",00.00,"172,985.57"
02-Jan-2024,Commission,00.00,"28,830.93","144,154.64"
02-Jan-2024,Miscellaneous,00.00,"16,017.18","128,137.46"
02-Jan-2024,Miscellaneous,00.00,"64,068.73","64,068.73"
02-Jan-2024,Transfer,00.00,"64,068.73",00.00
02-Jan-2024,NEFT,08.00,00.00,08.00
03-Jan-2024,Cheque,00.00,01.00,07.00
03-Jan-2024,Tax,00.00,00.88,06.12
03-Jan-2024,ATM,"108,693.16",00.00,"108,699.28"
03-Jan-2024,RTGS,"47,828.38",00.00,"156,527.66"
03-Jan-2024,Purchase,00.00,"17,391.96","139,135.70"
03-Jan-2024,Commission,53.00,00.00,"139,188.70"
03-Jan-2024,Transfer,08.00,00.00,"139,196.70"
03-Jan-2024,Cheque,00.00,"15,466.30","123,730.40"
03-Jan-2024,Purchase,00.00,"24,746.08","98,984.32"
03-Jan-2024,Interest,"3,760.00",00.00,"102,744.32"
03-Jan-2024,Tax,"36,297.90",00.00,"139,042.22"
03-Jan-2024,IMPS,"186,379.00",00.00,"325,421.22"
03-Jan-2024,Reversal,25.80,00.00,"325,447.02"
03-Jan-2024,Cheque,00.00,"108,482.34","216,964.68"
03-Jan-2024,Interest,00.00,"24,107.19","192,857.49"
03-Jan-2024,Commission,00.00,"192,857.49",00.00
03-Jan-2024,ATM,899.00,00.00,899.00
03-Jan-2024,Purchase,"971,046.00",00.00,"971,945.00"
03-Jan-2024,Interest,00.00,"971,945.00",00.00
03-Jan-2024,Interest,"28,802.00",00.00,"28,802.00"
03-Jan-2024,Cheque,00.00,"5,760.40","23,041.60"
03-Jan-2024,IMPS,00.00,"3,291.66","19,749.94"
03-Jan-2024,NEFT,00.00,"4,937.49","14,812.45"
03-Jan-2024,Purchase,00.00,"1,481.25","13,331.20"
03-Jan-2024,Commission,76.48,00.00,"13,407.68"
03-Jan-2024,RTGS,00.00,"6,703.84","6,703.84"
03-Jan-2024,Miscellaneous,"18,884.43",00.00,"25,588.27"
03-Jan-2024,IMPS,"191,209.00",00.00,"216,797.27"
03-Jan-2024,Purchase,196.00,00.00,"216,993.27"
03-Jan-2024,Purchase,00.00,"108,496.64","108,496.64"
03-Jan-2024,Tax,00.00,"12,055.18","96,441.46"
03-Jan-2024,RTGS,00.00,"32,147.15","64,294.31"
03-Jan-2024,IMPS,00.00,"8,036.79","56,257.52"
03-Jan-2024,Transfer,00.00,"6,250.84","50,006.68"
03-Jan-2024,ATM,00.00,"8,334.45","41,672.23"
03-Jan-2024,Transfer,"2,274.00",00.00,"43,946.23"
03-Jan-2024,Reversal,"1,578,222.75",00.00,"1,622,168.98"
03-Jan-2024,Reversal,03.00,00.00,"1,622,171.98"
03-Jan-2024,Purchase,00.00,"231,738.85","1,390,433.13"
03-Jan-2024,Cheque,00.00,"139,043.31","1,251,389.82"
03-Jan-2024,Transfer,00.00,"1,251,389.82",00.00
03-Jan-2024,Transfer,"254,876.94",00.00,"254,876.94"
03-Jan-2024,Purchase,00.00,"25,487.69","229,389.25"
03-Jan-2024,Interest,00.00,"25,487.69","203,901.56"
03-Jan-2024,Cheque,"102,086.59",00.00,"305,988.15"
03-Jan-2024,Interest,00.00,"61,197.63","244,790.52"
03-Jan-2024,Cash,"601,002.25",00.00,"845,792.77"
03-Jan-2024,Cheque,00.00,"422,896.39","422,896.38"
03-Jan-2024,Cash,"1,182,663.80",00.00,"1,605,560.18"
03-Jan-2024,RTGS,"1,820,797.50",00.00,"3,426,357.68"
03-Jan-2024,ATM,68.75,00.00,"3,426,426.43"
03-Jan-2024,Miscellaneous,00.00,"571,071.07","2,855,355.36"
03-Jan-2024,Debit Card,00.00,"713,838.84","2,141,516.52"
03-Jan-2024,Commission,00.00,"1,070,758.26","1,070,758.26"
03-Jan-2024,IMPS,00.00,"133,844.78","936,913.48"
03-Jan-2024,RTGS,00.00,"312,304.49","624,608.99"
03-Jan-2024,NEFT,"231,322.00",00.00,"855,930.99"
03-Jan-2024,Bill,"1,241.00",00.00,"857,171.99"
03-Jan-2024,Miscellaneous,00.00,"171,434.40","685,737.59"
03-Jan-2024,NEFT,36.10,00.00,"685,773.69"
04-Jan-2024,Purchase,00.00,"685,773.69",00.00
04-Jan-2024,Transfer,884.20,00.00,884.20
04-Jan-2024,Purchase,00.00,442.10,442.10
04-Jan-2024,Cash,359.60,00.00,801.70
04-Jan-2024,Bill,00.00,80.17,721.53
04-Jan-2024,Debit Card,"539,433.50",00.00,"540,155.03"
04-Jan-2024,Cash,00.00,"60,017.23","480,137.80"
04-Jan-2024,Purchase,00.00,"160,045.93","320,091.87"
04-Jan-2024,Reversal,00.00,"35,565.76","284,526.11"
04-Jan-2024,Purchase,39.90,00.00,"284,566.01"
04-Jan-2024,IMPS,00.00,"28,456.60","256,109.41"
04-Jan-2024,RTGS,124.00,00.00,"256,233.41"
04-Jan-2024,Tax,00.00,"128,116.71","128,116.70"
04-Jan-2024,Interest,"251,976.00",00.00,"380,092.70"
04-Jan-2024,Commission,00.00,"190,046.35","190,046.35"
04-Jan-2024,Reversal,00.00,"190,046.35",00.00
04-Jan-2024,Cheque,"222,857.60",00.00,"222,857.60"
04-Jan-2024,Tax,"26,381.00",00.00,"249,238.60"
04-Jan-2024,Purchase,42.31,00.00,"249,280.91"
04-Jan-2024,IMPS,"322,900.00",00.00,"572,180.91"
04-Jan-2024,Transfer,"175,067.97",00.00,"747,248.88"
04-Jan-2024,Cash,"1,877,973.50",00.00,"2,625,222.38"
04-Jan-2024,IMPS,"192,948.70",00.00,"2,818,171.08"
04-Jan-2024,Purchase,"235,911.90",00.00,"3,054,082.98"
04-Jan-2024,ATM,"30,792.29",00.00,"3,084,875.27"
04-Jan-2024,NEFT,00.00,"440,696.47","2,644,178.80"
04-Jan-2024,Debit Card,"487,848.00",00.00,"3,132,026.80"
04-Jan-2024,Cheque,00.00,"1,566,013.40","1,566,013.40"
04-Jan-2024,IMPS,00.00,"391,503.35","1,174,510.05"
04-Jan-2024,Bill,00.00,"146,813.76","1,027,696.29"
04-Jan-2024,Tax,00.00,"1,027,696.29",00.00
04-Jan-2024,NEFT,48.40,00.00,48.40
04-Jan-2024,Interest,31.52,00.00,79.92
04-Jan-2024,Debit Card,04.72,00.00,84.64
04-Jan-2024,ATM,00.00,10.58,74.06
04-Jan-2024,Commission,"246,616.00",00.00,"246,690.06"
04-Jan-2024,Interest,10.68,00.00,"246,700.74"
04-Jan-2024,Tax,00.00,"35,242.96","211,457.78"
04-Jan-2024,Bill,00.00,"21,145.78","190,312.00"
04-Jan-2024,Reversal,59.70,00.00,"190,371.70"
04-Jan-2024,NEFT,42.00,00.00,"190,413.70"
04-Jan-2024,RTGS,"5,092.95",00.00,"195,506.65"
04-Jan-2024,NEFT,"23,951.80",00.00,"219,458.45"
04-Jan-2024,Transfer,00.00,"43,891.69","175,566.76"
04-Jan-2024,Cash,00.00,"58,522.25","117,044.51"
04-Jan-2024,Bill,40.62,00.00,"117,085.13"
04-Jan-2024,ATM,"95,907.00",00.00,"212,992.13"
04-Jan-2024,Cash,00.00,"21,299.21","191,692.92"
04-Jan-2024,Tax,00.00,"31,948.82","159,744.10"
04-Jan-2024,Tax,00.00,"53,248.03","106,496.07"
04-Jan-2024,Transfer,00.00,"15,213.72","91,282.35"
04-Jan-2024,RTGS,00.00,"11,410.29","79,872.06"
04-Jan-2024,Commission,"23,358.97",00.00,"103,231.03"
04-Jan-2024,NEFT,00.00,"34,410.34","68,820.69"
04-Jan-2024,Commission,"18,909.00",00.00,"87,729.69"
04-Jan-2024,NEFT,"174,018.88",00.00,"261,748.57"
04-Jan-2024,Cheque,00.00,"26,174.86","235,573.71"
04-Jan-2024,Cash,00.00,"23,557.37","212,016.34"
04-Jan-2024,IMPS,272.00,00.00,"212,288.34"
04-Jan-2024,ATM,"9,790.50",00.00,"222,078.84"
04-Jan-2024,Commission,00.00,"55,519.71","166,559.13"
04-Jan-2024,Cheque,"88,488.00",00.00,"255,047.13"
04-Jan-2024,Transfer,"3,279.55",00.00,"258,326.68"
04-Jan-2024,Debit Card,00.00,"258,326.68",00.00
04-Jan-2024,Miscellaneous,"2,334.00",00.00,"2,334.00"
04-Jan-2024,Tax,00.00,389.00,"1,945.00"
04-Jan-2024,Purchase,00.00,389.00,"1,556.00"
05-Jan-2024,IMPS,00.00,172.89,"1,383.11"
05-Jan-2024,Cash,01.80,00.00,"1,384.91"
05-Jan-2024,Purchase,00.00,173.11,"1,211.80"
05-Jan-2024,Purchase,00.00,173.11,"1,038.69"
05-Jan-2024,Interest,"114,624.38",00.00,"115,663.07"
05-Jan-2024,Commission,"13,606.84",00.00,"129,269.91"
05-Jan-2024,RTGS,06.22,00.00,"129,276.13"
05-Jan-2024,Miscellaneous,00.00,"16,159.52","113,116.61"
05-Jan-2024,Cash,"6,520.22",00.00,"119,636.83"
05-Jan-2024,Commission,00.00,"39,878.94","79,757.89"
05-Jan-2024,Cash,00.00,"9,969.74","69,788.15"
05-Jan-2024,Purchase,24.20,00.00,"69,812.35"
05-Jan-2024,ATM,"741,305.00",00.00,"811,117.35"
05-Jan-2024,Bill,00.00,"405,558.68","405,558.68"
05-Jan-2024,Cash,00.00,"81,111.74","324,446.94"
05-Jan-2024,Cash,00.00,"324,446.94",00.00
05-Jan-2024,Debit Card,"2,464.00",00.00,"2,464.00"
05-Jan-2024,Purchase,"151,457.97",00.00,"153,921.97"
05-Jan-2024,Interest,"3,343.30",00.00,"157,265.27"
05-Jan-2024,IMPS,00.00,"31,453.05","125,812.22"
05-Jan-2024,Miscellaneous,305.50,00.00,"126,117.72"
05-Jan-2024,RTGS,00.00,"126,117.72",00.00
05-Jan-2024,Transfer,05.00,00.00,05.00
06-Jan-2024,Interest,00.00,01.00,04.00
06-Jan-2024,Purchase,"935,546.00",00.00,"935,550.00"
06-Jan-2024,Cash,00.00,"133,650.00","801,900.00"
06-Jan-2024,Reversal,44.00,00.00,"801,944.00"
06-Jan-2024,Purchase,18.90,00.00,"801,962.90"
06-Jan-2024,Purchase,00.00,"267,320.97","534,641.93"
06-Jan-2024,Commission,00.00,"53,464.19","481,177.74"
06-Jan-2024,NEFT,00.00,"68,739.68","412,438.06"
06-Jan-2024,ATM,00.00,"45,826.45","366,611.61"
06-Jan-2024,Commission,"13,137.75",00.00,"379,749.36"
06-Jan-2024,IMPS,21.23,00.00,"379,770.59"
06-Jan-2024,NEFT,00.00,"94,942.65","284,827.94"
06-Jan-2024,Miscellaneous,"1,683,617.20",00.00,"1,968,445.14"
06-Jan-2024,Reversal,00.00,"393,689.03","1,574,756.11"
07-Jan-2024,ATM,"1,168,718.80",00.00,"2,743,474.91"
08-Jan-2024,IMPS,00.00,"914,491.64","1,828,983.27"
08-Jan-2024,NEFT,43.63,00.00,"1,829,026.90"
08-Jan-2024,Cash,"100,636.75",00.00,"1,929,663.65"
08-Jan-2024,Tax,60.10,00.00,"1,929,723.75"
08-Jan-2024,Reversal,18.00,00.00,"1,929,741.75"
08-Jan-2024,Purchase,"247,176.91",00.00,"2,176,918.66"
08-Jan-2024,Miscellaneous,"2,029,457.00",00.00,"4,206,375.66"
08-Jan-2024,Bill,00.00,"701,062.61","3,505,313.05"
08-Jan-2024,Bill,10.00,00.00,"3,505,323.05"
08-Jan-2024,Purchase,05.30,00.00,"3,505,328.35"
08-Jan-2024,Debit Card,00.00,"584,221.39","2,921,106.96"
08-Jan-2024,Miscellaneous,"28,961.00",00.00,"2,950,067.96"
08-Jan-2024,Purchase,00.00,"983,355.99","1,966,711.97"
08-Jan-2024,Commission,00.00,"196,671.20","1,770,040.77"
08-Jan-2024,NEFT,00.00,"354,008.15","1,416,032.62"
08-Jan-2024,Debit Card,00.00,"708,016.31","708,016.31"
08-Jan-2024,Commission,00.00,"118,002.72","590,013.59"
08-Jan-2024,Cheque,00.00,"84,287.66","505,725.93"
08-Jan-2024,Reversal,00.00,"126,431.48","379,294.45"
08-Jan-2024,Commission,"1,810,733.75",00.00,"2,190,028.20"
08-Jan-2024,Tax,00.00,"312,861.17","1,877,167.03"
08-Jan-2024,Debit Card,00.00,"375,433.41","1,501,733.62"
08-Jan-2024,IMPS,00.00,"150,173.36","1,351,560.26"
08-Jan-2024,Debit Card,00.00,"225,260.04","1,126,300.22"
08-Jan-2024,Commission,00.00,"140,787.53","985,512.69"
09-Jan-2024,Transfer,05.80,00.00,"985,518.49"
09-Jan-2024,Miscellaneous,00.00,"197,103.70","788,414.79"
09-Jan-2024,Cash,"27,122.80",00.00,"815,537.59"
09-Jan-2024,Commission,00.00,"271,845.86","543,691.73"
09-Jan-2024,Purchase,01.49,00.00,"543,693.22"
09-Jan-2024,Transfer,53.01,00.00,"543,746.23"
09-Jan-2024,IMPS,00.00,"135,936.56","407,809.67"
09-Jan-2024,Commission,00.00,"135,936.56","271,873.11"
09-Jan-2024,Reversal,00.00,"67,968.28","203,904.83"
09-Jan-2024,Commission,"185,208.00",00.00,"389,112.83"
09-Jan-2024,Reversal,00.00,"38,911.28","350,201.55"
09-Jan-2024,Interest,"8,606.00",00.00,"358,807.55"
09-Jan-2024,Miscellaneous,00.00,"39,867.51","318,940.04"
09-Jan-2024,RTGS,00.00,"53,156.67","265,783.37"
10-Jan-2024,RTGS,00.00,"53,156.67","212,626.70"
10-Jan-2024,Debit Card,"5,234.41",00.00,"217,861.11"
10-Jan-2024,ATM,00.00,"108,930.56","108,930.56"
10-Jan-2024,Debit Card,"91,670.00",00.00,"200,600.56"
10-Jan-2024,Interest,"198,504.00",00.00,"399,104.56"
10-Jan-2024,RTGS,00.00,"133,034.85","266,069.71"
10-Jan-2024,Commission,00.00,"266,069.71",00.00
10-Jan-2024,Miscellaneous,"3,969.81",00.00,"3,969.81"
10-Jan-2024,Commission,00.00,441.09,"3,528.72"
10-Jan-2024,Purchase,"13,173.80",00.00,"16,702.52"
10-Jan-2024,Debit Card,"30,320.10",00.00,"47,022.62"
10-Jan-2024,Transfer,"3,190.10",00.00,"50,212.72"
10-Jan-2024,Reversal,00.00,"5,579.19","44,633.53"
10-Jan-2024,NEFT,07.00,00.00,"44,640.53"
10-Jan-2024,Purchase,00.00,"14,880.18","29,760.35"
10-Jan-2024,ATM,00.00,"29,760.35",00.00
11-Jan-2024,Interest,"29,291.00",00.00,"29,291.00"
11-Jan-2024,Miscellaneous,24.00,00.00,"29,315.00"
11-Jan-2024,Interest,07.30,00.00,"29,322.30"
11-Jan-2024,Purchase,"21,688.50",00.00,"51,010.80"
11-Jan-2024,ATM,00.00,"17,003.60","34,007.20"
11-Jan-2024,Commission,"19,836.00",00.00,"53,843.20"
11-Jan-2024,Debit Card,06.90,00.00,"53,850.10"
11-Jan-2024,Miscellaneous,00.00,"17,950.03","35,900.07"
11-Jan-2024,Commission,00.00,"17,950.04","17,950.04"
11-Jan-2024,Purchase,"22,570.40",00.00,"40,520.44"
11-Jan-2024,Purchase,00.00,"8,104.09","32,416.35"
11-Jan-2024,IMPS,"3,755.30",00.00,"36,171.65"
11-Jan-2024,Transfer,00.00,"18,085.83","18,085.82"
11-Jan-2024,Interest,00.00,"9,042.91","9,042.91"
11-Jan-2024,Purchase,"2,977.70",00.00,"12,020.61"
11-Jan-2024,Cash,00.00,"1,335.62","10,684.99"
11-Jan-2024,Miscellaneous,"16,651.00",00.00,"27,335.99"
11-Jan-2024,Tax,00.00,"13,668.00","13,668.00"
11-Jan-2024,Debit Card,"454,458.25",00.00,"468,126.25"
11-Jan-2024,Transfer,46.00,00.00,"468,172.25"
11-Jan-2024,Interest,00.00,"46,817.23","421,355.02"
11-Jan-2024,ATM,313.80,00.00,"421,668.82"
11-Jan-2024,Debit Card,00.00,"105,417.21","316,251.62"
11-Jan-2024,Commission,00.00,"31,625.16","284,626.46"
11-Jan-2024,NEFT,08.00,00.00,"284,634.46"
11-Jan-2024,Transfer,63.90,00.00,"284,698.36"
11-Jan-2024,Bill,00.00,"284,698.36",00.00
11-Jan-2024,Bill,29.71,00.00,29.71
11-Jan-2024,NEFT,"803,678.00",00.00,"803,707.71"
12-Jan-2024,RTGS,00.00,"401,853.86","401,853.86"
12-Jan-2024,RTGS,00.00,"80,370.77","321,483.09"
12-Jan-2024,Reversal,160.14,00.00,"321,643.23"
12-Jan-2024,ATM,"1,815,761.00",00.00,"2,137,404.23"
12-Jan-2024,Purchase,"14,956.50",00.00,"2,152,360.73"
12-Jan-2024,Cheque,"249,990.00",00.00,"2,402,350.73"
12-Jan-2024,IMPS,431.00,00.00,"2,402,781.73"
12-Jan-2024,Purchase,"1,625.40",00.00,"2,404,407.13"
12-Jan-2024,Cheque,00.00,"343,486.73","2,060,920.40"
12-Jan-2024,Cash,00.00,"228,991.16","1,831,929.24"
12-Jan-2024,Cash,"1,618.70",00.00,"1,833,547.94"
12-Jan-2024,Cash,06.32,00.00,"1,833,554.26"
12-Jan-2024,IMPS,00.00,"916,777.13","916,777.13"
12-Jan-2024,Transfer,00.00,"114,597.14","802,179.99"
12-Jan-2024,Interest,00.00,"100,272.50","701,907.49"
12-Jan-2024,Reversal,02.00,00.00,"701,909.49"
12-Jan-2024,Interest,33.30,00.00,"701,942.79"
12-Jan-2024,Transfer,00.00,"140,388.56","561,554.23"
12-Jan-2024,Purchase,"1,466,137.00",00.00,"2,027,691.23"
12-Jan-2024,Tax,00.00,"337,948.54","1,689,742.69"
12-Jan-2024,Miscellaneous,00.10,00.00,"1,689,742.79"
12-Jan-2024,Cheque,45.72,00.00,"1,689,788.51"
12-Jan-2024,Cash,00.00,"422,447.13","1,267,341.38"
12-Jan-2024,Tax,"6,757.75",00.00,"1,274,099.13"
12-Jan-2024,Bill,"256,997.50",00.00,"1,531,096.63"
12-Jan-2024,Bill,00.00,"218,728.09","1,312,368.54"
12-Jan-2024,Bill,"36,687.00",00.00,"1,349,055.54"
12-Jan-2024,NEFT,16.08,00.00,"1,349,071.62"
12-Jan-2024,Miscellaneous,"1,977.00",00.00,"1,351,048.62"
12-Jan-2024,NEFT,"1,614,136.00",00.00,"2,965,184.62"
12-Jan-2024,RTGS,00.00,"1,482,592.31","1,482,592.31"
12-Jan-2024,Commission,"315,510.00",00.00,"1,798,102.31"
12-Jan-2024,Miscellaneous,00.00,"599,367.44","1,198,734.87"
13-Jan-2024,Interest,54.00,00.00,"1,198,788.87"
13-Jan-2024,ATM,00.00,"299,697.22","899,091.65"
13-Jan-2024,Cash,00.00,"449,545.83","449,545.82"
13-Jan-2024,ATM,00.00,"64,220.83","385,324.99"
13-Jan-2024,Commission,"3,140.00",00.00,"388,464.99"
13-Jan-2024,Cheque,00.00,"48,558.12","339,906.87"
13-Jan-2024,ATM,496.60,00.00,"340,403.47"
13-Jan-2024,NEFT,00.00,"42,550.43","297,853.04"
13-Jan-2024,ATM,445.40,00.00,"298,298.44"
13-Jan-2024,ATM,00.00,"149,149.22","149,149.22"
13-Jan-2024,Reversal,07.50,00.00,"149,156.72"
13-Jan-2024,Transfer,"1,049,420.00",00.00,"1,198,576.72"
13-Jan-2024,Cheque,00.00,"1,198,576.72",00.00
13-Jan-2024,Interest,00.00,00.00,00.00
13-Jan-2024,ATM,"1,811,969.75",00.00,"1,811,969.75"
13-Jan-2024,Cash,00.00,00.00,"1,811,969.75"
13-Jan-2024,Debit Card,"23,530.61",00.00,"1,835,500.36"
13-Jan-2024,Tax,00.00,"229,437.55","1,606,062.82"
13-Jan-2024,Purchase,00.00,"401,515.71","1,204,547.12"
13-Jan-2024,Interest,"11,406.54",00.00,"1,215,953.66"
13-Jan-2024,Commission,00.00,"303,988.42","911,965.24"
13-Jan-2024,Debit Card,659.62,00.00,"912,624.86"
13-Jan-2024,NEFT,00.00,"304,208.29","608,416.57"
13-Jan-2024,IMPS,00.00,"101,402.76","507,013.81"
13-Jan-2024,Reversal,00.00,"72,430.54","434,583.27"
13-Jan-2024,Transfer,"94,503.00",00.00,"529,086.27"
13-Jan-2024,RTGS,00.00,"105,817.25","423,269.02"
13-Jan-2024,Transfer,"88,655.06",00.00,"511,924.08"
13-Jan-2024,Reversal,"3,343.90",00.00,"515,267.98"
13-Jan-2024,IMPS,319.04,00.00,"515,587.02"
13-Jan-2024,ATM,00.00,"51,558.70","464,028.32"
13-Jan-2024,Cash,56.00,00.00,"464,084.32"
13-Jan-2024,Transfer,87.09,00.00,"464,171.41"
13-Jan-2024,Commission,01.00,00.00,"464,172.41"
13-Jan-2024,Debit Card,00.00,"66,310.34","397,862.07"
13-Jan-2024,Commission,423.00,00.00,"398,285.07"
13-Jan-2024,Bill,00.00,"66,380.85","331,904.22"
13-Jan-2024,RTGS,00.00,"331,904.22",00.00
13-Jan-2024,Miscellaneous,"192,802.50",00.00,"192,802.50"
14-Jan-2024,ATM,08.00,00.00,"192,810.50"
14-Jan-2024,ATM,00.00,"192,810.50",00.00
14-Jan-2024,Miscellaneous,"36,130.40",00.00,"36,130.40"
14-Jan-2024,Cheque,"12,327.11",00.00,"48,457.51"
14-Jan-2024,ATM,"875,428.00",00.00,"923,885.51"
14-Jan-2024,Cash,04.70,00.00,"923,890.21"
14-Jan-2024,Cheque,191.00,00.00,"924,081.21"
14-Jan-2024,Commission,470.90,00.00,"924,552.11"
14-Jan-2024,Cash,00.00,"154,092.02","770,460.09"
14-Jan-2024,Interest,149.14,00.00,"770,609.23"
14-Jan-2024,RTGS,"1,595,081.00",00.00,"2,365,690.23"
14-Jan-2024,ATM,00.00,"394,281.71","1,971,408.52"
14-Jan-2024,Interest,61.90,00.00,"1,971,470.42"
14-Jan-2024,Miscellaneous,00.00,"219,052.27","1,752,418.15"
14-Jan-2024,Miscellaneous,"196,226.00",00.00,"1,948,644.15"
14-Jan-2024,IMPS,"3,787.81",00.00,"1,952,431.96"
14-Jan-2024,ATM,"1,065,621.50",00.00,"3,018,053.46"
14-Jan-2024,Commission,"5,354.00",00.00,"3,023,407.46"
14-Jan-2024,Commission,"1,555,199.00",00.00,"4,578,606.46"
15-Jan-2024,Interest,159.00,00.00,"4,578,765.46"
15-Jan-2024,Cheque,00.00,"763,127.58","3,815,637.88"
15-Jan-2024,ATM,484.40,00.00,"3,816,122.28"
15-Jan-2024,Miscellaneous,305.00,00.00,"3,816,427.28"
15-Jan-2024,ATM,"14,731.00",00.00,"3,831,158.28"
15-Jan-2024,Interest,"27,354.68",00.00,"3,858,512.96"
15-Jan-2024,Transfer,89.80,00.00,"3,858,602.76"
15-Jan-2024,Purchase,00.00,"1,929,301.38","1,929,301.38"
15-Jan-2024,Transfer,00.00,"214,366.82","1,714,934.56"
15-Jan-2024,Transfer,"1,291,814.50",00.00,"3,006,749.06"
15-Jan-2024,IMPS,00.00,"751,687.27","2,255,061.80"
15-Jan-2024,IMPS,"1,229,184.00",00.00,"3,484,245.80"
15-Jan-2024,RTGS,"1,816.09",00.00,"3,486,061.89"
15-Jan-2024,Bill,03.80,00.00,"3,486,065.69"
15-Jan-2024,ATM,00.00,"3,486,065.69",00.00
15-Jan-2024,Purchase,819.00,00.00,819.00
15-Jan-2024,Bill,"3,474.90",00.00,"4,293.90"
15-Jan-2024,Commission,00.00,613.41,"3,680.49"
15-Jan-2024,Reversal,04.20,00.00,"3,684.69"
15-Jan-2024,Bill,00.00,526.38,"3,158.31"
16-Jan-2024,Cash,00.00,"1,579.16","1,579.16"
16-Jan-2024,Tax,00.00,225.59,"1,353.57"
16-Jan-2024,RTGS,"3,752.92",00.00,"5,106.49"
16-Jan-2024,Commission,00.00,851.08,"4,255.41"
16-Jan-2024,RTGS,00.00,"4,255.41",00.00
16-Jan-2024,Commission,315.00,00.00,315.00
16-Jan-2024,Cash,00.00,315.00,00.00
16-Jan-2024,Purchase,466.56,00.00,466.56
16-Jan-2024,Purchase,453.20,00.00,919.76
16-Jan-2024,Reversal,"1,853,933.50",00.00,"1,854,853.26"
16-Jan-2024,Cheque,00.00,"185,485.33","1,669,367.93"
16-Jan-2024,Commission,00.00,"185,485.33","1,483,882.60"
16-Jan-2024,Commission,00.00,"247,313.77","1,236,568.83"
16-Jan-2024,Commission,"2,217.60",00.00,"1,238,786.43"
16-Jan-2024,Miscellaneous,00.00,"123,878.64","1,114,907.79"
16-Jan-2024,Transfer,00.00,"123,878.64","991,029.15"
16-Jan-2024,Purchase,00.00,"198,205.83","792,823.32"
17-Jan-2024,Purchase,"3,516.00",00.00,"796,339.32"
17-Jan-2024,Bill,"159,252.00",00.00,"955,591.32"
18-Jan-2024,Debit Card,02.00,00.00,"955,593.32"
18-Jan-2024,Commission,"24,244.80",00.00,"979,838.12"
18-Jan-2024,Bill,06.00,00.00,"979,844.12"
18-Jan-2024,Interest,00.00,"489,922.06","489,922.06"
18-Jan-2024,IMPS,04.30,00.00,"489,926.36"
18-Jan-2024,Purchase,"3,456.00",00.00,"493,382.36"
18-Jan-2024,NEFT,00.00,"82,230.39","411,151.97"
18-Jan-2024,Miscellaneous,48.00,00.00,"411,199.97"
18-Jan-2024,Bill,00.00,"411,199.97",00.00
18-Jan-2024,IMPS,436.98,00.00,436.98
18-Jan-2024,Cash,00.00,436.98,00.00
19-Jan-2024,Debit Card,"392,012.25",00.00,"392,012.25"
19-Jan-2024,Transfer,"1,119,438.00",00.00,"1,511,450.25"
19-Jan-2024,Interest,00.00,"755,725.13","755,725.12"
19-Jan-2024,Commission,00.00,"251,908.37","503,816.75"
19-Jan-2024,Cheque,21.95,00.00,"503,838.70"
19-Jan-2024,IMPS,00.00,"62,979.84","440,858.86"
19-Jan-2024,Cheque,00.00,"73,476.48","367,382.38"
19-Jan-2024,Tax,"10,837.00",00.00,"378,219.38"
19-Jan-2024,Reversal,42.00,00.00,"378,261.38"
19-Jan-2024,Tax,"13,079.10",00.00,"391,340.48"
19-Jan-2024,Tax,58.00,00.00,"391,398.48"
19-Jan-2024,ATM,"1,564.60",00.00,"392,963.08"
19-Jan-2024,Cash,42.00,00.00,"393,005.08"
19-Jan-2024,Tax,09.05,00.00,"393,014.13"
19-Jan-2024,IMPS,01.00,00.00,"393,015.13"
19-Jan-2024,Transfer,"253,424.00",00.00,"646,439.13"
19-Jan-2024,Miscellaneous,00.00,"129,287.83","517,151.30"
19-Jan-2024,IMPS,00.00,"517,151.30",00.00
19-Jan-2024,Cheque,06.00,00.00,06.00
19-Jan-2024,Interest,00.00,00.86,05.14
20-Jan-2024,RTGS,00.00,01.71,03.43
20-Jan-2024,NEFT,"73,388.62",00.00,"73,392.05"
20-Jan-2024,Cash,00.00,"7,339.21","66,052.84"
20-Jan-2024,IMPS,00.00,"33,026.42","33,026.42"
20-Jan-2024,RTGS,00.00,"4,128.30","28,898.12"
20-Jan-2024,NEFT,00.00,"9,632.71","19,265.41"
20-Jan-2024,Miscellaneous,00.00,"2,752.20","16,513.21"
20-Jan-2024,Miscellaneous,"5,280.00",00.00,"21,793.21"
20-Jan-2024,Cheque,49.00,00.00,"21,842.21"
20-Jan-2024,Miscellaneous,"957,083.00",00.00,"978,925.21"
20-Jan-2024,Reversal,461.00,00.00,"979,386.21"
20-Jan-2024,Reversal,00.00,"326,462.07","652,924.14"
20-Jan-2024,Miscellaneous,00.00,"72,547.13","580,377.01"
20-Jan-2024,Transfer,00.00,"64,486.33","515,890.68"
21-Jan-2024,Purchase,00.00,"57,321.19","458,569.49"
21-Jan-2024,Bill,692.00,00.00,"459,261.49"
21-Jan-2024,IMPS,"674,055.20",00.00,"1,133,316.69"
21-Jan-2024,Commission,"448,081.00",00.00,"1,581,397.69"
21-Jan-2024,Commission,"177,642.60",00.00,"1,759,040.29"
21-Jan-2024,Transfer,00.00,"175,904.03","1,583,136.26"
21-Jan-2024,Cheque,24.60,00.00,"1,583,160.86"
21-Jan-2024,Debit Card,00.00,"158,316.09","1,424,844.77"
21-Jan-2024,RTGS,00.00,"178,105.60","1,246,739.17"
21-Jan-2024,Reversal,"3,080.00",00.00,"1,249,819.17"
21-Jan-2024,Bill,00.00,"624,909.59","624,909.58"
21-Jan-2024,ATM,00.00,"156,227.40","468,682.18"
21-Jan-2024,Debit Card,00.00,"117,170.55","351,511.64"
21-Jan-2024,Cash,"159,355.10",00.00,"510,866.74"
21-Jan-2024,Commission,170.64,00.00,"511,037.38"
21-Jan-2024,Tax,"24,450.25",00.00,"535,487.63"
21-Jan-2024,Cash,00.00,"535,487.63",00.00
21-Jan-2024,Reversal,00.70,00.00,00.70
21-Jan-2024,IMPS,00.00,00.09,00.61
21-Jan-2024,Commission,57.10,00.00,57.71
22-Jan-2024,Cash,"70,444.10",00.00,"70,501.81"
22-Jan-2024,Transfer,00.00,"14,100.36","56,401.45"
22-Jan-2024,IMPS,"3,222.04",00.00,"59,623.49"
22-Jan-2024,Miscellaneous,00.00,"6,624.83","52,998.66"
22-Jan-2024,IMPS,"2,954.73",00.00,"55,953.39"
22-Jan-2024,NEFT,00.00,"5,595.34","50,358.05"
22-Jan-2024,RTGS,00.00,"5,595.34","44,762.71"
22-Jan-2024,IMPS,00.00,"22,381.36","22,381.36"
22-Jan-2024,Debit Card,"32,169.00",00.00,"54,550.36"
22-Jan-2024,Miscellaneous,00.00,"5,455.04","49,095.32"
22-Jan-2024,Cheque,00.00,"24,547.66","24,547.66"
22-Jan-2024,IMPS,00.00,"8,182.55","16,365.11"
22-Jan-2024,Bill,00.00,"1,636.51","14,728.60"
22-Jan-2024,Reversal,371.00,00.00,"15,099.60"
22-Jan-2024,Cheque,"19,714.00",00.00,"34,813.60"
22-Jan-2024,Transfer,00.00,"4,973.37","29,840.23"
22-Jan-2024,NEFT,164.80,00.00,"30,005.03"
22-Jan-2024,Bill,15.00,00.00,"30,020.03"
22-Jan-2024,Commission,00.00,"30,020.03",00.00
22-Jan-2024,Bill,03.00,00.00,03.00
22-Jan-2024,Interest,00.00,01.50,01.50
22-Jan-2024,Bill,00.00,00.19,01.31
22-Jan-2024,Cash,01.00,00.00,02.31
22-Jan-2024,Debit Card,01.70,00.00,04.01
22-Jan-2024,Transfer,"762,675.00",00.00,"762,679.01"
22-Jan-2024,Interest,00.00,"254,226.34","508,452.67"
23-Jan-2024,Cash,"618,696.00",00.00,"1,127,148.67"
23-Jan-2024,Commission,"2,529.50",00.00,"1,129,678.17"
23-Jan-2024,IMPS,07.00,00.00,"1,129,685.17"
23-Jan-2024,Reversal,00.00,"141,210.65","988,474.52"
23-Jan-2024,Cheque,"2,022,251.00",00.00,"3,010,725.52"
23-Jan-2024,IMPS,55.16,00.00,"3,010,780.68"
23-Jan-2024,Bill,00.00,"602,156.14","2,408,624.54"
23-Jan-2024,NEFT,00.00,"602,156.14","1,806,468.40"
23-Jan-2024,Cheque,00.00,"903,234.20","903,234.20"
24-Jan-2024,Transfer,00.00,"112,904.28","790,329.92"
25-Jan-2024,Bill,00.00,"112,904.27","677,425.65"
25-Jan-2024,Debit Card,53.00,00.00,"677,478.65"
25-Jan-2024,Reversal,00.00,"75,275.41","602,203.24"
25-Jan-2024,Purchase,454.89,00.00,"602,658.13"
25-Jan-2024,Commission,00.00,"602,658.13",00.00
25-Jan-2024,NEFT,01.00,00.00,01.00
25-Jan-2024,NEFT,"30,028.30",00.00,"30,029.30"
25-Jan-2024,Commission,00.00,"5,004.88","25,024.42"
25-Jan-2024,Tax,00.00,"12,512.21","12,512.21"
25-Jan-2024,NEFT,"3,710.87",00.00,"16,223.08"
25-Jan-2024,Miscellaneous,00.00,"1,622.31","14,600.77"
25-Jan-2024,Tax,00.00,"1,622.31","12,978.46"
25-Jan-2024,Cash,00.00,"6,489.23","6,489.23"
25-Jan-2024,ATM,"2,004.85",00.00,"8,494.08"
25-Jan-2024,Interest,"570,362.20",00.00,"578,856.28"
25-Jan-2024,Miscellaneous,"10,289.20",00.00,"589,145.48"
25-Jan-2024,Debit Card,00.00,"58,914.55","530,230.93"
25-Jan-2024,ATM,00.00,"265,115.47","265,115.47"
25-Jan-2024,Purchase,"1,357.18",00.00,"266,472.65"
25-Jan-2024,NEFT,"1,066,039.00",00.00,"1,332,511.65"
25-Jan-2024,Bill,"25,549.20",00.00,"1,358,060.85"
25-Jan-2024,Commission,275.30,00.00,"1,358,336.15"
26-Jan-2024,Cash,00.00,"1,358,336.15",00.00
26-Jan-2024,IMPS,"848,322.00",00.00,"848,322.00"
26-Jan-2024,Tax,00.00,"121,188.86","727,133.14"
26-Jan-2024,Cash,"1,150,307.50",00.00,"1,877,440.64"
26-Jan-2024,NEFT,00.00,"268,205.81","1,609,234.83"
26-Jan-2024,Commission,"30,723.70",00.00,"1,639,958.53"
26-Jan-2024,Commission,00.00,"819,979.27","819,979.26"
26-Jan-2024,Reversal,"1,289,694.50",00.00,"2,109,673.76"
26-Jan-2024,RTGS,00.00,"351,612.29","1,758,061.47"
26-Jan-2024,NEFT,32.00,00.00,"1,758,093.47"
26-Jan-2024,Cash,02.90,00.00,"1,758,096.37"
26-Jan-2024,ATM,00.00,"351,619.27","1,406,477.10"
26-Jan-2024,Transfer,00.00,"234,412.85","1,172,064.25"
26-Jan-2024,ATM,00.00,"234,412.85","937,651.40"
26-Jan-2024,Purchase,00.01,00.00,"937,651.41"
26-Jan-2024,Tax,"10,710.80",00.00,"948,362.21"
27-Jan-2024,IMPS,"29,782.69",00.00,"978,144.90"
27-Jan-2024,ATM,00.00,"163,024.15","815,120.75"
27-Jan-2024,RTGS,15.00,00.00,"815,135.75"
27-Jan-2024,Bill,"1,963,279.50",00.00,"2,778,415.25"
27-Jan-2024,Tax,"17,657.90",00.00,"2,796,073.15"
27-Jan-2024,Purchase,04.00,00.00,"2,796,077.15"
27-Jan-2024,Commission,00.00,00.00,"2,796,077.15"
27-Jan-2024,Bill,00.00,"466,012.86","2,330,064.29"
27-Jan-2024,Interest,00.00,"233,006.43","2,097,057.86"
27-Jan-2024,Reversal,38.57,00.00,"2,097,096.43"
27-Jan-2024,RTGS,357.00,00.00,"2,097,453.43"
27-Jan-2024,RTGS,00.00,"349,575.57","1,747,877.86"
27-Jan-2024,Commission,00.00,"291,312.98","1,456,564.88"
27-Jan-2024,ATM,495.90,00.00,"1,457,060.78"
27-Jan-2024,Interest,182.70,00.00,"1,457,243.48"
27-Jan-2024,NEFT,"1,336.44",00.00,"1,458,579.92"
27-Jan-2024,Bill,03.70,00.00,"1,458,583.62"
27-Jan-2024,ATM,"6,690.41",00.00,"1,465,274.03"
28-Jan-2024,Debit Card,"973,109.80",00.00,"2,438,383.83"
28-Jan-2024,ATM,491.00,00.00,"2,438,874.83"
28-Jan-2024,Commission,00.00,"487,774.97","1,951,099.86"
28-Jan-2024,Commission,00.00,"216,788.87","1,734,310.99"
28-Jan-2024,Tax,"9,887.00",00.00,"1,744,197.99"
28-Jan-2024,Tax,00.00,"1,744,197.99",00.00
28-Jan-2024,ATM,"169,660.00",00.00,"169,660.00"
28-Jan-2024,RTGS,00.00,"16,966.00","152,694.00"
28-Jan-2024,RTGS,00.00,"30,538.80","122,155.20"
28-Jan-2024,NEFT,00.00,"24,431.04","97,724.16"
28-Jan-2024,Purchase,00.00,"19,544.83","78,179.33"
28-Jan-2024,ATM,00.00,"15,635.87","62,543.46"
28-Jan-2024,ATM,"115,405.84",00.00,"177,949.30"
28-Jan-2024,Miscellaneous,00.00,"44,487.33","133,461.97"
28-Jan-2024,Reversal,"3,520.00",00.00,"136,981.97"
28-Jan-2024,ATM,"3,453.51",00.00,"140,435.48"
28-Jan-2024,Interest,00.00,"14,043.55","126,391.93"
28-Jan-2024,Purchase,00.00,"12,639.19","113,752.74"
28-Jan-2024,Debit Card,00.00,"14,219.09","99,533.65"
28-Jan-2024,Cash,00.00,"24,883.41","74,650.24"
28-Jan-2024,IMPS,00.00,"12,441.71","62,208.53"
28-Jan-2024,RTGS,"202,338.50",00.00,"264,547.03"
28-Jan-2024,RTGS,06.00,00.00,"264,553.03"
28-Jan-2024,Transfer,61.86,00.00,"264,614.89"
28-Jan-2024,RTGS,160.00,00.00,"264,774.89"
28-Jan-2024,Cheque,07.62,00.00,"264,782.51"
28-Jan-2024,Reversal,00.00,"52,956.50","211,826.01"
28-Jan-2024,Reversal,00.00,"52,956.50","158,869.51"
28-Jan-2024,Debit Card,00.00,"17,652.17","141,217.34"
28-Jan-2024,Transfer,00.00,"35,304.34","105,913.00"
28-Jan-2024,Commission,01.43,00.00,"105,914.43"
28-Jan-2024,Transfer,00.00,"13,239.30","92,675.13"
28-Jan-2024,Cash,"577,101.80",00.00,"669,776.93"
28-Jan-2024,Cheque,00.00,"223,258.98","446,517.95"
28-Jan-2024,IMPS,00.00,"223,258.98","223,258.98"
28-Jan-2024,ATM,03.30,00.00,"223,262.28"
28-Jan-2024,Transfer,"2,088.90",00.00,"225,351.18"
28-Jan-2024,IMPS,00.00,"45,070.24","180,280.94"
28-Jan-2024,Cheque,"646,774.25",00.00,"827,055.19"
28-Jan-2024,IMPS,"238,829.00",00.00,"1,065,884.19"
28-Jan-2024,Bill,"1,647,059.75",00.00,"2,712,943.94"
28-Jan-2024,Cheque,00.00,"301,438.22","2,411,505.72"
28-Jan-2024,IMPS,"152,107.16",00.00,"2,563,612.88"
28-Jan-2024,ATM,55.40,00.00,"2,563,668.28"
28-Jan-2024,Purchase,"346,758.80",00.00,"2,910,427.08"
28-Jan-2024,Commission,761.57,00.00,"2,911,188.65"
28-Jan-2024,Commission,00.00,"485,198.11","2,425,990.54"
28-Jan-2024,Purchase,00.00,"606,497.64","1,819,492.90"
28-Jan-2024,NEFT,00.34,00.00,"1,819,493.24"
28-Jan-2024,Miscellaneous,453.50,00.00,"1,819,946.74"
28-Jan-2024,Transfer,"3,031.50",00.00,"1,822,978.24"
28-Jan-2024,Transfer,00.00,"607,659.41","1,215,318.83"
28-Jan-2024,Tax,"166,585.59",00.00,"1,381,904.42"
29-Jan-2024,Tax,"247,063.30",00.00,"1,628,967.72"
29-Jan-2024,Tax,227.10,00.00,"1,629,194.82"
29-Jan-2024,NEFT,"40,794.50",00.00,"1,669,989.32"
29-Jan-2024,Miscellaneous,00.00,"333,997.86","1,335,991.46"
29-Jan-2024,Interest,00.00,"133,599.15","1,202,392.31"
29-Jan-2024,Purchase,00.00,"120,239.23","1,082,153.08"
29-Jan-2024,Miscellaneous,00.00,"270,538.27","811,614.81"
29-Jan-2024,Purchase,00.00,"81,161.48","730,453.33"
29-Jan-2024,Tax,154.00,00.00,"730,607.33"
29-Jan-2024,Bill,00.00,"73,060.73","657,546.60"
29-Jan-2024,Bill,00.00,"73,060.73","584,485.87"
29-Jan-2024,IMPS,00.00,"64,942.87","519,543.00"
29-Jan-2024,Tax,00.00,"74,220.43","445,322.57"
29-Jan-2024,Tax,"1,219,019.25",00.00,"1,664,341.82"
29-Jan-2024,Tax,"79,502.62",00.00,"1,743,844.44"
29-Jan-2024,Purchase,00.00,"290,640.74","1,453,203.70"
29-Jan-2024,Tax,"952,550.50",00.00,"2,405,754.20"
29-Jan-2024,Reversal,00.00,"801,918.07","1,603,836.13"
29-Jan-2024,Tax,02.81,00.00,"1,603,838.94"
29-Jan-2024,Purchase,132.46,00.00,"1,603,971.40"
29-Jan-2024,IMPS,72.00,00.00,"1,604,043.40"
29-Jan-2024,Debit Card,00.00,"267,340.57","1,336,702.83"
29-Jan-2024,Miscellaneous,00.00,"445,567.61","891,135.22"
29-Jan-2024,NEFT,474.41,00.00,"891,609.63"
29-Jan-2024,Miscellaneous,00.00,"891,609.63",00.00
29-Jan-2024,Commission,05.10,00.00,05.10
29-Jan-2024,Transfer,00.00,00.73,04.37
29-Jan-2024,Interest,00.00,01.46,02.91
29-Jan-2024,Purchase,"134,306.90",00.00,"134,309.81"
29-Jan-2024,Transfer,"1,633,943.00",00.00,"1,768,252.81"
29-Jan-2024,Transfer,00.00,"196,472.53","1,571,780.28"
29-Jan-2024,Bill,57.47,00.00,"1,571,837.75"
29-Jan-2024,Commission,00.00,"174,648.64","1,397,189.11"
29-Jan-2024,Debit Card,"207,563.30",00.00,"1,604,752.41"
29-Jan-2024,IMPS,00.00,"160,475.24","1,444,277.17"
29-Jan-2024,Purchase,"4,070.00",00.00,"1,448,347.17"
29-Jan-2024,NEFT,02.00,00.00,"1,448,349.17"
29-Jan-2024,Bill,00.00,"241,391.53","1,206,957.64"
29-Jan-2024,Debit Card,"226,163.00",00.00,"1,433,120.64"
29-Jan-2024,Interest,"18,190.70",00.00,"1,451,311.34"
29-Jan-2024,Transfer,00.00,"145,131.13","1,306,180.21"
29-Jan-2024,Miscellaneous,00.00,"217,696.70","1,088,483.51"
29-Jan-2024,Tax,00.00,"544,241.76","544,241.76"
29-Jan-2024,Bill,00.00,"54,424.18","489,817.58"
29-Jan-2024,Reversal,98.00,00.00,"489,915.58"
29-Jan-2024,Purchase,00.00,"97,983.12","391,932.46"
29-Jan-2024,Miscellaneous,00.00,"97,983.12","293,949.35"
29-Jan-2024,Cheque,00.00,"97,983.12","195,966.23"
29-Jan-2024,Cash,56.00,00.00,"196,022.23"
29-Jan-2024,ATM,00.00,"98,011.12","98,011.12"
29-Jan-2024,Debit Card,00.00,"49,005.56","49,005.56"
29-Jan-2024,Transfer,00.00,"4,900.56","44,105.00"
29-Jan-2024,Reversal,"442,202.00",00.00,"486,307.00"
29-Jan-2024,Bill,00.00,"243,153.50","243,153.50"
29-Jan-2024,NEFT,31.20,00.00,"243,184.70"
29-Jan-2024,Debit Card,"993,974.80",00.00,"1,237,159.50"
30-Jan-2024,Debit Card,339.54,00.00,"1,237,499.04"
30-Jan-2024,Bill,00.00,"123,749.90","1,113,749.14"
30-Jan-2024,IMPS,00.00,"159,107.02","954,642.12"
31-Jan-2024,Transfer,23.77,00.00,"954,665.89"
31-Jan-2024,Cheque,294.00,00.00,"954,959.89"
31-Jan-2024,Miscellaneous,"162,501.90",00.00,"1,117,461.79"
31-Jan-2024,NEFT,00.00,"111,746.18","1,005,715.61"
31-Jan-2024,Reversal,"4,391.90",00.00,"1,010,107.51"
31-Jan-2024,Interest,"984,426.50",00.00,"1,994,534.01"
31-Jan-2024,Tax,"1,123,058.20",00.00,"3,117,592.21"
31-Jan-2024,Transfer,"19,588.00",00.00,"3,137,180.21"
31-Jan-2024,Cheque,00.00,"522,863.37","2,614,316.84"
31-Jan-2024,RTGS,00.00,"326,789.61","2,287,527.24"
31-Jan-2024,Interest,00.00,"762,509.08","1,525,018.16"
31-Jan-2024,NEFT,31.92,00.00,"1,525,050.08"
31-Jan-2024,RTGS,00.00,"508,350.03","1,016,700.05"
31-Jan-2024,Commission,"4,553.00",00.00,"1,021,253.05"
31-Jan-2024,Cash,"1,695,832.25",00.00,"2,717,085.30"
31-Jan-2024,Transfer,00.00,"452,847.55","2,264,237.75"
31-Jan-2024,Transfer,975.00,00.00,"2,265,212.75"
31-Jan-2024,Cash,"16,432.43",00.00,"2,281,645.18"
31-Jan-2024,Tax,00.00,"456,329.04","1,825,316.14"
31-Jan-2024,Commission,00.00,"912,658.07","912,658.07"
31-Jan-2024,NEFT,"7,424.10",00.00,"920,082.17"
31-Jan-2024,ATM,"937,366.00",00.00,"1,857,448.17"
31-Jan-2024,Transfer,"239,879.78",00.00,"2,097,327.95"
31-Jan-2024,Bill,00.00,"209,732.80","1,887,595.16"
31-Jan-2024,Commission,"92,643.47",00.00,"1,980,238.63"
31-Jan-2024,IMPS,"1,630,898.00",00.00,"3,611,136.63"
31-Jan-2024,Bill,00.00,"3,611,136.63",00.00
31-Jan-2024,Reversal,01.90,00.00,01.90
31-Jan-2024,Reversal,00.00,00.32,01.58
31-Jan-2024,ATM,00.00,00.16,01.42
31-Jan-2024,Miscellaneous,123.67,00.00,125.09
31-Jan-2024,IMPS,"2,265.59",00.00,"2,390.68"
31-Jan-2024,Interest,00.80,00.00,"2,391.48"
31-Jan-2024,ATM,00.00,265.72,"2,125.76"
31-Jan-2024,RTGS,00.00,"2,125.76",00.00
31-Jan-2024,RTGS,"570,641.00",00.00,"570,641.00"
31-Jan-2024,NEFT,00.00,"570,641.00",00.00
31-Jan-2024,ATM,"1,363,906.00",00.00,"1,363,906.00"
31-Jan-2024,Reversal,"111,345.00",00.00,"1,475,251.00"
31-Jan-2024,Miscellaneous,01.00,00.00,"1,475,252.00"
31-Jan-2024,IMPS,00.00,"147,525.20","1,327,726.80"
31-Jan-2024,Miscellaneous,"3,501.00",00.00,"1,331,227.80"
31-Jan-2024,Interest,00.00,"190,175.40","1,141,052.40"
01-Feb-2024,Transfer,"112,455.00",00.00,"1,253,507.40"
01-Feb-2024,RTGS,00.00,"125,350.74","1,128,156.66"
01-Feb-2024,Commission,00.00,"188,026.11","940,130.55"
02-Feb-2024,Commission,00.00,"235,032.64","705,097.91"
02-Feb-2024,NEFT,329.00,00.00,"705,426.91"
02-Feb-2024,NEFT,"18,634.71",00.00,"724,061.62"
02-Feb-2024,Reversal,00.00,"181,015.41","543,046.22"
02-Feb-2024,Reversal,00.00,"135,761.56","407,284.66"
02-Feb-2024,Cheque,"164,351.62",00.00,"571,636.28"
02-Feb-2024,Miscellaneous,00.00,"142,909.07","428,727.21"
02-Feb-2024,Miscellaneous,"30,255.73",00.00,"458,982.94"
03-Feb-2024,Miscellaneous,00.00,"229,491.47","229,491.47"
04-Feb-2024,Interest,73.70,00.00,"229,565.17"
04-Feb-2024,Tax,00.00,"22,956.52","206,608.65"
04-Feb-2024,Bill,37.90,00.00,"206,646.55"
04-Feb-2024,Commission,00.00,"206,646.55",00.00
04-Feb-2024,RTGS,18.24,00.00,18.24
04-Feb-2024,NEFT,00.00,01.82,16.42
04-Feb-2024,Reversal,32.40,00.00,48.82
04-Feb-2024,Bill,"60,840.00",00.00,"60,888.82"
04-Feb-2024,Tax,00.00,"10,148.14","50,740.68"
04-Feb-2024,Interest,902.10,00.00,"51,642.78"
04-Feb-2024,Commission,00.00,"5,164.28","46,478.50"
04-Feb-2024,RTGS,00.00,"5,809.81","40,668.69"
04-Feb-2024,Cash,00.00,"6,778.12","33,890.58"
04-Feb-2024,Cash,270.00,00.00,"34,160.58"
04-Feb-2024,Reversal,00.00,"17,080.29","17,080.29"
04-Feb-2024,Tax,00.00,"5,693.43","11,386.86"
04-Feb-2024,Reversal,00.00,"5,693.43","5,693.43"
04-Feb-2024,Miscellaneous,00.00,632.60,"5,060.83"
04-Feb-2024,Bill,"2,475.00",00.00,"7,535.83"
04-Feb-2024,IMPS,264.00,00.00,"7,799.83"
04-Feb-2024,Debit Card,"72,739.90",00.00,"80,539.73"
04-Feb-2024,RTGS,00.00,"26,846.58","53,693.15"
04-Feb-2024,Interest,430.00,00.00,"54,123.15"
04-Feb-2024,Miscellaneous,"32,022.13",00.00,"86,145.28"
04-Feb-2024,IMPS,"70,453.20",00.00,"156,598.48"
04-Feb-2024,Debit Card,41.87,00.00,"156,640.35"
04-Feb-2024,ATM,00.00,"26,106.73","130,533.62"
04-Feb-2024,Reversal,01.69,00.00,"130,535.31"
05-Feb-2024,IMPS,00.00,"26,107.06","104,428.25"
05-Feb-2024,Commission,"73,607.00",00.00,"178,035.25"
05-Feb-2024,IMPS,00.00,"178,035.25",00.00
05-Feb-2024,Tax,05.00,00.00,05.00
05-Feb-2024,NEFT,00.00,00.83,04.17
05-Feb-2024,IMPS,"1,818.60",00.00,"1,822.77"
05-Feb-2024,NEFT,"1,648.70",00.00,"3,471.47"
05-Feb-2024,Miscellaneous,00.00,"3,471.47",00.00
05-Feb-2024,Reversal,23.98,00.00,23.98
05-Feb-2024,Cheque,00.00,06.00,17.98
05-Feb-2024,Commission,"1,448.06",00.00,"1,466.04"
05-Feb-2024,Cash,00.00,209.43,"1,256.61"
05-Feb-2024,Debit Card,00.00,"1,256.61",00.00
05-Feb-2024,Tax,29.70,00.00,29.70
05-Feb-2024,Purchase,00.00,03.30,26.40
05-Feb-2024,Bill,29.00,00.00,55.40
05-Feb-2024,Commission,38.47,00.00,93.87
06-Feb-2024,ATM,00.00,46.94,46.94
06-Feb-2024,Bill,00.00,07.82,39.12
06-Feb-2024,Tax,"2,620.00",00.00,"2,659.12"
06-Feb-2024,Tax,373.00,00.00,"3,032.12"
06-Feb-2024,Commission,00.00,"1,516.06","1,516.06"
06-Feb-2024,Cheque,00.00,303.21,"1,212.85"
06-Feb-2024,NEFT,00.00,173.26,"1,039.59"
06-Feb-2024,RTGS,"3,769.48",00.00,"4,809.07"
06-Feb-2024,NEFT,00.00,480.91,"4,328.16"
06-Feb-2024,Cash,00.00,480.91,"3,847.25"
06-Feb-2024,Purchase,"114,308.03",00.00,"118,155.28"
06-Feb-2024,Miscellaneous,"41,232.20",00.00,"159,387.48"
06-Feb-2024,Cash,00.00,"53,129.16","106,258.32"
06-Feb-2024,Cheque,00.00,"13,282.29","92,976.03"
06-Feb-2024,Cash,325.90,00.00,"93,301.93"
06-Feb-2024,Purchase,00.00,"23,325.48","69,976.45"
06-Feb-2024,Tax,00.00,"7,775.16","62,201.29"
06-Feb-2024,Cheque,04.70,00.00,"62,205.99"
06-Feb-2024,Debit Card,"432,646.20",00.00,"494,852.19"
06-Feb-2024,Transfer,00.00,"49,485.22","445,366.97"
06-Feb-2024,Purchase,00.00,"63,623.85","381,743.12"
06-Feb-2024,ATM,00.00,"38,174.31","343,568.81"
06-Feb-2024,Commission,00.00,"57,261.47","286,307.34"
06-Feb-2024,Commission,00.00,"95,435.78","190,871.56"
06-Feb-2024,Transfer,00.00,"31,811.93","159,059.63"
06-Feb-2024,Reversal,"76,558.56",00.00,"235,618.19"
06-Feb-2024,Miscellaneous,"707,180.25",00.00,"942,798.44"
06-Feb-2024,RTGS,00.00,"942,798.44",00.00
07-Feb-2024,Cash,"1,234,537.75",00.00,"1,234,537.75"
07-Feb-2024,ATM,00.00,"617,268.88","617,268.88"
07-Feb-2024,Tax,00.00,"617,268.88",00.00
07-Feb-2024,Cash,07.20,00.00,07.20
07-Feb-2024,NEFT,52.14,00.00,59.34
07-Feb-2024,Cheque,55.24,00.00,114.58
07-Feb-2024,Tax,00.00,22.92,91.66
08-Feb-2024,Cheque,00.00,13.09,78.57
08-Feb-2024,Purchase,00.00,13.10,65.47
08-Feb-2024,Debit Card,56.00,00.00,121.47
08-Feb-2024,NEFT,00.00,15.18,106.29
08-Feb-2024,Tax,00.00,13.29,93.00
08-Feb-2024,Purchase,00.00,11.63,81.38
09-Feb-2024,RTGS,207.20,00.00,288.58
09-Feb-2024,NEFT,00.00,57.72,230.86
09-Feb-2024,Interest,00.00,230.86,00.00
09-Feb-2024,Interest,"2,951.80",00.00,"2,951.80"
09-Feb-2024,NEFT,"1,753,467.50",00.00,"1,756,419.30"
09-Feb-2024,ATM,02.00,00.00,"1,756,421.30"
09-Feb-2024,NEFT,"5,198.00",00.00,"1,761,619.30"
09-Feb-2024,ATM,00.00,"220,202.41","1,541,416.89"
09-Feb-2024,Transfer,"1,115.48",00.00,"1,542,532.37"
09-Feb-2024,Miscellaneous,"2,093.00",00.00,"1,544,625.37"
09-Feb-2024,Tax,00.00,"1,544,625.37",00.00
09-Feb-2024,Transfer,"1,246.00",00.00,"1,246.00"
09-Feb-2024,Debit Card,00.00,"1,246.00",00.00
09-Feb-2024,ATM,03.36,00.00,03.36
09-Feb-2024,Transfer,00.00,00.48,02.88
09-Feb-2024,Reversal,00.00,00.96,01.92
09-Feb-2024,Tax,00.00,01.92,00.00
09-Feb-2024,Cheque,08.00,00.00,08.00
09-Feb-2024,RTGS,04.00,00.00,12.00
09-Feb-2024,Bill,175.47,00.00,187.47
09-Feb-2024,Purchase,"21,236.60",00.00,"21,424.07"
09-Feb-2024,Cash,00.00,"10,712.04","10,712.04"
09-Feb-2024,Transfer,00.00,"1,190.23","9,521.81"
09-Feb-2024,RTGS,"354,420.75",00.00,"363,942.56"
09-Feb-2024,Cheque,00.00,"51,991.79","311,950.77"
10-Feb-2024,Cash,00.00,"62,390.15","249,560.62"
10-Feb-2024,Interest,05.00,00.00,"249,565.62"
10-Feb-2024,Transfer,335.00,00.00,"249,900.62"
10-Feb-2024,Bill,00.00,"83,300.21","166,600.41"
10-Feb-2024,Debit Card,"2,505.20",00.00,"169,105.61"
10-Feb-2024,Purchase,"1,895.33",00.00,"171,000.94"
10-Feb-2024,Debit Card,"1,158,202.80",00.00,"1,329,203.74"
10-Feb-2024,Commission,00.00,"664,601.87","664,601.87"
11-Feb-2024,Miscellaneous,06.82,00.00,"664,608.69"
11-Feb-2024,Purchase,"2,959.10",00.00,"667,567.79"
11-Feb-2024,Miscellaneous,"1,971,981.80",00.00,"2,639,549.59"
11-Feb-2024,RTGS,00.00,"527,909.92","2,111,639.67"
11-Feb-2024,Transfer,"15,275.80",00.00,"2,126,915.47"
11-Feb-2024,IMPS,04.00,00.00,"2,126,919.47"
11-Feb-2024,ATM,00.00,"265,864.93","1,861,054.54"
11-Feb-2024,Interest,00.00,"206,783.84","1,654,270.70"
11-Feb-2024,Commission,"1,377.61",00.00,"1,655,648.31"
11-Feb-2024,Cheque,00.00,"275,941.39","1,379,706.92"
11-Feb-2024,Purchase,"4,842.31",00.00,"1,384,549.23"
11-Feb-2024,Commission,"666,473.50",00.00,"2,051,022.73"
11-Feb-2024,Commission,27.00,00.00,"2,051,049.73"
11-Feb-2024,ATM,00.00,"410,209.95","1,640,839.78"
11-Feb-2024,IMPS,00.00,"546,946.59","1,093,893.19"
11-Feb-2024,Debit Card,226.00,00.00,"1,094,119.19"
11-Feb-2024,Purchase,"71,924.00",00.00,"1,166,043.19"
11-Feb-2024,Commission,00.00,"1,166,043.19",00.00
11-Feb-2024,Transfer,"1,952.30",00.00,"1,952.30"
11-Feb-2024,IMPS,00.00,"1,952.30",00.00
11-Feb-2024,Purchase,32.00,00.00,32.00
11-Feb-2024,NEFT,00.00,05.33,26.67
11-Feb-2024,RTGS,63.80,00.00,90.47
11-Feb-2024,IMPS,373.70,00.00,464.17
11-Feb-2024,Tax,00.00,116.04,348.13
11-Feb-2024,RTGS,00.00,87.03,261.10
11-Feb-2024,Commission,00.00,65.28,195.82
11-Feb-2024,Debit Card,10.94,00.00,206.76
11-Feb-2024,Tax,"2,003,941.20",00.00,"2,004,147.96"
11-Feb-2024,Reversal,00.00,"222,683.11","1,781,464.85"
11-Feb-2024,Tax,507.30,00.00,"1,781,972.15"
11-Feb-2024,Cheque,00.00,"197,996.91","1,583,975.24"
11-Feb-2024,IMPS,"651,240.20",00.00,"2,235,215.44"
11-Feb-2024,Cheque,"235,681.20",00.00,"2,470,896.64"
11-Feb-2024,Commission,00.00,"411,816.11","2,059,080.53"
11-Feb-2024,RTGS,00.00,"514,770.13","1,544,310.40"
11-Feb-2024,Bill,00.00,"514,770.13","1,029,540.27"
11-Feb-2024,Purchase,18.90,00.00,"1,029,559.17"
11-Feb-2024,Cash,"1,201,305.00",00.00,"2,230,864.17"
11-Feb-2024,ATM,"220,070.00",00.00,"2,450,934.17"
11-Feb-2024,Bill,"906,190.25",00.00,"3,357,124.42"
11-Feb-2024,Commission,00.00,"839,281.11","2,517,843.32"
11-Feb-2024,Miscellaneous,07.47,00.00,"2,517,850.79"
11-Feb-2024,Miscellaneous,"161,752.00",00.00,"2,679,602.79"
11-Feb-2024,IMPS,00.00,"893,200.93","1,786,401.86"
11-Feb-2024,ATM,00.00,"893,200.93","893,200.93"
11-Feb-2024,NEFT,00.00,"223,300.23","669,900.70"
11-Feb-2024,Reversal,01.20,00.00,"669,901.90"
11-Feb-2024,Transfer,00.00,"669,901.90",00.00
11-Feb-2024,ATM,"1,130,358.00",00.00,"1,130,358.00"
11-Feb-2024,Cash,00.00,"141,294.75","989,063.25"
11-Feb-2024,NEFT,00.00,"494,531.63","494,531.62"
11-Feb-2024,Reversal,"250,219.00",00.00,"744,750.62"
11-Feb-2024,Transfer,00.00,"744,750.62",00.00
11-Feb-2024,Cheque,"1,587.00",00.00,"1,587.00"
11-Feb-2024,Bill,00.00,176.33,"1,410.67"
11-Feb-2024,ATM,00.00,156.74,"1,253.93"
11-Feb-2024,Transfer,00.00,156.74,"1,097.19"
11-Feb-2024,Reversal,26.50,00.00,"1,123.69"
11-Feb-2024,Purchase,00.00,224.74,898.95
11-Feb-2024,RTGS,00.00,149.83,749.12
11-Feb-2024,NEFT,00.00,107.02,642.10
11-Feb-2024,Cheque,06.72,00.00,648.82
11-Feb-2024,Transfer,"64,277.00",00.00,"64,925.82"
11-Feb-2024,ATM,"19,706.00",00.00,"84,631.82"
11-Feb-2024,Debit Card,"11,087.53",00.00,"95,719.35"
11-Feb-2024,Transfer,00.00,"13,674.19","82,045.16"
11-Feb-2024,Transfer,21.60,00.00,"82,066.76"
11-Feb-2024,Commission,00.00,"13,677.79","68,388.97"
11-Feb-2024,Purchase,00.00,"34,194.49","34,194.48"
11-Feb-2024,Bill,71.00,00.00,"34,265.48"
11-Feb-2024,Transfer,00.00,"4,283.19","29,982.30"
11-Feb-2024,Cheque,00.00,"4,997.05","24,985.25"
11-Feb-2024,Commission,00.00,"2,498.53","22,486.72"
11-Feb-2024,Commission,"1,688.40",00.00,"24,175.12"
11-Feb-2024,NEFT,339.63,00.00,"24,514.75"
11-Feb-2024,Bill,06.00,00.00,"24,520.75"
11-Feb-2024,Commission,00.00,"3,065.09","21,455.66"
11-Feb-2024,NEFT,"40,303.00",00.00,"61,758.66"
11-Feb-2024,Interest,00.00,"6,175.87","55,582.79"
11-Feb-2024,IMPS,22.00,00.00,"55,604.79"
11-Feb-2024,Purchase,"168,009.75",00.00,"223,614.54"
11-Feb-2024,Bill,00.00,"24,846.06","198,768.48"
11-Feb-2024,Cheque,00.00,"24,846.06","173,922.42"
11-Feb-2024,Cheque,00.00,"57,974.14","115,948.28"
11-Feb-2024,Transfer,00.00,"11,594.83","104,353.45"
11-Feb-2024,Transfer,00.00,"104,353.45",00.00
11-Feb-2024,Bill,05.68,00.00,05.68
11-Feb-2024,Interest,00.00,00.71,04.97
11-Feb-2024,Cheque,00.00,00.99,03.98
11-Feb-2024,Commission,00.00,00.66,03.32
11-Feb-2024,Purchase,00.00,00.33,02.99
11-Feb-2024,Cash,56.94,00.00,59.93
11-Feb-2024,Bill,43.00,00.00,102.93
11-Feb-2024,Miscellaneous,00.00,11.44,91.49
11-Feb-2024,Cash,00.00,45.75,45.74
12-Feb-2024,ATM,243.30,00.00,289.04
12-Feb-2024,Cash,"207,191.00",00.00,"207,480.04"
12-Feb-2024,NEFT,10.00,00.00,"207,490.04"
12-Feb-2024,Reversal,00.99,00.00,"207,491.03"
12-Feb-2024,ATM,00.00,"20,749.10","186,741.93"
12-Feb-2024,ATM,06.86,00.00,"186,748.79"
12-Feb-2024,RTGS,00.00,"20,749.87","165,998.92"
12-Feb-2024,Miscellaneous,00.00,"27,666.49","138,332.43"
12-Feb-2024,Reversal,28.00,00.00,"138,360.43"
12-Feb-2024,Interest,25.00,00.00,"138,385.43"
12-Feb-2024,Transfer,00.00,"34,596.36","103,789.07"
12-Feb-2024,Bill,00.00,"34,596.36","69,192.71"
12-Feb-2024,Cash,00.00,"9,884.67","59,308.04"
12-Feb-2024,Bill,53.00,00.00,"59,361.04"
12-Feb-2024,ATM,00.00,"9,893.51","49,467.53"
12-Feb-2024,Cash,00.00,"8,244.59","41,222.94"
12-Feb-2024,NEFT,00.00,"4,122.29","37,100.65"
12-Feb-2024,Purchase,00.00,"18,550.33","18,550.32"
12-Feb-2024,ATM,00.00,"2,650.05","15,900.27"
12-Feb-2024,Bill,00.00,"3,180.05","12,720.22"
12-Feb-2024,Miscellaneous,00.00,"12,720.22",00.00
12-Feb-2024,Miscellaneous,01.14,00.00,01.14
12-Feb-2024,Transfer,00.00,00.13,01.01
12-Feb-2024,ATM,00.00,00.51,00.50
12-Feb-2024,Cheque,06.00,00.00,06.50
12-Feb-2024,Purchase,812.10,00.00,818.60
12-Feb-2024,RTGS,"930,408.00",00.00,"931,226.60"
12-Feb-2024,Reversal,00.00,"310,408.87","620,817.73"
12-Feb-2024,Debit Card,"110,869.70",00.00,"731,687.43"
12-Feb-2024,Bill,"1,205,767.00",00.00,"1,937,454.43"
12-Feb-2024,Cheque,"202,643.34",00.00,"2,140,097.77"
12-Feb-2024,Transfer,01.74,00.00,"2,140,099.51"
12-Feb-2024,Debit Card,"2,794.00",00.00,"2,142,893.51"
12-Feb-2024,Interest,"10,642.00",00.00,"2,153,535.51"
12-Feb-2024,RTGS,00.00,"538,383.88","1,615,151.63"
12-Feb-2024,Interest,00.00,"323,030.33","1,292,121.30"
12-Feb-2024,Interest,00.00,"323,030.33","969,090.98"
12-Feb-2024,Debit Card,88.90,00.00,"969,179.88"
12-Feb-2024,Commission,"1,473,248.75",00.00,"2,442,428.63"
12-Feb-2024,Interest,00.00,"814,142.88","1,628,285.75"
12-Feb-2024,Commission,00.00,"180,920.64","1,447,365.11"
12-Feb-2024,IMPS,01.75,00.00,"1,447,366.86"
12-Feb-2024,NEFT,00.00,"289,473.37","1,157,893.49"
12-Feb-2024,Tax,"32,675.10",00.00,"1,190,568.59"
12-Feb-2024,IMPS,00.00,"198,428.10","992,140.49"
12-Feb-2024,Cash,15.00,00.00,"992,155.49"
12-Feb-2024,Interest,00.00,"496,077.75","496,077.74"
12-Feb-2024,Bill,07.00,00.00,"496,084.74"
12-Feb-2024,RTGS,"21,128.00",00.00,"517,212.74"
12-Feb-2024,Commission,00.00,"64,651.59","452,561.15"
12-Feb-2024,Debit Card,06.50,00.00,"452,567.65"
12-Feb-2024,Purchase,00.00,"452,567.65",00.00
12-Feb-2024,ATM,08.00,00.00,08.00
13-Feb-2024,Bill,00.00,02.67,05.33
13-Feb-2024,Reversal,00.00,05.33,00.00
13-Feb-2024,Transfer,"3,290.40",00.00,"3,290.40"
13-Feb-2024,Commission,00.00,411.30,"2,879.10"
13-Feb-2024,Transfer,06.00,00.00,"2,885.10"
13-Feb-2024,Purchase,"3,826.70",00.00,"6,711.80"
13-Feb-2024,IMPS,"460,150.00",00.00,"466,861.80"
13-Feb-2024,Purchase,01.79,00.00,"466,863.59"
13-Feb-2024,Transfer,"4,927.48",00.00,"471,791.07"
13-Feb-2024,NEFT,00.00,"117,947.77","353,843.30"
13-Feb-2024,Purchase,"72,886.10",00.00,"426,729.40"
13-Feb-2024,Commission,"2,038,344.00",00.00,"2,465,073.40"
13-Feb-2024,Interest,00.00,"308,134.18","2,156,939.22"
13-Feb-2024,NEFT,00.00,"359,489.87","1,797,449.35"
13-Feb-2024,Cash,00.00,"898,724.68","898,724.68"
13-Feb-2024,Transfer,00.00,"179,744.94","718,979.74"
13-Feb-2024,ATM,06.77,00.00,"718,986.51"
13-Feb-2024,IMPS,00.00,"143,797.30","575,189.21"
13-Feb-2024,ATM,39.00,00.00,"575,228.21"
13-Feb-2024,Tax,"2,131.00",00.00,"577,359.21"
13-Feb-2024,IMPS,02.00,00.00,"577,361.21"
13-Feb-2024,IMPS,00.00,"96,226.87","481,134.34"
13-Feb-2024,NEFT,00.00,"60,141.79","420,992.55"
13-Feb-2024,IMPS,03.34,00.00,"420,995.89"
13-Feb-2024,Cheque,43.10,00.00,"421,038.99"
13-Feb-2024,Interest,07.00,00.00,"421,045.99"
13-Feb-2024,Debit Card,00.00,"84,209.20","336,836.79"
13-Feb-2024,Interest,00.00,"42,104.60","294,732.19"
13-Feb-2024,NEFT,17.46,00.00,"294,749.65"
13-Feb-2024,Transfer,00.00,"294,749.65",00.00
13-Feb-2024,Tax,219.30,00.00,219.30
13-Feb-2024,Tax,00.00,73.10,146.20
13-Feb-2024,Interest,01.00,00.00,147.20
13-Feb-2024,NEFT,03.93,00.00,151.13
13-Feb-2024,Commission,33.00,00.00,184.13
13-Feb-2024,Reversal,00.00,46.03,138.10
14-Feb-2024,NEFT,"2,005,452.00",00.00,"2,005,590.10"
14-Feb-2024,Commission,"3,040.00",00.00,"2,008,630.10"
14-Feb-2024,Tax,"140,697.70",00.00,"2,149,327.80"
14-Feb-2024,NEFT,"553,949.00",00.00,"2,703,276.80"
14-Feb-2024,Purchase,09.00,00.00,"2,703,285.80"
14-Feb-2024,ATM,00.00,"675,821.45","2,027,464.35"
14-Feb-2024,Commission,"1,768.10",00.00,"2,029,232.45"
14-Feb-2024,Miscellaneous,00.00,"2,029,232.45",00.00
14-Feb-2024,NEFT,"23,677.00",00.00,"23,677.00"
14-Feb-2024,Cash,00.00,"11,838.50","11,838.50"
14-Feb-2024,Bill,"27,531.55",00.00,"39,370.05"
14-Feb-2024,Commission,00.00,"4,374.45","34,995.60"
14-Feb-2024,Cheque,40.00,00.00,"35,035.60"
14-Feb-2024,Commission,00.00,"4,379.45","30,656.15"
14-Feb-2024,Cheque,00.00,"7,664.04","22,992.11"
14-Feb-2024,Cheque,00.00,"7,664.04","15,328.07"
14-Feb-2024,Purchase,00.00,"5,109.36","10,218.71"
14-Feb-2024,Miscellaneous,00.00,"3,406.24","6,812.47"
14-Feb-2024,Transfer,00.00,"1,703.12","5,109.35"
14-Feb-2024,Transfer,"28,126.64",00.00,"33,235.99"
14-Feb-2024,ATM,"1,905,059.00",00.00,"1,938,294.99"
14-Feb-2024,Commission,03.00,00.00,"1,938,297.99"
14-Feb-2024,Commission,00.00,"1,938,297.99",00.00
14-Feb-2024,Reversal,"2,556.69",00.00,"2,556.69"
14-Feb-2024,Bill,217.90,00.00,"2,774.59"
14-Feb-2024,Bill,16.50,00.00,"2,791.09"
14-Feb-2024,Tax,00.00,930.36,"1,860.73"
14-Feb-2024,Transfer,00.00,620.24,"1,240.49"
14-Feb-2024,Cheque,"2,206.00",00.00,"3,446.49"
14-Feb-2024,Cheque,00.00,344.65,"3,101.84"
14-Feb-2024,Cash,00.00,"3,101.84",00.00
14-Feb-2024,Miscellaneous,"10,152.30",00.00,"10,152.30"
14-Feb-2024,Cheque,"14,682.56",00.00,"24,834.86"
14-Feb-2024,Miscellaneous,00.00,"3,547.84","21,287.02"
14-Feb-2024,Bill,499.80,00.00,"21,786.82"
14-Feb-2024,Cheque,00.00,"7,262.27","14,524.55"
14-Feb-2024,Miscellaneous,00.00,"3,631.14","10,893.41"
15-Feb-2024,Tax,32.35,00.00,"10,925.76"
15-Feb-2024,Purchase,151.40,00.00,"11,077.16"
15-Feb-2024,ATM,"1,679,224.25",00.00,"1,690,301.41"
16-Feb-2024,Cheque,00.00,"211,287.68","1,479,013.73"
16-Feb-2024,Tax,00.00,"1,479,013.73",00.00
16-Feb-2024,Debit Card,23.30,00.00,23.30
16-Feb-2024,Reversal,00.00,03.88,19.42
16-Feb-2024,Purchase,133.10,00.00,152.52
16-Feb-2024,Cheque,30.10,00.00,182.62
17-Feb-2024,Cheque,02.30,00.00,184.92
17-Feb-2024,Miscellaneous,00.00,26.42,158.50
17-Feb-2024,Interest,00.00,15.85,142.65
17-Feb-2024,Reversal,00.00,28.53,114.12
17-Feb-2024,Commission,"11,499.27",00.00,"11,613.39"
17-Feb-2024,Debit Card,340.00,00.00,"11,953.39"
17-Feb-2024,Bill,00.00,"1,707.63","10,245.76"
17-Feb-2024,Commission,00.00,"2,561.44","7,684.32"
17-Feb-2024,NEFT,"1,207,180.50",00.00,"1,214,864.82"
17-Feb-2024,Purchase,22.83,00.00,"1,214,887.65"
17-Feb-2024,Purchase,00.00,"121,488.77","1,093,398.88"
17-Feb-2024,Interest,00.00,"1,093,398.88",00.00
18-Feb-2024,IMPS,01.32,00.00,01.32
18-Feb-2024,Transfer,389.10,00.00,390.42
18-Feb-2024,IMPS,"34,918.00",00.00,"35,308.42"
18-Feb-2024,Reversal,"14,119.00",00.00,"49,427.42"
18-Feb-2024,RTGS,00.00,"49,427.42",00.00
18-Feb-2024,Interest,"1,823.30",00.00,"1,823.30"
18-Feb-2024,NEFT,00.12,00.00,"1,823.42"
18-Feb-2024,Commission,00.00,455.86,"1,367.56"
18-Feb-2024,Miscellaneous,147.20,00.00,"1,514.76"
18-Feb-2024,Interest,32.00,00.00,"1,546.76"
18-Feb-2024,Cheque,00.00,386.69,"1,160.07"
18-Feb-2024,Cash,"149,919.30",00.00,"151,079.37"
18-Feb-2024,Cash,"24,683.00",00.00,"175,762.37"
19-Feb-2024,RTGS,00.00,"19,529.15","156,233.22"
19-Feb-2024,Reversal,"16,083.80",00.00,"172,317.02"
19-Feb-2024,Commission,469.99,00.00,"172,787.01"
19-Feb-2024,Tax,"117,682.40",00.00,"290,469.41"
19-Feb-2024,Transfer,00.00,"290,469.41",00.00
19-Feb-2024,IMPS,32.11,00.00,32.11
19-Feb-2024,Interest,16.40,00.00,48.51
19-Feb-2024,Miscellaneous,00.00,48.51,00.00
19-Feb-2024,Reversal,"177,407.00",00.00,"177,407.00"
19-Feb-2024,Purchase,04.00,00.00,"177,411.00"
19-Feb-2024,Commission,00.00,"19,712.33","157,698.67"
19-Feb-2024,NEFT,00.00,"22,528.38","135,170.29"
19-Feb-2024,Purchase,00.00,"22,528.38","112,641.91"
19-Feb-2024,Cheque,"3,114.70",00.00,"115,756.61"
19-Feb-2024,RTGS,05.45,00.00,"115,762.06"
19-Feb-2024,NEFT,43.00,00.00,"115,805.06"
19-Feb-2024,Purchase,00.00,"28,951.27","86,853.80"
19-Feb-2024,Reversal,"1,350,494.00",00.00,"1,437,347.80"
19-Feb-2024,Cheque,00.00,"479,115.93","958,231.87"
19-Feb-2024,RTGS,00.48,00.00,"958,232.35"
19-Feb-2024,Cash,"2,356.20",00.00,"960,588.55"
19-Feb-2024,Cash,"185,953.10",00.00,"1,146,541.65"
19-Feb-2024,Bill,00.00,"163,791.66","982,749.99"
19-Feb-2024,Reversal,03.00,00.00,"982,752.99"
19-Feb-2024,Cheque,"15,597.04",00.00,"998,350.03"
19-Feb-2024,RTGS,"106,762.50",00.00,"1,105,112.53"
19-Feb-2024,Cheque,04.56,00.00,"1,105,117.09"
19-Feb-2024,NEFT,00.00,"368,372.36","736,744.73"
19-Feb-2024,Transfer,00.00,"184,186.18","552,558.55"
19-Feb-2024,Purchase,00.00,"276,279.28","276,279.28"
19-Feb-2024,Debit Card,"78,498.00",00.00,"354,777.28"
19-Feb-2024,NEFT,11.31,00.00,"354,788.59"
19-Feb-2024,Cash,00.00,"35,478.86","319,309.73"
19-Feb-2024,IMPS,"3,150.00",00.00,"322,459.73"
19-Feb-2024,Purchase,"2,302.40",00.00,"324,762.13"
19-Feb-2024,Cheque,"220,893.44",00.00,"545,655.57"
19-Feb-2024,Reversal,00.00,"136,413.89","409,241.68"
19-Feb-2024,NEFT,"3,272.00",00.00,"412,513.68"
19-Feb-2024,Bill,"29,205.00",00.00,"441,718.68"
19-Feb-2024,RTGS,00.00,"73,619.78","368,098.90"
19-Feb-2024,Interest,07.00,00.00,"368,105.90"
19-Feb-2024,Commission,00.00,"92,026.48","276,079.43"
19-Feb-2024,Bill,01.00,00.00,"276,080.43"
19-Feb-2024,NEFT,58.00,00.00,"276,138.43"
19-Feb-2024,Reversal,00.00,"69,034.61","207,103.82"
20-Feb-2024,IMPS,"229,989.40",00.00,"437,093.22"
20-Feb-2024,Purchase,00.00,"437,093.22",00.00
20-Feb-2024,Tax,"3,600.90",00.00,"3,600.90"
20-Feb-2024,Bill,00.00,450.11,"3,150.79"
20-Feb-2024,NEFT,"54,982.80",00.00,"58,133.59"
20-Feb-2024,Cash,04.00,00.00,"58,137.59"
20-Feb-2024,Interest,"2,621.30",00.00,"60,758.89"
20-Feb-2024,Transfer,227.00,00.00,"60,985.89"
20-Feb-2024,Reversal,00.00,"60,985.89",00.00
20-Feb-2024,Commission,"16,757.60",00.00,"16,757.60"
20-Feb-2024,ATM,05.30,00.00,"16,762.90"
20-Feb-2024,Bill,"319,450.20",00.00,"336,213.10"
20-Feb-2024,RTGS,00.00,"84,053.28","252,159.82"
20-Feb-2024,Purchase,75.80,00.00,"252,235.62"
20-Feb-2024,Purchase,"2,157.00",00.00,"254,392.62"
20-Feb-2024,Tax,00.00,"28,265.85","226,126.77"
20-Feb-2024,ATM,00.00,"56,531.69","169,595.08"
21-Feb-2024,Tax,00.00,"33,919.02","135,676.06"
21-Feb-2024,Commission,02.50,00.00,"135,678.56"
21-Feb-2024,Interest,58.65,00.00,"135,737.21"
21-Feb-2024,Cash,"649,890.00",00.00,"785,627.21"
21-Feb-2024,Tax,00.00,"98,203.40","687,423.81"
21-Feb-2024,Miscellaneous,00.00,"229,141.27","458,282.54"
21-Feb-2024,IMPS,00.00,"458,282.54",00.00
21-Feb-2024,Transfer,"3,295.00",00.00,"3,295.00"
21-Feb-2024,Cash,00.00,"1,647.50","1,647.50"
21-Feb-2024,Cash,00.00,329.50,"1,318.00"
21-Feb-2024,ATM,00.00,439.33,878.67
22-Feb-2024,NEFT,"2,799.30",00.00,"3,677.97"
22-Feb-2024,Miscellaneous,676.76,00.00,"4,354.73"
22-Feb-2024,RTGS,"243,355.19",00.00,"247,709.92"
22-Feb-2024,Miscellaneous,00.00,"30,963.74","216,746.18"
22-Feb-2024,Cheque,00.00,"27,093.27","189,652.91"
22-Feb-2024,Interest,00.00,"94,826.46","94,826.46"
22-Feb-2024,Cheque,00.00,"13,546.64","81,279.82"
22-Feb-2024,RTGS,00.00,"16,255.96","65,023.86"
22-Feb-2024,Bill,00.00,"13,004.77","52,019.09"
22-Feb-2024,RTGS,"185,969.22",00.00,"237,988.31"
22-Feb-2024,Miscellaneous,42.00,00.00,"238,030.31"
22-Feb-2024,Purchase,00.00,"119,015.16","119,015.16"
22-Feb-2024,Purchase,00.00,"13,223.91","105,791.25"
22-Feb-2024,Cash,00.00,"26,447.81","79,343.44"
22-Feb-2024,IMPS,391.00,00.00,"79,734.44"
22-Feb-2024,ATM,00.00,"26,578.15","53,156.29"
22-Feb-2024,Cheque,00.00,"7,593.76","45,562.53"
22-Feb-2024,Reversal,00.00,"5,695.32","39,867.21"
22-Feb-2024,Cash,07.60,00.00,"39,874.81"
22-Feb-2024,IMPS,00.00,"9,968.70","29,906.11"
22-Feb-2024,Commission,333.20,00.00,"30,239.31"
22-Feb-2024,Interest,06.00,00.00,"30,245.31"
22-Feb-2024,Commission,00.00,"3,024.53","27,220.78"
22-Feb-2024,IMPS,232.62,00.00,"27,453.40"
22-Feb-2024,Tax,"226,351.20",00.00,"253,804.60"
22-Feb-2024,Reversal,00.00,"126,902.30","126,902.30"
22-Feb-2024,Debit Card,00.00,"21,150.38","105,751.92"
22-Feb-2024,Cheque,00.00,"11,750.21","94,001.71"
22-Feb-2024,IMPS,00.00,"23,500.43","70,501.28"
22-Feb-2024,Miscellaneous,"185,393.10",00.00,"255,894.38"
22-Feb-2024,Cash,00.00,"51,178.88","204,715.50"
22-Feb-2024,Cheque,17.00,00.00,"204,732.50"
22-Feb-2024,Tax,"1,404,784.00",00.00,"1,609,516.50"
22-Feb-2024,Purchase,"20,482.00",00.00,"1,629,998.50"
22-Feb-2024,Tax,"940,081.50",00.00,"2,570,080.00"
22-Feb-2024,RTGS,"17,295.00",00.00,"2,587,375.00"
22-Feb-2024,Debit Card,995.43,00.00,"2,588,370.43"
22-Feb-2024,Commission,"211,721.80",00.00,"2,800,092.23"
22-Feb-2024,IMPS,00.00,00.00,"2,800,092.23"
22-Feb-2024,Reversal,00.00,"2,800,092.23",00.00
22-Feb-2024,RTGS,"1,149.00",00.00,"1,149.00"
22-Feb-2024,Cheque,33.00,00.00,"1,182.00"
22-Feb-2024,Commission,"223,656.94",00.00,"224,838.94"
22-Feb-2024,Tax,"696,135.20",00.00,"920,974.14"
22-Feb-2024,ATM,00.00,"102,330.46","818,643.68"
22-Feb-2024,Debit Card,00.00,"90,960.41","727,683.27"
22-Feb-2024,Transfer,00.00,"181,920.82","545,762.45"
22-Feb-2024,RTGS,00.00,"109,152.49","436,609.96"
22-Feb-2024,Miscellaneous,00.00,"436,609.96",00.00
22-Feb-2024,Miscellaneous,"66,916.97",00.00,"66,916.97"
23-Feb-2024,Bill,00.00,"22,305.66","44,611.31"
23-Feb-2024,Miscellaneous,271.34,00.00,"44,882.65"
23-Feb-2024,Transfer,00.00,"4,488.27","40,394.38"
23-Feb-2024,Transfer,"1,989,978.75",00.00,"2,030,373.13"
23-Feb-2024,Transfer,00.00,"253,796.64","1,776,576.49"
23-Feb-2024,Commission,00.00,"444,144.12","1,332,432.37"
23-Feb-2024,Miscellaneous,"5,889.28",00.00,"1,338,321.65"
23-Feb-2024,Transfer,"17,169.00",00.00,"1,355,490.65"
23-Feb-2024,Cash,"12,491.80",00.00,"1,367,982.45"
23-Feb-2024,Reversal,324.00,00.00,"1,368,306.45"
24-Feb-2024,Transfer,"1,117,565.00",00.00,"2,485,871.45"
24-Feb-2024,Miscellaneous,00.00,"621,467.86","1,864,403.59"
24-Feb-2024,IMPS,00.00,"466,100.90","1,398,302.69"
24-Feb-2024,Cheque,00.00,"155,366.97","1,242,935.72"
24-Feb-2024,Interest,"27,913.00",00.00,"1,270,848.72"
24-Feb-2024,ATM,"1,135.85",00.00,"1,271,984.57"
24-Feb-2024,Bill,00.00,"423,994.86","847,989.71"
24-Feb-2024,NEFT,"13,253.00",00.00,"861,242.71"
24-Feb-2024,ATM,00.00,"86,124.27","775,118.44"
25-Feb-2024,Purchase,"1,584,230.75",00.00,"2,359,349.19"
25-Feb-2024,ATM,00.00,"235,934.92","2,123,414.27"
25-Feb-2024,Tax,00.00,"530,853.57","1,592,560.70"
25-Feb-2024,Commission,00.00,"199,070.09","1,393,490.61"
25-Feb-2024,Reversal,365.90,00.00,"1,393,856.51"
25-Feb-2024,Debit Card,07.90,00.00,"1,393,864.41"
25-Feb-2024,ATM,55.00,00.00,"1,393,919.41"
25-Feb-2024,Bill,00.00,"154,879.93","1,239,039.48"
25-Feb-2024,Bill,00.00,"137,671.05","1,101,368.43"
25-Feb-2024,Reversal,19.80,00.00,"1,101,388.23"
25-Feb-2024,IMPS,00.00,"183,564.71","917,823.52"
25-Feb-2024,Reversal,00.00,"305,941.17","611,882.35"
25-Feb-2024,Cash,00.00,"203,960.78","407,921.57"
25-Feb-2024,Miscellaneous,00.00,"203,960.79","203,960.78"
25-Feb-2024,Cheque,125.00,00.00,"204,085.78"
25-Feb-2024,Bill,"3,423.00",00.00,"207,508.78"
25-Feb-2024,IMPS,52.54,00.00,"207,561.32"
25-Feb-2024,ATM,00.00,"34,593.55","172,967.77"
25-Feb-2024,Transfer,"585,480.00",00.00,"758,447.77"
25-Feb-2024,Miscellaneous,04.45,00.00,"758,452.22"
25-Feb-2024,Tax,00.00,"108,350.32","650,101.90"
25-Feb-2024,Cash,"2,102.15",00.00,"652,204.05"
25-Feb-2024,Cash,00.00,"652,204.05",00.00
26-Feb-2024,Commission,00.50,00.00,00.50
26-Feb-2024,Debit Card,59.00,00.00,59.50
26-Feb-2024,Miscellaneous,00.00,05.95,53.55
26-Feb-2024,Miscellaneous,"2,789.47",00.00,"2,843.02"
26-Feb-2024,ATM,00.00,355.38,"2,487.64"
26-Feb-2024,Tax,00.00,276.40,"2,211.24"
26-Feb-2024,Transfer,00.00,221.12,"1,990.12"
26-Feb-2024,Transfer,00.00,995.06,995.06
26-Feb-2024,Cheque,50.00,00.00,"1,045.06"
26-Feb-2024,Tax,379.00,00.00,"1,424.06"
26-Feb-2024,IMPS,"70,323.60",00.00,"71,747.66"
26-Feb-2024,RTGS,600.66,00.00,"72,348.32"
26-Feb-2024,ATM,"11,462.30",00.00,"83,810.62"
26-Feb-2024,Bill,00.00,"83,810.62",00.00
26-Feb-2024,Bill,"210,942.90",00.00,"210,942.90"
26-Feb-2024,Miscellaneous,27.43,00.00,"210,970.33"
26-Feb-2024,RTGS,04.49,00.00,"210,974.82"
26-Feb-2024,Interest,56.00,00.00,"211,030.82"
26-Feb-2024,Commission,00.00,"70,343.61","140,687.21"
26-Feb-2024,Cash,00.00,"35,171.80","105,515.41"
26-Feb-2024,Bill,00.00,"10,551.54","94,963.87"
26-Feb-2024,Cheque,05.10,00.00,"94,968.97"
26-Feb-2024,Debit Card,03.80,00.00,"94,972.77"
26-Feb-2024,Bill,00.00,"47,486.39","47,486.38"
26-Feb-2024,IMPS,"381,047.00",00.00,"428,533.38"
26-Feb-2024,RTGS,"3,414.20",00.00,"431,947.58"
26-Feb-2024,Transfer,00.00,"431,947.58",00.00
26-Feb-2024,Tax,"138,656.00",00.00,"138,656.00"
26-Feb-2024,RTGS,"3,288.00",00.00,"141,944.00"
26-Feb-2024,Interest,23.00,00.00,"141,967.00"
26-Feb-2024,Transfer,00.00,"17,745.88","124,221.12"
26-Feb-2024,RTGS,00.00,"12,422.11","111,799.01"
26-Feb-2024,Cash,"2,815.00",00.00,"114,614.01"
26-Feb-2024,IMPS,"96,209.00",00.00,"210,823.01"
26-Feb-2024,Reversal,00.00,"21,082.30","189,740.71"
26-Feb-2024,Cash,00.00,"31,623.45","158,117.26"
26-Feb-2024,Miscellaneous,00.00,"39,529.32","118,587.94"
26-Feb-2024,Tax,"333,283.80",00.00,"451,871.74"
26-Feb-2024,Tax,"16,073.00",00.00,"467,944.74"
26-Feb-2024,RTGS,"16,401.60",00.00,"484,346.34"
26-Feb-2024,Cash,00.00,"121,086.59","363,259.76"
26-Feb-2024,Miscellaneous,"133,522.80",00.00,"496,782.56"
26-Feb-2024,Bill,00.00,"70,968.94","425,813.62"
26-Feb-2024,Debit Card,00.00,"212,906.81","212,906.81"
26-Feb-2024,Purchase,00.00,"30,415.26","182,491.55"
26-Feb-2024,Debit Card,00.00,"60,830.52","121,661.03"
26-Feb-2024,Miscellaneous,"1,877.00",00.00,"123,538.03"
26-Feb-2024,Bill,"3,295.00",00.00,"126,833.03"
26-Feb-2024,Purchase,00.00,"15,854.13","110,978.90"
26-Feb-2024,Debit Card,00.00,"27,744.73","83,234.17"
26-Feb-2024,RTGS,00.00,"8,323.42","74,910.75"
27-Feb-2024,RTGS,239.00,00.00,"75,149.75"
27-Feb-2024,Miscellaneous,00.00,"75,149.75",00.00
27-Feb-2024,Tax,"12,174.00",00.00,"12,174.00"
27-Feb-2024,Miscellaneous,00.00,"1,352.67","10,821.33"
27-Feb-2024,ATM,"37,446.66",00.00,"48,267.99"
27-Feb-2024,Cheque,00.00,"6,895.43","41,372.56"
27-Feb-2024,Cheque,04.00,00.00,"41,376.56"
27-Feb-2024,IMPS,511.57,00.00,"41,888.13"
27-Feb-2024,RTGS,"14,288.90",00.00,"56,177.03"
27-Feb-2024,ATM,00.00,"18,725.68","37,451.35"
27-Feb-2024,Miscellaneous,"1,146.00",00.00,"38,597.35"
27-Feb-2024,Reversal,"185,055.44",00.00,"223,652.79"
27-Feb-2024,Reversal,00.20,00.00,"223,652.99"
27-Feb-2024,Bill,00.00,"111,826.50","111,826.50"
27-Feb-2024,ATM,00.00,"18,637.75","93,188.75"
27-Feb-2024,Transfer,"3,441.85",00.00,"96,630.60"
27-Feb-2024,NEFT,"5,776.00",00.00,"102,406.60"
27-Feb-2024,Purchase,00.00,"14,629.51","87,777.09"
27-Feb-2024,Transfer,"1,862,908.00",00.00,"1,950,685.09"
27-Feb-2024,NEFT,00.00,"390,137.02","1,560,548.07"
27-Feb-2024,Cash,14.08,00.00,"1,560,562.15"
27-Feb-2024,Cheque,"131,527.38",00.00,"1,692,089.53"
28-Feb-2024,Cheque,06.52,00.00,"1,692,096.05"
28-Feb-2024,Bill,00.00,"188,010.67","1,504,085.38"
28-Feb-2024,IMPS,00.00,"1,504,085.38",00.00
29-Feb-2024,Cash,125.95,00.00,125.95
29-Feb-2024,ATM,00.00,125.95,00.00
29-Feb-2024,Transfer,"2,025.30",00.00,"2,025.30"
29-Feb-2024,Miscellaneous,"1,535,399.00",00.00,"1,537,424.30"
29-Feb-2024,Purchase,00.00,"512,474.77","1,024,949.53"
29-Feb-2024,Tax,00.00,"341,649.84","683,299.69"
29-Feb-2024,Tax,00.00,"227,766.56","455,533.13"
01-Mar-2024,IMPS,06.10,00.00,"455,539.23"
01-Mar-2024,Bill,02.10,00.00,"455,541.33"
01-Mar-2024,Miscellaneous,18.00,00.00,"455,559.33"
01-Mar-2024,Cheque,"5,688.96",00.00,"461,248.29"
01-Mar-2024,Tax,"216,441.66",00.00,"677,689.95"
01-Mar-2024,IMPS,00.00,"338,844.98","338,844.98"
01-Mar-2024,Transfer,00.00,"33,884.50","304,960.48"
01-Mar-2024,Commission,94.00,00.00,"305,054.48"
01-Mar-2024,NEFT,00.00,"152,527.24","152,527.24"
01-Mar-2024,Transfer,00.00,"152,527.24",00.00
01-Mar-2024,Transfer,852.28,00.00,852.28
01-Mar-2024,Interest,00.00,284.09,568.19
01-Mar-2024,NEFT,00.00,568.19,00.00
01-Mar-2024,Debit Card,137.00,00.00,137.00
01-Mar-2024,Purchase,402.00,00.00,539.00
01-Mar-2024,Transfer,00.00,269.50,269.50
01-Mar-2024,NEFT,"1,350.36",00.00,"1,619.86"
01-Mar-2024,Reversal,"11,631.00",00.00,"13,250.86"
01-Mar-2024,Cash,"26,544.30",00.00,"39,795.16"
01-Mar-2024,Bill,"1,581,289.50",00.00,"1,621,084.66"
01-Mar-2024,Bill,"1,758.00",00.00,"1,622,842.66"
01-Mar-2024,Interest,07.40,00.00,"1,622,850.06"
01-Mar-2024,Miscellaneous,"855,239.00",00.00,"2,478,089.06"
01-Mar-2024,NEFT,00.00,"309,761.13","2,168,327.93"
01-Mar-2024,Reversal,"2,969.00",00.00,"2,171,296.93"
01-Mar-2024,Interest,00.00,"2,171,296.93",00.00
01-Mar-2024,RTGS,"594,457.80",00.00,"594,457.80"
02-Mar-2024,RTGS,00.00,"66,050.87","528,406.93"
02-Mar-2024,Bill,492.33,00.00,"528,899.26"
02-Mar-2024,NEFT,"1,364,425.00",00.00,"1,893,324.26"
02-Mar-2024,Transfer,00.00,"270,474.89","1,622,849.37"
02-Mar-2024,Debit Card,00.00,"202,856.17","1,419,993.20"
02-Mar-2024,Tax,00.00,"141,999.32","1,277,993.88"
02-Mar-2024,NEFT,00.00,"425,997.96","851,995.92"
02-Mar-2024,Bill,00.00,"851,995.92",00.00
02-Mar-2024,NEFT,"21,938.70",00.00,"21,938.70"
02-Mar-2024,Interest,"32,694.00",00.00,"54,632.70"
02-Mar-2024,Cheque,00.00,"18,210.90","36,421.80"
02-Mar-2024,Miscellaneous,00.00,"3,642.18","32,779.62"
02-Mar-2024,NEFT,00.00,"8,194.91","24,584.72"
02-Mar-2024,Interest,"30,309.63",00.00,"54,894.35"
02-Mar-2024,RTGS,00.00,"10,978.87","43,915.48"
02-Mar-2024,Tax,"233,652.72",00.00,"277,568.20"
02-Mar-2024,RTGS,00.00,"138,784.10","138,784.10"
02-Mar-2024,RTGS,"176,641.40",00.00,"315,425.50"
02-Mar-2024,Commission,45.88,00.00,"315,471.38"
02-Mar-2024,Cheque,00.00,"52,578.56","262,892.82"
02-Mar-2024,Bill,00.00,"29,210.31","233,682.51"
02-Mar-2024,Debit Card,00.00,"29,210.31","204,472.20"
02-Mar-2024,Bill,00.00,"68,157.40","136,314.80"
02-Mar-2024,Bill,"176,741.50",00.00,"313,056.30"
02-Mar-2024,RTGS,"1,672.19",00.00,"314,728.49"
02-Mar-2024,Interest,00.00,"39,341.06","275,387.43"
02-Mar-2024,ATM,202.10,00.00,"275,589.53"
02-Mar-2024,Debit Card,00.29,00.00,"275,589.82"
02-Mar-2024,ATM,00.00,"30,621.09","244,968.73"
02-Mar-2024,RTGS,00.00,"27,218.75","217,749.98"
02-Mar-2024,Debit Card,00.00,"31,107.14","186,642.84"
02-Mar-2024,Tax,"163,942.00",00.00,"350,584.84"
02-Mar-2024,Cheque,00.00,"35,058.48","315,526.36"
02-Mar-2024,RTGS,124.30,00.00,"315,650.66"
02-Mar-2024,RTGS,00.00,"35,072.30","280,578.36"
02-Mar-2024,Miscellaneous,00.00,"93,526.12","187,052.24"
02-Mar-2024,Bill,02.40,00.00,"187,054.64"
02-Mar-2024,NEFT,00.00,"20,783.85","166,270.79"
02-Mar-2024,Interest,00.00,"18,474.53","147,796.26"
02-Mar-2024,RTGS,00.00,"73,898.13","73,898.13"
02-Mar-2024,Cash,00.00,"18,474.53","55,423.60"
02-Mar-2024,Debit Card,03.30,00.00,"55,426.90"
02-Mar-2024,Transfer,"3,091.92",00.00,"58,518.82"
02-Mar-2024,Bill,00.00,"14,629.71","43,889.12"
02-Mar-2024,RTGS,00.00,"21,944.56","21,944.56"
02-Mar-2024,Bill,279.00,00.00,"22,223.56"
02-Mar-2024,RTGS,00.00,"22,223.56",00.00
02-Mar-2024,Tax,41.00,00.00,41.00
02-Mar-2024,Tax,00.50,00.00,41.50
02-Mar-2024,ATM,00.00,05.19,36.31
02-Mar-2024,NEFT,140.00,00.00,176.31
02-Mar-2024,Bill,"17,857.00",00.00,"18,033.31"
03-Mar-2024,Bill,00.00,"1,803.33","16,229.98"
04-Mar-2024,Tax,"415,206.20",00.00,"431,436.18"
04-Mar-2024,Purchase,01.44,00.00,"431,437.62"
04-Mar-2024,IMPS,"483,907.75",00.00,"915,345.37"
04-Mar-2024,Purchase,02.97,00.00,"915,348.34"
04-Mar-2024,Bill,00.00,"915,348.34",00.00
04-Mar-2024,ATM,336.49,00.00,336.49
04-Mar-2024,RTGS,00.00,67.30,269.19
04-Mar-2024,NEFT,00.00,134.60,134.60
04-Mar-2024,Reversal,00.00,67.30,67.30
04-Mar-2024,Cash,"261,626.00",00.00,"261,693.30"
04-Mar-2024,Tax,00.00,"29,077.03","232,616.27"
04-Mar-2024,Tax,00.00,"46,523.25","186,093.02"
04-Mar-2024,NEFT,"85,390.00",00.00,"271,483.02"
04-Mar-2024,Miscellaneous,00.00,"54,296.60","217,186.42"
04-Mar-2024,Debit Card,00.00,"24,131.82","193,054.60"
04-Mar-2024,Reversal,"20,598.66",00.00,"213,653.26"
04-Mar-2024,Reversal,153.00,00.00,"213,806.26"
04-Mar-2024,Commission,"1,499,332.00",00.00,"1,713,138.26"
04-Mar-2024,NEFT,00.00,"428,284.57","1,284,853.70"
04-Mar-2024,Debit Card,00.00,"160,606.71","1,124,246.99"
04-Mar-2024,Tax,00.00,"124,916.33","999,330.66"
04-Mar-2024,Interest,"1,824.80",00.00,"1,001,155.46"
04-Mar-2024,Commission,60.00,00.00,"1,001,215.46"
04-Mar-2024,Cheque,"17,386.00",00.00,"1,018,601.46"
04-Mar-2024,Interest,00.00,"127,325.18","891,276.28"
04-Mar-2024,Interest,00.00,"111,409.54","779,866.74"
04-Mar-2024,Commission,"136,954.70",00.00,"916,821.44"
04-Mar-2024,NEFT,00.00,"101,869.05","814,952.39"
04-Mar-2024,NEFT,00.00,"814,952.39",00.00
04-Mar-2024,IMPS,"22,465.58",00.00,"22,465.58"
04-Mar-2024,Commission,59.00,00.00,"22,524.58"
04-Mar-2024,Interest,00.00,"11,262.29","11,262.29"
04-Mar-2024,Purchase,00.00,"2,252.46","9,009.83"
04-Mar-2024,Cash,00.00,"1,126.23","7,883.60"
04-Mar-2024,IMPS,00.00,"2,627.87","5,255.73"
04-Mar-2024,Purchase,00.00,875.96,"4,379.77"
04-Mar-2024,Miscellaneous,47.40,00.00,"4,427.17"
04-Mar-2024,RTGS,"972,187.00",00.00,"976,614.17"
04-Mar-2024,Interest,"1,645.00",00.00,"978,259.17"
04-Mar-2024,Debit Card,118.00,00.00,"978,377.17"
04-Mar-2024,Reversal,27.00,00.00,"978,404.17"
05-Mar-2024,NEFT,00.00,"139,772.02","838,632.15"
05-Mar-2024,Debit Card,"22,901.50",00.00,"861,533.65"
05-Mar-2024,Reversal,00.00,"861,533.65",00.00
05-Mar-2024,Interest,491.80,00.00,491.80
05-Mar-2024,IMPS,"1,321.00",00.00,"1,812.80"
05-Mar-2024,Purchase,13.89,00.00,"1,826.69"
05-Mar-2024,Bill,250.50,00.00,"2,077.19"
05-Mar-2024,NEFT,00.00,415.44,"1,661.75"
05-Mar-2024,Debit Card,00.00,237.39,"1,424.36"
05-Mar-2024,Interest,00.00,356.09,"1,068.27"
05-Mar-2024,ATM,23.73,00.00,"1,092.00"
05-Mar-2024,Transfer,00.00,109.20,982.80
05-Mar-2024,ATM,"115,591.00",00.00,"116,573.80"
05-Mar-2024,NEFT,00.00,"23,314.76","93,259.04"
05-Mar-2024,Reversal,319.00,00.00,"93,578.04"
05-Mar-2024,Commission,00.00,"31,192.68","62,385.36"
05-Mar-2024,Miscellaneous,00.00,"31,192.68","31,192.68"
05-Mar-2024,Commission,00.00,"3,119.27","28,073.41"
05-Mar-2024,Commission,"3,446.80",00.00,"31,520.21"
05-Mar-2024,NEFT,14.02,00.00,"31,534.23"
05-Mar-2024,Interest,00.00,"3,941.78","27,592.45"
05-Mar-2024,RTGS,197.77,00.00,"27,790.22"
05-Mar-2024,Commission,00.00,"6,947.56","20,842.66"
05-Mar-2024,Bill,00.00,"10,421.33","10,421.33"
05-Mar-2024,Miscellaneous,"26,428.00",00.00,"36,849.33"
05-Mar-2024,RTGS,"13,793.80",00.00,"50,643.13"
05-Mar-2024,IMPS,00.00,"16,881.04","33,762.09"
05-Mar-2024,RTGS,"1,113,593.20",00.00,"1,147,355.29"
05-Mar-2024,Commission,00.00,"191,225.88","956,129.41"
05-Mar-2024,Bill,05.00,00.00,"956,134.41"
05-Mar-2024,Purchase,00.00,"95,613.44","860,520.97"
05-Mar-2024,Debit Card,00.00,"172,104.19","688,416.78"
05-Mar-2024,Bill,33.40,00.00,"688,450.18"
05-Mar-2024,Reversal,07.00,00.00,"688,457.18"
05-Mar-2024,RTGS,05.59,00.00,"688,462.77"
05-Mar-2024,Bill,"1,880,991.20",00.00,"2,569,453.97"
05-Mar-2024,Cash,00.00,"1,284,726.99","1,284,726.99"
05-Mar-2024,Tax,00.00,"1,284,726.99",00.00
05-Mar-2024,Bill,05.03,00.00,05.03
05-Mar-2024,Debit Card,00.00,00.72,04.31
05-Mar-2024,Bill,245.20,00.00,249.51
05-Mar-2024,Bill,"3,883.50",00.00,"4,133.01"
05-Mar-2024,IMPS,00.00,413.30,"3,719.71"
05-Mar-2024,Miscellaneous,37.00,00.00,"3,756.71"
05-Mar-2024,Cheque,00.00,939.18,"2,817.53"
05-Mar-2024,Commission,"2,451.10",00.00,"5,268.63"
05-Mar-2024,Bill,00.00,878.11,"4,390.52"
05-Mar-2024,Purchase,460.00,00.00,"4,850.52"
05-Mar-2024,Miscellaneous,00.00,"4,850.52",00.00
05-Mar-2024,Cash,709.00,00.00,709.00
05-Mar-2024,ATM,"1,496,844.00",00.00,"1,497,553.00"
05-Mar-2024,Debit Card,359.20,00.00,"1,497,912.20"
05-Mar-2024,ATM,00.00,"1,497,912.20",00.00
05-Mar-2024,IMPS,"184,783.09",00.00,"184,783.09"
05-Mar-2024,RTGS,661.30,00.00,"185,444.39"
05-Mar-2024,RTGS,00.00,"92,722.20","92,722.20"
05-Mar-2024,Miscellaneous,"94,176.00",00.00,"186,898.20"
05-Mar-2024,IMPS,00.00,"31,149.70","155,748.50"
05-Mar-2024,Bill,08.00,00.00,"155,756.50"
05-Mar-2024,Transfer,95.00,00.00,"155,851.50"
05-Mar-2024,Reversal,362.60,00.00,"156,214.10"
05-Mar-2024,Reversal,00.00,"15,621.41","140,592.69"
05-Mar-2024,IMPS,00.00,"14,059.27","126,533.42"
05-Mar-2024,RTGS,00.00,"14,059.27","112,474.15"
05-Mar-2024,Transfer,00.00,"37,491.38","74,982.77"
05-Mar-2024,Bill,"9,566.28",00.00,"84,549.05"
05-Mar-2024,IMPS,00.00,"8,454.91","76,094.14"
05-Mar-2024,Bill,00.00,"8,454.90","67,639.24"
05-Mar-2024,Transfer,06.10,00.00,"67,645.34"
05-Mar-2024,RTGS,03.00,00.00,"67,648.34"
05-Mar-2024,Tax,00.00,"8,456.04","59,192.30"
05-Mar-2024,NEFT,316.44,00.00,"59,508.74"
05-Mar-2024,Commission,"3,475.65",00.00,"62,984.39"
05-Mar-2024,Tax,07.00,00.00,"62,991.39"
05-Mar-2024,Cash,00.00,"20,997.13","41,994.26"
05-Mar-2024,NEFT,"1,830.68",00.00,"43,824.94"
05-Mar-2024,Transfer,"8,166.88",00.00,"51,991.82"
05-Mar-2024,Cheque,699.00,00.00,"52,690.82"
05-Mar-2024,Cheque,00.00,"5,854.54","46,836.28"
05-Mar-2024,Tax,"91,724.03",00.00,"138,560.31"
05-Mar-2024,RTGS,"9,523.00",00.00,"148,083.31"
05-Mar-2024,Cash,56.40,00.00,"148,139.71"
05-Mar-2024,Debit Card,"12,513.60",00.00,"160,653.31"
05-Mar-2024,Purchase,196.10,00.00,"160,849.41"
05-Mar-2024,Purchase,"1,178,605.00",00.00,"1,339,454.41"
05-Mar-2024,Debit Card,00.00,"191,350.63","1,148,103.78"
05-Mar-2024,Purchase,00.00,"287,025.95","861,077.84"
05-Mar-2024,Transfer,"5,921.10",00.00,"866,998.94"
05-Mar-2024,Cheque,14.90,00.00,"867,013.84"
05-Mar-2024,Interest,"12,474.56",00.00,"879,488.40"
05-Mar-2024,Cheque,30.35,00.00,"879,518.75"
05-Mar-2024,NEFT,233.00,00.00,"879,751.75"
06-Mar-2024,RTGS,"169,444.40",00.00,"1,049,196.15"
06-Mar-2024,IMPS,07.80,00.00,"1,049,203.95"
06-Mar-2024,Debit Card,"131,252.50",00.00,"1,180,456.45"
06-Mar-2024,Tax,00.00,"236,091.29","944,365.16"
06-Mar-2024,NEFT,"2,437.60",00.00,"946,802.76"
06-Mar-2024,Transfer,273.04,00.00,"947,075.80"
06-Mar-2024,Transfer,"23,680.24",00.00,"970,756.04"
06-Mar-2024,Purchase,"2,765.40",00.00,"973,521.44"
06-Mar-2024,Commission,00.00,"108,169.05","865,352.39"
06-Mar-2024,Purchase,00.00,"865,352.39",00.00
06-Mar-2024,Cash,05.93,00.00,05.93
06-Mar-2024,Cash,"3,833.80",00.00,"3,839.73"
06-Mar-2024,Bill,"2,226.10",00.00,"6,065.83"
06-Mar-2024,Tax,00.00,758.23,"5,307.60"
06-Mar-2024,Transfer,00.00,758.23,"4,549.37"
06-Mar-2024,Tax,02.00,00.00,"4,551.37"
06-Mar-2024,Miscellaneous,00.00,505.71,"4,045.66"
06-Mar-2024,Reversal,"3,703.20",00.00,"7,748.86"
06-Mar-2024,Miscellaneous,00.00,"1,291.48","6,457.38"
06-Mar-2024,Cheque,"805,112.00",00.00,"811,569.38"
06-Mar-2024,ATM,00.00,"162,313.88","649,255.50"
06-Mar-2024,RTGS,00.00,"72,139.50","577,116.00"
06-Mar-2024,IMPS,00.00,"64,124.00","512,992.00"
06-Mar-2024,ATM,00.00,"56,999.11","455,992.89"
06-Mar-2024,RTGS,"1,888,197.00",00.00,"2,344,189.89"
06-Mar-2024,Tax,07.00,00.00,"2,344,196.89"
06-Mar-2024,Interest,379.00,00.00,"2,344,575.89"
06-Mar-2024,Miscellaneous,00.00,"234,457.59","2,110,118.30"
06-Mar-2024,ATM,00.00,"1,055,059.15","1,055,059.15"
06-Mar-2024,Purchase,00.00,"150,722.74","904,336.41"
06-Mar-2024,Purchase,"120,330.19",00.00,"1,024,666.60"
06-Mar-2024,Transfer,00.00,"1,024,666.60",00.00
06-Mar-2024,IMPS,"4,212.00",00.00,"4,212.00"
06-Mar-2024,Tax,00.00,702.00,"3,510.00"
06-Mar-2024,Commission,01.00,00.00,"3,511.00"
06-Mar-2024,Cash,00.00,"1,755.50","1,755.50"
07-Mar-2024,Debit Card,00.00,438.88,"1,316.62"
08-Mar-2024,Miscellaneous,"848,321.80",00.00,"849,638.42"
08-Mar-2024,Cash,00.00,"121,376.92","728,261.50"
08-Mar-2024,Debit Card,01.10,00.00,"728,262.60"
08-Mar-2024,Purchase,00.00,"364,131.30","364,131.30"
08-Mar-2024,Tax,00.00,"45,516.41","318,614.89"
08-Mar-2024,Interest,00.00,"106,204.96","212,409.93"
08-Mar-2024,NEFT,03.00,00.00,"212,412.93"
08-Mar-2024,Interest,00.00,"53,103.23","159,309.70"
08-Mar-2024,IMPS,"1,171,527.75",00.00,"1,330,837.45"
08-Mar-2024,Transfer,00.00,"147,870.83","1,182,966.62"
08-Mar-2024,Reversal,00.00,"118,296.66","1,064,669.96"
09-Mar-2024,RTGS,05.00,00.00,"1,064,674.96"
09-Mar-2024,Miscellaneous,00.00,"177,445.83","887,229.13"
09-Mar-2024,Cheque,00.00,"177,445.83","709,783.30"
09-Mar-2024,Cash,"196,850.00",00.00,"906,633.30"
09-Mar-2024,Miscellaneous,00.00,"181,326.66","725,306.64"
09-Mar-2024,RTGS,06.50,00.00,"725,313.14"
09-Mar-2024,Bill,"235,106.40",00.00,"960,419.54"
09-Mar-2024,Reversal,"8,325.00",00.00,"968,744.54"
09-Mar-2024,Interest,00.00,"107,638.28","861,106.26"
09-Mar-2024,Tax,00.00,"287,035.42","574,070.84"
09-Mar-2024,Commission,00.00,"574,070.84",00.00
09-Mar-2024,Transfer,"618,870.20",00.00,"618,870.20"
09-Mar-2024,Transfer,00.00,"123,774.04","495,096.16"
09-Mar-2024,NEFT,00.88,00.00,"495,097.04"
09-Mar-2024,Interest,"2,830.00",00.00,"497,927.04"
09-Mar-2024,Miscellaneous,00.00,"55,325.23","442,601.81"
09-Mar-2024,NEFT,"1,897,171.00",00.00,"2,339,772.81"
09-Mar-2024,Tax,229.00,00.00,"2,340,001.81"
09-Mar-2024,Cheque,00.00,"390,000.30","1,950,001.51"
09-Mar-2024,RTGS,00.00,"390,000.30","1,560,001.21"
09-Mar-2024,Cash,900.40,00.00,"1,560,901.61"
09-Mar-2024,Debit Card,00.00,"222,985.94","1,337,915.67"
09-Mar-2024,NEFT,00.00,"267,583.13","1,070,332.54"
09-Mar-2024,Debit Card,"173,119.91",00.00,"1,243,452.45"
09-Mar-2024,Transfer,03.00,00.00,"1,243,455.45"
09-Mar-2024,Interest,00.00,"124,345.55","1,119,109.90"
09-Mar-2024,NEFT,00.00,"111,910.99","1,007,198.91"
09-Mar-2024,Tax,00.00,"125,899.86","881,299.05"
09-Mar-2024,Reversal,00.00,"88,129.91","793,169.14"
09-Mar-2024,RTGS,"29,389.00",00.00,"822,558.14"
09-Mar-2024,Debit Card,06.07,00.00,"822,564.21"
09-Mar-2024,Interest,00.00,"82,256.42","740,307.79"
09-Mar-2024,RTGS,00.00,"370,153.90","370,153.90"
09-Mar-2024,Transfer,00.00,"41,128.21","329,025.69"
09-Mar-2024,Debit Card,154.80,00.00,"329,180.49"
09-Mar-2024,Cash,00.00,"109,726.83","219,453.66"
09-Mar-2024,Cash,00.00,"21,945.37","197,508.29"
09-Mar-2024,Transfer,"139,724.72",00.00,"337,233.01"
09-Mar-2024,Tax,"63,885.00",00.00,"401,118.01"
09-Mar-2024,Cash,"10,803.00",00.00,"411,921.01"
09-Mar-2024,Debit Card,"38,382.62",00.00,"450,303.63"
09-Mar-2024,Reversal,"122,075.09",00.00,"572,378.72"
09-Mar-2024,Purchase,477.24,00.00,"572,855.96"
09-Mar-2024,Reversal,07.10,00.00,"572,863.06"
09-Mar-2024,ATM,104.00,00.00,"572,967.06"
09-Mar-2024,Reversal,00.00,"95,494.51","477,472.55"
09-Mar-2024,RTGS,00.00,"47,747.26","429,725.30"
09-Mar-2024,Reversal,00.00,"85,945.06","343,780.24"
09-Mar-2024,Miscellaneous,05.80,00.00,"343,786.04"
10-Mar-2024,Transfer,00.00,"85,946.51","257,839.53"
10-Mar-2024,Bill,04.00,00.00,"257,843.53"
10-Mar-2024,Bill,00.00,"128,921.77","128,921.76"
10-Mar-2024,Commission,00.00,"12,892.18","116,029.58"
10-Mar-2024,NEFT,00.00,"116,029.58",00.00
10-Mar-2024,ATM,72.00,00.00,72.00
10-Mar-2024,NEFT,00.00,18.00,54.00
10-Mar-2024,Miscellaneous,26.60,00.00,80.60
10-Mar-2024,NEFT,00.00,20.15,60.45
10-Mar-2024,Reversal,06.00,00.00,66.45
10-Mar-2024,NEFT,390.60,00.00,457.05
10-Mar-2024,Reversal,00.00,457.05,00.00
10-Mar-2024,Interest,"18,105.90",00.00,"18,105.90"
10-Mar-2024,Cheque,00.14,00.00,"18,106.04"
10-Mar-2024,Miscellaneous,160.00,00.00,"18,266.04"
10-Mar-2024,Purchase,00.00,"18,266.04",00.00
10-Mar-2024,Reversal,"18,715.00",00.00,"18,715.00"
10-Mar-2024,Reversal,00.00,"2,079.44","16,635.56"
10-Mar-2024,Commission,04.00,00.00,"16,639.56"
10-Mar-2024,Cash,00.00,"2,377.08","14,262.48"
10-Mar-2024,Transfer,"24,910.00",00.00,"39,172.48"
10-Mar-2024,NEFT,00.00,"5,596.07","33,576.41"
10-Mar-2024,Cash,00.00,"3,730.71","29,845.70"
10-Mar-2024,IMPS,283.71,00.00,"30,129.41"
10-Mar-2024,Cheque,"1,136.47",00.00,"31,265.88"
10-Mar-2024,Bill,00.00,"10,421.96","20,843.92"
10-Mar-2024,RTGS,31.46,00.00,"20,875.38"
10-Mar-2024,Bill,00.00,"4,175.08","16,700.30"
10-Mar-2024,Cheque,"1,276,675.75",00.00,"1,293,376.05"
11-Mar-2024,IMPS,"1,878,617.50",00.00,"3,171,993.55"
11-Mar-2024,Purchase,"176,881.16",00.00,"3,348,874.71"
11-Mar-2024,Debit Card,"710,275.00",00.00,"4,059,149.71"
11-Mar-2024,Purchase,"142,775.00",00.00,"4,201,924.71"
11-Mar-2024,NEFT,"930,324.50",00.00,"5,132,249.21"
11-Mar-2024,Bill,706.00,00.00,"5,132,955.21"
11-Mar-2024,Transfer,202.41,00.00,"5,133,157.62"
11-Mar-2024,ATM,"1,219.00",00.00,"5,134,376.62"
11-Mar-2024,Debit Card,00.00,"513,437.66","4,620,938.96"
11-Mar-2024,IMPS,"27,940.70",00.00,"4,648,879.66"
11-Mar-2024,Cheque,00.00,"464,887.97","4,183,991.69"
11-Mar-2024,ATM,00.00,"522,998.96","3,660,992.73"
11-Mar-2024,ATM,"643,178.50",00.00,"4,304,171.23"
11-Mar-2024,Miscellaneous,00.00,"2,152,085.62","2,152,085.62"
11-Mar-2024,IMPS,00.00,"358,680.94","1,793,404.68"
11-Mar-2024,Miscellaneous,00.00,"597,801.56","1,195,603.12"
11-Mar-2024,Bill,00.00,"298,900.78","896,702.34"
12-Mar-2024,ATM,00.00,"128,100.33","768,602.01"
12-Mar-2024,Purchase,00.00,"768,602.01",00.00
12-Mar-2024,ATM,"117,720.30",00.00,"117,720.30"
12-Mar-2024,Cheque,00.00,"11,772.03","105,948.27"
12-Mar-2024,RTGS,"734,040.00",00.00,"839,988.27"
12-Mar-2024,Bill,03.58,00.00,"839,991.85"
12-Mar-2024,Transfer,00.00,"279,997.28","559,994.57"
12-Mar-2024,Debit Card,"3,547.60",00.00,"563,542.17"
12-Mar-2024,Interest,"134,015.40",00.00,"697,557.57"
12-Mar-2024,Debit Card,"1,716,005.00",00.00,"2,413,562.57"
12-Mar-2024,Miscellaneous,00.00,"482,712.51","1,930,850.06"
12-Mar-2024,Reversal,00.00,"241,356.26","1,689,493.80"
12-Mar-2024,Cash,00.00,"187,721.53","1,501,772.27"
12-Mar-2024,Miscellaneous,00.00,"214,538.90","1,287,233.37"
12-Mar-2024,RTGS,00.00,"643,616.69","643,616.69"
12-Mar-2024,NEFT,00.00,"160,904.17","482,712.52"
12-Mar-2024,Tax,00.00,"160,904.17","321,808.35"
12-Mar-2024,Tax,32.00,00.00,"321,840.35"
13-Mar-2024,Miscellaneous,00.00,"80,460.09","241,380.26"
13-Mar-2024,Interest,00.00,"80,460.09","160,920.17"
13-Mar-2024,Cheque,57.00,00.00,"160,977.17"
13-Mar-2024,Miscellaneous,00.00,"80,488.59","80,488.59"
13-Mar-2024,Bill,"6,168.53",00.00,"86,657.12"
13-Mar-2024,Tax,00.00,"43,328.56","43,328.56"
13-Mar-2024,Cheque,461.50,00.00,"43,790.06"
13-Mar-2024,ATM,"165,378.00",00.00,"209,168.06"
13-Mar-2024,ATM,"3,617.54",00.00,"212,785.60"
13-Mar-2024,Cheque,"826,050.50",00.00,"1,038,836.10"
13-Mar-2024,IMPS,06.00,00.00,"1,038,842.10"
13-Mar-2024,ATM,00.00,"519,421.05","519,421.05"
14-Mar-2024,Commission,52.20,00.00,"519,473.25"
14-Mar-2024,Purchase,00.00,"74,210.46","445,262.79"
14-Mar-2024,Cash,348.93,00.00,"445,611.72"
14-Mar-2024,ATM,00.00,"445,611.72",00.00
14-Mar-2024,Reversal,"62,427.00",00.00,"62,427.00"
14-Mar-2024,RTGS,00.00,"20,809.00","41,618.00"
14-Mar-2024,Cheque,"2,249.00",00.00,"43,867.00"
14-Mar-2024,Commission,61.90,00.00,"43,928.90"
14-Mar-2024,Miscellaneous,"191,157.70",00.00,"235,086.60"
14-Mar-2024,Cheque,00.00,"33,583.80","201,502.80"
15-Mar-2024,Cheque,00.00,"100,751.40","100,751.40"
15-Mar-2024,NEFT,352.70,00.00,"101,104.10"
15-Mar-2024,NEFT,357.00,00.00,"101,461.10"
15-Mar-2024,Transfer,08.00,00.00,"101,469.10"
15-Mar-2024,Cash,00.00,"12,683.64","88,785.46"
15-Mar-2024,Transfer,"1,306.90",00.00,"90,092.36"
15-Mar-2024,Transfer,00.00,"10,010.26","80,082.10"
15-Mar-2024,Reversal,00.00,"80,082.10",00.00
15-Mar-2024,Transfer,"254,295.20",00.00,"254,295.20"
15-Mar-2024,Debit Card,00.00,"25,429.52","228,865.68"
15-Mar-2024,Transfer,"218,557.00",00.00,"447,422.68"
15-Mar-2024,Interest,00.00,"63,917.53","383,505.15"
15-Mar-2024,Miscellaneous,00.00,"47,938.14","335,567.01"
15-Mar-2024,Debit Card,00.00,"167,783.51","167,783.50"
15-Mar-2024,ATM,234.95,00.00,"168,018.45"
15-Mar-2024,Tax,01.80,00.00,"168,020.25"
15-Mar-2024,NEFT,00.00,"56,006.75","112,013.50"
15-Mar-2024,Cheque,00.00,"28,003.38","84,010.12"
15-Mar-2024,Cheque,00.00,"16,802.02","67,208.10"
15-Mar-2024,Debit Card,"1,592,602.50",00.00,"1,659,810.60"
15-Mar-2024,NEFT,01.19,00.00,"1,659,811.79"
15-Mar-2024,Debit Card,00.00,"276,635.30","1,383,176.49"
15-Mar-2024,Debit Card,00.00,"138,317.65","1,244,858.84"
15-Mar-2024,Bill,00.00,"207,476.47","1,037,382.37"
15-Mar-2024,Debit Card,"7,362.00",00.00,"1,044,744.37"
15-Mar-2024,NEFT,00.00,"149,249.20","895,495.17"
15-Mar-2024,Purchase,44.05,00.00,"895,539.22"
15-Mar-2024,Reversal,"1,910.97",00.00,"897,450.19"
15-Mar-2024,IMPS,425.53,00.00,"897,875.72"
15-Mar-2024,Commission,08.00,00.00,"897,883.72"
15-Mar-2024,RTGS,"31,819.10",00.00,"929,702.82"
15-Mar-2024,Commission,00.00,"116,212.85","813,489.97"
15-Mar-2024,ATM,00.00,"203,372.49","610,117.48"
15-Mar-2024,RTGS,58.60,00.00,"610,176.08"
15-Mar-2024,Commission,00.00,"67,797.34","542,378.74"
15-Mar-2024,Commission,00.00,"271,189.37","271,189.37"
15-Mar-2024,Cash,00.00,"27,118.94","244,070.43"
15-Mar-2024,RTGS,00.00,"122,035.22","122,035.22"
15-Mar-2024,NEFT,00.00,"20,339.20","101,696.02"
15-Mar-2024,Transfer,00.00,"11,299.56","90,396.46"
15-Mar-2024,IMPS,"1,130,577.00",00.00,"1,220,973.46"
15-Mar-2024,RTGS,"1,820.02",00.00,"1,222,793.48"
15-Mar-2024,RTGS,203.00,00.00,"1,222,996.48"
15-Mar-2024,Debit Card,00.00,"244,599.30","978,397.18"
15-Mar-2024,Commission,00.00,"108,710.80","869,686.38"
15-Mar-2024,Purchase,00.00,"86,968.64","782,717.74"
15-Mar-2024,Commission,00.00,"86,968.64","695,749.10"
15-Mar-2024,Reversal,"260,783.00",00.00,"956,532.10"
15-Mar-2024,Purchase,00.00,"136,647.44","819,884.66"
15-Mar-2024,IMPS,06.18,00.00,"819,890.84"
15-Mar-2024,RTGS,"9,373.07",00.00,"829,263.91"
15-Mar-2024,NEFT,628.00,00.00,"829,891.91"
15-Mar-2024,Cash,15.09,00.00,"829,907.00"
15-Mar-2024,Commission,262.88,00.00,"830,169.88"
15-Mar-2024,Bill,00.00,"207,542.47","622,627.41"
15-Mar-2024,RTGS,00.00,"77,828.43","544,798.98"
15-Mar-2024,ATM,232.46,00.00,"545,031.44"
15-Mar-2024,Purchase,00.00,"77,861.63","467,169.81"
15-Mar-2024,Miscellaneous,00.00,"77,861.64","389,308.18"
15-Mar-2024,Miscellaneous,00.00,"77,861.64","311,446.54"
15-Mar-2024,Cheque,00.00,"31,144.65","280,301.89"
15-Mar-2024,NEFT,00.00,"93,433.96","186,867.93"
15-Mar-2024,IMPS,"188,155.72",00.00,"375,023.65"
15-Mar-2024,Cheque,00.00,"41,669.29","333,354.36"
15-Mar-2024,Reversal,00.87,00.00,"333,355.23"
15-Mar-2024,Purchase,"1,021.00",00.00,"334,376.23"
15-Mar-2024,NEFT,"16,741.30",00.00,"351,117.53"
15-Mar-2024,Miscellaneous,"156,020.00",00.00,"507,137.53"
15-Mar-2024,Miscellaneous,"4,276.10",00.00,"511,413.63"
15-Mar-2024,Cheque,00.00,"51,141.36","460,272.27"
15-Mar-2024,Debit Card,"1,918,819.80",00.00,"2,379,092.07"
15-Mar-2024,IMPS,"70,903.00",00.00,"2,449,995.07"
16-Mar-2024,IMPS,00.00,"306,249.38","2,143,745.69"
16-Mar-2024,NEFT,00.00,"267,968.21","1,875,777.48"
16-Mar-2024,Cheque,00.00,"234,472.19","1,641,305.30"
16-Mar-2024,Purchase,"1,138.00",00.00,"1,642,443.30"
16-Mar-2024,Purchase,00.00,"821,221.65","821,221.65"
16-Mar-2024,Commission,"13,064.00",00.00,"834,285.65"
16-Mar-2024,ATM,00.00,"417,142.83","417,142.82"
16-Mar-2024,Miscellaneous,00.00,"139,047.61","278,095.21"
16-Mar-2024,Interest,00.00,"30,899.47","247,195.74"
16-Mar-2024,Reversal,"22,622.40",00.00,"269,818.14"
16-Mar-2024,ATM,00.00,"269,818.14",00.00
16-Mar-2024,Debit Card,167.00,00.00,167.00
16-Mar-2024,Bill,45.94,00.00,212.94
16-Mar-2024,Cheque,00.00,23.66,189.28
16-Mar-2024,Transfer,00.00,21.03,168.25
16-Mar-2024,Miscellaneous,73.00,00.00,241.25
16-Mar-2024,Cash,00.00,30.16,211.09
16-Mar-2024,Tax,466.49,00.00,677.58
16-Mar-2024,Miscellaneous,293.00,00.00,970.58
16-Mar-2024,Cash,00.00,107.84,862.74
16-Mar-2024,Miscellaneous,"1,351,096.25",00.00,"1,351,958.99"
16-Mar-2024,Miscellaneous,"2,461.20",00.00,"1,354,420.19"
16-Mar-2024,Cash,00.00,"169,302.52","1,185,117.67"
16-Mar-2024,Tax,"216,463.00",00.00,"1,401,580.67"
16-Mar-2024,Commission,00.00,"140,158.07","1,261,422.60"
16-Mar-2024,ATM,00.00,"252,284.52","1,009,138.08"
16-Mar-2024,RTGS,289.71,00.00,"1,009,427.79"
16-Mar-2024,NEFT,00.00,"504,713.90","504,713.90"
16-Mar-2024,Reversal,"191,902.25",00.00,"696,616.15"
16-Mar-2024,Tax,"14,401.25",00.00,"711,017.40"
16-Mar-2024,NEFT,00.00,"88,877.18","622,140.22"
16-Mar-2024,Tax,118.70,00.00,"622,258.92"
16-Mar-2024,Reversal,00.00,"207,419.64","414,839.28"
16-Mar-2024,Cash,"18,606.90",00.00,"433,446.18"
16-Mar-2024,Purchase,00.00,"61,920.88","371,525.30"
16-Mar-2024,Commission,00.00,"37,152.53","334,372.77"
16-Mar-2024,Reversal,28.56,00.00,"334,401.33"
16-Mar-2024,Tax,"63,896.75",00.00,"398,298.08"
16-Mar-2024,Transfer,03.21,00.00,"398,301.29"
16-Mar-2024,Tax,"19,360.60",00.00,"417,661.89"
16-Mar-2024,Tax,04.90,00.00,"417,666.79"
16-Mar-2024,IMPS,00.00,"46,407.42","371,259.37"
16-Mar-2024,Cheque,00.00,"61,876.56","309,382.81"
16-Mar-2024,Purchase,00.00,"309,382.81",00.00
16-Mar-2024,RTGS,"90,525.28",00.00,"90,525.28"
16-Mar-2024,Tax,00.00,"45,262.64","45,262.64"
16-Mar-2024,Cheque,09.70,00.00,"45,272.34"
16-Mar-2024,Commission,00.00,"11,318.09","33,954.25"
16-Mar-2024,Cash,00.00,"11,318.08","22,636.17"
16-Mar-2024,Cash,"1,575.00",00.00,"24,211.17"
16-Mar-2024,Debit Card,"16,573.00",00.00,"40,784.17"
16-Mar-2024,Debit Card,03.80,00.00,"40,787.97"
16-Mar-2024,Commission,05.40,00.00,"40,793.37"
16-Mar-2024,Tax,"2,748.60",00.00,"43,541.97"
16-Mar-2024,NEFT,46.45,00.00,"43,588.42"
16-Mar-2024,NEFT,00.00,"10,897.11","32,691.32"
16-Mar-2024,Commission,"211,902.00",00.00,"244,593.32"
16-Mar-2024,ATM,"494,173.00",00.00,"738,766.32"
16-Mar-2024,Debit Card,"23,574.00",00.00,"762,340.32"
16-Mar-2024,RTGS,"2,800.15",00.00,"765,140.47"
16-Mar-2024,Transfer,"150,215.00",00.00,"915,355.47"
16-Mar-2024,Miscellaneous,00.00,"228,838.87","686,516.60"
16-Mar-2024,Purchase,00.00,"85,814.58","600,702.02"
16-Mar-2024,Interest,00.00,"120,140.40","480,561.62"
16-Mar-2024,Bill,477.10,00.00,"481,038.72"
16-Mar-2024,Purchase,"22,790.30",00.00,"503,829.02"
16-Mar-2024,Interest,"3,271.00",00.00,"507,100.02"
16-Mar-2024,Tax,01.90,00.00,"507,101.92"
16-Mar-2024,RTGS,00.00,"101,420.38","405,681.54"
16-Mar-2024,Reversal,00.00,"135,227.18","270,454.36"
16-Mar-2024,Debit Card,"1,393.80",00.00,"271,848.16"
17-Mar-2024,Reversal,58.61,00.00,"271,906.77"
17-Mar-2024,Miscellaneous,"176,087.90",00.00,"447,994.67"
17-Mar-2024,Purchase,62.12,00.00,"448,056.79"
17-Mar-2024,Interest,00.00,"74,676.13","373,380.66"
17-Mar-2024,ATM,153.90,00.00,"373,534.56"
17-Mar-2024,Miscellaneous,"227,632.00",00.00,"601,166.56"
17-Mar-2024,NEFT,194.00,00.00,"601,360.56"
17-Mar-2024,Bill,00.00,"601,360.56",00.00
17-Mar-2024,Interest,"1,010.00",00.00,"1,010.00"
17-Mar-2024,Cheque,"1,187.00",00.00,"2,197.00"
17-Mar-2024,Bill,00.00,244.11,"1,952.89"
17-Mar-2024,Cash,00.00,976.45,976.44
17-Mar-2024,Commission,00.00,976.44,00.00
17-Mar-2024,IMPS,"25,867.60",00.00,"25,867.60"
17-Mar-2024,Debit Card,00.00,"8,622.53","17,245.07"
17-Mar-2024,Interest,31.20,00.00,"17,276.27"
17-Mar-2024,Tax,00.00,"8,638.14","8,638.14"
17-Mar-2024,Bill,"625,035.20",00.00,"633,673.34"
17-Mar-2024,NEFT,00.00,"158,418.34","475,255.00"
17-Mar-2024,Transfer,46.00,00.00,"475,301.00"
17-Mar-2024,NEFT,"27,290.60",00.00,"502,591.60"
17-Mar-2024,Miscellaneous,"681,678.00",00.00,"1,184,269.60"
17-Mar-2024,Bill,00.00,"197,378.27","986,891.33"
17-Mar-2024,Purchase,00.00,"140,984.48","845,906.85"
17-Mar-2024,NEFT,00.00,"120,843.84","725,063.01"
17-Mar-2024,IMPS,00.00,"145,012.60","580,050.41"
18-Mar-2024,RTGS,"28,414.00",00.00,"608,464.41"
18-Mar-2024,NEFT,00.00,"608,464.41",00.00
18-Mar-2024,Commission,"224,655.56",00.00,"224,655.56"
18-Mar-2024,Debit Card,00.00,"24,961.73","199,693.83"
18-Mar-2024,NEFT,"25,422.75",00.00,"225,116.58"
18-Mar-2024,ATM,00.00,"28,139.57","196,977.01"
18-Mar-2024,ATM,59.21,00.00,"197,036.22"
18-Mar-2024,Cash,00.00,"24,629.53","172,406.69"
18-Mar-2024,ATM,"218,340.12",00.00,"390,746.81"
18-Mar-2024,Transfer,00.00,"48,843.35","341,903.46"
18-Mar-2024,Reversal,00.80,00.00,"341,904.26"
18-Mar-2024,Bill,00.00,"341,904.26",00.00
18-Mar-2024,Interest,"4,933.69",00.00,"4,933.69"
18-Mar-2024,IMPS,916.00,00.00,"5,849.69"
18-Mar-2024,Purchase,"1,973.00",00.00,"7,822.69"
18-Mar-2024,Cheque,33.88,00.00,"7,856.57"
18-Mar-2024,Miscellaneous,05.00,00.00,"7,861.57"
18-Mar-2024,Cash,00.00,"3,930.79","3,930.78"
18-Mar-2024,Debit Card,03.00,00.00,"3,933.78"
18-Mar-2024,IMPS,47.10,00.00,"3,980.88"
18-Mar-2024,Cheque,00.00,"3,980.88",00.00
18-Mar-2024,Bill,"3,086.10",00.00,"3,086.10"
18-Mar-2024,Tax,00.00,"3,086.10",00.00
18-Mar-2024,Miscellaneous,878.60,00.00,878.60
18-Mar-2024,ATM,331.60,00.00,"1,210.20"
18-Mar-2024,Commission,00.00,302.55,907.65
18-Mar-2024,RTGS,00.00,226.91,680.74
18-Mar-2024,Purchase,00.00,680.74,00.00
18-Mar-2024,Purchase,313.20,00.00,313.20
18-Mar-2024,Cheque,"1,225.90",00.00,"1,539.10"
18-Mar-2024,Transfer,00.00,256.52,"1,282.58"
18-Mar-2024,Commission,"156,809.20",00.00,"158,091.78"
18-Mar-2024,Reversal,00.00,"17,565.75","140,526.03"
18-Mar-2024,Miscellaneous,63.86,00.00,"140,589.89"
18-Mar-2024,Cheque,"2,314.42",00.00,"142,904.31"
18-Mar-2024,Bill,00.00,"23,817.39","119,086.92"
18-Mar-2024,RTGS,00.00,"17,012.42","102,074.50"
18-Mar-2024,Transfer,00.00,"102,074.50",00.00
19-Mar-2024,Cash,189.00,00.00,189.00
19-Mar-2024,Interest,00.00,27.00,162.00
19-Mar-2024,Cheque,00.00,81.00,81.00
19-Mar-2024,Bill,00.00,08.10,72.90
19-Mar-2024,IMPS,408.20,00.00,481.10
19-Mar-2024,NEFT,"1,260,210.20",00.00,"1,260,691.30"
20-Mar-2024,Interest,"64,968.00",00.00,"1,325,659.30"
20-Mar-2024,Miscellaneous,00.00,"265,131.86","1,060,527.44"
20-Mar-2024,Miscellaneous,00.00,"117,836.38","942,691.06"
20-Mar-2024,Debit Card,388.00,00.00,"943,079.06"
20-Mar-2024,ATM,00.00,"188,615.81","754,463.25"
20-Mar-2024,Miscellaneous,02.00,00.00,"754,465.25"
20-Mar-2024,Miscellaneous,"393,216.00",00.00,"1,147,681.25"
20-Mar-2024,Purchase,00.00,"382,560.42","765,120.83"
20-Mar-2024,NEFT,00.00,"76,512.08","688,608.75"
20-Mar-2024,Purchase,00.00,"229,536.25","459,072.50"
20-Mar-2024,Reversal,47.00,00.00,"459,119.50"
20-Mar-2024,Purchase,"1,260.00",00.00,"460,379.50"
20-Mar-2024,Interest,390.90,00.00,"460,770.40"
20-Mar-2024,IMPS,00.00,"153,590.13","307,180.27"
20-Mar-2024,Commission,06.00,00.00,"307,186.27"
20-Mar-2024,RTGS,00.00,"43,883.75","263,302.52"
21-Mar-2024,IMPS,00.00,"52,660.50","210,642.02"
21-Mar-2024,Miscellaneous,24.00,00.00,"210,666.02"
21-Mar-2024,Interest,00.00,"210,666.02",00.00
21-Mar-2024,Tax,00.80,00.00,00.80
21-Mar-2024,Bill,"89,699.00",00.00,"89,699.80"
21-Mar-2024,RTGS,270.00,00.00,"89,969.80"
21-Mar-2024,Debit Card,00.00,"44,984.90","44,984.90"
21-Mar-2024,Tax,00.00,"22,492.45","22,492.45"
21-Mar-2024,IMPS,"2,052.10",00.00,"24,544.55"
21-Mar-2024,IMPS,00.00,"2,454.46","22,090.10"
21-Mar-2024,IMPS,00.00,"2,209.01","19,881.09"
21-Mar-2024,Commission,00.00,"9,940.55","9,940.54"
21-Mar-2024,Miscellaneous,48.12,00.00,"9,988.66"
21-Mar-2024,NEFT,55.20,00.00,"10,043.86"
21-Mar-2024,NEFT,00.00,"5,021.93","5,021.93"
21-Mar-2024,Interest,00.00,"1,255.48","3,766.45"
21-Mar-2024,Cheque,00.00,753.29,"3,013.16"
21-Mar-2024,ATM,"148,141.00",00.00,"151,154.16"
21-Mar-2024,Interest,00.55,00.00,"151,154.71"
21-Mar-2024,Cheque,00.00,"18,894.34","132,260.37"
21-Mar-2024,Cheque,06.30,00.00,"132,266.67"
21-Mar-2024,Interest,00.00,"33,066.67","99,200.00"
21-Mar-2024,Miscellaneous,00.00,"49,600.00","49,600.00"
21-Mar-2024,Tax,"4,251.00",00.00,"53,851.00"
21-Mar-2024,RTGS,04.60,00.00,"53,855.60"
21-Mar-2024,Cash,409.90,00.00,"54,265.50"
21-Mar-2024,ATM,00.00,"5,426.55","48,838.95"
21-Mar-2024,Debit Card,00.00,"12,209.74","36,629.21"
21-Mar-2024,Bill,31.00,00.00,"36,660.21"
21-Mar-2024,IMPS,00.00,"9,165.05","27,495.16"
21-Mar-2024,Cheque,44.80,00.00,"27,539.96"
21-Mar-2024,Bill,00.00,"3,442.50","24,097.46"
21-Mar-2024,Commission,"2,638.00",00.00,"26,735.46"
21-Mar-2024,Reversal,"2,644.98",00.00,"29,380.44"
21-Mar-2024,ATM,00.00,"3,672.56","25,707.88"
21-Mar-2024,Reversal,46.20,00.00,"25,754.08"
21-Mar-2024,IMPS,00.00,"12,877.04","12,877.04"
21-Mar-2024,Interest,22.00,00.00,"12,899.04"
21-Mar-2024,Interest,"66,480.60",00.00,"79,379.64"
21-Mar-2024,Cheque,"13,780.00",00.00,"93,159.64"
21-Mar-2024,Purchase,04.30,00.00,"93,163.94"
21-Mar-2024,Reversal,19.00,00.00,"93,182.94"
21-Mar-2024,Tax,00.00,"15,530.49","77,652.45"
21-Mar-2024,ATM,"241,060.00",00.00,"318,712.45"
21-Mar-2024,RTGS,"1,263.33",00.00,"319,975.78"
21-Mar-2024,Interest,00.00,"106,658.59","213,317.19"
21-Mar-2024,RTGS,"184,315.31",00.00,"397,632.50"
21-Mar-2024,Tax,"3,750.00",00.00,"401,382.50"
21-Mar-2024,RTGS,"876,532.00",00.00,"1,277,914.50"
21-Mar-2024,Miscellaneous,00.00,"425,971.50","851,943.00"
21-Mar-2024,Bill,00.00,"85,194.30","766,748.70"
22-Mar-2024,Bill,"6,005.00",00.00,"772,753.70"
22-Mar-2024,IMPS,00.00,"96,594.21","676,159.49"
22-Mar-2024,Purchase,"2,974.79",00.00,"679,134.28"
22-Mar-2024,Miscellaneous,00.00,"339,567.14","339,567.14"
22-Mar-2024,RTGS,"159,048.20",00.00,"498,615.34"
23-Mar-2024,Cash,"23,341.66",00.00,"521,957.00"
23-Mar-2024,Commission,334.00,00.00,"522,291.00"
23-Mar-2024,NEFT,00.00,"87,048.50","435,242.50"
23-Mar-2024,Purchase,02.00,00.00,"435,244.50"
23-Mar-2024,Purchase,00.00,"72,540.75","362,703.75"
24-Mar-2024,Purchase,"7,103.89",00.00,"369,807.64"
24-Mar-2024,Miscellaneous,00.00,"36,980.76","332,826.88"
24-Mar-2024,Bill,00.00,"332,826.88",00.00
24-Mar-2024,Interest,00.68,00.00,00.68
24-Mar-2024,Purchase,07.00,00.00,07.68
24-Mar-2024,ATM,224.40,00.00,232.08
24-Mar-2024,Miscellaneous,00.00,77.36,154.72
24-Mar-2024,Reversal,"32,539.17",00.00,"32,693.89"
24-Mar-2024,IMPS,00.00,"16,346.95","16,346.94"
24-Mar-2024,Interest,"1,539,548.50",00.00,"1,555,895.44"
24-Mar-2024,RTGS,776.00,00.00,"1,556,671.44"
24-Mar-2024,Miscellaneous,29.20,00.00,"1,556,700.64"
24-Mar-2024,Cash,00.00,"194,587.58","1,362,113.06"
24-Mar-2024,ATM,00.00,"151,345.90","1,210,767.16"
24-Mar-2024,Commission,376.79,00.00,"1,211,143.95"
24-Mar-2024,Purchase,38.00,00.00,"1,211,181.95"
24-Mar-2024,Commission,"3,452.00",00.00,"1,214,633.95"
24-Mar-2024,Interest,"10,601.00",00.00,"1,225,234.95"
24-Mar-2024,Reversal,680.20,00.00,"1,225,915.15"
24-Mar-2024,Bill,63.00,00.00,"1,225,978.15"
24-Mar-2024,Commission,"369,559.80",00.00,"1,595,537.95"
24-Mar-2024,IMPS,09.00,00.00,"1,595,546.95"
24-Mar-2024,RTGS,00.00,"177,282.99","1,418,263.96"
25-Mar-2024,Commission,00.00,"709,131.98","709,131.98"
25-Mar-2024,Debit Card,"63,225.00",00.00,"772,356.98"
25-Mar-2024,Bill,07.00,00.00,"772,363.98"
25-Mar-2024,Interest,00.00,"85,818.22","686,545.76"
25-Mar-2024,Reversal,00.00,"343,272.88","343,272.88"
25-Mar-2024,Tax,00.00,"38,141.43","305,131.45"
25-Mar-2024,Reversal,00.00,"152,565.73","152,565.72"
25-Mar-2024,Purchase,00.00,"76,282.86","76,282.86"
25-Mar-2024,IMPS,00.00,"9,535.36","66,747.50"
25-Mar-2024,Interest,"2,917.03",00.00,"69,664.53"
25-Mar-2024,ATM,00.00,"9,952.08","59,712.45"
25-Mar-2024,ATM,25.00,00.00,"59,737.45"
25-Mar-2024,Reversal,"15,641.00",00.00,"75,378.45"
25-Mar-2024,Commission,"199,684.00",00.00,"275,062.45"
25-Mar-2024,Cash,"3,601.20",00.00,"278,663.65"
26-Mar-2024,Commission,154.67,00.00,"278,818.32"
26-Mar-2024,Miscellaneous,00.00,"39,831.19","238,987.13"
26-Mar-2024,Debit Card,00.00,"26,554.13","212,433.00"
26-Mar-2024,Commission,02.00,00.00,"212,435.00"
26-Mar-2024,Interest,00.00,"106,217.50","106,217.50"
26-Mar-2024,Debit Card,"3,862.00",00.00,"110,079.50"
26-Mar-2024,Tax,"123,433.80",00.00,"233,513.30"
26-Mar-2024,Tax,"1,029,520.00",00.00,"1,263,033.30"
26-Mar-2024,IMPS,00.00,"315,758.33","947,274.98"
26-Mar-2024,Commission,00.00,"236,818.75","710,456.24"
26-Mar-2024,NEFT,00.00,"142,091.25","568,364.99"
26-Mar-2024,Interest,"189,329.00",00.00,"757,693.99"
26-Mar-2024,Cheque,"3,326.54",00.00,"761,020.53"
26-Mar-2024,IMPS,00.00,"84,557.84","676,462.69"
26-Mar-2024,Tax,01.66,00.00,"676,464.35"
26-Mar-2024,Tax,"1,025,829.50",00.00,"1,702,293.85"
27-Mar-2024,RTGS,289.50,00.00,"1,702,583.35"
27-Mar-2024,Debit Card,00.00,"212,822.92","1,489,760.43"
27-Mar-2024,NEFT,"1,159,139.00",00.00,"2,648,899.43"
27-Mar-2024,Tax,"258,092.06",00.00,"2,906,991.49"
27-Mar-2024,Debit Card,111.00,00.00,"2,907,102.49"
27-Mar-2024,Purchase,265.07,00.00,"2,907,367.56"
27-Mar-2024,Purchase,00.00,"290,736.76","2,616,630.80"
27-Mar-2024,Commission,"2,476.00",00.00,"2,619,106.80"
27-Mar-2024,Commission,"939,803.25",00.00,"3,558,910.05"
28-Mar-2024,Interest,"207,272.62",00.00,"3,766,182.67"
28-Mar-2024,Purchase,00.00,"627,697.11","3,138,485.56"
28-Mar-2024,Bill,"939,190.00",00.00,"4,077,675.56"
28-Mar-2024,ATM,"2,121.18",00.00,"4,079,796.74"
28-Mar-2024,Miscellaneous,05.00,00.00,"4,079,801.74"
28-Mar-2024,Cash,55.45,00.00,"4,079,857.19"
28-Mar-2024,Purchase,06.50,00.00,"4,079,863.69"
28-Mar-2024,Cheque,00.00,"509,982.96","3,569,880.73"
28-Mar-2024,NEFT,"26,857.90",00.00,"3,596,738.63"
28-Mar-2024,Interest,13.00,00.00,"3,596,751.63"
28-Mar-2024,Tax,00.00,"449,593.95","3,147,157.68"
28-Mar-2024,Purchase,00.00,"1,573,578.84","1,573,578.84"
28-Mar-2024,Transfer,00.00,"157,357.88","1,416,220.96"
28-Mar-2024,Cash,"17,217.75",00.00,"1,433,438.71"
28-Mar-2024,Interest,22.90,00.00,"1,433,461.61"
28-Mar-2024,RTGS,268.20,00.00,"1,433,729.81"
28-Mar-2024,Transfer,00.00,"358,432.45","1,075,297.36"
28-Mar-2024,Interest,00.00,"134,412.17","940,885.19"
28-Mar-2024,ATM,41.55,00.00,"940,926.74"
28-Mar-2024,Cheque,05.00,00.00,"940,931.74"
28-Mar-2024,Cash,441.00,00.00,"941,372.74"
28-Mar-2024,Debit Card,00.00,"941,372.74",00.00
28-Mar-2024,Cash,"1,482,365.50",00.00,"1,482,365.50"
28-Mar-2024,NEFT,00.00,"148,236.55","1,334,128.95"
28-Mar-2024,Debit Card,00.00,"444,709.65","889,419.30"
28-Mar-2024,Tax,00.00,"111,177.41","778,241.89"
28-Mar-2024,Transfer,00.00,"194,560.47","583,681.42"
28-Mar-2024,Purchase,00.00,"58,368.14","525,313.28"
28-Mar-2024,NEFT,"1,445,874.00",00.00,"1,971,187.28"
28-Mar-2024,IMPS,00.00,"197,118.73","1,774,068.55"
28-Mar-2024,Commission,00.00,"295,678.09","1,478,390.46"
28-Mar-2024,Cheque,00.00,"211,198.64","1,267,191.82"
28-Mar-2024,Cash,28.10,00.00,"1,267,219.92"
28-Mar-2024,Reversal,"2,043.10",00.00,"1,269,263.02"
28-Mar-2024,Reversal,697.53,00.00,"1,269,960.55"
28-Mar-2024,NEFT,00.00,"634,980.28","634,980.28"
28-Mar-2024,Tax,"233,448.00",00.00,"868,428.28"
28-Mar-2024,Transfer,"2,651.00",00.00,"871,079.28"
28-Mar-2024,RTGS,00.00,"871,079.28",00.00
28-Mar-2024,Bill,"1,390.92",00.00,"1,390.92"
28-Mar-2024,Tax,00.00,463.64,927.28
28-Mar-2024,Cheque,03.70,00.00,930.98
28-Mar-2024,Cheque,06.00,00.00,936.98
28-Mar-2024,Interest,"3,048.00",00.00,"3,984.98"
28-Mar-2024,ATM,00.00,"3,984.98",00.00
28-Mar-2024,Cash,"11,057.40",00.00,"11,057.40"
28-Mar-2024,NEFT,00.00,"5,528.70","5,528.70"
28-Mar-2024,Cheque,00.00,552.87,"4,975.83"
28-Mar-2024,Reversal,"1,431.02",00.00,"6,406.85"
28-Mar-2024,Cheque,00.00,"1,281.37","5,125.48"
29-Mar-2024,Transfer,"3,501.00",00.00,"8,626.48"
29-Mar-2024,Purchase,"609,858.25",00.00,"618,484.73"
30-Mar-2024,Purchase,00.00,"88,354.96","530,129.77"
31-Mar-2024,Cheque,00.00,"106,025.95","424,103.82"
31-Mar-2024,ATM,00.00,"70,683.97","353,419.85"
31-Mar-2024,Interest,00.00,"35,341.99","318,077.86"
31-Mar-2024,Purchase,00.00,"79,519.47","238,558.40"
31-Mar-2024,Cheque,00.00,"34,079.77","204,478.63"
31-Mar-2024,NEFT,00.00,"29,211.23","175,267.40"
31-Mar-2024,Tax,05.50,00.00,"175,272.90"
31-Mar-2024,Tax,00.00,"43,818.23","131,454.67"
31-Mar-2024,Interest,386.00,00.00,"131,840.67"
31-Mar-2024,Purchase,07.16,00.00,"131,847.83"
31-Mar-2024,Debit Card,"151,753.40",00.00,"283,601.23"
31-Mar-2024,NEFT,28.35,00.00,"283,629.58"
31-Mar-2024,Cash,00.00,"94,543.19","189,086.39"
31-Mar-2024,Commission,"1,145,190.50",00.00,"1,334,276.89"
31-Mar-2024,NEFT,05.09,00.00,"1,334,281.98"
31-Mar-2024,Reversal,00.00,"148,253.55","1,186,028.43"
31-Mar-2024,RTGS,01.03,00.00,"1,186,029.46"
31-Mar-2024,Reversal,"48,272.00",00.00,"1,234,301.46"
31-Mar-2024,Debit Card,"25,550.00",00.00,"1,259,851.46"
31-Mar-2024,Commission,"3,367.00",00.00,"1,263,218.46"
31-Mar-2024,Commission,"2,009,887.00",00.00,"3,273,105.46"
31-Mar-2024,Reversal,"2,108.95",00.00,"3,275,214.41"
31-Mar-2024,Miscellaneous,"3,461.00",00.00,"3,278,675.41"
31-Mar-2024,Purchase,"4,646.80",00.00,"3,283,322.21"
31-Mar-2024,Cash,"26,101.78",00.00,"3,309,423.99"
31-Mar-2024,Miscellaneous,"169,138.94",00.00,"3,478,562.93"
31-Mar-2024,Commission,"1,088,279.00",00.00,"4,566,841.93"
31-Mar-2024,NEFT,00.00,"4,566,841.93",00.00
01-Apr-2024,Transfer,31.25,00.00,31.25
01-Apr-2024,Interest,362.00,00.00,393.25
01-Apr-2024,ATM,00.00,56.18,337.07
01-Apr-2024,RTGS,00.00,00.00,337.07
01-Apr-2024,ATM,00.00,112.36,224.71
01-Apr-2024,Commission,00.00,28.09,196.62
01-Apr-2024,RTGS,00.00,196.62,00.00
02-Apr-2024,Debit Card,"31,440.36",00.00,"31,440.36"
02-Apr-2024,NEFT,"3,908.08",00.00,"35,348.44"
02-Apr-2024,ATM,"2,963.20",00.00,"38,311.64"
02-Apr-2024,Debit Card,02.00,00.00,"38,313.64"
02-Apr-2024,Bill,00.00,"9,578.41","28,735.23"
02-Apr-2024,Purchase,00.00,"28,735.23",00.00
02-Apr-2024,Commission,130.20,00.00,130.20
02-Apr-2024,Interest,00.00,13.02,117.18
02-Apr-2024,Reversal,"2,268.40",00.00,"2,385.58"
02-Apr-2024,Miscellaneous,00.00,340.80,"2,044.78"
02-Apr-2024,Debit Card,00.00,511.20,"1,533.58"
02-Apr-2024,Miscellaneous,08.00,00.00,"1,541.58"
02-Apr-2024,ATM,00.00,256.93,"1,284.65"
02-Apr-2024,Cash,"79,248.00",00.00,"80,532.65"
02-Apr-2024,RTGS,00.00,"40,266.33","40,266.32"
02-Apr-2024,IMPS,427.00,00.00,"40,693.32"
02-Apr-2024,RTGS,00.00,"20,346.66","20,346.66"
02-Apr-2024,Bill,"503,606.80",00.00,"523,953.46"
02-Apr-2024,Tax,00.00,"104,790.69","419,162.77"
02-Apr-2024,Miscellaneous,630.30,00.00,"419,793.07"
02-Apr-2024,Interest,00.00,"59,970.44","359,822.63"
02-Apr-2024,Debit Card,"4,442.15",00.00,"364,264.78"
02-Apr-2024,Purchase,"2,317.00",00.00,"366,581.78"
02-Apr-2024,RTGS,"1,770,159.00",00.00,"2,136,740.78"
02-Apr-2024,Reversal,"8,471.00",00.00,"2,145,211.78"
02-Apr-2024,NEFT,00.00,"429,042.36","1,716,169.42"
02-Apr-2024,NEFT,00.00,"858,084.71","858,084.71"
02-Apr-2024,Miscellaneous,"737,138.25",00.00,"1,595,222.96"
02-Apr-2024,Miscellaneous,00.00,"199,402.87","1,395,820.09"
02-Apr-2024,ATM,00.00,"1,395,820.09",00.00
02-Apr-2024,Cheque,"3,026.10",00.00,"3,026.10"
02-Apr-2024,IMPS,"6,587.33",00.00,"9,613.43"
02-Apr-2024,Bill,45.11,00.00,"9,658.54"
02-Apr-2024,Miscellaneous,"107,528.34",00.00,"117,186.88"
02-Apr-2024,Bill,00.00,"39,062.29","78,124.59"
02-Apr-2024,Reversal,"1,039,576.25",00.00,"1,117,700.84"
02-Apr-2024,Commission,"9,202.00",00.00,"1,126,902.84"
03-Apr-2024,Cash,00.00,"160,986.12","965,916.72"
03-Apr-2024,Cash,"110,995.44",00.00,"1,076,912.16"
03-Apr-2024,Bill,00.00,"215,382.43","861,529.73"
03-Apr-2024,Debit Card,00.00,"143,588.29","717,941.44"
03-Apr-2024,Debit Card,"109,713.10",00.00,"827,654.54"
03-Apr-2024,Bill,02.06,00.00,"827,656.60"
03-Apr-2024,Miscellaneous,05.79,00.00,"827,662.39"
03-Apr-2024,RTGS,07.51,00.00,"827,669.90"
03-Apr-2024,Tax,58.80,00.00,"827,728.70"
03-Apr-2024,Cheque,"2,210.00",00.00,"829,938.70"
03-Apr-2024,Cheque,00.00,"276,646.23","553,292.47"
04-Apr-2024,Cash,00.00,"553,292.47",00.00
04-Apr-2024,IMPS,"1,901.00",00.00,"1,901.00"
04-Apr-2024,IMPS,00.00,237.63,"1,663.38"
04-Apr-2024,Purchase,00.00,332.68,"1,330.70"
04-Apr-2024,Bill,00.00,190.10,"1,140.60"
05-Apr-2024,Cash,00.00,570.30,570.30
05-Apr-2024,Commission,00.00,81.47,488.83
05-Apr-2024,Commission,05.80,00.00,494.63
05-Apr-2024,RTGS,"22,454.30",00.00,"22,948.93"
05-Apr-2024,Bill,"5,010.32",00.00,"27,959.25"
05-Apr-2024,IMPS,00.00,"3,994.18","23,965.07"
05-Apr-2024,RTGS,922.02,00.00,"24,887.09"
05-Apr-2024,Interest,00.00,"4,147.85","20,739.24"
05-Apr-2024,Miscellaneous,"1,314,343.80",00.00,"1,335,083.04"
05-Apr-2024,Interest,00.00,"445,027.68","890,055.36"
05-Apr-2024,Cheque,340.21,00.00,"890,395.57"
05-Apr-2024,Interest,189.00,00.00,"890,584.57"
05-Apr-2024,Miscellaneous,"1,630,298.80",00.00,"2,520,883.37"
05-Apr-2024,ATM,492.40,00.00,"2,521,375.77"
05-Apr-2024,Purchase,00.00,"2,521,375.77",00.00
05-Apr-2024,Miscellaneous,"6,994.00",00.00,"6,994.00"
05-Apr-2024,Debit Card,00.00,"3,497.00","3,497.00"
05-Apr-2024,Cheque,01.20,00.00,"3,498.20"
05-Apr-2024,Purchase,"1,784,083.00",00.00,"1,787,581.20"
05-Apr-2024,Interest,00.80,00.00,"1,787,582.00"
05-Apr-2024,Interest,00.00,"595,860.67","1,191,721.33"
05-Apr-2024,Miscellaneous,48.00,00.00,"1,191,769.33"
05-Apr-2024,Cheque,00.00,"119,176.93","1,072,592.40"
05-Apr-2024,RTGS,"3,201.64",00.00,"1,075,794.04"
05-Apr-2024,Transfer,46.52,00.00,"1,075,840.56"
05-Apr-2024,Cash,00.00,"358,613.52","717,227.04"
05-Apr-2024,Transfer,00.00,"89,653.38","627,573.66"
05-Apr-2024,Cash,00.00,"313,786.83","313,786.83"
05-Apr-2024,Interest,01.30,00.00,"313,788.13"
05-Apr-2024,Bill,00.00,"44,826.88","268,961.25"
06-Apr-2024,RTGS,00.00,"67,240.31","201,720.94"
06-Apr-2024,Commission,06.00,00.00,"201,726.94"
06-Apr-2024,Commission,00.00,"40,345.39","161,381.55"
06-Apr-2024,Purchase,"2,910.81",00.00,"164,292.36"
06-Apr-2024,RTGS,58.00,00.00,"164,350.36"
06-Apr-2024,Interest,48.00,00.00,"164,398.36"
06-Apr-2024,Interest,00.00,"41,099.59","123,298.77"
06-Apr-2024,Tax,"120,403.00",00.00,"243,701.77"
06-Apr-2024,Cash,00.00,"24,370.18","219,331.59"
06-Apr-2024,Bill,00.00,"109,665.80","109,665.80"
06-Apr-2024,Cheque,"213,032.00",00.00,"322,697.80"
06-Apr-2024,RTGS,00.00,"161,348.90","161,348.90"
06-Apr-2024,Cash,00.00,"32,269.78","129,079.12"
06-Apr-2024,ATM,00.00,"16,134.89","112,944.23"
06-Apr-2024,Miscellaneous,"3,300.20",00.00,"116,244.43"
06-Apr-2024,Commission,"1,373,040.00",00.00,"1,489,284.43"
06-Apr-2024,Reversal,00.00,"212,754.92","1,276,529.51"
06-Apr-2024,Reversal,00.00,"425,509.84","851,019.67"
06-Apr-2024,Purchase,00.00,"141,836.61","709,183.06"
06-Apr-2024,RTGS,"399,179.50",00.00,"1,108,362.56"
06-Apr-2024,NEFT,00.00,"110,836.26","997,526.30"
06-Apr-2024,Cash,00.00,"997,526.30",00.00
06-Apr-2024,Bill,"1,974,457.00",00.00,"1,974,457.00"
06-Apr-2024,Reversal,298.00,00.00,"1,974,755.00"
06-Apr-2024,Cheque,00.00,"394,951.00","1,579,804.00"
06-Apr-2024,Reversal,53.00,00.00,"1,579,857.00"
06-Apr-2024,Debit Card,00.00,"315,971.40","1,263,885.60"
06-Apr-2024,ATM,00.00,"140,431.73","1,123,453.87"
07-Apr-2024,Reversal,00.00,"561,726.94","561,726.94"
07-Apr-2024,Debit Card,"742,795.00",00.00,"1,304,521.94"
07-Apr-2024,Purchase,"79,215.80",00.00,"1,383,737.74"
07-Apr-2024,Debit Card,"222,227.60",00.00,"1,605,965.34"
07-Apr-2024,RTGS,00.00,"178,440.59","1,427,524.75"
07-Apr-2024,Debit Card,00.00,"178,440.59","1,249,084.16"
07-Apr-2024,NEFT,477.10,00.00,"1,249,561.26"
07-Apr-2024,Cash,00.00,"249,912.25","999,649.01"
07-Apr-2024,Cash,"272,759.20",00.00,"1,272,408.21"
07-Apr-2024,Purchase,954.63,00.00,"1,273,362.84"
07-Apr-2024,RTGS,05.70,00.00,"1,273,368.54"
07-Apr-2024,Transfer,00.00,"318,342.14","955,026.40"
07-Apr-2024,Tax,00.00,"191,005.28","764,021.12"
07-Apr-2024,NEFT,18.00,00.00,"764,039.12"
07-Apr-2024,Cash,00.00,"191,009.78","573,029.34"
07-Apr-2024,Transfer,00.00,"143,257.34","429,772.00"
07-Apr-2024,Cheque,00.00,"429,772.00",00.00
07-Apr-2024,Miscellaneous,"1,861.70",00.00,"1,861.70"
07-Apr-2024,Tax,00.00,620.57,"1,241.13"
07-Apr-2024,Cheque,00.00,"1,241.13",00.00
07-Apr-2024,Tax,"19,988.00",00.00,"19,988.00"
07-Apr-2024,NEFT,05.90,00.00,"19,993.90"
07-Apr-2024,ATM,00.00,"4,998.48","14,995.42"
07-Apr-2024,RTGS,02.00,00.00,"14,997.42"
07-Apr-2024,RTGS,255.50,00.00,"15,252.92"
07-Apr-2024,Miscellaneous,00.00,"15,252.92",00.00
07-Apr-2024,RTGS,"59,226.09",00.00,"59,226.09"
07-Apr-2024,NEFT,00.00,"11,845.22","47,380.87"
07-Apr-2024,Interest,495.40,00.00,"47,876.27"
07-Apr-2024,RTGS,"1,715,448.00",00.00,"1,763,324.27"
07-Apr-2024,Reversal,58.90,00.00,"1,763,383.17"
07-Apr-2024,NEFT,00.00,"440,845.79","1,322,537.38"
07-Apr-2024,Purchase,"50,925.16",00.00,"1,373,462.54"
07-Apr-2024,Cash,02.78,00.00,"1,373,465.32"
07-Apr-2024,RTGS,00.00,"457,821.77","915,643.55"
07-Apr-2024,Commission,"4,772.00",00.00,"920,415.55"
07-Apr-2024,NEFT,00.00,"184,083.11","736,332.44"
07-Apr-2024,NEFT,03.55,00.00,"736,335.99"
07-Apr-2024,RTGS,00.00,"245,445.33","490,890.66"
07-Apr-2024,Debit Card,00.00,"81,815.11","409,075.55"
07-Apr-2024,ATM,00.00,"204,537.78","204,537.78"
07-Apr-2024,RTGS,"223,907.12",00.00,"428,444.90"
07-Apr-2024,Bill,00.00,"428,444.90",00.00
07-Apr-2024,Cheque,477.00,00.00,477.00
07-Apr-2024,Miscellaneous,112.11,00.00,589.11
07-Apr-2024,RTGS,"25,569.56",00.00,"26,158.67"
07-Apr-2024,Bill,"232,429.97",00.00,"258,588.64"
07-Apr-2024,ATM,332.10,00.00,"258,920.74"
07-Apr-2024,Commission,00.00,"36,988.68","221,932.06"
07-Apr-2024,RTGS,00.00,"55,483.02","166,449.04"
07-Apr-2024,Miscellaneous,"1,773,730.75",00.00,"1,940,179.79"
07-Apr-2024,Interest,"1,967,136.50",00.00,"3,907,316.29"
07-Apr-2024,Tax,52.00,00.00,"3,907,368.29"
07-Apr-2024,Miscellaneous,02.00,00.00,"3,907,370.29"
07-Apr-2024,Cheque,03.00,00.00,"3,907,373.29"
07-Apr-2024,Interest,00.00,"1,953,686.65","1,953,686.64"
07-Apr-2024,Transfer,01.70,00.00,"1,953,688.34"
07-Apr-2024,Transfer,"250,240.60",00.00,"2,203,928.94"
08-Apr-2024,Transfer,00.00,"244,880.99","1,959,047.95"
08-Apr-2024,Interest,"136,430.80",00.00,"2,095,478.75"
08-Apr-2024,Interest,"1,051.60",00.00,"2,096,530.35"
08-Apr-2024,Transfer,00.00,"349,421.73","1,747,108.62"
08-Apr-2024,Commission,"26,432.00",00.00,"1,773,540.62"
08-Apr-2024,NEFT,"450,706.00",00.00,"2,224,246.62"
08-Apr-2024,Bill,00.00,"370,707.77","1,853,538.85"
08-Apr-2024,Transfer,"28,964.90",00.00,"1,882,503.75"
08-Apr-2024,NEFT,00.00,"268,929.11","1,613,574.64"
08-Apr-2024,NEFT,18.00,00.00,"1,613,592.64"
08-Apr-2024,Bill,"2,246.07",00.00,"1,615,838.71"
08-Apr-2024,Debit Card,"2,013.14",00.00,"1,617,851.85"
08-Apr-2024,Debit Card,142.80,00.00,"1,617,994.65"
08-Apr-2024,Bill,"1,965,479.50",00.00,"3,583,474.15"
08-Apr-2024,Tax,47.80,00.00,"3,583,521.95"
08-Apr-2024,Cash,"1,481,969.00",00.00,"5,065,490.95"
08-Apr-2024,Interest,678.00,00.00,"5,066,168.95"
08-Apr-2024,Tax,"178,594.00",00.00,"5,244,762.95"
08-Apr-2024,Miscellaneous,"45,773.00",00.00,"5,290,535.95"
08-Apr-2024,Transfer,"11,637.00",00.00,"5,302,172.95"
08-Apr-2024,Purchase,00.00,"1,767,390.98","3,534,781.97"
08-Apr-2024,Commission,431.58,00.00,"3,535,213.55"
08-Apr-2024,RTGS,00.00,00.00,"3,535,213.55"
09-Apr-2024,Interest,01.73,00.00,"3,535,215.28"
09-Apr-2024,Purchase,183.00,00.00,"3,535,398.28"
09-Apr-2024,Tax,00.20,00.00,"3,535,398.48"
09-Apr-2024,Bill,"1,890.90",00.00,"3,537,289.38"
09-Apr-2024,Bill,00.00,"589,548.23","2,947,741.15"
09-Apr-2024,Commission,00.00,"589,548.23","2,358,192.92"
09-Apr-2024,Cheque,00.00,"336,884.70","2,021,308.22"
09-Apr-2024,Bill,00.00,"224,589.80","1,796,718.42"
09-Apr-2024,RTGS,"14,879.45",00.00,"1,811,597.87"
09-Apr-2024,Transfer,"1,238,784.80",00.00,"3,050,382.67"
09-Apr-2024,Debit Card,00.00,"610,076.53","2,440,306.14"
09-Apr-2024,Miscellaneous,00.00,"2,440,306.14",00.00
09-Apr-2024,NEFT,"2,683.00",00.00,"2,683.00"
09-Apr-2024,Reversal,"28,988.00",00.00,"31,671.00"
09-Apr-2024,Cheque,"98,685.20",00.00,"130,356.20"
09-Apr-2024,Miscellaneous,00.00,"130,356.20",00.00
09-Apr-2024,Purchase,"2,927.50",00.00,"2,927.50"
09-Apr-2024,Interest,28.10,00.00,"2,955.60"
09-Apr-2024,IMPS,00.00,"2,955.60",00.00
09-Apr-2024,NEFT,"787,484.25",00.00,"787,484.25"
09-Apr-2024,IMPS,"1,420,574.00",00.00,"2,208,058.25"
09-Apr-2024,Cheque,331.32,00.00,"2,208,389.57"
09-Apr-2024,RTGS,881.50,00.00,"2,209,271.07"
09-Apr-2024,Purchase,00.00,"315,610.15","1,893,660.92"
09-Apr-2024,Cheque,"1,133,769.00",00.00,"3,027,429.92"
09-Apr-2024,Interest,00.00,"378,428.74","2,649,001.18"
09-Apr-2024,Purchase,00.00,"441,500.20","2,207,500.98"
09-Apr-2024,Cash,"6,752.30",00.00,"2,214,253.28"
09-Apr-2024,Bill,06.04,00.00,"2,214,259.32"
09-Apr-2024,Reversal,"7,542.50",00.00,"2,221,801.82"
09-Apr-2024,Cash,"2,700.30",00.00,"2,224,502.12"
09-Apr-2024,Tax,00.00,"247,166.90","1,977,335.22"
09-Apr-2024,IMPS,46.00,00.00,"1,977,381.22"
09-Apr-2024,Cheque,00.00,"329,563.54","1,647,817.68"
09-Apr-2024,Purchase,346.41,00.00,"1,648,164.09"
09-Apr-2024,ATM,"1,895,528.00",00.00,"3,543,692.09"
09-Apr-2024,Transfer,00.00,"885,923.02","2,657,769.07"
09-Apr-2024,Cheque,"698,533.80",00.00,"3,356,302.87"
09-Apr-2024,ATM,00.00,"671,260.57","2,685,042.30"
09-Apr-2024,Miscellaneous,11.00,00.00,"2,685,053.30"
09-Apr-2024,Transfer,"650,165.00",00.00,"3,335,218.30"
09-Apr-2024,Debit Card,00.00,"1,667,609.15","1,667,609.15"
09-Apr-2024,ATM,36.76,00.00,"1,667,645.91"
09-Apr-2024,Miscellaneous,00.00,"833,822.96","833,822.96"
09-Apr-2024,Reversal,"32,734.00",00.00,"866,556.96"
09-Apr-2024,Tax,"1,898,027.80",00.00,"2,764,584.76"
09-Apr-2024,NEFT,"2,192.00",00.00,"2,766,776.76"
09-Apr-2024,ATM,26.50,00.00,"2,766,803.26"
09-Apr-2024,Miscellaneous,00.00,"461,133.88","2,305,669.38"
09-Apr-2024,Bill,"7,343.00",00.00,"2,313,012.38"
09-Apr-2024,Tax,00.00,"2,313,012.38",00.00
09-Apr-2024,Cheque,575.35,00.00,575.35
09-Apr-2024,Bill,00.00,71.92,503.43
09-Apr-2024,Miscellaneous,00.00,251.72,251.72
09-Apr-2024,Purchase,00.00,125.86,125.86
09-Apr-2024,Purchase,00.00,20.98,104.88
09-Apr-2024,ATM,06.80,00.00,111.68
09-Apr-2024,IMPS,00.00,18.61,93.07
09-Apr-2024,Cash,"256,202.00",00.00,"256,295.07"
09-Apr-2024,ATM,"136,947.28",00.00,"393,242.35"
09-Apr-2024,Transfer,00.00,"49,155.29","344,087.06"
09-Apr-2024,Cash,04.02,00.00,"344,091.08"
09-Apr-2024,Miscellaneous,00.00,"38,232.34","305,858.74"
09-Apr-2024,ATM,"235,840.00",00.00,"541,698.74"
09-Apr-2024,Debit Card,05.22,00.00,"541,703.96"
09-Apr-2024,Cash,00.00,"270,851.98","270,851.98"
09-Apr-2024,Cheque,06.90,00.00,"270,858.88"
09-Apr-2024,NEFT,00.00,"135,429.44","135,429.44"
09-Apr-2024,Miscellaneous,00.00,"33,857.36","101,572.08"
09-Apr-2024,Interest,00.00,"14,510.30","87,061.78"
09-Apr-2024,Commission,"9,016.10",00.00,"96,077.88"
09-Apr-2024,Reversal,469.41,00.00,"96,547.29"
09-Apr-2024,Cash,"8,926.00",00.00,"105,473.29"
09-Apr-2024,IMPS,00.00,"26,368.32","79,104.97"
09-Apr-2024,Bill,00.00,"79,104.97",00.00
10-Apr-2024,Bill,15.82,00.00,15.82
10-Apr-2024,Interest,"614,488.00",00.00,"614,503.82"
10-Apr-2024,Cheque,"2,530.60",00.00,"617,034.42"
10-Apr-2024,Interest,28.21,00.00,"617,062.63"
10-Apr-2024,NEFT,"1,566.90",00.00,"618,629.53"
10-Apr-2024,Commission,00.00,"206,209.84","412,419.69"
10-Apr-2024,Bill,51.00,00.00,"412,470.69"
10-Apr-2024,Debit Card,00.00,"137,490.23","274,980.46"
10-Apr-2024,Bill,"237,900.25",00.00,"512,880.71"
10-Apr-2024,Commission,"15,147.22",00.00,"528,027.93"
10-Apr-2024,Bill,"1,097,546.00",00.00,"1,625,573.93"
10-Apr-2024,RTGS,00.00,"270,928.99","1,354,644.94"
10-Apr-2024,RTGS,00.00,"338,661.24","1,015,983.70"
10-Apr-2024,Purchase,"5,009.90",00.00,"1,020,993.60"
10-Apr-2024,NEFT,00.00,"340,331.20","680,662.40"
10-Apr-2024,Cheque,00.00,"226,887.47","453,774.93"
10-Apr-2024,Miscellaneous,00.00,"90,754.99","363,019.94"
10-Apr-2024,Miscellaneous,00.25,00.00,"363,020.19"
10-Apr-2024,Reversal,"3,453.90",00.00,"366,474.09"
10-Apr-2024,Cheque,10.12,00.00,"366,484.21"
10-Apr-2024,Reversal,489.72,00.00,"366,973.93"
10-Apr-2024,Commission,"24,562.73",00.00,"391,536.66"
10-Apr-2024,NEFT,55.00,00.00,"391,591.66"
10-Apr-2024,Cheque,00.00,"391,591.66",00.00
10-Apr-2024,Purchase,"9,779.00",00.00,"9,779.00"
10-Apr-2024,Cheque,"873,274.00",00.00,"883,053.00"
10-Apr-2024,Purchase,"1,133.00",00.00,"884,186.00"
10-Apr-2024,Commission,"30,173.43",00.00,"914,359.43"
10-Apr-2024,Transfer,"27,464.93",00.00,"941,824.36"
10-Apr-2024,Cash,00.00,"941,824.36",00.00
10-Apr-2024,ATM,"3,594.64",00.00,"3,594.64"
10-Apr-2024,Debit Card,01.89,00.00,"3,596.53"
10-Apr-2024,Tax,00.00,"1,798.27","1,798.26"
10-Apr-2024,RTGS,00.00,599.42,"1,198.84"
10-Apr-2024,Commission,00.00,149.86,"1,048.98"
10-Apr-2024,ATM,54.00,00.00,"1,102.98"
10-Apr-2024,Interest,05.72,00.00,"1,108.70"
10-Apr-2024,Transfer,00.00,221.74,886.96
10-Apr-2024,Purchase,"29,552.00",00.00,"30,438.96"
10-Apr-2024,Cash,00.00,"10,146.32","20,292.64"
10-Apr-2024,Interest,00.00,"20,292.64",00.00
10-Apr-2024,Bill,287.35,00.00,287.35
10-Apr-2024,Interest,00.00,47.89,239.46
10-Apr-2024,Cheque,"328,456.00",00.00,"328,695.46"
10-Apr-2024,Cheque,00.00,"54,782.58","273,912.88"
10-Apr-2024,Commission,03.40,00.00,"273,916.28"
10-Apr-2024,NEFT,00.00,"34,239.54","239,676.75"
10-Apr-2024,ATM,00.00,"23,967.68","215,709.08"
11-Apr-2024,RTGS,00.00,"43,141.82","172,567.26"
11-Apr-2024,ATM,26.00,00.00,"172,593.26"
11-Apr-2024,Miscellaneous,28.00,00.00,"172,621.26"
11-Apr-2024,Purchase,00.00,"43,155.32","129,465.94"
11-Apr-2024,Cash,"1,578,285.00",00.00,"1,707,750.94"
11-Apr-2024,ATM,00.00,"213,468.87","1,494,282.07"
11-Apr-2024,Cash,00.00,"249,047.01","1,245,235.06"
11-Apr-2024,IMPS,281.00,00.00,"1,245,516.06"
11-Apr-2024,Interest,00.00,"415,172.02","830,344.04"
11-Apr-2024,NEFT,"504,338.00",00.00,"1,334,682.04"
11-Apr-2024,ATM,00.00,"148,298.00","1,186,384.04"
11-Apr-2024,Commission,00.00,"593,192.02","593,192.02"
11-Apr-2024,NEFT,00.00,"84,741.72","508,450.30"
11-Apr-2024,Tax,"1,083,197.00",00.00,"1,591,647.30"
11-Apr-2024,RTGS,00.00,"265,274.55","1,326,372.75"
11-Apr-2024,Bill,00.00,"442,124.25","884,248.50"
11-Apr-2024,Reversal,04.00,00.00,"884,252.50"
11-Apr-2024,Miscellaneous,00.00,"110,531.56","773,720.94"
11-Apr-2024,Purchase,00.00,"386,860.47","386,860.47"
11-Apr-2024,Cash,"16,165.10",00.00,"403,025.57"
11-Apr-2024,RTGS,00.00,"201,512.79","201,512.78"
12-Apr-2024,ATM,07.82,00.00,"201,520.60"
12-Apr-2024,Cheque,"1,208.00",00.00,"202,728.60"
12-Apr-2024,ATM,06.70,00.00,"202,735.30"
12-Apr-2024,ATM,00.00,"28,962.19","173,773.11"
12-Apr-2024,Commission,06.40,00.00,"173,779.51"
12-Apr-2024,Debit Card,00.00,"17,377.95","156,401.56"
12-Apr-2024,Debit Card,00.00,"22,343.08","134,058.48"
12-Apr-2024,Cheque,00.00,"67,029.24","67,029.24"
12-Apr-2024,Commission,44.22,00.00,"67,073.46"
12-Apr-2024,Cheque,00.00,"8,384.18","58,689.28"
12-Apr-2024,Bill,00.00,"58,689.28",00.00
12-Apr-2024,RTGS,"808,290.00",00.00,"808,290.00"
12-Apr-2024,Purchase,00.00,"115,470.00","692,820.00"
12-Apr-2024,Purchase,00.00,"86,602.50","606,217.50"
12-Apr-2024,Debit Card,00.00,"303,108.75","303,108.75"
13-Apr-2024,RTGS,00.00,"303,108.75",00.00
13-Apr-2024,Miscellaneous,"14,753.48",00.00,"14,753.48"
13-Apr-2024,Bill,"1,747,250.75",00.00,"1,762,004.23"
13-Apr-2024,RTGS,00.00,"176,200.42","1,585,803.81"
13-Apr-2024,Tax,"131,801.00",00.00,"1,717,604.81"
13-Apr-2024,Debit Card,00.00,"286,267.47","1,431,337.34"
13-Apr-2024,RTGS,00.00,"477,112.45","954,224.89"
13-Apr-2024,Purchase,"21,000.18",00.00,"975,225.07"
13-Apr-2024,NEFT,02.00,00.00,"975,227.07"
13-Apr-2024,Cheque,00.00,"325,075.69","650,151.38"
13-Apr-2024,Transfer,"32,070.00",00.00,"682,221.38"
13-Apr-2024,Tax,"3,761.00",00.00,"685,982.38"
13-Apr-2024,Miscellaneous,705.00,00.00,"686,687.38"
13-Apr-2024,Reversal,"1,541.40",00.00,"688,228.78"
13-Apr-2024,Cheque,00.00,"137,645.76","550,583.02"
13-Apr-2024,Cheque,"294,049.50",00.00,"844,632.52"
13-Apr-2024,Debit Card,"992,913.25",00.00,"1,837,545.77"
13-Apr-2024,ATM,00.00,"306,257.63","1,531,288.14"
13-Apr-2024,Transfer,00.00,"191,411.02","1,339,877.12"
13-Apr-2024,Cash,00.00,"167,484.64","1,172,392.48"
13-Apr-2024,Interest,00.00,"146,549.06","1,025,843.42"
13-Apr-2024,Debit Card,00.00,"102,584.34","923,259.08"
13-Apr-2024,RTGS,00.00,"184,651.82","738,607.26"
13-Apr-2024,IMPS,00.00,"82,067.47","656,539.79"
13-Apr-2024,NEFT,"1,754,679.25",00.00,"2,411,219.04"
13-Apr-2024,IMPS,00.00,"344,459.86","2,066,759.18"
13-Apr-2024,RTGS,57.00,00.00,"2,066,816.18"
13-Apr-2024,Cheque,00.00,"1,033,408.09","1,033,408.09"
13-Apr-2024,Interest,00.00,"103,340.81","930,067.28"
13-Apr-2024,Tax,00.00,"232,516.82","697,550.46"
13-Apr-2024,NEFT,06.00,00.00,"697,556.46"
13-Apr-2024,Purchase,00.00,"174,389.12","523,167.34"
13-Apr-2024,Miscellaneous,00.00,"87,194.56","435,972.78"
13-Apr-2024,Commission,"2,269.10",00.00,"438,241.88"
13-Apr-2024,Purchase,00.00,"73,040.31","365,201.57"
13-Apr-2024,IMPS,00.82,00.00,"365,202.39"
13-Apr-2024,Transfer,00.00,"52,171.77","313,030.62"
13-Apr-2024,Purchase,11.30,00.00,"313,041.92"
13-Apr-2024,Debit Card,"27,203.72",00.00,"340,245.64"
13-Apr-2024,Reversal,00.00,"113,415.21","226,830.43"
14-Apr-2024,Commission,"42,656.40",00.00,"269,486.83"
14-Apr-2024,IMPS,95.00,00.00,"269,581.83"
14-Apr-2024,Purchase,"1,710.26",00.00,"271,292.09"
14-Apr-2024,Debit Card,"4,367.50",00.00,"275,659.59"
14-Apr-2024,Bill,"1,792,838.25",00.00,"2,068,497.84"
14-Apr-2024,Miscellaneous,00.00,"206,849.78","1,861,648.06"
14-Apr-2024,Debit Card,25.14,00.00,"1,861,673.20"
14-Apr-2024,Miscellaneous,04.30,00.00,"1,861,677.50"
14-Apr-2024,Purchase,00.00,"465,419.38","1,396,258.12"
14-Apr-2024,Tax,446.60,00.00,"1,396,704.72"
14-Apr-2024,Debit Card,07.50,00.00,"1,396,712.22"
14-Apr-2024,Bill,408.70,00.00,"1,397,120.92"
14-Apr-2024,Cheque,00.00,"1,397,120.92",00.00
14-Apr-2024,NEFT,350.40,00.00,350.40
14-Apr-2024,Bill,00.00,38.93,311.47
14-Apr-2024,RTGS,260.70,00.00,572.17
14-Apr-2024,IMPS,00.00,190.72,381.45
14-Apr-2024,Transfer,00.00,190.73,190.72
14-Apr-2024,ATM,00.00,190.72,00.00
14-Apr-2024,NEFT,"1,999,370.50",00.00,"1,999,370.50"
14-Apr-2024,Cheque,00.00,"199,937.05","1,799,433.45"
14-Apr-2024,Cash,"126,948.00",00.00,"1,926,381.45"
14-Apr-2024,Reversal,00.00,"214,042.38","1,712,339.07"
14-Apr-2024,Bill,"1,301,669.50",00.00,"3,014,008.57"
14-Apr-2024,Purchase,"20,030.66",00.00,"3,034,039.23"
14-Apr-2024,Bill,00.00,"337,115.47","2,696,923.76"
14-Apr-2024,Miscellaneous,"1,849.00",00.00,"2,698,772.76"
14-Apr-2024,Tax,360.00,00.00,"2,699,132.76"
14-Apr-2024,Purchase,"629,752.00",00.00,"3,328,884.76"
14-Apr-2024,ATM,06.00,00.00,"3,328,890.76"
15-Apr-2024,Reversal,00.00,"1,109,630.25","2,219,260.51"
15-Apr-2024,Purchase,00.00,"369,876.75","1,849,383.76"
15-Apr-2024,Bill,"9,538.00",00.00,"1,858,921.76"
15-Apr-2024,Debit Card,"244,056.62",00.00,"2,102,978.38"
15-Apr-2024,Interest,00.00,"420,595.68","1,682,382.70"
15-Apr-2024,Interest,"106,311.00",00.00,"1,788,693.70"
15-Apr-2024,Tax,00.00,"447,173.43","1,341,520.27"
15-Apr-2024,Miscellaneous,"558,224.00",00.00,"1,899,744.27"
15-Apr-2024,Purchase,"3,348.00",00.00,"1,903,092.27"
15-Apr-2024,Commission,00.00,"380,618.45","1,522,473.82"
15-Apr-2024,RTGS,00.00,"217,496.26","1,304,977.56"
15-Apr-2024,RTGS,"199,423.00",00.00,"1,504,400.56"
15-Apr-2024,Debit Card,00.00,"214,914.37","1,289,486.19"
15-Apr-2024,Tax,"21,744.20",00.00,"1,311,230.39"
15-Apr-2024,Miscellaneous,00.00,"327,807.60","983,422.79"
15-Apr-2024,Cheque,"3,416.50",00.00,"986,839.29"
15-Apr-2024,Debit Card,441.00,00.00,"987,280.29"
15-Apr-2024,NEFT,"86,284.94",00.00,"1,073,565.23"
15-Apr-2024,Debit Card,00.00,"357,855.08","715,710.15"
15-Apr-2024,Tax,00.00,"79,523.35","636,186.80"
15-Apr-2024,Cheque,"242,615.00",00.00,"878,801.80"
15-Apr-2024,Miscellaneous,00.00,"219,700.45","659,101.35"
15-Apr-2024,Cheque,04.00,00.00,"659,105.35"
15-Apr-2024,Cash,"1,385,468.00",00.00,"2,044,573.35"
15-Apr-2024,ATM,00.00,"227,174.82","1,817,398.53"
15-Apr-2024,Transfer,"1,659,901.50",00.00,"3,477,300.03"
15-Apr-2024,Miscellaneous,21.00,00.00,"3,477,321.03"
15-Apr-2024,Cheque,00.00,"3,477,321.03",00.00
15-Apr-2024,Tax,"1,032.70",00.00,"1,032.70"
15-Apr-2024,Debit Card,33.34,00.00,"1,066.04"
15-Apr-2024,Transfer,00.00,266.51,799.53
15-Apr-2024,Commission,"343,410.00",00.00,"344,209.53"
15-Apr-2024,RTGS,00.00,"86,052.38","258,157.15"
15-Apr-2024,ATM,"2,223.00",00.00,"260,380.15"
15-Apr-2024,RTGS,00.00,"65,095.04","195,285.11"
15-Apr-2024,IMPS,02.30,00.00,"195,287.41"
15-Apr-2024,IMPS,"2,086,848.80",00.00,"2,282,136.21"
15-Apr-2024,ATM,00.00,"380,356.04","1,901,780.18"
15-Apr-2024,Reversal,"73,870.80",00.00,"1,975,650.98"
15-Apr-2024,Bill,00.10,00.00,"1,975,651.08"
15-Apr-2024,Transfer,00.00,"395,130.22","1,580,520.86"
15-Apr-2024,Cash,00.00,"263,420.14","1,317,100.72"
15-Apr-2024,Purchase,380.00,00.00,"1,317,480.72"
15-Apr-2024,NEFT,00.00,"131,748.07","1,185,732.65"
15-Apr-2024,Interest,"1,527,942.75",00.00,"2,713,675.40"
15-Apr-2024,IMPS,490.20,00.00,"2,714,165.60"
15-Apr-2024,ATM,"669,916.20",00.00,"3,384,081.80"
16-Apr-2024,NEFT,497.93,00.00,"3,384,579.73"
16-Apr-2024,Transfer,00.00,"1,128,193.24","2,256,386.49"
17-Apr-2024,Purchase,"21,943.94",00.00,"2,278,330.43"
17-Apr-2024,NEFT,04.65,00.00,"2,278,335.08"
17-Apr-2024,Cheque,35.00,00.00,"2,278,370.08"
17-Apr-2024,Interest,00.00,"759,456.69","1,518,913.39"
17-Apr-2024,Miscellaneous,00.00,"151,891.34","1,367,022.05"
17-Apr-2024,Bill,00.59,00.00,"1,367,022.64"
17-Apr-2024,RTGS,"2,712.40",00.00,"1,369,735.04"
17-Apr-2024,Transfer,"1,227.19",00.00,"1,370,962.23"
17-Apr-2024,RTGS,04.68,00.00,"1,370,966.91"
17-Apr-2024,Miscellaneous,295.00,00.00,"1,371,261.91"
18-Apr-2024,Miscellaneous,"230,391.90",00.00,"1,601,653.81"
18-Apr-2024,Cash,00.00,"200,206.73","1,401,447.08"
18-Apr-2024,Bill,155.50,00.00,"1,401,602.58"
18-Apr-2024,Debit Card,00.00,"280,320.52","1,121,282.06"
18-Apr-2024,ATM,00.00,"1,121,282.06",00.00
18-Apr-2024,Interest,14.39,00.00,14.39
18-Apr-2024,Tax,00.00,01.80,12.59
18-Apr-2024,Debit Card,40.00,00.00,52.59
18-Apr-2024,Bill,"259,406.62",00.00,"259,459.21"
18-Apr-2024,ATM,00.00,"64,864.80","194,594.41"
18-Apr-2024,IMPS,"107,485.00",00.00,"302,079.41"
18-Apr-2024,Miscellaneous,"137,889.80",00.00,"439,969.21"
18-Apr-2024,Interest,00.00,"43,996.92","395,972.29"
18-Apr-2024,NEFT,00.00,"39,597.23","356,375.06"
18-Apr-2024,Purchase,00.00,"50,910.72","305,464.34"
18-Apr-2024,Bill,00.00,"76,366.09","229,098.26"
18-Apr-2024,Reversal,00.00,"114,549.13","114,549.13"
18-Apr-2024,Commission,00.00,"12,727.68","101,821.45"
18-Apr-2024,IMPS,"3,754.37",00.00,"105,575.82"
18-Apr-2024,RTGS,00.00,"13,196.98","92,378.84"
18-Apr-2024,Purchase,00.00,"30,792.95","61,585.89"
18-Apr-2024,Commission,52.00,00.00,"61,637.89"
18-Apr-2024,Miscellaneous,00.00,"10,272.98","51,364.91"
18-Apr-2024,Bill,07.46,00.00,"51,372.37"
18-Apr-2024,Reversal,00.00,"5,137.24","46,235.13"
19-Apr-2024,Miscellaneous,00.00,"5,137.24","41,097.89"
19-Apr-2024,Reversal,05.40,00.00,"41,103.29"
19-Apr-2024,Cash,"1,539,162.20",00.00,"1,580,265.49"
19-Apr-2024,IMPS,15.29,00.00,"1,580,280.78"
20-Apr-2024,Miscellaneous,00.00,"790,140.39","790,140.39"
20-Apr-2024,Reversal,48.00,00.00,"790,188.39"
20-Apr-2024,NEFT,00.00,"790,188.39",00.00
20-Apr-2024,Miscellaneous,"5,190.00",00.00,"5,190.00"
20-Apr-2024,Miscellaneous,"2,404.80",00.00,"7,594.80"
20-Apr-2024,Commission,"26,287.63",00.00,"33,882.43"
20-Apr-2024,Interest,00.00,"8,470.61","25,411.82"
20-Apr-2024,Cheque,"52,836.00",00.00,"78,247.82"
20-Apr-2024,IMPS,311.00,00.00,"78,558.82"
20-Apr-2024,Tax,00.00,"39,279.41","39,279.41"
20-Apr-2024,NEFT,970.00,00.00,"40,249.41"
20-Apr-2024,Interest,"1,685,069.00",00.00,"1,725,318.41"
20-Apr-2024,Cheque,00.00,"431,329.60","1,293,988.81"
20-Apr-2024,Reversal,41.00,00.00,"1,294,029.81"
20-Apr-2024,Tax,"25,910.60",00.00,"1,319,940.41"
20-Apr-2024,Cheque,00.00,"146,660.05","1,173,280.36"
20-Apr-2024,Cheque,"64,448.47",00.00,"1,237,728.83"
20-Apr-2024,Reversal,04.60,00.00,"1,237,733.43"
21-Apr-2024,RTGS,15.58,00.00,"1,237,749.01"
21-Apr-2024,Transfer,"6,214.05",00.00,"1,243,963.06"
21-Apr-2024,Miscellaneous,00.00,"177,709.01","1,066,254.05"
21-Apr-2024,IMPS,"3,295.00",00.00,"1,069,549.05"
21-Apr-2024,Bill,00.00,"267,387.26","802,161.79"
21-Apr-2024,Tax,00.00,"401,080.90","401,080.90"
21-Apr-2024,IMPS,00.00,"133,693.63","267,387.27"
21-Apr-2024,ATM,00.00,"66,846.82","200,540.45"
21-Apr-2024,Commission,350.00,00.00,"200,890.45"
22-Apr-2024,Miscellaneous,00.00,"22,321.16","178,569.29"
22-Apr-2024,Purchase,205.00,00.00,"178,774.29"
22-Apr-2024,Tax,"301,930.50",00.00,"480,704.79"
22-Apr-2024,ATM,"207,134.00",00.00,"687,838.79"
22-Apr-2024,Interest,00.00,"343,919.40","343,919.40"
22-Apr-2024,Commission,00.00,"34,391.94","309,527.46"
22-Apr-2024,Commission,"9,536.69",00.00,"319,064.15"
22-Apr-2024,Interest,801.33,00.00,"319,865.48"
22-Apr-2024,Reversal,05.00,00.00,"319,870.48"
22-Apr-2024,Miscellaneous,04.97,00.00,"319,875.45"
22-Apr-2024,Cash,"200,968.00",00.00,"520,843.45"
22-Apr-2024,Purchase,07.10,00.00,"520,850.55"
22-Apr-2024,ATM,00.00,"130,212.64","390,637.91"
22-Apr-2024,Transfer,00.00,"130,212.64","260,425.27"
22-Apr-2024,Miscellaneous,118.10,00.00,"260,543.37"
23-Apr-2024,Interest,04.58,00.00,"260,547.95"
23-Apr-2024,Cash,00.00,"52,109.59","208,438.36"
23-Apr-2024,Purchase,"21,272.10",00.00,"229,710.46"
23-Apr-2024,Purchase,"58,262.00",00.00,"287,972.46"
23-Apr-2024,Interest,422.89,00.00,"288,395.35"
23-Apr-2024,NEFT,03.59,00.00,"288,398.94"
23-Apr-2024,Debit Card,00.00,"28,839.89","259,559.05"
23-Apr-2024,Debit Card,00.00,"25,955.91","233,603.14"
23-Apr-2024,Interest,00.00,"46,720.63","186,882.51"
23-Apr-2024,Cash,00.00,"23,360.31","163,522.20"
23-Apr-2024,Transfer,00.00,"163,522.20",00.00
23-Apr-2024,ATM,34.10,00.00,34.10
23-Apr-2024,NEFT,502.00,00.00,536.10
23-Apr-2024,RTGS,00.00,134.03,402.08
23-Apr-2024,Cash,00.00,134.03,268.05
23-Apr-2024,ATM,"14,903.12",00.00,"15,171.17"
24-Apr-2024,Interest,00.00,"1,896.40","13,274.77"
24-Apr-2024,Transfer,00.00,"1,327.48","11,947.29"
24-Apr-2024,ATM,00.00,"1,706.76","10,240.53"
24-Apr-2024,Reversal,00.00,"5,120.27","5,120.27"
24-Apr-2024,Commission,63.48,00.00,"5,183.75"
24-Apr-2024,Purchase,"247,644.00",00.00,"252,827.75"
24-Apr-2024,IMPS,"1,441,703.75",00.00,"1,694,531.50"
24-Apr-2024,Debit Card,"51,244.00",00.00,"1,745,775.50"
24-Apr-2024,Transfer,00.00,"218,221.94","1,527,553.56"
24-Apr-2024,RTGS,00.00,"152,755.36","1,374,798.20"
24-Apr-2024,NEFT,290.10,00.00,"1,375,088.30"
24-Apr-2024,ATM,"3,878.00",00.00,"1,378,966.30"
24-Apr-2024,NEFT,00.00,"172,370.79","1,206,595.51"
24-Apr-2024,IMPS,02.00,00.00,"1,206,597.51"
24-Apr-2024,Bill,00.00,"134,066.39","1,072,531.12"
24-Apr-2024,NEFT,"29,901.80",00.00,"1,102,432.92"
24-Apr-2024,NEFT,"27,338.30",00.00,"1,129,771.22"
24-Apr-2024,RTGS,00.00,"141,221.40","988,549.82"
24-Apr-2024,Purchase,00.00,"988,549.82",00.00
24-Apr-2024,Cheque,"83,005.80",00.00,"83,005.80"
24-Apr-2024,Miscellaneous,"1,563.40",00.00,"84,569.20"
24-Apr-2024,ATM,00.00,"16,913.84","67,655.36"
24-Apr-2024,IMPS,"3,386.10",00.00,"71,041.46"
24-Apr-2024,ATM,"2,402.00",00.00,"73,443.46"
24-Apr-2024,ATM,"223,159.20",00.00,"296,602.66"
24-Apr-2024,Reversal,00.00,"42,371.81","254,230.85"
24-Apr-2024,Interest,"3,032.50",00.00,"257,263.35"
24-Apr-2024,Tax,436.40,00.00,"257,699.75"
24-Apr-2024,NEFT,145.00,00.00,"257,844.75"
24-Apr-2024,Tax,41.49,00.00,"257,886.24"
24-Apr-2024,Tax,44.64,00.00,"257,930.88"
25-Apr-2024,Bill,00.00,"51,586.18","206,344.70"
25-Apr-2024,Transfer,00.00,"25,793.09","180,551.61"
25-Apr-2024,Interest,00.80,00.00,"180,552.41"
25-Apr-2024,Tax,214.00,00.00,"180,766.41"
25-Apr-2024,Cash,00.00,"36,153.28","144,613.13"
25-Apr-2024,Reversal,00.00,"144,613.13",00.00
25-Apr-2024,IMPS,"30,160.81",00.00,"30,160.81"
25-Apr-2024,NEFT,00.00,"3,016.08","27,144.73"
25-Apr-2024,Bill,00.00,"2,714.47","24,430.26"
25-Apr-2024,Miscellaneous,07.00,00.00,"24,437.26"
25-Apr-2024,Cash,00.00,"24,437.26",00.00
25-Apr-2024,Purchase,01.00,00.00,01.00
25-Apr-2024,Miscellaneous,380.47,00.00,381.47
25-Apr-2024,Interest,05.00,00.00,386.47
25-Apr-2024,ATM,"2,983.83",00.00,"3,370.30"
25-Apr-2024,Commission,00.00,"1,123.43","2,246.87"
25-Apr-2024,Cash,"3,702.40",00.00,"5,949.27"
25-Apr-2024,Purchase,00.00,743.66,"5,205.61"
25-Apr-2024,Bill,197.00,00.00,"5,402.61"
25-Apr-2024,Interest,02.63,00.00,"5,405.24"
25-Apr-2024,NEFT,00.00,"1,801.75","3,603.49"
26-Apr-2024,Cheque,"436,078.25",00.00,"439,681.74"
26-Apr-2024,Bill,00.00,"54,960.22","384,721.52"
27-Apr-2024,NEFT,"21,485.18",00.00,"406,206.70"
27-Apr-2024,Tax,00.00,"135,402.23","270,804.47"
27-Apr-2024,Interest,"20,074.20",00.00,"290,878.67"
28-Apr-2024,Cheque,"134,753.38",00.00,"425,632.05"
28-Apr-2024,Reversal,234.80,00.00,"425,866.85"
28-Apr-2024,RTGS,"134,340.00",00.00,"560,206.85"
28-Apr-2024,NEFT,00.00,"560,206.85",00.00
28-Apr-2024,Miscellaneous,56.00,00.00,56.00
28-Apr-2024,Transfer,"1,041.70",00.00,"1,097.70"
28-Apr-2024,Debit Card,00.00,548.85,548.85
28-Apr-2024,RTGS,"28,044.00",00.00,"28,592.85"
28-Apr-2024,Miscellaneous,00.00,"2,859.29","25,733.56"
28-Apr-2024,Commission,00.00,"6,433.39","19,300.17"
29-Apr-2024,Miscellaneous,"2,905.22",00.00,"22,205.39"
29-Apr-2024,Debit Card,"1,744,570.00",00.00,"1,766,775.39"
29-Apr-2024,Miscellaneous,152.60,00.00,"1,766,927.99"
30-Apr-2024,Cash,00.00,"294,488.00","1,472,439.99"
30-Apr-2024,Reversal,00.00,"736,220.00","736,220.00"
30-Apr-2024,Debit Card,00.00,"184,055.00","552,165.00"
30-Apr-2024,Purchase,00.00,"110,433.00","441,732.00"
30-Apr-2024,Tax,"399,882.75",00.00,"841,614.75"
30-Apr-2024,Cash,00.00,"84,161.48","757,453.28"
30-Apr-2024,Bill,00.00,"151,490.66","605,962.62"
30-Apr-2024,Bill,"14,074.00",00.00,"620,036.62"
30-Apr-2024,IMPS,00.00,"310,018.31","310,018.31"
30-Apr-2024,Debit Card,"31,288.55",00.00,"341,306.86"
30-Apr-2024,Cash,00.00,"170,653.43","170,653.43"
30-Apr-2024,Purchase,00.00,"85,326.72","85,326.72"
30-Apr-2024,Reversal,01.53,00.00,"85,328.25"
30-Apr-2024,Commission,00.00,"12,189.75","73,138.50"
30-Apr-2024,Commission,03.50,00.00,"73,142.00"
30-Apr-2024,Debit Card,"245,583.00",00.00,"318,725.00"
30-Apr-2024,Commission,00.00,"159,362.50","159,362.50"
30-Apr-2024,RTGS,"1,217,209.50",00.00,"1,376,572.00"
30-Apr-2024,Miscellaneous,59.00,00.00,"1,376,631.00"
30-Apr-2024,Commission,00.00,"458,877.00","917,754.00"
30-Apr-2024,Cheque,61.60,00.00,"917,815.60"
30-Apr-2024,NEFT,00.00,"305,938.53","611,877.07"
30-Apr-2024,ATM,56.21,00.00,"611,933.28"
30-Apr-2024,Cheque,00.00,"76,491.66","535,441.62"
30-Apr-2024,Transfer,00.00,"76,491.66","458,949.96"
30-Apr-2024,Tax,"7,767.24",00.00,"466,717.20"
30-Apr-2024,Reversal,05.73,00.00,"466,722.93"
30-Apr-2024,IMPS,02.10,00.00,"466,725.03"
30-Apr-2024,ATM,169.50,00.00,"466,894.53"
30-Apr-2024,ATM,00.00,"58,361.82","408,532.71"
30-Apr-2024,RTGS,00.00,"40,853.27","367,679.44"
30-Apr-2024,Cheque,00.00,00.00,"367,679.44"
30-Apr-2024,RTGS,00.00,"183,839.72","183,839.72"
30-Apr-2024,Interest,"13,278.00",00.00,"197,117.72"
30-Apr-2024,Purchase,00.00,"21,901.97","175,215.75"
30-Apr-2024,Bill,00.00,"175,215.75",00.00
30-Apr-2024,NEFT,"96,836.00",00.00,"96,836.00"
30-Apr-2024,IMPS,"9,254.50",00.00,"106,090.50"
30-Apr-2024,Tax,06.49,00.00,"106,096.99"
30-Apr-2024,ATM,"300,378.00",00.00,"406,474.99"
30-Apr-2024,Transfer,"91,390.70",00.00,"497,865.69"
30-Apr-2024,Cheque,"213,743.40",00.00,"711,609.09"
30-Apr-2024,RTGS,"178,603.40",00.00,"890,212.49"
30-Apr-2024,Debit Card,"1,509,765.00",00.00,"2,399,977.49"
30-Apr-2024,Interest,00.00,"479,995.50","1,919,981.99"
30-Apr-2024,Purchase,"27,039.00",00.00,"1,947,020.99"
30-Apr-2024,Reversal,00.00,"278,145.86","1,668,875.13"
30-Apr-2024,Bill,00.00,"185,430.57","1,483,444.56"
30-Apr-2024,Bill,"36,911.47",00.00,"1,520,356.03"
30-Apr-2024,Debit Card,"14,680.27",00.00,"1,535,036.30"
30-Apr-2024,Bill,"31,440.16",00.00,"1,566,476.46"
30-Apr-2024,Commission,"943,803.00",00.00,"2,510,279.46"
30-Apr-2024,NEFT,"7,470.75",00.00,"2,517,750.21"
30-Apr-2024,Miscellaneous,00.00,"279,750.02","2,238,000.19"
30-Apr-2024,Bill,481.69,00.00,"2,238,481.88"
30-Apr-2024,Reversal,00.00,"223,848.19","2,014,633.69"
30-Apr-2024,RTGS,"1,588,609.80",00.00,"3,603,243.49"
30-Apr-2024,Commission,"17,485.00",00.00,"3,620,728.49"
30-Apr-2024,Reversal,00.00,"1,810,364.25","1,810,364.24"
30-Apr-2024,Interest,07.00,00.00,"1,810,371.24"
30-Apr-2024,Tax,"32,698.00",00.00,"1,843,069.24"
30-Apr-2024,Cheque,00.00,"460,767.31","1,382,301.93"
30-Apr-2024,Purchase,02.00,00.00,"1,382,303.93"
30-Apr-2024,Bill,399.00,00.00,"1,382,702.93"
30-Apr-2024,ATM,"1,358,855.75",00.00,"2,741,558.68"
30-Apr-2024,Transfer,"18,106.96",00.00,"2,759,665.64"
30-Apr-2024,Interest,07.74,00.00,"2,759,673.38"
30-Apr-2024,NEFT,"166,036.88",00.00,"2,925,710.26"
30-Apr-2024,Debit Card,00.00,"585,142.05","2,340,568.21"
30-Apr-2024,RTGS,00.00,"260,063.13","2,080,505.08"
30-Apr-2024,Tax,31.87,00.00,"2,080,536.95"
30-Apr-2024,Commission,"2,538.10",00.00,"2,083,075.05"
30-Apr-2024,Purchase,00.00,"347,179.18","1,735,895.88"
30-Apr-2024,Debit Card,00.00,"578,631.96","1,157,263.92"
01-May-2024,Bill,"315,635.00",00.00,"1,472,898.92"
01-May-2024,Transfer,"30,229.50",00.00,"1,503,128.42"
01-May-2024,Cheque,"2,916.00",00.00,"1,506,044.42"
01-May-2024,Debit Card,32.34,00.00,"1,506,076.76"
01-May-2024,Debit Card,"1,698,102.00",00.00,"3,204,178.76"
01-May-2024,Commission,"47,237.00",00.00,"3,251,415.76"
01-May-2024,RTGS,"1,216.30",00.00,"3,252,632.06"
01-May-2024,Bill,"2,304.70",00.00,"3,254,936.76"
01-May-2024,RTGS,224.26,00.00,"3,255,161.02"
01-May-2024,Reversal,00.00,"325,516.10","2,929,644.92"
01-May-2024,Cheque,21.13,00.00,"2,929,666.05"
01-May-2024,ATM,00.00,"2,929,666.05",00.00
01-May-2024,Cash,"2,358.80",00.00,"2,358.80"
01-May-2024,Transfer,00.00,589.70,"1,769.10"
01-May-2024,NEFT,835.30,00.00,"2,604.40"
01-May-2024,IMPS,48.90,00.00,"2,653.30"
01-May-2024,IMPS,00.00,294.81,"2,358.49"
01-May-2024,Commission,00.00,589.62,"1,768.87"
01-May-2024,Transfer,70.80,00.00,"1,839.67"
01-May-2024,Debit Card,00.00,613.22,"1,226.45"
01-May-2024,Debit Card,"908,418.25",00.00,"909,644.70"
01-May-2024,Debit Card,"800,660.00",00.00,"1,710,304.70"
01-May-2024,Cash,00.00,"244,329.24","1,465,975.46"
01-May-2024,IMPS,"84,418.69",00.00,"1,550,394.15"
01-May-2024,RTGS,"1,309,157.25",00.00,"2,859,551.40"
01-May-2024,IMPS,"27,706.00",00.00,"2,887,257.40"
01-May-2024,Cheque,13.00,00.00,"2,887,270.40"
01-May-2024,Purchase,00.00,"721,817.60","2,165,452.80"
01-May-2024,IMPS,00.00,"721,817.60","1,443,635.20"
01-May-2024,ATM,00.00,"206,233.60","1,237,401.60"
01-May-2024,Tax,00.00,"247,480.32","989,921.28"
01-May-2024,Miscellaneous,494.00,00.00,"990,415.28"
01-May-2024,Purchase,00.00,"330,138.43","660,276.85"
01-May-2024,Transfer,00.00,"132,055.37","528,221.48"
01-May-2024,Bill,00.00,"58,691.28","469,530.20"
01-May-2024,IMPS,00.00,"78,255.03","391,275.17"
02-May-2024,NEFT,00.00,"130,425.06","260,850.11"
02-May-2024,Cash,00.00,"32,606.26","228,243.85"
02-May-2024,Debit Card,"1,620.00",00.00,"229,863.85"
02-May-2024,Purchase,00.00,"32,837.69","197,026.16"
02-May-2024,IMPS,"162,614.20",00.00,"359,640.36"
02-May-2024,Tax,04.49,00.00,"359,644.85"
02-May-2024,NEFT,"181,675.80",00.00,"541,320.65"
02-May-2024,Interest,"2,299.74",00.00,"543,620.39"
02-May-2024,ATM,"1,402,932.00",00.00,"1,946,552.39"
02-May-2024,NEFT,"2,682.73",00.00,"1,949,235.12"
02-May-2024,Transfer,399.00,00.00,"1,949,634.12"
02-May-2024,Debit Card,00.00,"278,519.16","1,671,114.96"
02-May-2024,Miscellaneous,00.00,"238,730.71","1,432,384.25"
02-May-2024,Cash,"164,932.10",00.00,"1,597,316.35"
02-May-2024,Miscellaneous,257.00,00.00,"1,597,573.35"
02-May-2024,ATM,00.00,"798,786.68","798,786.68"
02-May-2024,Transfer,"67,619.28",00.00,"866,405.96"
02-May-2024,RTGS,00.00,"144,400.99","722,004.97"
02-May-2024,Interest,"68,151.75",00.00,"790,156.72"
02-May-2024,Bill,"121,518.00",00.00,"911,674.72"
02-May-2024,Tax,"2,129.74",00.00,"913,804.46"
02-May-2024,Bill,00.00,"182,760.89","731,043.57"
02-May-2024,Interest,"1,525.00",00.00,"732,568.57"
02-May-2024,NEFT,36.00,00.00,"732,604.57"
02-May-2024,Purchase,"228,496.00",00.00,"961,100.57"
02-May-2024,Cheque,"28,199.50",00.00,"989,300.07"
03-May-2024,ATM,00.00,"109,922.23","879,377.84"
03-May-2024,NEFT,386.00,00.00,"879,763.84"
03-May-2024,Transfer,00.00,"97,751.54","782,012.30"
03-May-2024,Reversal,00.00,"391,006.15","391,006.15"
03-May-2024,Cheque,00.00,"55,858.02","335,148.13"
03-May-2024,Miscellaneous,00.00,"335,148.13",00.00
03-May-2024,Transfer,"21,193.60",00.00,"21,193.60"
03-May-2024,ATM,"58,811.00",00.00,"80,004.60"
03-May-2024,IMPS,00.00,"40,002.30","40,002.30"
03-May-2024,Interest,00.00,"6,667.05","33,335.25"
04-May-2024,Miscellaneous,"1,707.64",00.00,"35,042.89"
04-May-2024,Transfer,00.00,"3,504.29","31,538.60"
04-May-2024,Bill,00.00,"3,504.29","28,034.31"
04-May-2024,Cash,11.20,00.00,"28,045.51"
04-May-2024,Reversal,62.00,00.00,"28,107.51"
04-May-2024,Cash,291.52,00.00,"28,399.03"
04-May-2024,RTGS,00.00,"9,466.34","18,932.69"
04-May-2024,Interest,15.70,00.00,"18,948.39"
05-May-2024,RTGS,01.40,00.00,"18,949.79"
05-May-2024,ATM,00.00,"4,737.45","14,212.34"
05-May-2024,Debit Card,430.05,00.00,"14,642.39"
05-May-2024,Transfer,00.00,"1,626.93","13,015.46"
05-May-2024,Commission,"1,959.00",00.00,"14,974.46"
05-May-2024,Cash,00.00,"14,974.46",00.00
05-May-2024,Transfer,"945,487.75",00.00,"945,487.75"
05-May-2024,Cash,00.00,"118,185.97","827,301.78"
05-May-2024,Reversal,00.00,"165,460.36","661,841.42"
05-May-2024,Interest,"9,064.73",00.00,"670,906.15"
05-May-2024,Miscellaneous,"2,849.26",00.00,"673,755.41"
05-May-2024,RTGS,16.09,00.00,"673,771.50"
05-May-2024,Reversal,00.46,00.00,"673,771.96"
05-May-2024,Debit Card,00.00,"336,885.98","336,885.98"
05-May-2024,Commission,00.00,"56,147.66","280,738.32"
05-May-2024,Miscellaneous,00.00,"70,184.58","210,553.74"
05-May-2024,Commission,00.00,"30,079.11","180,474.63"
05-May-2024,NEFT,00.00,"25,782.09","154,692.54"
05-May-2024,NEFT,"3,003.00",00.00,"157,695.54"
05-May-2024,Interest,05.05,00.00,"157,700.59"
05-May-2024,Debit Card,433.20,00.00,"158,133.79"
05-May-2024,Miscellaneous,03.40,00.00,"158,137.19"
05-May-2024,Reversal,00.00,"31,627.44","126,509.75"
05-May-2024,Reversal,00.00,"14,056.64","112,453.11"
05-May-2024,Transfer,00.00,"18,742.19","93,710.92"
05-May-2024,Tax,00.00,"10,412.32","83,298.60"
05-May-2024,Commission,00.00,"13,883.10","69,415.50"
05-May-2024,Reversal,"20,672.70",00.00,"90,088.20"
05-May-2024,Cheque,14.67,00.00,"90,102.87"
05-May-2024,Debit Card,446.20,00.00,"90,549.07"
05-May-2024,Cash,02.60,00.00,"90,551.67"
05-May-2024,Cheque,"2,316.26",00.00,"92,867.93"
05-May-2024,Tax,"616,583.20",00.00,"709,451.13"
05-May-2024,Miscellaneous,00.00,"177,362.78","532,088.35"
05-May-2024,RTGS,58.00,00.00,"532,146.35"
05-May-2024,Cash,00.00,"266,073.18","266,073.18"
05-May-2024,Cash,00.00,"29,563.69","236,509.49"
05-May-2024,Bill,00.00,"33,787.07","202,722.42"
05-May-2024,Miscellaneous,"22,498.00",00.00,"225,220.42"
05-May-2024,Bill,"3,534.00",00.00,"228,754.42"
05-May-2024,Miscellaneous,00.00,"228,754.42",00.00
05-May-2024,Purchase,509.80,00.00,509.80
05-May-2024,Cash,476.16,00.00,985.96
05-May-2024,Miscellaneous,"5,181.40",00.00,"6,167.36"
05-May-2024,Debit Card,"151,350.00",00.00,"157,517.36"
05-May-2024,NEFT,10.00,00.00,"157,527.36"
05-May-2024,NEFT,00.00,"52,509.12","105,018.24"
05-May-2024,Bill,00.00,"17,503.04","87,515.20"
05-May-2024,Bill,00.00,"29,171.73","58,343.47"
05-May-2024,Cheque,"1,672,381.00",00.00,"1,730,724.47"
05-May-2024,Miscellaneous,00.00,"173,072.45","1,557,652.02"
05-May-2024,IMPS,00.00,"778,826.01","778,826.01"
05-May-2024,IMPS,00.00,"129,804.34","649,021.68"
05-May-2024,IMPS,"145,288.00",00.00,"794,309.68"
05-May-2024,Cash,06.76,00.00,"794,316.44"
05-May-2024,Commission,00.00,"158,863.29","635,453.15"
05-May-2024,IMPS,"3,493.20",00.00,"638,946.35"
05-May-2024,NEFT,03.80,00.00,"638,950.15"
05-May-2024,Tax,00.00,"127,790.03","511,160.12"
05-May-2024,Miscellaneous,00.00,"73,022.87","438,137.25"
05-May-2024,Bill,00.00,"219,068.63","219,068.62"
05-May-2024,NEFT,159.37,00.00,"219,227.99"
05-May-2024,Bill,00.00,"27,403.50","191,824.49"
05-May-2024,Reversal,17.90,00.00,"191,842.39"
05-May-2024,ATM,00.00,"23,980.30","167,862.09"
05-May-2024,Cash,02.59,00.00,"167,864.68"
05-May-2024,Bill,"1,786.00",00.00,"169,650.68"
05-May-2024,Transfer,05.00,00.00,"169,655.68"
05-May-2024,Purchase,"3,451.50",00.00,"173,107.18"
05-May-2024,Reversal,"1,515.81",00.00,"174,622.99"
05-May-2024,IMPS,00.00,"34,924.60","139,698.39"
05-May-2024,Reversal,"20,334.00",00.00,"160,032.39"
05-May-2024,Tax,00.00,"80,016.20","80,016.20"
05-May-2024,Interest,00.00,"20,004.05","60,012.15"
05-May-2024,Reversal,00.00,"6,668.02","53,344.13"
05-May-2024,NEFT,00.00,"53,344.13",00.00
06-May-2024,Cheque,"47,113.00",00.00,"47,113.00"
06-May-2024,Debit Card,44.30,00.00,"47,157.30"
06-May-2024,Cash,41.49,00.00,"47,198.79"
06-May-2024,Debit Card,501.47,00.00,"47,700.26"
06-May-2024,Debit Card,00.00,"6,814.32","40,885.94"
07-May-2024,Reversal,00.00,"13,628.65","27,257.29"
07-May-2024,Interest,07.90,00.00,"27,265.19"
07-May-2024,Tax,00.00,"6,816.30","20,448.89"
07-May-2024,RTGS,"145,798.00",00.00,"166,246.89"
07-May-2024,ATM,00.00,"16,624.69","149,622.20"
07-May-2024,Commission,00.00,"49,874.07","99,748.13"
07-May-2024,Debit Card,00.00,"99,748.13",00.00
07-May-2024,Bill,07.94,00.00,07.94
07-May-2024,Interest,00.00,01.99,05.96
07-May-2024,Miscellaneous,"2,070.87",00.00,"2,076.83"
07-May-2024,NEFT,00.00,"2,076.83",00.00
07-May-2024,ATM,40.00,00.00,40.00
07-May-2024,Purchase,00.00,05.71,34.29
07-May-2024,Commission,"805,905.80",00.00,"805,940.09"
07-May-2024,Interest,"6,188.87",00.00,"812,128.96"
07-May-2024,Transfer,"49,143.00",00.00,"861,271.96"
07-May-2024,IMPS,09.00,00.00,"861,280.96"
07-May-2024,Cash,00.00,"430,640.48","430,640.48"
07-May-2024,Tax,00.00,"215,320.24","215,320.24"
07-May-2024,Reversal,00.00,"215,320.24",00.00
07-May-2024,Transfer,104.00,00.00,104.00
07-May-2024,Reversal,"2,499.30",00.00,"2,603.30"
07-May-2024,Transfer,00.00,325.41,"2,277.89"
07-May-2024,Tax,00.00,455.58,"1,822.31"
07-May-2024,Cheque,"49,910.88",00.00,"51,733.19"
07-May-2024,Debit Card,00.00,"25,866.60","25,866.60"
07-May-2024,IMPS,317.00,00.00,"26,183.60"
07-May-2024,Purchase,00.00,"3,740.51","22,443.09"
07-May-2024,RTGS,"1,037,634.00",00.00,"1,060,077.09"
07-May-2024,Reversal,"1,237,917.80",00.00,"2,297,994.89"
07-May-2024,Debit Card,"1,063,140.00",00.00,"3,361,134.89"
07-May-2024,NEFT,00.00,"672,226.98","2,688,907.91"
07-May-2024,Bill,"1,832,045.00",00.00,"4,520,952.91"
07-May-2024,Bill,05.10,00.00,"4,520,958.01"
07-May-2024,IMPS,00.00,"502,328.67","4,018,629.34"
07-May-2024,NEFT,04.54,00.00,"4,018,633.88"
07-May-2024,ATM,00.00,"502,329.24","3,516,304.64"
07-May-2024,Interest,00.00,"1,172,101.55","2,344,203.09"
07-May-2024,Interest,"920,953.50",00.00,"3,265,156.59"
07-May-2024,Bill,47.70,00.00,"3,265,204.29"
07-May-2024,Tax,00.00,"816,301.07","2,448,903.22"
07-May-2024,Cash,"627,158.80",00.00,"3,076,062.02"
07-May-2024,Interest,00.00,"512,677.00","2,563,385.02"
07-May-2024,Bill,"66,726.00",00.00,"2,630,111.02"
07-May-2024,Tax,00.00,"375,730.15","2,254,380.87"
07-May-2024,Interest,"3,522.58",00.00,"2,257,903.45"
07-May-2024,Bill,00.00,"282,237.93","1,975,665.52"
07-May-2024,Tax,"1,891.70",00.00,"1,977,557.22"
07-May-2024,RTGS,00.00,"988,778.61","988,778.61"
07-May-2024,RTGS,"30,372.00",00.00,"1,019,150.61"
07-May-2024,Transfer,00.00,"203,830.12","815,320.49"
07-May-2024,NEFT,20.00,00.00,"815,340.49"
07-May-2024,Tax,168.80,00.00,"815,509.29"
07-May-2024,Cash,"1,673,647.75",00.00,"2,489,157.04"
07-May-2024,Interest,00.00,"2,489,157.04",00.00
07-May-2024,Commission,"3,429.70",00.00,"3,429.70"
07-May-2024,IMPS,01.33,00.00,"3,431.03"
07-May-2024,Reversal,00.00,571.84,"2,859.19"
07-May-2024,Reversal,05.00,00.00,"2,864.19"
08-May-2024,Debit Card,00.00,409.17,"2,455.02"
08-May-2024,Cheque,02.48,00.00,"2,457.50"
08-May-2024,RTGS,403.04,00.00,"2,860.54"
08-May-2024,RTGS,00.00,317.84,"2,542.70"
08-May-2024,Tax,"12,584.43",00.00,"15,127.13"
08-May-2024,Reversal,00.00,"3,781.78","11,345.35"
08-May-2024,Cheque,00.00,"1,620.76","9,724.59"
08-May-2024,Debit Card,00.00,"1,389.23","8,335.36"
08-May-2024,Cash,00.00,"2,083.84","6,251.52"
08-May-2024,Debit Card,01.71,00.00,"6,253.23"
08-May-2024,Miscellaneous,"203,591.50",00.00,"209,844.73"
08-May-2024,IMPS,"1,160.00",00.00,"211,004.73"
08-May-2024,Cheque,"3,537.60",00.00,"214,542.33"
09-May-2024,Miscellaneous,00.00,"21,454.23","193,088.10"
09-May-2024,Interest,40.20,00.00,"193,128.30"
09-May-2024,Transfer,00.00,"21,458.70","171,669.60"
09-May-2024,Bill,00.00,"19,074.40","152,595.20"
09-May-2024,Cash,00.00,"15,259.52","137,335.68"
09-May-2024,Debit Card,"2,025,025.75",00.00,"2,162,361.43"
10-May-2024,Cheque,00.00,"360,393.57","1,801,967.86"
10-May-2024,Transfer,147.43,00.00,"1,802,115.29"
10-May-2024,Bill,38.45,00.00,"1,802,153.74"
10-May-2024,Bill,00.00,"450,538.44","1,351,615.30"
11-May-2024,Miscellaneous,"8,776.00",00.00,"1,360,391.30"
11-May-2024,IMPS,"24,978.70",00.00,"1,385,370.00"
11-May-2024,Bill,"185,903.50",00.00,"1,571,273.50"
11-May-2024,Purchase,06.43,00.00,"1,571,279.93"
11-May-2024,Reversal,64.60,00.00,"1,571,344.53"
11-May-2024,Commission,00.00,"157,134.45","1,414,210.08"
11-May-2024,NEFT,00.00,"1,414,210.08",00.00
11-May-2024,Miscellaneous,"32,075.92",00.00,"32,075.92"
11-May-2024,Bill,00.00,"3,207.59","28,868.33"
11-May-2024,Tax,00.00,"2,886.83","25,981.50"
11-May-2024,Tax,07.00,00.00,"25,988.50"
11-May-2024,Reversal,00.00,"2,598.85","23,389.65"
11-May-2024,Reversal,00.00,"2,923.71","20,465.94"
11-May-2024,Debit Card,"560,563.25",00.00,"581,029.19"
11-May-2024,Purchase,00.00,"145,257.30","435,771.89"
11-May-2024,Cheque,"24,293.01",00.00,"460,064.90"
11-May-2024,Commission,00.00,"153,354.97","306,709.93"
11-May-2024,Tax,"21,303.80",00.00,"328,013.73"
11-May-2024,Commission,661.00,00.00,"328,674.73"
11-May-2024,ATM,30.20,00.00,"328,704.93"
11-May-2024,Tax,00.00,"82,176.23","246,528.70"
11-May-2024,Interest,00.00,"246,528.70",00.00
11-May-2024,ATM,"27,437.00",00.00,"27,437.00"
11-May-2024,Tax,00.00,"9,145.67","18,291.33"
11-May-2024,Reversal,06.00,00.00,"18,297.33"
11-May-2024,Reversal,"4,745.44",00.00,"23,042.77"
11-May-2024,Purchase,00.00,"4,608.55","18,434.22"
11-May-2024,Commission,00.00,"3,686.84","14,747.38"
11-May-2024,Transfer,00.00,"4,915.79","9,831.59"
11-May-2024,Interest,03.30,00.00,"9,834.89"
11-May-2024,Cash,00.00,983.49,"8,851.40"
11-May-2024,Bill,00.00,"2,212.85","6,638.55"
11-May-2024,Debit Card,"795,706.00",00.00,"802,344.55"
11-May-2024,Transfer,54.08,00.00,"802,398.63"
11-May-2024,Bill,00.00,"80,239.86","722,158.77"
11-May-2024,Debit Card,00.00,"180,539.69","541,619.08"
11-May-2024,Cheque,"3,572.42",00.00,"545,191.50"
11-May-2024,Cash,04.00,00.00,"545,195.50"
11-May-2024,Bill,320.00,00.00,"545,515.50"
11-May-2024,Transfer,01.00,00.00,"545,516.50"
11-May-2024,ATM,11.00,00.00,"545,527.50"
11-May-2024,Reversal,00.00,"109,105.50","436,422.00"
11-May-2024,Transfer,08.00,00.00,"436,430.00"
11-May-2024,Miscellaneous,60.50,00.00,"436,490.50"
11-May-2024,Transfer,484.81,00.00,"436,975.31"
11-May-2024,IMPS,00.00,"48,552.81","388,422.50"
12-May-2024,ATM,00.00,"48,552.81","339,869.69"
12-May-2024,NEFT,00.00,"48,552.81","291,316.88"
12-May-2024,Debit Card,"1,098,854.00",00.00,"1,390,170.88"
12-May-2024,Reversal,00.00,"463,390.29","926,780.59"
12-May-2024,Reversal,20.00,00.00,"926,800.59"
12-May-2024,IMPS,00.00,"463,400.30","463,400.30"
12-May-2024,Cash,00.00,"92,680.06","370,720.24"
12-May-2024,Cash,00.00,"185,360.12","185,360.12"
12-May-2024,NEFT,06.00,00.00,"185,366.12"
12-May-2024,Transfer,57.00,00.00,"185,423.12"
12-May-2024,Transfer,00.00,"185,423.12",00.00
12-May-2024,NEFT,"3,694.00",00.00,"3,694.00"
12-May-2024,Commission,00.00,410.44,"3,283.56"
12-May-2024,RTGS,00.00,"3,283.56",00.00
12-May-2024,Debit Card,05.00,00.00,05.00
12-May-2024,Bill,"2,439.00",00.00,"2,444.00"
12-May-2024,Interest,"28,700.00",00.00,"31,144.00"
12-May-2024,Debit Card,00.00,"6,228.80","24,915.20"
12-May-2024,NEFT,00.00,"4,152.53","20,762.67"
12-May-2024,Reversal,06.00,00.00,"20,768.67"
12-May-2024,RTGS,00.00,"2,966.95","17,801.72"
12-May-2024,Reversal,00.00,"5,933.91","11,867.81"
12-May-2024,Debit Card,"4,056.09",00.00,"15,923.90"
12-May-2024,IMPS,00.00,"5,307.97","10,615.93"
12-May-2024,Cheque,04.86,00.00,"10,620.79"
12-May-2024,Commission,00.00,"2,124.16","8,496.63"
12-May-2024,Bill,00.00,"4,248.32","4,248.31"
12-May-2024,Bill,00.00,606.90,"3,641.41"
12-May-2024,Commission,00.00,910.35,"2,731.06"
12-May-2024,Cash,03.30,00.00,"2,734.36"
12-May-2024,Interest,"6,969.00",00.00,"9,703.36"
12-May-2024,Cheque,"26,675.60",00.00,"36,378.96"
12-May-2024,Commission,00.00,"9,094.74","27,284.22"
12-May-2024,Cash,00.00,"9,094.74","18,189.48"
12-May-2024,Reversal,"438,974.00",00.00,"457,163.48"
12-May-2024,Bill,417.00,00.00,"457,580.48"
12-May-2024,Debit Card,"107,155.00",00.00,"564,735.48"
12-May-2024,Miscellaneous,00.00,"112,947.10","451,788.38"
12-May-2024,RTGS,"625,369.50",00.00,"1,077,157.88"
12-May-2024,Commission,462.30,00.00,"1,077,620.18"
12-May-2024,Commission,250.94,00.00,"1,077,871.12"
12-May-2024,Purchase,"1,369.10",00.00,"1,079,240.22"
12-May-2024,NEFT,03.00,00.00,"1,079,243.22"
12-May-2024,RTGS,55.50,00.00,"1,079,298.72"
12-May-2024,Miscellaneous,00.00,"119,922.08","959,376.64"
12-May-2024,Commission,00.00,"159,896.11","799,480.53"
12-May-2024,Debit Card,00.00,"159,896.11","639,584.42"
12-May-2024,Cash,00.00,"106,597.40","532,987.02"
12-May-2024,NEFT,364.05,00.00,"533,351.07"
12-May-2024,Cheque,00.00,"88,891.85","444,459.22"
12-May-2024,NEFT,224.10,00.00,"444,683.32"
12-May-2024,Interest,"1,004,146.25",00.00,"1,448,829.57"
12-May-2024,Reversal,409.00,00.00,"1,449,238.57"
12-May-2024,Purchase,915.00,00.00,"1,450,153.57"
12-May-2024,Commission,14.70,00.00,"1,450,168.27"
12-May-2024,IMPS,00.00,"1,450,168.27",00.00
12-May-2024,Cash,48.57,00.00,48.57
12-May-2024,ATM,00.00,48.57,00.00
12-May-2024,Cash,"17,975.00",00.00,"17,975.00"
12-May-2024,RTGS,00.00,"2,995.83","14,979.17"
12-May-2024,Miscellaneous,357.00,00.00,"15,336.17"
12-May-2024,Miscellaneous,"32,418.70",00.00,"47,754.87"
12-May-2024,Interest,00.00,"15,918.29","31,836.58"
12-May-2024,Debit Card,"4,004.00",00.00,"35,840.58"
12-May-2024,Miscellaneous,00.00,"5,120.08","30,720.50"
12-May-2024,NEFT,"34,033.09",00.00,"64,753.59"
12-May-2024,Interest,00.38,00.00,"64,753.97"
12-May-2024,Commission,"46,840.00",00.00,"111,593.97"
12-May-2024,IMPS,00.00,"37,197.99","74,395.98"
12-May-2024,Reversal,00.00,"24,798.66","49,597.32"
12-May-2024,RTGS,05.00,00.00,"49,602.32"
12-May-2024,Bill,08.00,00.00,"49,610.32"
12-May-2024,Tax,"1,588,443.00",00.00,"1,638,053.32"
12-May-2024,Miscellaneous,"10,105.00",00.00,"1,648,158.32"
12-May-2024,IMPS,00.00,"274,693.05","1,373,465.27"
12-May-2024,ATM,"25,896.60",00.00,"1,399,361.87"
12-May-2024,Tax,00.00,"466,453.96","932,907.91"
12-May-2024,Interest,"2,813.30",00.00,"935,721.21"
12-May-2024,Commission,"2,002.00",00.00,"937,723.21"
12-May-2024,Reversal,07.00,00.00,"937,730.21"
13-May-2024,Interest,"1,140,881.00",00.00,"2,078,611.21"
13-May-2024,Cheque,"115,954.59",00.00,"2,194,565.80"
13-May-2024,Tax,"1,854,274.00",00.00,"4,048,839.80"
13-May-2024,Cash,00.00,"4,048,839.80",00.00
13-May-2024,Purchase,"256,668.00",00.00,"256,668.00"
13-May-2024,Miscellaneous,00.00,"25,666.80","231,001.20"
13-May-2024,Commission,00.00,"57,750.30","173,250.90"
13-May-2024,ATM,"20,846.00",00.00,"194,096.90"
13-May-2024,RTGS,"217,432.88",00.00,"411,529.78"
13-May-2024,Commission,00.00,"58,789.97","352,739.81"
13-May-2024,Cash,"381,464.00",00.00,"734,203.81"
13-May-2024,NEFT,"188,878.00",00.00,"923,081.81"
13-May-2024,Transfer,00.00,"102,564.65","820,517.16"
13-May-2024,IMPS,00.00,"91,168.57","729,348.59"
13-May-2024,Interest,00.00,"72,934.86","656,413.73"
13-May-2024,ATM,00.00,"656,413.73",00.00
13-May-2024,Cash,05.30,00.00,05.30
13-May-2024,Bill,00.00,02.65,02.65
13-May-2024,RTGS,00.00,00.33,02.32
13-May-2024,Cheque,"131,158.20",00.00,"131,160.52"
13-May-2024,ATM,29.20,00.00,"131,189.72"
14-May-2024,Reversal,00.00,"65,594.86","65,594.86"
14-May-2024,ATM,00.00,"21,864.95","43,729.91"
14-May-2024,Interest,00.00,"21,864.96","21,864.96"
14-May-2024,Purchase,00.00,"5,466.24","16,398.72"
14-May-2024,Miscellaneous,00.00,"2,733.12","13,665.60"
14-May-2024,Transfer,03.00,00.00,"13,668.60"
14-May-2024,NEFT,"13,811.00",00.00,"27,479.60"
14-May-2024,Interest,00.00,"3,434.95","24,044.65"
14-May-2024,Commission,01.53,00.00,"24,046.18"
14-May-2024,Miscellaneous,00.00,"4,809.24","19,236.94"
14-May-2024,Interest,00.00,"1,923.69","17,313.25"
14-May-2024,Miscellaneous,23.00,00.00,"17,336.25"
14-May-2024,Reversal,00.00,"2,167.03","15,169.22"
14-May-2024,Cash,311.85,00.00,"15,481.07"
14-May-2024,Purchase,00.00,"3,096.21","12,384.86"
15-May-2024,NEFT,"258,102.50",00.00,"270,487.36"
15-May-2024,Interest,00.00,"67,621.84","202,865.52"
15-May-2024,Miscellaneous,39.39,00.00,"202,904.91"
15-May-2024,Tax,05.00,00.00,"202,909.91"
15-May-2024,Reversal,"2,330.00",00.00,"205,239.91"
16-May-2024,RTGS,00.00,"25,654.99","179,584.92"
17-May-2024,Cash,00.00,"22,448.12","157,136.81"
17-May-2024,Commission,63.16,00.00,"157,199.97"
17-May-2024,Commission,04.00,00.00,"157,203.97"
17-May-2024,IMPS,"673,605.75",00.00,"830,809.72"
17-May-2024,Bill,444.00,00.00,"831,253.72"
17-May-2024,Cheque,53.00,00.00,"831,306.72"
17-May-2024,Transfer,508.46,00.00,"831,815.18"
17-May-2024,Cheque,"3,954.00",00.00,"835,769.18"
17-May-2024,Reversal,00.00,"417,884.59","417,884.59"
17-May-2024,NEFT,00.00,"139,294.86","278,589.73"
17-May-2024,Purchase,"3,711.56",00.00,"282,301.29"
17-May-2024,Tax,"21,913.47",00.00,"304,214.76"
17-May-2024,Cash,"206,236.00",00.00,"510,450.76"
17-May-2024,Commission,01.76,00.00,"510,452.52"
17-May-2024,ATM,"242,193.40",00.00,"752,645.92"
17-May-2024,Cash,00.00,"83,627.32","669,018.60"
17-May-2024,Transfer,"895,900.50",00.00,"1,564,919.10"
17-May-2024,Cash,"16,733.30",00.00,"1,581,652.40"
17-May-2024,Transfer,"452,502.00",00.00,"2,034,154.40"
17-May-2024,Miscellaneous,00.00,"226,017.16","1,808,137.24"
17-May-2024,ATM,"2,135.90",00.00,"1,810,273.14"
17-May-2024,Commission,"27,250.00",00.00,"1,837,523.14"
17-May-2024,Bill,"237,064.00",00.00,"2,074,587.14"
17-May-2024,NEFT,"82,296.59",00.00,"2,156,883.73"
17-May-2024,Debit Card,"1,484.00",00.00,"2,158,367.73"
17-May-2024,Miscellaneous,"16,544.91",00.00,"2,174,912.64"
17-May-2024,Reversal,00.00,"362,485.44","1,812,427.20"
17-May-2024,Tax,"4,095.70",00.00,"1,816,522.90"
17-May-2024,Miscellaneous,751.00,00.00,"1,817,273.90"
17-May-2024,Purchase,00.00,"181,727.39","1,635,546.51"
17-May-2024,RTGS,00.00,"204,443.31","1,431,103.20"
17-May-2024,Reversal,00.00,"357,775.80","1,073,327.40"
17-May-2024,Cheque,01.00,00.00,"1,073,328.40"
17-May-2024,Interest,"22,644.00",00.00,"1,095,972.40"
17-May-2024,Debit Card,190.75,00.00,"1,096,163.15"
18-May-2024,Interest,00.00,"274,040.79","822,122.36"
18-May-2024,Transfer,"3,569.80",00.00,"825,692.16"
18-May-2024,RTGS,00.00,"825,692.16",00.00
18-May-2024,RTGS,"914,221.00",00.00,"914,221.00"
19-May-2024,Bill,"13,303.26",00.00,"927,524.26"
19-May-2024,Bill,07.87,00.00,"927,532.13"
19-May-2024,Cheque,"1,604.80",00.00,"929,136.93"
19-May-2024,Cheque,"80,127.00",00.00,"1,009,263.93"
19-May-2024,Transfer,"22,383.60",00.00,"1,031,647.53"
19-May-2024,Reversal,"231,481.50",00.00,"1,263,129.03"
19-May-2024,Purchase,00.00,"140,347.67","1,122,781.36"
19-May-2024,Cash,165.40,00.00,"1,122,946.76"
19-May-2024,Transfer,00.00,"112,294.68","1,010,652.08"
19-May-2024,Transfer,"165,502.56",00.00,"1,176,154.64"
19-May-2024,IMPS,00.00,"130,683.85","1,045,470.79"
19-May-2024,Cheque,"74,061.80",00.00,"1,119,532.59"
19-May-2024,Interest,"716,265.75",00.00,"1,835,798.34"
19-May-2024,IMPS,00.00,"917,899.17","917,899.17"
19-May-2024,Interest,00.00,"152,983.20","764,915.98"
19-May-2024,RTGS,00.00,"76,491.60","688,424.38"
19-May-2024,Transfer,00.00,"76,491.60","611,932.78"
19-May-2024,Tax,"1,874,506.00",00.00,"2,486,438.78"
20-May-2024,IMPS,00.00,"248,643.88","2,237,794.90"
20-May-2024,Transfer,"15,437.60",00.00,"2,253,232.50"
20-May-2024,Bill,00.00,"281,654.06","1,971,578.44"
20-May-2024,Purchase,00.00,"394,315.69","1,577,262.75"
20-May-2024,RTGS,"6,112.80",00.00,"1,583,375.55"
20-May-2024,Miscellaneous,00.00,"1,583,375.55",00.00
20-May-2024,Commission,"37,492.00",00.00,"37,492.00"
20-May-2024,ATM,00.00,"4,165.78","33,326.22"
20-May-2024,Reversal,00.00,"4,165.78","29,160.44"
20-May-2024,Interest,02.32,00.00,"29,162.76"
20-May-2024,ATM,"17,637.84",00.00,"46,800.60"
20-May-2024,Tax,"22,451.93",00.00,"69,252.53"
20-May-2024,ATM,"837,339.25",00.00,"906,591.78"
20-May-2024,RTGS,"3,012.00",00.00,"909,603.78"
20-May-2024,Interest,00.00,"454,801.89","454,801.89"
20-May-2024,Purchase,"1,962,614.00",00.00,"2,417,415.89"
20-May-2024,NEFT,00.00,"604,353.97","1,813,061.92"
20-May-2024,RTGS,00.00,"362,612.38","1,450,449.54"
20-May-2024,Bill,371.00,00.00,"1,450,820.54"
20-May-2024,NEFT,00.00,"145,082.05","1,305,738.49"
20-May-2024,Commission,00.00,"130,573.85","1,175,164.64"
20-May-2024,Reversal,00.00,"391,721.55","783,443.09"
20-May-2024,RTGS,00.00,"130,573.85","652,869.24"
20-May-2024,Reversal,00.00,"93,267.03","559,602.21"
20-May-2024,Reversal,00.00,"559,602.21",00.00
20-May-2024,Commission,"24,149.00",00.00,"24,149.00"
20-May-2024,Cheque,00.00,"4,829.80","19,319.20"
20-May-2024,ATM,00.00,"4,829.80","14,489.40"
20-May-2024,Cash,00.00,"1,811.18","12,678.22"
20-May-2024,NEFT,780.00,00.00,"13,458.22"
20-May-2024,Reversal,"167,924.75",00.00,"181,382.97"
20-May-2024,Tax,00.00,"18,138.30","163,244.67"
20-May-2024,RTGS,00.00,"27,207.45","136,037.22"
20-May-2024,Cash,28.94,00.00,"136,066.16"
20-May-2024,Debit Card,"71,089.00",00.00,"207,155.16"
21-May-2024,RTGS,00.00,"34,525.86","172,629.30"
21-May-2024,ATM,12.00,00.00,"172,641.30"
21-May-2024,Cheque,"9,864.61",00.00,"182,505.91"
21-May-2024,Transfer,"3,322.00",00.00,"185,827.91"
21-May-2024,RTGS,"228,975.10",00.00,"414,803.01"
21-May-2024,Miscellaneous,06.30,00.00,"414,809.31"
21-May-2024,NEFT,"254,006.25",00.00,"668,815.56"
21-May-2024,Purchase,00.00,"83,601.95","585,213.62"
21-May-2024,Cash,"1,913.00",00.00,"587,126.62"
21-May-2024,Miscellaneous,"2,853.20",00.00,"589,979.82"
21-May-2024,Commission,00.00,"84,282.83","505,696.99"
21-May-2024,Cash,43.00,00.00,"505,739.99"
21-May-2024,IMPS,00.00,"63,217.50","442,522.49"
21-May-2024,Purchase,"1,684,150.25",00.00,"2,126,672.74"
21-May-2024,Bill,00.00,"212,667.27","1,914,005.47"
21-May-2024,IMPS,"31,432.31",00.00,"1,945,437.78"
21-May-2024,RTGS,00.00,"194,543.78","1,750,894.00"
21-May-2024,NEFT,00.00,"1,750,894.00",00.00
21-May-2024,IMPS,"131,906.40",00.00,"131,906.40"
21-May-2024,Bill,00.00,"26,381.28","105,525.12"
21-May-2024,IMPS,"1,278.00",00.00,"106,803.12"
21-May-2024,Interest,13.40,00.00,"106,816.52"
21-May-2024,Miscellaneous,00.00,"26,704.13","80,112.39"
21-May-2024,Tax,"22,554.00",00.00,"102,666.39"
21-May-2024,RTGS,00.00,"17,111.07","85,555.32"
21-May-2024,Cash,00.00,"21,388.83","64,166.49"
21-May-2024,Reversal,00.00,"12,833.30","51,333.19"
21-May-2024,Purchase,00.00,"6,416.65","44,916.54"
21-May-2024,Miscellaneous,19.00,00.00,"44,935.54"
21-May-2024,Debit Card,46.40,00.00,"44,981.94"
21-May-2024,Miscellaneous,00.00,"14,993.98","29,987.96"
21-May-2024,Debit Card,00.00,"7,496.99","22,490.97"
22-May-2024,Purchase,120.00,00.00,"22,610.97"
22-May-2024,Bill,"21,837.60",00.00,"44,448.57"
22-May-2024,Bill,14.00,00.00,"44,462.57"
22-May-2024,NEFT,00.00,"22,231.29","22,231.28"
22-May-2024,Interest,00.00,"2,470.14","19,761.14"
22-May-2024,Interest,00.00,"2,195.68","17,565.46"
22-May-2024,Bill,82.50,00.00,"17,647.96"
22-May-2024,Purchase,06.00,00.00,"17,653.96"
22-May-2024,Miscellaneous,47.43,00.00,"17,701.39"
22-May-2024,Cash,"175,809.40",00.00,"193,510.79"
22-May-2024,NEFT,00.00,"19,351.08","174,159.71"
22-May-2024,NEFT,00.00,"19,351.08","154,808.63"
22-May-2024,Commission,00.00,"51,602.88","103,205.75"
22-May-2024,Interest,00.00,"17,200.96","86,004.79"
22-May-2024,ATM,05.64,00.00,"86,010.43"
23-May-2024,Commission,09.00,00.00,"86,019.43"
23-May-2024,Debit Card,33.00,00.00,"86,052.43"
23-May-2024,Interest,313.60,00.00,"86,366.03"
23-May-2024,Tax,00.00,"10,795.75","75,570.28"
23-May-2024,Debit Card,00.00,"15,114.06","60,456.22"
23-May-2024,Debit Card,00.00,"20,152.07","40,304.15"
23-May-2024,Bill,"14,662.82",00.00,"54,966.97"
23-May-2024,Debit Card,414.20,00.00,"55,381.17"
23-May-2024,ATM,340.60,00.00,"55,721.77"
23-May-2024,Miscellaneous,00.00,"11,144.35","44,577.42"
23-May-2024,Bill,00.00,"4,953.05","39,624.37"
23-May-2024,Reversal,"13,182.50",00.00,"52,806.87"
23-May-2024,Interest,00.00,"6,600.86","46,206.01"
23-May-2024,ATM,"2,697.00",00.00,"48,903.01"
23-May-2024,Cheque,01.90,00.00,"48,904.91"
23-May-2024,ATM,40.95,00.00,"48,945.86"
23-May-2024,IMPS,00.00,"5,438.43","43,507.43"
23-May-2024,RTGS,168.68,00.00,"43,676.11"
23-May-2024,IMPS,"12,788.00",00.00,"56,464.11"
23-May-2024,IMPS,"144,315.00",00.00,"200,779.11"
23-May-2024,NEFT,00.00,"22,308.79","178,470.32"
23-May-2024,Interest,"134,789.00",00.00,"313,259.32"
23-May-2024,Miscellaneous,"3,335.00",00.00,"316,594.32"
23-May-2024,Cash,00.00,"45,227.76","271,366.56"
23-May-2024,Reversal,00.00,"90,455.52","180,911.04"
23-May-2024,Miscellaneous,30.90,00.00,"180,941.94"
23-May-2024,RTGS,00.00,"180,941.94",00.00
23-May-2024,Purchase,"569,997.00",00.00,"569,997.00"
23-May-2024,Cheque,00.00,"284,998.50","284,998.50"
23-May-2024,Bill,"55,471.80",00.00,"340,470.30"
23-May-2024,Bill,"1,214.00",00.00,"341,684.30"
23-May-2024,Miscellaneous,00.00,"68,336.86","273,347.44"
23-May-2024,Reversal,"10,308.00",00.00,"283,655.44"
23-May-2024,Transfer,00.00,"31,517.27","252,138.17"
23-May-2024,Miscellaneous,"183,833.00",00.00,"435,971.17"
23-May-2024,RTGS,55.00,00.00,"436,026.17"
23-May-2024,Commission,01.10,00.00,"436,027.27"
23-May-2024,Miscellaneous,02.80,00.00,"436,030.07"
23-May-2024,IMPS,"20,105.50",00.00,"456,135.57"
23-May-2024,ATM,474.40,00.00,"456,609.97"
23-May-2024,Purchase,00.00,"228,304.99","228,304.98"
23-May-2024,IMPS,377.04,00.00,"228,682.02"
23-May-2024,Tax,00.00,"76,227.34","152,454.68"
23-May-2024,Debit Card,00.00,"16,939.41","135,515.27"
23-May-2024,IMPS,00.00,"19,359.32","116,155.95"
23-May-2024,NEFT,00.00,"12,906.22","103,249.73"
23-May-2024,Transfer,00.00,"12,906.22","90,343.51"
24-May-2024,Cheque,22.18,00.00,"90,365.69"
24-May-2024,Cash,00.00,"22,591.42","67,774.27"
24-May-2024,Transfer,00.00,"11,295.71","56,478.56"
24-May-2024,Debit Card,"216,725.25",00.00,"273,203.81"
24-May-2024,Reversal,00.00,"273,203.81",00.00
24-May-2024,Commission,50.00,00.00,50.00
24-May-2024,Debit Card,00.00,07.14,42.86
24-May-2024,Cash,00.00,10.72,32.14
24-May-2024,RTGS,01.00,00.00,33.14
24-May-2024,IMPS,01.98,00.00,35.12
24-May-2024,IMPS,02.30,00.00,37.42
24-May-2024,Commission,"21,268.90",00.00,"21,306.32"
24-May-2024,Cash,32.00,00.00,"21,338.32"
24-May-2024,Bill,"219,913.00",00.00,"241,251.32"
24-May-2024,Purchase,142.00,00.00,"241,393.32"
25-May-2024,Commission,00.00,"26,821.48","214,571.84"
25-May-2024,Bill,00.00,"23,841.32","190,730.52"
25-May-2024,ATM,"1,295.68",00.00,"192,026.20"
25-May-2024,Reversal,00.00,"96,013.10","96,013.10"
25-May-2024,Purchase,05.52,00.00,"96,018.62"
25-May-2024,Purchase,00.00,"19,203.72","76,814.90"
25-May-2024,IMPS,"13,180.20",00.00,"89,995.10"
25-May-2024,Bill,"554,412.00",00.00,"644,407.10"
25-May-2024,Tax,00.00,"92,058.16","552,348.94"
25-May-2024,Miscellaneous,00.00,"110,469.79","441,879.15"
25-May-2024,IMPS,186.20,00.00,"442,065.35"
25-May-2024,IMPS,919.00,00.00,"442,984.35"
25-May-2024,RTGS,15.30,00.00,"442,999.65"
25-May-2024,IMPS,"17,693.27",00.00,"460,692.92"
25-May-2024,Miscellaneous,00.00,"153,564.31","307,128.61"
25-May-2024,Commission,"998,914.00",00.00,"1,306,042.61"
25-May-2024,Tax,03.89,00.00,"1,306,046.50"
25-May-2024,NEFT,"269,212.00",00.00,"1,575,258.50"
25-May-2024,ATM,00.00,"225,036.93","1,350,221.57"
25-May-2024,Reversal,05.10,00.00,"1,350,226.67"
25-May-2024,Commission,35.60,00.00,"1,350,262.27"
25-May-2024,Debit Card,244.00,00.00,"1,350,506.27"
25-May-2024,Bill,00.00,"225,084.38","1,125,421.89"
25-May-2024,Interest,01.16,00.00,"1,125,423.05"
25-May-2024,Interest,11.30,00.00,"1,125,434.35"
25-May-2024,Purchase,"10,292.30",00.00,"1,135,726.65"
25-May-2024,Bill,00.00,"141,965.83","993,760.82"
25-May-2024,Interest,"308,148.00",00.00,"1,301,908.82"
25-May-2024,ATM,"40,218.00",00.00,"1,342,126.82"
25-May-2024,Tax,00.00,"335,531.71","1,006,595.12"
25-May-2024,Purchase,00.00,"143,799.30","862,795.82"
25-May-2024,Cash,"64,326.00",00.00,"927,121.82"
25-May-2024,Debit Card,00.00,"103,013.54","824,108.28"
25-May-2024,Miscellaneous,00.00,"117,729.75","706,378.53"
25-May-2024,Bill,00.00,"78,486.50","627,892.03"
25-May-2024,Cash,"3,034.10",00.00,"630,926.13"
25-May-2024,Cash,"3,250.00",00.00,"634,176.13"
25-May-2024,Bill,"12,805.80",00.00,"646,981.93"
25-May-2024,Purchase,"1,995,559.00",00.00,"2,642,540.93"
26-May-2024,Reversal,00.00,"330,317.62","2,312,223.31"
26-May-2024,NEFT,07.70,00.00,"2,312,231.01"
26-May-2024,Cheque,00.00,"2,312,231.01",00.00
26-May-2024,IMPS,465.00,00.00,465.00
26-May-2024,Commission,331.00,00.00,796.00
26-May-2024,Bill,00.00,159.20,636.80
26-May-2024,NEFT,105.00,00.00,741.80
26-May-2024,RTGS,"1,675.00",00.00,"2,416.80"
27-May-2024,Tax,"14,017.41",00.00,"16,434.21"
27-May-2024,Commission,00.00,"16,434.21",00.00
27-May-2024,RTGS,"1,542,260.00",00.00,"1,542,260.00"
27-May-2024,Cash,00.00,"257,043.33","1,285,216.67"
27-May-2024,Reversal,22.13,00.00,"1,285,238.80"
27-May-2024,Cheque,00.00,"257,047.76","1,028,191.04"
27-May-2024,Commission,"1,188,703.00",00.00,"2,216,894.04"
27-May-2024,Cash,278.10,00.00,"2,217,172.14"
27-May-2024,IMPS,"1,408.59",00.00,"2,218,580.73"
27-May-2024,Commission,07.00,00.00,"2,218,587.73"
27-May-2024,IMPS,"119,786.00",00.00,"2,338,373.73"
28-May-2024,Purchase,00.00,"584,593.43","1,753,780.30"
28-May-2024,Miscellaneous,00.00,"292,296.72","1,461,483.58"
28-May-2024,IMPS,"10,961.68",00.00,"1,472,445.26"
28-May-2024,Miscellaneous,00.00,"245,407.54","1,227,037.72"
28-May-2024,Interest,"8,274.00",00.00,"1,235,311.72"
28-May-2024,Reversal,00.00,"137,256.86","1,098,054.86"
28-May-2024,IMPS,12.17,00.00,"1,098,067.03"
28-May-2024,Interest,00.00,"137,258.38","960,808.65"
28-May-2024,Commission,17.04,00.00,"960,825.69"
28-May-2024,RTGS,"616,353.50",00.00,"1,577,179.19"
28-May-2024,NEFT,"3,116.78",00.00,"1,580,295.97"
28-May-2024,Purchase,178.00,00.00,"1,580,473.97"
28-May-2024,Debit Card,00.00,"263,412.33","1,317,061.64"
28-May-2024,RTGS,05.00,00.00,"1,317,066.64"
28-May-2024,Miscellaneous,"2,918.04",00.00,"1,319,984.68"
28-May-2024,NEFT,00.00,"188,569.24","1,131,415.44"
28-May-2024,IMPS,00.00,"188,569.24","942,846.20"
28-May-2024,Cash,"24,706.90",00.00,"967,553.10"
28-May-2024,Miscellaneous,00.00,"120,944.14","846,608.96"
28-May-2024,Bill,308.94,00.00,"846,917.90"
28-May-2024,Purchase,00.00,"105,864.74","741,053.16"
28-May-2024,RTGS,00.00,"148,210.63","592,842.53"
28-May-2024,NEFT,00.00,"148,210.63","444,631.90"
28-May-2024,Purchase,00.00,"44,463.19","400,168.71"
28-May-2024,Commission,00.00,"50,021.09","350,147.62"
28-May-2024,Tax,27.00,00.00,"350,174.62"
28-May-2024,Tax,00.00,"50,024.95","300,149.67"
28-May-2024,Bill,39.30,00.00,"300,188.97"
28-May-2024,Miscellaneous,00.00,"30,018.90","270,170.07"
28-May-2024,Bill,"808,328.50",00.00,"1,078,498.57"
28-May-2024,NEFT,55.70,00.00,"1,078,554.27"
28-May-2024,Bill,"131,778.00",00.00,"1,210,332.27"
28-May-2024,Reversal,00.00,"302,583.07","907,749.20"
28-May-2024,Tax,00.00,"907,749.20",00.00
28-May-2024,Transfer,07.50,00.00,07.50
28-May-2024,Cheque,00.00,00.83,06.67
28-May-2024,Reversal,"126,418.00",00.00,"126,424.67"
28-May-2024,Interest,07.14,00.00,"126,431.81"
28-May-2024,ATM,00.00,"21,071.97","105,359.84"
28-May-2024,Interest,00.00,"13,169.98","92,189.86"
28-May-2024,Purchase,00.00,"18,437.97","73,751.89"
28-May-2024,Commission,04.75,00.00,"73,756.64"
28-May-2024,Reversal,"718,633.25",00.00,"792,389.89"
28-May-2024,Miscellaneous,00.00,"792,389.89",00.00
28-May-2024,Miscellaneous,07.00,00.00,07.00
28-May-2024,Debit Card,"139,990.60",00.00,"139,997.60"
28-May-2024,Cash,"1,412,780.00",00.00,"1,552,777.60"
28-May-2024,IMPS,00.00,"194,097.20","1,358,680.40"
28-May-2024,Debit Card,"35,541.20",00.00,"1,394,221.60"
28-May-2024,Miscellaneous,02.40,00.00,"1,394,224.00"
28-May-2024,ATM,00.00,"154,913.78","1,239,310.22"
28-May-2024,ATM,"1,975.00",00.00,"1,241,285.22"
28-May-2024,Miscellaneous,"117,404.80",00.00,"1,358,690.02"
28-May-2024,Cheque,"43,425.00",00.00,"1,402,115.02"
29-May-2024,Tax,08.00,00.00,"1,402,123.02"
29-May-2024,Debit Card,00.00,"280,424.60","1,121,698.42"
29-May-2024,Debit Card,62.00,00.00,"1,121,760.42"
29-May-2024,Debit Card,"1,329,061.50",00.00,"2,450,821.92"
29-May-2024,Cash,"3,474.50",00.00,"2,454,296.42"
29-May-2024,IMPS,386.90,00.00,"2,454,683.32"
29-May-2024,Cheque,"32,721.54",00.00,"2,487,404.86"
29-May-2024,IMPS,57.00,00.00,"2,487,461.86"
29-May-2024,Miscellaneous,"454,392.25",00.00,"2,941,854.11"
29-May-2024,ATM,00.00,"2,941,854.11",00.00
29-May-2024,NEFT,"2,465.10",00.00,"2,465.10"
29-May-2024,Tax,00.00,616.28,"1,848.82"
29-May-2024,Transfer,"190,579.40",00.00,"192,428.22"
29-May-2024,Reversal,00.00,"19,242.82","173,185.40"
29-May-2024,Interest,"127,145.00",00.00,"300,330.40"
29-May-2024,Interest,00.00,"300,330.40",00.00
29-May-2024,Cash,326.90,00.00,326.90
29-May-2024,Tax,"1,680.00",00.00,"2,006.90"
29-May-2024,Bill,505.00,00.00,"2,511.90"
29-May-2024,Cheque,00.00,627.98,"1,883.93"
29-May-2024,Reversal,"75,672.00",00.00,"77,555.93"
29-May-2024,Bill,"824,059.00",00.00,"901,614.93"
29-May-2024,Purchase,00.00,"100,179.44","801,435.49"
29-May-2024,Bill,00.00,"200,358.87","601,076.62"
29-May-2024,RTGS,04.74,00.00,"601,081.36"
29-May-2024,Transfer,00.00,"150,270.34","450,811.02"
29-May-2024,Cash,00.00,"112,702.76","338,108.26"
29-May-2024,Debit Card,89.70,00.00,"338,197.96"
29-May-2024,Cheque,34.90,00.00,"338,232.86"
29-May-2024,Commission,00.00,"56,372.14","281,860.72"
29-May-2024,Cash,46.00,00.00,"281,906.72"
29-May-2024,ATM,"118,508.00",00.00,"400,414.72"
29-May-2024,Reversal,366.90,00.00,"400,781.62"
29-May-2024,Cheque,"2,015.50",00.00,"402,797.12"
29-May-2024,Cheque,00.00,"402,797.12",00.00
29-May-2024,Miscellaneous,"1,490,686.00",00.00,"1,490,686.00"
29-May-2024,Miscellaneous,00.00,"186,335.75","1,304,350.25"
29-May-2024,Tax,"11,587.60",00.00,"1,315,937.85"
30-May-2024,RTGS,"2,004,091.00",00.00,"3,320,028.85"
30-May-2024,ATM,05.00,00.00,"3,320,033.85"
30-May-2024,Bill,458.80,00.00,"3,320,492.65"
30-May-2024,Interest,00.00,"368,943.63","2,951,549.02"
30-May-2024,Purchase,00.00,"327,949.89","2,623,599.13"
30-May-2024,Interest,00.00,"1,311,799.57","1,311,799.56"
30-May-2024,Transfer,00.00,"262,359.91","1,049,439.65"
30-May-2024,Miscellaneous,"2,944.80",00.00,"1,052,384.45"
30-May-2024,Cheque,"24,171.00",00.00,"1,076,555.45"
30-May-2024,Tax,00.00,"538,277.73","538,277.72"
30-May-2024,Interest,"70,383.00",00.00,"608,660.72"
30-May-2024,NEFT,00.00,"101,443.45","507,217.27"
30-May-2024,Tax,"3,109.41",00.00,"510,326.68"
30-May-2024,Cheque,00.00,"102,065.34","408,261.34"
30-May-2024,Debit Card,00.00,"102,065.34","306,196.00"
30-May-2024,IMPS,00.00,"30,619.60","275,576.40"
30-May-2024,Reversal,41.80,00.00,"275,618.20"
30-May-2024,Bill,00.00,"39,374.03","236,244.17"
30-May-2024,Reversal,00.00,"78,748.06","157,496.11"
30-May-2024,Debit Card,95.40,00.00,"157,591.51"
30-May-2024,Reversal,00.00,"17,510.17","140,081.34"
30-May-2024,Commission,"22,370.99",00.00,"162,452.33"
30-May-2024,Cash,256.50,00.00,"162,708.83"
30-May-2024,Cheque,00.00,"23,244.12","139,464.71"
30-May-2024,Interest,305.90,00.00,"139,770.61"
30-May-2024,Purchase,550.91,00.00,"140,321.52"
30-May-2024,Bill,"813,762.00",00.00,"954,083.52"
30-May-2024,Transfer,"871,380.00",00.00,"1,825,463.52"
30-May-2024,Purchase,00.00,"228,182.94","1,597,280.58"
30-May-2024,Reversal,00.00,"319,456.12","1,277,824.46"
31-May-2024,Cheque,"40,964.70",00.00,"1,318,789.16"
31-May-2024,RTGS,39.71,00.00,"1,318,828.87"
31-May-2024,Commission,00.00,"219,804.81","1,099,024.06"
31-May-2024,Debit Card,156.16,00.00,"1,099,180.22"
31-May-2024,Miscellaneous,00.00,"157,025.75","942,154.47"
31-May-2024,Transfer,00.00,"471,077.24","471,077.24"
31-May-2024,Cash,00.00,"47,107.72","423,969.52"
31-May-2024,Bill,178.00,00.00,"424,147.52"
31-May-2024,Commission,00.00,"47,127.50","377,020.02"
31-May-2024,Cheque,00.00,"41,891.11","335,128.91"
31-May-2024,Purchase,"69,019.10",00.00,"404,148.01"
31-May-2024,ATM,56.80,00.00,"404,204.81"
31-May-2024,Transfer,692.03,00.00,"404,896.84"
31-May-2024,NEFT,00.00,"40,489.68","364,407.16"
31-May-2024,Bill,"995,819.75",00.00,"1,360,226.91"
31-May-2024,Bill,00.00,"272,045.38","1,088,181.53"
31-May-2024,Cash,00.00,"362,727.18","725,454.35"
31-May-2024,Reversal,314.40,00.00,"725,768.75"
31-May-2024,Purchase,00.00,"241,922.92","483,845.83"
31-May-2024,Transfer,00.00,"120,961.46","362,884.37"
31-May-2024,IMPS,00.00,"90,721.09","272,163.28"
31-May-2024,NEFT,00.00,"38,880.47","233,282.81"
31-May-2024,IMPS,36.89,00.00,"233,319.70"
31-May-2024,Bill,00.00,00.00,"233,319.70"
31-May-2024,Reversal,00.00,"38,886.62","194,433.08"
31-May-2024,Commission,"133,068.12",00.00,"327,501.20"
31-May-2024,Bill,"10,771.57",00.00,"338,272.77"
31-May-2024,Miscellaneous,00.00,"48,324.68","289,948.09"
31-May-2024,Purchase,"23,101.40",00.00,"313,049.49"
31-May-2024,Commission,03.19,00.00,"313,052.68"
31-May-2024,Cheque,00.00,"44,721.81","268,330.87"
31-May-2024,Bill,30.80,00.00,"268,361.67"
31-May-2024,Bill,00.00,"33,545.21","234,816.46"
31-May-2024,Cash,00.00,"58,704.12","176,112.34"
31-May-2024,Transfer,"2,470.00",00.00,"178,582.34"
31-May-2024,Tax,"23,259.60",00.00,"201,841.94"
31-May-2024,Tax,00.00,"67,280.65","134,561.29"
31-May-2024,Commission,"23,353.00",00.00,"157,914.29"
31-May-2024,Tax,00.00,"31,582.86","126,331.43"
31-May-2024,Transfer,"148,600.44",00.00,"274,931.87"
31-May-2024,Debit Card,05.13,00.00,"274,937.00"
31-May-2024,Debit Card,216.70,00.00,"275,153.70"
31-May-2024,Transfer,00.00,"68,788.43","206,365.28"
31-May-2024,Debit Card,"6,920.00",00.00,"213,285.28"
31-May-2024,Reversal,00.00,"213,285.28",00.00
31-May-2024,RTGS,01.72,00.00,01.72
31-May-2024,Cheque,00.00,00.19,01.53
31-May-2024,IMPS,02.10,00.00,03.63
31-May-2024,IMPS,00.00,00.40,03.23
31-May-2024,Reversal,00.00,03.23,00.00
31-May-2024,IMPS,16.40,00.00,16.40
31-May-2024,RTGS,"346,132.50",00.00,"346,148.90"
31-May-2024,Bill,"1,255,692.25",00.00,"1,601,841.15"
31-May-2024,Cash,00.00,"177,982.35","1,423,858.80"
31-May-2024,Purchase,00.00,"711,929.40","711,929.40"
31-May-2024,NEFT,00.00,"79,103.27","632,826.13"
31-May-2024,NEFT,163.00,00.00,"632,989.13"
31-May-2024,Commission,00.00,"70,332.13","562,657.00"
31-May-2024,Reversal,"8,799.60",00.00,"571,456.60"
31-May-2024,Cheque,"2,057,834.00",00.00,"2,629,290.60"
31-May-2024,Purchase,00.00,"525,858.12","2,103,432.48"
31-May-2024,Debit Card,00.00,"262,929.06","1,840,503.42"
01-Jun-2024,Bill,361.50,00.00,"1,840,864.92"
01-Jun-2024,Transfer,"1,414,406.00",00.00,"3,255,270.92"
01-Jun-2024,ATM,"1,726.00",00.00,"3,256,996.92"
01-Jun-2024,ATM,00.00,"1,628,498.46","1,628,498.46"
01-Jun-2024,Tax,406.00,00.00,"1,628,904.46"
01-Jun-2024,Tax,"152,168.10",00.00,"1,781,072.56"
01-Jun-2024,Bill,27.70,00.00,"1,781,100.26"
01-Jun-2024,Reversal,"9,235.90",00.00,"1,790,336.16"
01-Jun-2024,Cheque,128.41,00.00,"1,790,464.57"
02-Jun-2024,Interest,38.00,00.00,"1,790,502.57"
02-Jun-2024,Commission,00.00,"255,786.08","1,534,716.49"
02-Jun-2024,Interest,01.04,00.00,"1,534,717.53"
02-Jun-2024,ATM,00.00,"170,524.17","1,364,193.36"
02-Jun-2024,ATM,00.00,"341,048.34","1,023,145.02"
02-Jun-2024,Cheque,"25,604.97",00.00,"1,048,749.99"
02-Jun-2024,Tax,00.00,"349,583.33","699,166.66"
02-Jun-2024,Commission,"1,538,076.00",00.00,"2,237,242.66"
02-Jun-2024,Transfer,35.30,00.00,"2,237,277.96"
02-Jun-2024,Commission,"187,492.20",00.00,"2,424,770.16"
02-Jun-2024,ATM,00.00,"2,424,770.16",00.00
02-Jun-2024,Cheque,414.00,00.00,414.00
02-Jun-2024,Interest,00.00,51.75,362.25
02-Jun-2024,Cash,00.00,40.25,322.00
02-Jun-2024,Cheque,220.50,00.00,542.50
02-Jun-2024,NEFT,00.00,135.63,406.88
02-Jun-2024,Tax,"3,164.00",00.00,"3,570.88"
02-Jun-2024,IMPS,"178,136.91",00.00,"181,707.79"
02-Jun-2024,Interest,00.00,"45,426.95","136,280.84"
02-Jun-2024,ATM,"121,122.59",00.00,"257,403.43"
02-Jun-2024,Interest,00.00,"28,600.38","228,803.05"
02-Jun-2024,ATM,141.00,00.00,"228,944.05"
02-Jun-2024,Commission,00.00,"228,944.05",00.00
02-Jun-2024,Commission,"2,289.00",00.00,"2,289.00"
02-Jun-2024,Interest,00.00,286.13,"2,002.88"
02-Jun-2024,Tax,"3,226.46",00.00,"5,229.34"
02-Jun-2024,Tax,"1,960,007.00",00.00,"1,965,236.34"
02-Jun-2024,Tax,00.00,"218,359.59","1,746,876.75"
02-Jun-2024,Miscellaneous,"2,732.00",00.00,"1,749,608.75"
02-Jun-2024,Purchase,00.00,"174,960.88","1,574,647.88"
02-Jun-2024,Reversal,00.00,"224,949.70","1,349,698.18"
02-Jun-2024,NEFT,25.73,00.00,"1,349,723.91"
02-Jun-2024,RTGS,751.23,00.00,"1,350,475.14"
02-Jun-2024,RTGS,"18,070.30",00.00,"1,368,545.44"
02-Jun-2024,Tax,00.00,"152,060.60","1,216,484.84"
02-Jun-2024,Reversal,00.00,"243,296.97","973,187.87"
02-Jun-2024,Debit Card,00.00,"162,197.98","810,989.89"
02-Jun-2024,RTGS,"4,068.92",00.00,"815,058.81"
02-Jun-2024,RTGS,"1,403,848.00",00.00,"2,218,906.81"
02-Jun-2024,Tax,00.00,"277,363.35","1,941,543.46"
02-Jun-2024,RTGS,00.00,"1,941,543.46",00.00
02-Jun-2024,RTGS,"192,023.00",00.00,"192,023.00"
02-Jun-2024,Purchase,141.00,00.00,"192,164.00"
02-Jun-2024,RTGS,00.00,"27,452.00","164,712.00"
02-Jun-2024,Bill,"53,444.50",00.00,"218,156.50"
02-Jun-2024,Purchase,00.00,"24,239.61","193,916.89"
02-Jun-2024,Debit Card,90.00,00.00,"194,006.89"
02-Jun-2024,ATM,07.00,00.00,"194,013.89"
02-Jun-2024,RTGS,00.00,"27,716.27","166,297.62"
02-Jun-2024,Commission,00.00,"41,574.41","124,723.22"
02-Jun-2024,Cash,00.00,"13,858.14","110,865.08"
02-Jun-2024,IMPS,00.00,"27,716.27","83,148.81"
02-Jun-2024,Tax,00.47,00.00,"83,149.28"
02-Jun-2024,RTGS,00.00,00.00,"83,149.28"
02-Jun-2024,Purchase,02.40,00.00,"83,151.68"
02-Jun-2024,Cash,00.00,"8,315.17","74,836.51"
02-Jun-2024,Bill,03.40,00.00,"74,839.91"
02-Jun-2024,Interest,"2,635.00",00.00,"77,474.91"
02-Jun-2024,Purchase,00.00,"19,368.73","58,106.18"
02-Jun-2024,Bill,00.00,"8,300.88","49,805.30"
02-Jun-2024,Cheque,"23,567.80",00.00,"73,373.10"
02-Jun-2024,Debit Card,00.00,"12,228.85","61,144.25"
02-Jun-2024,Tax,"961,194.00",00.00,"1,022,338.25"
02-Jun-2024,Debit Card,"158,488.72",00.00,"1,180,826.97"
02-Jun-2024,Transfer,00.00,"1,180,826.97",00.00
02-Jun-2024,Reversal,"38,437.00",00.00,"38,437.00"
02-Jun-2024,Tax,"3,490.42",00.00,"41,927.42"
02-Jun-2024,Tax,00.00,"4,658.60","37,268.82"
03-Jun-2024,Interest,00.00,"9,317.21","27,951.62"
03-Jun-2024,Interest,00.00,"5,590.32","22,361.30"
03-Jun-2024,Interest,00.00,"5,590.33","16,770.97"
03-Jun-2024,NEFT,00.00,"2,096.37","14,674.60"
03-Jun-2024,Cash,04.91,00.00,"14,679.51"
03-Jun-2024,Cheque,00.00,"2,097.07","12,582.44"
03-Jun-2024,Bill,00.00,"2,097.07","10,485.37"
03-Jun-2024,ATM,00.00,"1,747.56","8,737.81"
03-Jun-2024,Interest,00.00,"1,456.30","7,281.51"
03-Jun-2024,Interest,01.81,00.00,"7,283.32"
03-Jun-2024,IMPS,"1,692,950.00",00.00,"1,700,233.32"
03-Jun-2024,Debit Card,"21,273.30",00.00,"1,721,506.62"
03-Jun-2024,RTGS,"8,365.87",00.00,"1,729,872.49"
03-Jun-2024,Cash,00.00,"1,729,872.49",00.00
03-Jun-2024,RTGS,"241,089.00",00.00,"241,089.00"
03-Jun-2024,Cheque,03.90,00.00,"241,092.90"
03-Jun-2024,Bill,00.00,"80,364.30","160,728.60"
03-Jun-2024,Miscellaneous,"14,022.91",00.00,"174,751.51"
03-Jun-2024,Cheque,42.30,00.00,"174,793.81"
04-Jun-2024,ATM,00.00,"21,849.23","152,944.58"
04-Jun-2024,NEFT,31.00,00.00,"152,975.58"
04-Jun-2024,Debit Card,"1,548,317.25",00.00,"1,701,292.83"
04-Jun-2024,Bill,"7,824.00",00.00,"1,709,116.83"
04-Jun-2024,IMPS,"1,744,138.75",00.00,"3,453,255.58"
05-Jun-2024,Miscellaneous,"127,753.00",00.00,"3,581,008.58"
05-Jun-2024,Debit Card,07.73,00.00,"3,581,016.31"
05-Jun-2024,Miscellaneous,"2,316.75",00.00,"3,583,333.06"
05-Jun-2024,IMPS,339.87,00.00,"3,583,672.93"
05-Jun-2024,Debit Card,00.00,"3,583,672.93",00.00
05-Jun-2024,Reversal,86.30,00.00,86.30
05-Jun-2024,Bill,00.00,08.63,77.67
06-Jun-2024,Purchase,00.00,08.63,69.04
06-Jun-2024,Tax,00.00,09.86,59.18
06-Jun-2024,Bill,00.00,05.92,53.26
06-Jun-2024,ATM,07.40,00.00,60.66
06-Jun-2024,Cash,"14,389.60",00.00,"14,450.26"
06-Jun-2024,Purchase,57.00,00.00,"14,507.26"
06-Jun-2024,RTGS,"28,797.16",00.00,"43,304.42"
06-Jun-2024,NEFT,00.00,"6,186.35","37,118.07"
06-Jun-2024,Debit Card,746.00,00.00,"37,864.07"
06-Jun-2024,Transfer,00.00,"12,621.36","25,242.71"
06-Jun-2024,Commission,00.00,"2,804.75","22,437.96"
06-Jun-2024,IMPS,"161,774.00",00.00,"184,211.96"
06-Jun-2024,Commission,00.00,"61,403.99","122,807.97"
06-Jun-2024,IMPS,"8,963.24",00.00,"131,771.21"
06-Jun-2024,Miscellaneous,05.00,00.00,"131,776.21"
06-Jun-2024,Commission,"3,462.80",00.00,"135,239.01"
06-Jun-2024,Debit Card,00.00,"22,539.84","112,699.18"
06-Jun-2024,IMPS,00.00,"37,566.39","75,132.79"
06-Jun-2024,Cash,00.00,"25,044.26","50,088.53"
06-Jun-2024,Debit Card,"6,275.60",00.00,"56,364.13"
06-Jun-2024,Miscellaneous,00.00,"9,394.02","46,970.11"
06-Jun-2024,Purchase,"175,181.00",00.00,"222,151.11"
06-Jun-2024,Bill,00.00,"24,683.46","197,467.65"
06-Jun-2024,Purchase,"1,103.00",00.00,"198,570.65"
06-Jun-2024,Bill,00.00,"99,285.33","99,285.32"
06-Jun-2024,NEFT,00.00,"12,410.67","86,874.66"
06-Jun-2024,IMPS,00.00,"8,687.47","78,187.19"
06-Jun-2024,RTGS,00.00,"11,169.60","67,017.59"
06-Jun-2024,Tax,00.00,"6,701.76","60,315.83"
06-Jun-2024,RTGS,00.00,"6,701.76","53,614.07"
06-Jun-2024,Debit Card,24.00,00.00,"53,638.07"
06-Jun-2024,Cheque,00.00,00.00,"53,638.07"
06-Jun-2024,Transfer,"7,814.00",00.00,"61,452.07"
06-Jun-2024,Commission,00.00,"61,452.07",00.00
06-Jun-2024,Reversal,"66,164.00",00.00,"66,164.00"
06-Jun-2024,Bill,116.39,00.00,"66,280.39"
07-Jun-2024,Reversal,00.00,"11,046.73","55,233.66"
07-Jun-2024,Tax,"174,114.00",00.00,"229,347.66"
07-Jun-2024,NEFT,62.00,00.00,"229,409.66"
07-Jun-2024,ATM,170.00,00.00,"229,579.66"
07-Jun-2024,Miscellaneous,00.00,"57,394.92","172,184.74"
07-Jun-2024,Cheque,00.00,"21,523.09","150,661.65"
07-Jun-2024,Cash,"1,783.00",00.00,"152,444.65"
07-Jun-2024,Cheque,00.00,"19,055.58","133,389.07"
07-Jun-2024,Miscellaneous,"15,234.00",00.00,"148,623.07"
07-Jun-2024,Miscellaneous,"15,609.00",00.00,"164,232.07"
07-Jun-2024,Debit Card,00.00,"23,461.72","140,770.35"
07-Jun-2024,Debit Card,06.00,00.00,"140,776.35"
07-Jun-2024,NEFT,00.00,"28,155.27","112,621.08"
07-Jun-2024,Purchase,00.00,"14,077.64","98,543.44"
07-Jun-2024,Bill,665.50,00.00,"99,208.94"
07-Jun-2024,Purchase,00.00,"24,802.24","74,406.70"
07-Jun-2024,IMPS,"37,857.00",00.00,"112,263.70"
07-Jun-2024,ATM,"1,513,917.50",00.00,"1,626,181.20"
07-Jun-2024,Transfer,"169,321.66",00.00,"1,795,502.86"
07-Jun-2024,Debit Card,00.00,"598,500.95","1,197,001.91"
07-Jun-2024,Debit Card,"865,595.00",00.00,"2,062,596.91"
07-Jun-2024,Commission,00.00,"1,031,298.46","1,031,298.46"
07-Jun-2024,Purchase,00.00,"257,824.62","773,473.84"
07-Jun-2024,Transfer,00.00,"128,912.31","644,561.53"
07-Jun-2024,Commission,"622,605.80",00.00,"1,267,167.33"
07-Jun-2024,Miscellaneous,"34,426.44",00.00,"1,301,593.77"
07-Jun-2024,RTGS,00.00,"260,318.75","1,041,275.02"
07-Jun-2024,Reversal,312.02,00.00,"1,041,587.04"
08-Jun-2024,Transfer,00.00,"130,198.38","911,388.66"
08-Jun-2024,Commission,00.00,"227,847.17","683,541.50"
08-Jun-2024,NEFT,03.00,00.00,"683,544.50"
08-Jun-2024,Tax,07.84,00.00,"683,552.34"
08-Jun-2024,Cash,00.00,"75,950.26","607,602.08"
08-Jun-2024,Purchase,00.00,"86,800.30","520,801.78"
08-Jun-2024,IMPS,00.00,"52,080.18","468,721.60"
08-Jun-2024,Debit Card,139.50,00.00,"468,861.10"
08-Jun-2024,Cash,00.00,"52,095.68","416,765.42"
08-Jun-2024,Interest,00.00,"46,307.27","370,458.15"
08-Jun-2024,IMPS,00.00,"46,307.27","324,150.88"
08-Jun-2024,Cheque,00.00,"54,025.15","270,125.73"
08-Jun-2024,IMPS,277.00,00.00,"270,402.73"
08-Jun-2024,Reversal,39.28,00.00,"270,442.01"
08-Jun-2024,Interest,00.00,"270,442.01",00.00
08-Jun-2024,Debit Card,48.00,00.00,48.00
08-Jun-2024,NEFT,00.00,06.00,42.00
08-Jun-2024,Transfer,"1,162,362.50",00.00,"1,162,404.50"
08-Jun-2024,Cash,00.00,"116,240.45","1,046,164.05"
08-Jun-2024,Miscellaneous,"12,618.31",00.00,"1,058,782.36"
08-Jun-2024,ATM,"700,959.75",00.00,"1,759,742.11"
08-Jun-2024,Transfer,00.00,"439,935.53","1,319,806.58"
08-Jun-2024,Miscellaneous,"3,926.00",00.00,"1,323,732.58"
08-Jun-2024,Debit Card,53.57,00.00,"1,323,786.15"
08-Jun-2024,Interest,20.00,00.00,"1,323,806.15"
08-Jun-2024,NEFT,"2,403.00",00.00,"1,326,209.15"
08-Jun-2024,Cash,48.00,00.00,"1,326,257.15"
08-Jun-2024,NEFT,00.00,"132,625.72","1,193,631.43"
08-Jun-2024,Bill,"1,519.00",00.00,"1,195,150.43"
08-Jun-2024,Debit Card,392.82,00.00,"1,195,543.25"
08-Jun-2024,Purchase,"77,297.00",00.00,"1,272,840.25"
08-Jun-2024,Interest,00.00,"212,140.04","1,060,700.21"
08-Jun-2024,ATM,"5,043.10",00.00,"1,065,743.31"
08-Jun-2024,RTGS,00.00,"355,247.77","710,495.54"
08-Jun-2024,Purchase,"29,082.00",00.00,"739,577.54"
08-Jun-2024,ATM,00.00,"73,957.75","665,619.79"
09-Jun-2024,Interest,00.00,"332,809.90","332,809.90"
09-Jun-2024,Reversal,"23,039.00",00.00,"355,848.90"
10-Jun-2024,IMPS,00.00,"44,481.11","311,367.79"
10-Jun-2024,Reversal,00.00,"103,789.26","207,578.53"
10-Jun-2024,NEFT,00.00,"51,894.63","155,683.90"
10-Jun-2024,Interest,00.00,"51,894.63","103,789.27"
10-Jun-2024,NEFT,"15,596.82",00.00,"119,386.09"
10-Jun-2024,NEFT,00.00,"39,795.36","79,590.73"
10-Jun-2024,Interest,"26,218.78",00.00,"105,809.51"
10-Jun-2024,Transfer,28.00,00.00,"105,837.51"
10-Jun-2024,RTGS,"910,423.00",00.00,"1,016,260.51"
10-Jun-2024,Bill,00.00,"203,252.10","813,008.41"
10-Jun-2024,Commission,00.00,"271,002.80","542,005.61"
10-Jun-2024,RTGS,"98,010.30",00.00,"640,015.91"
10-Jun-2024,IMPS,"15,696.00",00.00,"655,711.91"
10-Jun-2024,ATM,00.00,"65,571.19","590,140.72"
10-Jun-2024,ATM,53.90,00.00,"590,194.62"
10-Jun-2024,Bill,00.00,"118,038.92","472,155.70"
10-Jun-2024,ATM,00.00,"78,692.62","393,463.08"
10-Jun-2024,NEFT,00.00,"43,718.12","349,744.96"
10-Jun-2024,Cheque,"20,917.67",00.00,"370,662.63"
10-Jun-2024,Cash,"2,941.00",00.00,"373,603.63"
10-Jun-2024,Tax,27.75,00.00,"373,631.38"
10-Jun-2024,Transfer,00.00,"53,375.91","320,255.47"
10-Jun-2024,Commission,486.14,00.00,"320,741.61"
10-Jun-2024,Miscellaneous,00.00,"64,148.32","256,593.29"
10-Jun-2024,Debit Card,00.00,"42,765.55","213,827.74"
10-Jun-2024,RTGS,"1,355,789.00",00.00,"1,569,616.74"
10-Jun-2024,IMPS,07.00,00.00,"1,569,623.74"
10-Jun-2024,RTGS,"171,360.00",00.00,"1,740,983.74"
10-Jun-2024,RTGS,00.00,"870,491.87","870,491.87"
10-Jun-2024,Reversal,00.00,"96,721.32","773,770.55"
10-Jun-2024,Bill,300.88,00.00,"774,071.43"
10-Jun-2024,RTGS,29.96,00.00,"774,101.39"
10-Jun-2024,Debit Card,15.08,00.00,"774,116.47"
10-Jun-2024,Debit Card,00.00,"774,116.47",00.00
10-Jun-2024,NEFT,"179,855.00",00.00,"179,855.00"
10-Jun-2024,Interest,00.00,"22,481.88","157,373.12"
10-Jun-2024,Debit Card,"14,199.19",00.00,"171,572.31"
10-Jun-2024,IMPS,00.00,"28,595.39","142,976.92"
10-Jun-2024,Reversal,00.00,"28,595.38","114,381.54"
10-Jun-2024,Cheque,00.00,"16,340.22","98,041.32"
10-Jun-2024,Debit Card,42.10,00.00,"98,083.42"
10-Jun-2024,NEFT,00.00,"16,347.24","81,736.18"
10-Jun-2024,Interest,00.00,"10,217.02","71,519.16"
10-Jun-2024,Interest,00.00,"7,151.92","64,367.24"
10-Jun-2024,IMPS,00.00,"16,091.81","48,275.43"
10-Jun-2024,Cheque,56.00,00.00,"48,331.43"
10-Jun-2024,Debit Card,00.00,"9,666.29","38,665.14"
10-Jun-2024,Commission,"161,272.70",00.00,"199,937.84"
10-Jun-2024,Bill,00.00,"199,937.84",00.00
10-Jun-2024,IMPS,41.32,00.00,41.32
10-Jun-2024,Reversal,00.00,20.66,20.66
10-Jun-2024,Cheque,00.00,05.17,15.50
10-Jun-2024,ATM,434.90,00.00,450.40
10-Jun-2024,Transfer,"1,198.00",00.00,"1,648.40"
10-Jun-2024,Cheque,"1,642,325.80",00.00,"1,643,974.20"
11-Jun-2024,Miscellaneous,00.00,"164,397.42","1,479,576.78"
12-Jun-2024,Cheque,"3,807.37",00.00,"1,483,384.15"
12-Jun-2024,Commission,00.00,"247,230.69","1,236,153.46"
12-Jun-2024,Debit Card,00.00,"618,076.73","618,076.73"
12-Jun-2024,Bill,00.00,"309,038.37","309,038.36"
13-Jun-2024,Interest,"108,030.25",00.00,"417,068.61"
13-Jun-2024,Purchase,00.00,"83,413.72","333,654.89"
13-Jun-2024,Commission,00.00,"66,730.98","266,923.91"
13-Jun-2024,Transfer,00.00,"33,365.49","233,558.42"
13-Jun-2024,IMPS,"110,561.25",00.00,"344,119.67"
13-Jun-2024,Tax,"11,684.42",00.00,"355,804.09"
13-Jun-2024,Debit Card,"17,282.00",00.00,"373,086.09"
14-Jun-2024,Bill,606.00,00.00,"373,692.09"
14-Jun-2024,RTGS,"1,428.20",00.00,"375,120.29"
14-Jun-2024,Transfer,15.49,00.00,"375,135.78"
14-Jun-2024,RTGS,"1,373,409.75",00.00,"1,748,545.53"
14-Jun-2024,Reversal,"4,366.10",00.00,"1,752,911.63"
14-Jun-2024,RTGS,"113,520.91",00.00,"1,866,432.54"
14-Jun-2024,Miscellaneous,00.00,"186,643.25","1,679,789.29"
14-Jun-2024,Interest,00.00,"167,978.93","1,511,810.36"
14-Jun-2024,RTGS,00.00,"1,511,810.36",00.00
14-Jun-2024,Debit Card,193.33,00.00,193.33
14-Jun-2024,Debit Card,06.92,00.00,200.25
14-Jun-2024,Interest,00.00,22.25,178.00
14-Jun-2024,Cash,"172,259.70",00.00,"172,437.70"
14-Jun-2024,Reversal,170.00,00.00,"172,607.70"
14-Jun-2024,Transfer,843.51,00.00,"173,451.21"
14-Jun-2024,Transfer,00.00,"28,908.54","144,542.67"
14-Jun-2024,Reversal,00.00,"72,271.34","72,271.34"
14-Jun-2024,Bill,00.00,"72,271.34",00.00
14-Jun-2024,Cheque,46.00,00.00,46.00
14-Jun-2024,ATM,318.28,00.00,364.28
14-Jun-2024,Cheque,00.00,364.28,00.00
14-Jun-2024,Transfer,02.10,00.00,02.10
14-Jun-2024,RTGS,"28,663.62",00.00,"28,665.72"
14-Jun-2024,RTGS,04.00,00.00,"28,669.72"
14-Jun-2024,Tax,"1,245,102.50",00.00,"1,273,772.22"
14-Jun-2024,Debit Card,00.00,"254,754.44","1,019,017.78"
14-Jun-2024,Commission,"2,025.27",00.00,"1,021,043.05"
14-Jun-2024,Transfer,00.00,"1,021,043.05",00.00
14-Jun-2024,IMPS,"62,777.20",00.00,"62,777.20"
14-Jun-2024,Commission,"32,245.90",00.00,"95,023.10"
14-Jun-2024,ATM,62.20,00.00,"95,085.30"
14-Jun-2024,Tax,00.00,"13,583.61","81,501.69"
14-Jun-2024,Cheque,00.00,"40,750.85","40,750.84"
14-Jun-2024,Debit Card,00.00,"4,075.08","36,675.76"
14-Jun-2024,Transfer,00.00,"36,675.76",00.00
14-Jun-2024,IMPS,"1,134.99",00.00,"1,134.99"
14-Jun-2024,Transfer,"2,084.44",00.00,"3,219.43"
14-Jun-2024,NEFT,00.00,536.57,"2,682.86"
14-Jun-2024,IMPS,00.00,670.72,"2,012.14"
14-Jun-2024,Purchase,"165,629.59",00.00,"167,641.73"
14-Jun-2024,Purchase,"2,058.90",00.00,"169,700.63"
14-Jun-2024,Cash,"618,978.25",00.00,"788,678.88"
14-Jun-2024,IMPS,345.37,00.00,"789,024.25"
14-Jun-2024,Interest,00.00,"98,628.03","690,396.22"
14-Jun-2024,Debit Card,03.00,00.00,"690,399.22"
14-Jun-2024,Interest,00.00,"345,199.61","345,199.61"
14-Jun-2024,Debit Card,223.00,00.00,"345,422.61"
14-Jun-2024,Debit Card,"18,358.79",00.00,"363,781.40"
14-Jun-2024,Tax,"237,782.10",00.00,"601,563.50"
14-Jun-2024,Interest,"74,345.00",00.00,"675,908.50"
14-Jun-2024,Commission,00.00,"96,558.36","579,350.14"
14-Jun-2024,Transfer,00.00,"193,116.71","386,233.43"
14-Jun-2024,Miscellaneous,"1,665.00",00.00,"387,898.43"
14-Jun-2024,Interest,138.90,00.00,"388,037.33"
14-Jun-2024,NEFT,00.03,00.00,"388,037.36"
14-Jun-2024,Transfer,00.00,"48,504.67","339,532.69"
14-Jun-2024,IMPS,"21,912.10",00.00,"361,444.79"
14-Jun-2024,Cash,"155,438.20",00.00,"516,882.99"
14-Jun-2024,Bill,00.00,"64,610.37","452,272.62"
14-Jun-2024,Transfer,00.00,"75,378.77","376,893.85"
14-Jun-2024,Cheque,47.73,00.00,"376,941.58"
14-Jun-2024,ATM,00.00,"47,117.70","329,823.88"
14-Jun-2024,Purchase,00.00,"47,117.70","282,706.18"
14-Jun-2024,Bill,00.00,"31,411.80","251,294.38"
14-Jun-2024,Reversal,00.00,"62,823.60","188,470.78"
14-Jun-2024,Miscellaneous,00.00,"188,470.78",00.00
14-Jun-2024,ATM,"1,723,350.00",00.00,"1,723,350.00"
14-Jun-2024,ATM,14.94,00.00,"1,723,364.94"
14-Jun-2024,IMPS,"149,190.90",00.00,"1,872,555.84"
14-Jun-2024,Debit Card,327.20,00.00,"1,872,883.04"
14-Jun-2024,Debit Card,"1,798.30",00.00,"1,874,681.34"
14-Jun-2024,Miscellaneous,00.00,"312,446.89","1,562,234.45"
14-Jun-2024,Purchase,479.00,00.00,"1,562,713.45"
14-Jun-2024,Reversal,"3,515.00",00.00,"1,566,228.45"
14-Jun-2024,IMPS,"15,706.00",00.00,"1,581,934.45"
14-Jun-2024,Miscellaneous,00.00,"1,581,934.45",00.00
14-Jun-2024,Tax,02.90,00.00,02.90
14-Jun-2024,Reversal,07.00,00.00,09.90
14-Jun-2024,Cash,00.00,03.30,06.60
14-Jun-2024,Cheque,11.86,00.00,18.46
15-Jun-2024,Debit Card,"105,313.10",00.00,"105,331.56"
15-Jun-2024,NEFT,00.00,"26,332.89","78,998.67"
15-Jun-2024,Cheque,00.00,"8,777.63","70,221.04"
15-Jun-2024,Cheque,"657,054.00",00.00,"727,275.04"
15-Jun-2024,Cash,54.00,00.00,"727,329.04"
15-Jun-2024,Transfer,00.00,"90,916.13","636,412.91"
15-Jun-2024,Reversal,00.00,"63,641.29","572,771.62"
15-Jun-2024,RTGS,00.00,"95,461.94","477,309.68"
15-Jun-2024,RTGS,00.00,"238,654.84","238,654.84"
15-Jun-2024,IMPS,"1,554,374.00",00.00,"1,793,028.84"
15-Jun-2024,Purchase,"249,735.00",00.00,"2,042,763.84"
15-Jun-2024,Bill,00.00,"255,345.48","1,787,418.36"
15-Jun-2024,Debit Card,00.00,"178,741.84","1,608,676.52"
15-Jun-2024,IMPS,01.50,00.00,"1,608,678.02"
15-Jun-2024,Cash,00.00,"1,608,678.02",00.00
15-Jun-2024,Tax,393.30,00.00,393.30
15-Jun-2024,Interest,"203,655.00",00.00,"204,048.30"
15-Jun-2024,RTGS,175.50,00.00,"204,223.80"
15-Jun-2024,ATM,00.00,"102,111.90","102,111.90"
15-Jun-2024,Commission,00.00,"14,587.41","87,524.49"
15-Jun-2024,Purchase,32.72,00.00,"87,557.21"
15-Jun-2024,Transfer,00.00,"14,592.87","72,964.34"
15-Jun-2024,ATM,86.17,00.00,"73,050.51"
15-Jun-2024,Tax,222.76,00.00,"73,273.27"
15-Jun-2024,IMPS,"4,810.20",00.00,"78,083.47"
15-Jun-2024,Cash,07.00,00.00,"78,090.47"
15-Jun-2024,Miscellaneous,00.00,"9,761.31","68,329.16"
15-Jun-2024,Cheque,00.00,"17,082.29","51,246.87"
15-Jun-2024,Commission,00.00,"8,541.15","42,705.73"
15-Jun-2024,ATM,00.00,"21,352.87","21,352.86"
15-Jun-2024,Purchase,"156,049.90",00.00,"177,402.76"
15-Jun-2024,RTGS,05.20,00.00,"177,407.96"
15-Jun-2024,Transfer,00.00,"44,351.99","133,055.97"
15-Jun-2024,Cheque,25.50,00.00,"133,081.47"
15-Jun-2024,Purchase,"3,356.00",00.00,"136,437.47"
15-Jun-2024,IMPS,00.00,"19,491.07","116,946.40"
15-Jun-2024,Debit Card,"175,419.50",00.00,"292,365.90"
15-Jun-2024,Bill,00.00,"73,091.48","219,274.42"
15-Jun-2024,Cheque,00.00,"24,363.82","194,910.60"
15-Jun-2024,Bill,00.00,"24,363.83","170,546.78"
15-Jun-2024,Tax,00.00,"21,318.35","149,228.43"
15-Jun-2024,Tax,00.00,"74,614.22","74,614.22"
15-Jun-2024,Cash,00.00,"8,290.47","66,323.75"
15-Jun-2024,RTGS,00.00,"13,264.75","53,059.00"
15-Jun-2024,Cheque,06.00,00.00,"53,065.00"
16-Jun-2024,Transfer,00.00,"5,306.50","47,758.50"
16-Jun-2024,Bill,"22,031.38",00.00,"69,789.88"
16-Jun-2024,Tax,00.00,"23,263.29","46,526.59"
16-Jun-2024,Cash,50.20,00.00,"46,576.79"
16-Jun-2024,Bill,302.17,00.00,"46,878.96"
16-Jun-2024,Reversal,"3,900.80",00.00,"50,779.76"
16-Jun-2024,Reversal,00.00,"5,077.98","45,701.78"
16-Jun-2024,RTGS,00.00,"5,712.72","39,989.06"
16-Jun-2024,RTGS,26.62,00.00,"40,015.68"
17-Jun-2024,ATM,00.00,"4,446.19","35,569.49"
17-Jun-2024,RTGS,00.00,"35,569.49",00.00
17-Jun-2024,Tax,07.10,00.00,07.10
17-Jun-2024,Tax,00.00,00.71,06.39
17-Jun-2024,Commission,00.00,01.07,05.32
18-Jun-2024,Miscellaneous,00.00,00.89,04.43
18-Jun-2024,IMPS,"142,991.70",00.00,"142,996.13"
18-Jun-2024,IMPS,00.00,"15,888.46","127,107.67"
18-Jun-2024,IMPS,07.00,00.00,"127,114.67"
18-Jun-2024,ATM,746.99,00.00,"127,861.66"
18-Jun-2024,Debit Card,"1,129,400.00",00.00,"1,257,261.66"
18-Jun-2024,Interest,00.00,"1,257,261.66",00.00
18-Jun-2024,Cheque,44.40,00.00,44.40
18-Jun-2024,Cash,01.60,00.00,46.00
18-Jun-2024,Miscellaneous,00.00,05.11,40.89
18-Jun-2024,ATM,440.00,00.00,480.89
18-Jun-2024,Bill,00.00,120.22,360.67
18-Jun-2024,NEFT,00.00,36.07,324.60
18-Jun-2024,Interest,161.00,00.00,485.60
18-Jun-2024,Cheque,08.76,00.00,494.36
18-Jun-2024,Miscellaneous,02.00,00.00,496.36
18-Jun-2024,Cash,"621,651.80",00.00,"622,148.16"
18-Jun-2024,Commission,00.00,"77,768.52","544,379.64"
18-Jun-2024,Commission,55.00,00.00,"544,434.64"
18-Jun-2024,Interest,"98,506.38",00.00,"642,941.02"
18-Jun-2024,NEFT,00.00,00.00,"642,941.02"
18-Jun-2024,Tax,06.54,00.00,"642,947.56"
18-Jun-2024,Cheque,"143,020.00",00.00,"785,967.56"
18-Jun-2024,Miscellaneous,434.80,00.00,"786,402.36"
18-Jun-2024,Debit Card,00.00,"131,067.06","655,335.30"
18-Jun-2024,Commission,00.00,"163,833.83","491,501.48"
18-Jun-2024,IMPS,"1,753,471.00",00.00,"2,244,972.48"
18-Jun-2024,Miscellaneous,00.00,"320,710.35","1,924,262.13"
18-Jun-2024,Debit Card,01.06,00.00,"1,924,263.19"
18-Jun-2024,NEFT,"3,704.00",00.00,"1,927,967.19"
18-Jun-2024,RTGS,"30,161.04",00.00,"1,958,128.23"
18-Jun-2024,Tax,00.00,"979,064.12","979,064.12"
18-Jun-2024,Debit Card,02.23,00.00,"979,066.35"
18-Jun-2024,Miscellaneous,01.60,00.00,"979,067.95"
18-Jun-2024,Cheque,00.00,"979,067.95",00.00
18-Jun-2024,Bill,55.44,00.00,55.44
18-Jun-2024,Miscellaneous,00.00,13.86,41.58
18-Jun-2024,ATM,"22,304.30",00.00,"22,345.88"
18-Jun-2024,Debit Card,01.20,00.00,"22,347.08"
18-Jun-2024,NEFT,00.00,"3,724.51","18,622.57"
18-Jun-2024,Debit Card,00.00,"9,311.29","9,311.28"
18-Jun-2024,RTGS,"32,735.68",00.00,"42,046.96"
18-Jun-2024,Purchase,00.00,"42,046.96",00.00
18-Jun-2024,ATM,08.00,00.00,08.00
18-Jun-2024,Cheque,00.00,08.00,00.00
18-Jun-2024,RTGS,"1,052,518.00",00.00,"1,052,518.00"
18-Jun-2024,Cash,"95,794.00",00.00,"1,148,312.00"
18-Jun-2024,Miscellaneous,392.00,00.00,"1,148,704.00"
18-Jun-2024,Debit Card,00.00,"1,148,704.00",00.00
18-Jun-2024,Transfer,"194,384.00",00.00,"194,384.00"
18-Jun-2024,Tax,04.80,00.00,"194,388.80"
18-Jun-2024,Interest,"186,501.00",00.00,"380,889.80"
18-Jun-2024,NEFT,00.00,"42,321.09","338,568.71"
18-Jun-2024,ATM,00.00,"33,856.87","304,711.84"
18-Jun-2024,Bill,00.00,"30,471.18","274,240.66"
18-Jun-2024,Cheque,"1,328,950.00",00.00,"1,603,190.66"
18-Jun-2024,RTGS,"11,021.78",00.00,"1,614,212.44"
18-Jun-2024,NEFT,00.00,"230,601.78","1,383,610.66"
18-Jun-2024,Cash,05.38,00.00,"1,383,616.04"
18-Jun-2024,ATM,01.25,00.00,"1,383,617.29"
18-Jun-2024,IMPS,"1,811.00",00.00,"1,385,428.29"
18-Jun-2024,Commission,00.00,"138,542.83","1,246,885.46"
18-Jun-2024,RTGS,00.00,"207,814.24","1,039,071.22"
18-Jun-2024,RTGS,"740,908.00",00.00,"1,779,979.22"
18-Jun-2024,Purchase,20.80,00.00,"1,780,000.02"
18-Jun-2024,Cash,00.00,"593,333.34","1,186,666.68"
18-Jun-2024,Debit Card,00.00,"197,777.78","988,888.90"
18-Jun-2024,Miscellaneous,00.00,"329,629.63","659,259.27"
18-Jun-2024,Cash,504.90,00.00,"659,764.17"
18-Jun-2024,Transfer,00.00,"109,960.70","549,803.48"
18-Jun-2024,Transfer,00.00,"549,803.48",00.00
18-Jun-2024,Cheque,"89,972.00",00.00,"89,972.00"
18-Jun-2024,ATM,48.00,00.00,"90,020.00"
18-Jun-2024,Bill,01.37,00.00,"90,021.37"
18-Jun-2024,RTGS,"23,551.60",00.00,"113,572.97"
18-Jun-2024,Tax,"1,723.20",00.00,"115,296.17"
18-Jun-2024,Miscellaneous,"25,889.76",00.00,"141,185.93"
18-Jun-2024,Bill,"196,030.50",00.00,"337,216.43"
18-Jun-2024,IMPS,00.00,"48,173.78","289,042.65"
18-Jun-2024,Cheque,00.00,"96,347.55","192,695.10"
18-Jun-2024,RTGS,00.00,"32,115.85","160,579.25"
18-Jun-2024,RTGS,"1,978.90",00.00,"162,558.15"
18-Jun-2024,ATM,62.00,00.00,"162,620.15"
18-Jun-2024,ATM,00.00,"18,068.91","144,551.24"
18-Jun-2024,Cash,00.00,"28,910.25","115,640.99"
18-Jun-2024,Reversal,00.00,"38,547.00","77,093.99"
18-Jun-2024,Miscellaneous,"1,217,164.25",00.00,"1,294,258.24"
18-Jun-2024,Cheque,"117,262.00",00.00,"1,411,520.24"
18-Jun-2024,Purchase,63.20,00.00,"1,411,583.44"
18-Jun-2024,Interest,25.00,00.00,"1,411,608.44"
18-Jun-2024,IMPS,"10,146.74",00.00,"1,421,755.18"
18-Jun-2024,Bill,00.00,"710,877.59","710,877.59"
18-Jun-2024,Reversal,"1,520,764.75",00.00,"2,231,642.34"
18-Jun-2024,ATM,00.00,"278,955.29","1,952,687.05"
18-Jun-2024,Purchase,"158,894.30",00.00,"2,111,581.35"
18-Jun-2024,Interest,00.00,"234,620.15","1,876,961.20"
18-Jun-2024,Miscellaneous,00.00,"375,392.24","1,501,568.96"
18-Jun-2024,RTGS,"96,592.70",00.00,"1,598,161.66"
18-Jun-2024,IMPS,64.00,00.00,"1,598,225.66"
18-Jun-2024,NEFT,52.00,00.00,"1,598,277.66"
18-Jun-2024,Cash,386.39,00.00,"1,598,664.05"
18-Jun-2024,ATM,00.00,"177,629.34","1,421,034.71"
18-Jun-2024,Transfer,37.00,00.00,"1,421,071.71"
18-Jun-2024,Transfer,07.39,00.00,"1,421,079.10"
18-Jun-2024,Cash,40.19,00.00,"1,421,119.29"
18-Jun-2024,Transfer,625.30,00.00,"1,421,744.59"
18-Jun-2024,Tax,275.70,00.00,"1,422,020.29"
19-Jun-2024,Interest,00.00,"158,002.25","1,264,018.04"
19-Jun-2024,Cash,"1,763,976.75",00.00,"3,027,994.79"
19-Jun-2024,Reversal,54.00,00.00,"3,028,048.79"
19-Jun-2024,Tax,00.00,"432,578.40","2,595,470.39"
19-Jun-2024,ATM,00.00,"519,094.08","2,076,376.31"
19-Jun-2024,Cheque,00.00,"346,062.72","1,730,313.59"
19-Jun-2024,Reversal,00.00,"216,289.20","1,514,024.39"
19-Jun-2024,ATM,"184,212.16",00.00,"1,698,236.55"
19-Jun-2024,Miscellaneous,00.00,"283,039.43","1,415,197.12"
19-Jun-2024,RTGS,"2,288.65",00.00,"1,417,485.77"
19-Jun-2024,IMPS,157.90,00.00,"1,417,643.67"
19-Jun-2024,Reversal,00.00,"708,821.84","708,821.84"
19-Jun-2024,Interest,00.00,"78,757.98","630,063.86"
19-Jun-2024,Cheque,00.00,"210,021.29","420,042.57"
19-Jun-2024,Commission,00.00,"105,010.64","315,031.93"
19-Jun-2024,Transfer,"2,044.14",00.00,"317,076.07"
19-Jun-2024,Transfer,00.00,"63,415.21","253,660.86"
19-Jun-2024,Purchase,05.85,00.00,"253,666.71"
19-Jun-2024,Cheque,00.00,"126,833.36","126,833.36"
19-Jun-2024,IMPS,"1,661,450.00",00.00,"1,788,283.36"
19-Jun-2024,IMPS,00.00,"357,656.67","1,430,626.69"
19-Jun-2024,Miscellaneous,00.00,"357,656.67","1,072,970.02"
19-Jun-2024,Miscellaneous,"101,435.69",00.00,"1,174,405.71"
19-Jun-2024,Cash,"6,202.00",00.00,"1,180,607.71"
19-Jun-2024,Debit Card,00.00,"393,535.90","787,071.81"
19-Jun-2024,Interest,00.00,"157,414.36","629,657.45"
19-Jun-2024,Tax,00.00,"125,931.49","503,725.96"
19-Jun-2024,Transfer,03.30,00.00,"503,729.26"
19-Jun-2024,Transfer,"21,317.28",00.00,"525,046.54"
19-Jun-2024,RTGS,00.00,"87,507.76","437,538.78"
20-Jun-2024,RTGS,00.00,"62,505.54","375,033.24"
20-Jun-2024,Miscellaneous,00.00,"125,011.08","250,022.16"
20-Jun-2024,Debit Card,00.00,"83,340.72","166,681.44"
20-Jun-2024,Cash,00.00,"16,668.14","150,013.30"
20-Jun-2024,Transfer,00.00,"30,002.66","120,010.64"
20-Jun-2024,Debit Card,00.00,"60,005.32","60,005.32"
20-Jun-2024,Transfer,"276,808.00",00.00,"336,813.32"
20-Jun-2024,Tax,00.00,"48,116.19","288,697.13"
20-Jun-2024,Transfer,00.00,"96,232.38","192,464.75"
20-Jun-2024,RTGS,35.08,00.00,"192,499.83"
20-Jun-2024,Interest,04.00,00.00,"192,503.83"
20-Jun-2024,ATM,499.00,00.00,"193,002.83"
20-Jun-2024,Cash,07.90,00.00,"193,010.73"
20-Jun-2024,Cheque,"937,916.00",00.00,"1,130,926.73"
20-Jun-2024,Interest,52.10,00.00,"1,130,978.83"
21-Jun-2024,Commission,"3,811.40",00.00,"1,134,790.23"
21-Jun-2024,IMPS,00.00,"567,395.12","567,395.12"
21-Jun-2024,Transfer,07.90,00.00,"567,403.02"
21-Jun-2024,Cheque,05.00,00.00,"567,408.02"
21-Jun-2024,Transfer,00.00,"189,136.01","378,272.01"
21-Jun-2024,ATM,"1,591,450.50",00.00,"1,969,722.51"
21-Jun-2024,Bill,00.00,"218,858.06","1,750,864.45"
21-Jun-2024,Transfer,"226,198.50",00.00,"1,977,062.95"
21-Jun-2024,Cash,"28,445.00",00.00,"2,005,507.95"
21-Jun-2024,RTGS,00.00,00.00,"2,005,507.95"
21-Jun-2024,Transfer,00.00,"222,834.22","1,782,673.73"
21-Jun-2024,RTGS,00.00,"356,534.75","1,426,138.98"
21-Jun-2024,Transfer,00.00,"178,267.37","1,247,871.61"
21-Jun-2024,Transfer,07.26,00.00,"1,247,878.87"
21-Jun-2024,Tax,174.50,00.00,"1,248,053.37"
21-Jun-2024,Interest,00.00,"178,293.34","1,069,760.03"
21-Jun-2024,Debit Card,"289,349.75",00.00,"1,359,109.78"
21-Jun-2024,Interest,"17,845.18",00.00,"1,376,954.96"
21-Jun-2024,Miscellaneous,"2,901.30",00.00,"1,379,856.26"
21-Jun-2024,Bill,"2,015,829.00",00.00,"3,395,685.26"
21-Jun-2024,Purchase,07.91,00.00,"3,395,693.17"
21-Jun-2024,Commission,"3,228.00",00.00,"3,398,921.17"
21-Jun-2024,RTGS,00.00,"339,892.12","3,059,029.05"
21-Jun-2024,ATM,00.00,"305,902.91","2,753,126.14"
21-Jun-2024,Debit Card,"1,445,836.00",00.00,"4,198,962.14"
21-Jun-2024,Bill,"2,827.90",00.00,"4,201,790.04"
21-Jun-2024,Tax,132.00,00.00,"4,201,922.04"
22-Jun-2024,IMPS,"2,021.77",00.00,"4,203,943.81"
22-Jun-2024,NEFT,00.00,"840,788.76","3,363,155.05"
22-Jun-2024,Commission,00.05,00.00,"3,363,155.10"
22-Jun-2024,Cash,00.00,"1,681,577.55","1,681,577.55"
22-Jun-2024,Reversal,05.20,00.00,"1,681,582.75"
22-Jun-2024,Bill,"23,647.30",00.00,"1,705,230.05"
22-Jun-2024,Transfer,05.60,00.00,"1,705,235.65"
22-Jun-2024,ATM,00.00,"284,205.94","1,421,029.71"
22-Jun-2024,Tax,00.00,"236,838.29","1,184,191.42"
22-Jun-2024,Cheque,"30,011.07",00.00,"1,214,202.49"
22-Jun-2024,IMPS,03.35,00.00,"1,214,205.84"
22-Jun-2024,ATM,00.00,"173,457.98","1,040,747.86"
22-Jun-2024,RTGS,54.00,00.00,"1,040,801.86"
22-Jun-2024,Transfer,00.00,"148,685.98","892,115.88"
22-Jun-2024,Reversal,00.00,00.00,"892,115.88"
22-Jun-2024,Transfer,00.00,"111,514.49","780,601.40"
22-Jun-2024,Transfer,00.00,"780,601.40",00.00
22-Jun-2024,Cheque,269.90,00.00,269.90
22-Jun-2024,Cheque,00.00,134.95,134.95
22-Jun-2024,Commission,00.00,134.95,00.00
22-Jun-2024,Transfer,"2,272.00",00.00,"2,272.00"
22-Jun-2024,ATM,00.00,757.33,"1,514.67"
22-Jun-2024,RTGS,"954,019.50",00.00,"955,534.17"
22-Jun-2024,RTGS,"2,287.13",00.00,"957,821.30"
22-Jun-2024,Miscellaneous,00.00,"106,424.59","851,396.71"
22-Jun-2024,Tax,"19,203.30",00.00,"870,600.01"
22-Jun-2024,Transfer,31.56,00.00,"870,631.57"
22-Jun-2024,Cash,00.00,"96,736.84","773,894.73"
22-Jun-2024,Bill,00.00,"96,736.84","677,157.89"
22-Jun-2024,Debit Card,"933,603.80",00.00,"1,610,761.69"
22-Jun-2024,RTGS,"30,156.90",00.00,"1,640,918.59"
22-Jun-2024,Bill,00.00,"273,486.43","1,367,432.16"
22-Jun-2024,Cash,00.00,"455,810.72","911,621.44"
22-Jun-2024,Purchase,00.00,"130,231.63","781,389.81"
22-Jun-2024,NEFT,00.00,"390,694.91","390,694.90"
22-Jun-2024,RTGS,00.00,"195,347.45","195,347.45"
22-Jun-2024,Reversal,62.30,00.00,"195,409.75"
22-Jun-2024,Cheque,00.00,"48,852.44","146,557.31"
22-Jun-2024,Bill,05.33,00.00,"146,562.64"
22-Jun-2024,IMPS,07.02,00.00,"146,569.66"
22-Jun-2024,Cash,300.39,00.00,"146,870.05"
23-Jun-2024,RTGS,00.00,"24,478.34","122,391.71"
23-Jun-2024,ATM,00.00,"13,599.08","108,792.63"
23-Jun-2024,Interest,00.00,"13,599.08","95,193.55"
23-Jun-2024,Purchase,00.00,"47,596.78","47,596.78"
23-Jun-2024,Purchase,"148,653.97",00.00,"196,250.75"
23-Jun-2024,Reversal,00.00,"98,125.38","98,125.38"
23-Jun-2024,Cheque,00.00,"12,265.67","85,859.71"
23-Jun-2024,Cash,00.00,"10,732.46","75,127.25"
23-Jun-2024,Tax,00.00,"15,025.45","60,101.80"
23-Jun-2024,Bill,00.00,"6,677.98","53,423.82"
23-Jun-2024,Cheque,00.00,"10,684.76","42,739.06"
23-Jun-2024,RTGS,03.00,00.00,"42,742.06"
23-Jun-2024,IMPS,42.72,00.00,"42,784.78"
23-Jun-2024,Bill,01.40,00.00,"42,786.18"
23-Jun-2024,IMPS,"153,403.41",00.00,"196,189.59"
23-Jun-2024,Reversal,33.02,00.00,"196,222.61"
23-Jun-2024,Purchase,00.00,"32,703.77","163,518.84"
23-Jun-2024,IMPS,02.81,00.00,"163,521.65"
23-Jun-2024,Interest,00.00,"32,704.33","130,817.32"
23-Jun-2024,Transfer,00.00,"43,605.77","87,211.55"
23-Jun-2024,Cash,"1,349,115.75",00.00,"1,436,327.30"
23-Jun-2024,IMPS,00.00,"205,189.61","1,231,137.69"
23-Jun-2024,Transfer,"8,844.00",00.00,"1,239,981.69"
23-Jun-2024,Commission,332.00,00.00,"1,240,313.69"
23-Jun-2024,Tax,00.00,"248,062.74","992,250.95"
23-Jun-2024,Purchase,279.65,00.00,"992,530.60"
23-Jun-2024,Debit Card,"120,708.00",00.00,"1,113,238.60"
23-Jun-2024,Purchase,00.00,"111,323.86","1,001,914.74"
23-Jun-2024,Cheque,"181,824.00",00.00,"1,183,738.74"
23-Jun-2024,Reversal,"1,725,352.00",00.00,"2,909,090.74"
23-Jun-2024,Debit Card,00.00,"363,636.34","2,545,454.40"
23-Jun-2024,Debit Card,00.00,"363,636.34","2,181,818.06"
23-Jun-2024,Miscellaneous,63.60,00.00,"2,181,881.66"
23-Jun-2024,Bill,00.00,"242,431.30","1,939,450.36"
23-Jun-2024,Cheque,"4,062.21",00.00,"1,943,512.57"
23-Jun-2024,Reversal,00.00,"323,918.76","1,619,593.81"
23-Jun-2024,Commission,00.00,"539,864.60","1,079,729.21"
23-Jun-2024,ATM,00.00,"539,864.61","539,864.60"
23-Jun-2024,Transfer,"1,474.40",00.00,"541,339.00"
23-Jun-2024,Cash,00.00,"135,334.75","406,004.25"
23-Jun-2024,Purchase,"8,666.90",00.00,"414,671.15"
23-Jun-2024,IMPS,00.00,"51,833.89","362,837.26"
23-Jun-2024,IMPS,00.00,"181,418.63","181,418.63"
23-Jun-2024,Miscellaneous,00.00,"36,283.73","145,134.90"
23-Jun-2024,IMPS,00.00,"145,134.90",00.00
23-Jun-2024,Interest,29.07,00.00,29.07
23-Jun-2024,ATM,00.00,04.85,24.22
23-Jun-2024,Debit Card,00.00,02.69,21.53
23-Jun-2024,Commission,"1,207,552.75",00.00,"1,207,574.28"
23-Jun-2024,Purchase,01.00,00.00,"1,207,575.28"
23-Jun-2024,ATM,00.00,"201,262.55","1,006,312.73"
23-Jun-2024,Transfer,00.00,"335,437.58","670,875.15"
23-Jun-2024,Interest,138.54,00.00,"671,013.69"
23-Jun-2024,Reversal,00.00,"95,859.10","575,154.59"
23-Jun-2024,Bill,296.30,00.00,"575,450.89"
23-Jun-2024,ATM,00.00,"191,816.96","383,633.93"
23-Jun-2024,RTGS,00.00,"63,938.99","319,694.94"
23-Jun-2024,Cash,"19,998.60",00.00,"339,693.54"
23-Jun-2024,Debit Card,"177,476.00",00.00,"517,169.54"
23-Jun-2024,Purchase,502.00,00.00,"517,671.54"
23-Jun-2024,NEFT,00.00,"129,417.89","388,253.66"
23-Jun-2024,Purchase,00.00,"38,825.37","349,428.29"
23-Jun-2024,NEFT,"3,983.00",00.00,"353,411.29"
23-Jun-2024,Bill,00.00,"88,352.82","265,058.47"
23-Jun-2024,NEFT,00.00,"29,450.94","235,607.53"
23-Jun-2024,IMPS,"139,770.50",00.00,"375,378.03"
23-Jun-2024,Reversal,"325,890.25",00.00,"701,268.28"
23-Jun-2024,NEFT,00.00,"87,658.54","613,609.74"
23-Jun-2024,RTGS,"140,403.97",00.00,"754,013.71"
23-Jun-2024,Tax,06.00,00.00,"754,019.71"
23-Jun-2024,Purchase,00.00,"125,669.95","628,349.76"
23-Jun-2024,Reversal,00.00,"78,543.72","549,806.04"
23-Jun-2024,Cash,06.00,00.00,"549,812.04"
23-Jun-2024,Transfer,00.00,"91,635.34","458,176.70"
23-Jun-2024,NEFT,00.00,"50,908.52","407,268.18"
23-Jun-2024,Debit Card,00.00,"407,268.18",00.00
23-Jun-2024,Transfer,14.00,00.00,14.00
23-Jun-2024,Bill,"11,349.00",00.00,"11,363.00"
23-Jun-2024,Reversal,10.80,00.00,"11,373.80"
23-Jun-2024,RTGS,"2,032.90",00.00,"13,406.70"
23-Jun-2024,IMPS,00.00,"2,681.34","10,725.36"
23-Jun-2024,IMPS,00.00,"1,787.56","8,937.80"
23-Jun-2024,Purchase,00.00,893.78,"8,044.02"
23-Jun-2024,RTGS,00.00,"1,608.80","6,435.22"
23-Jun-2024,Miscellaneous,00.00,"1,608.81","4,826.42"
23-Jun-2024,Miscellaneous,00.00,804.40,"4,022.02"
23-Jun-2024,NEFT,"1,549,873.00",00.00,"1,553,895.02"
23-Jun-2024,IMPS,07.83,00.00,"1,553,902.85"
24-Jun-2024,Bill,00.00,"258,983.81","1,294,919.04"
24-Jun-2024,Purchase,00.00,"258,983.81","1,035,935.23"
24-Jun-2024,ATM,00.00,"129,491.90","906,443.33"
24-Jun-2024,Tax,"3,551.00",00.00,"909,994.33"
24-Jun-2024,RTGS,11.80,00.00,"910,006.13"
24-Jun-2024,Cash,00.00,"130,000.88","780,005.25"
25-Jun-2024,Bill,"466,391.20",00.00,"1,246,396.45"
25-Jun-2024,Purchase,00.00,"178,056.64","1,068,339.81"
25-Jun-2024,Debit Card,"253,669.00",00.00,"1,322,008.81"
25-Jun-2024,Transfer,21.72,00.00,"1,322,030.53"
25-Jun-2024,Miscellaneous,00.00,"132,203.05","1,189,827.48"
25-Jun-2024,RTGS,00.00,"198,304.58","991,522.90"
25-Jun-2024,NEFT,"31,703.00",00.00,"1,023,225.90"
25-Jun-2024,Transfer,06.50,00.00,"1,023,232.40"
25-Jun-2024,Cash,451.00,00.00,"1,023,683.40"
25-Jun-2024,RTGS,229.60,00.00,"1,023,913.00"
25-Jun-2024,Cheque,"21,180.00",00.00,"1,045,093.00"
25-Jun-2024,Cash,00.00,"522,546.50","522,546.50"
25-Jun-2024,Tax,"14,724.00",00.00,"537,270.50"
25-Jun-2024,Reversal,00.00,"59,696.72","477,573.78"
25-Jun-2024,Miscellaneous,"28,623.00",00.00,"506,196.78"
25-Jun-2024,Cheque,00.00,"72,313.83","433,882.95"
25-Jun-2024,Cheque,"59,284.40",00.00,"493,167.35"
25-Jun-2024,Tax,17.00,00.00,"493,184.35"
25-Jun-2024,Commission,00.00,"49,318.44","443,865.92"
25-Jun-2024,Bill,00.00,"110,966.48","332,899.44"
25-Jun-2024,Purchase,00.00,"83,224.86","249,674.58"
25-Jun-2024,Debit Card,00.00,"41,612.43","208,062.15"
25-Jun-2024,Bill,200.70,00.00,"208,262.85"
25-Jun-2024,ATM,"81,427.20",00.00,"289,690.05"
25-Jun-2024,Bill,00.00,"289,690.05",00.00
25-Jun-2024,Cheque,"15,075.05",00.00,"15,075.05"
25-Jun-2024,Miscellaneous,"1,013,238.80",00.00,"1,028,313.85"
25-Jun-2024,Commission,29.88,00.00,"1,028,343.73"
25-Jun-2024,Cheque,"10,473.53",00.00,"1,038,817.26"
25-Jun-2024,Tax,00.00,"259,704.32","779,112.94"
26-Jun-2024,RTGS,07.00,00.00,"779,119.94"
26-Jun-2024,Debit Card,"1,883,055.50",00.00,"2,662,175.44"
26-Jun-2024,Reversal,"8,982.00",00.00,"2,671,157.44"
26-Jun-2024,Interest,"146,255.12",00.00,"2,817,412.56"
26-Jun-2024,Cash,02.50,00.00,"2,817,415.06"
26-Jun-2024,RTGS,"818,858.00",00.00,"3,636,273.06"
26-Jun-2024,Transfer,"354,866.00",00.00,"3,991,139.06"
26-Jun-2024,NEFT,"2,712.88",00.00,"3,993,851.94"
26-Jun-2024,Transfer,"202,810.00",00.00,"4,196,661.94"
26-Jun-2024,Miscellaneous,"244,904.70",00.00,"4,441,566.64"
26-Jun-2024,IMPS,00.00,"1,480,522.21","2,961,044.43"
26-Jun-2024,Transfer,00.00,"740,261.11","2,220,783.32"
27-Jun-2024,NEFT,00.00,"277,597.92","1,943,185.40"
27-Jun-2024,ATM,"465,792.50",00.00,"2,408,977.90"
27-Jun-2024,ATM,00.00,"344,139.70","2,064,838.20"
27-Jun-2024,Reversal,00.00,"258,104.78","1,806,733.42"
27-Jun-2024,Cheque,"1,646,806.00",00.00,"3,453,539.42"
27-Jun-2024,Reversal,00.00,"1,726,769.71","1,726,769.71"
27-Jun-2024,Bill,"15,073.00",00.00,"1,741,842.71"
27-Jun-2024,RTGS,07.20,00.00,"1,741,849.91"
27-Jun-2024,Transfer,00.00,"193,538.88","1,548,311.03"
27-Jun-2024,Miscellaneous,"1,299.40",00.00,"1,549,610.43"
27-Jun-2024,Miscellaneous,00.00,"258,268.41","1,291,342.02"
27-Jun-2024,Tax,"681,776.00",00.00,"1,973,118.02"
27-Jun-2024,Bill,440.10,00.00,"1,973,558.12"
27-Jun-2024,RTGS,"1,102,834.00",00.00,"3,076,392.12"
27-Jun-2024,Cash,05.32,00.00,"3,076,397.44"
27-Jun-2024,Cheque,00.00,"615,279.49","2,461,117.95"
27-Jun-2024,Debit Card,"236,609.80",00.00,"2,697,727.75"
27-Jun-2024,Reversal,18.00,00.00,"2,697,745.75"
27-Jun-2024,Purchase,"1,160.95",00.00,"2,698,906.70"
27-Jun-2024,NEFT,02.00,00.00,"2,698,908.70"
27-Jun-2024,Miscellaneous,"51,404.20",00.00,"2,750,312.90"
27-Jun-2024,Bill,00.00,"916,770.97","1,833,541.93"
27-Jun-2024,Commission,00.00,"203,726.88","1,629,815.05"
27-Jun-2024,Commission,00.00,"232,830.72","1,396,984.33"
27-Jun-2024,Tax,00.00,"155,220.48","1,241,763.85"
27-Jun-2024,Cash,00.00,"124,176.39","1,117,587.47"
27-Jun-2024,Reversal,"1,089,226.20",00.00,"2,206,813.67"
27-Jun-2024,IMPS,00.00,"245,201.52","1,961,612.15"
27-Jun-2024,RTGS,998.00,00.00,"1,962,610.15"
27-Jun-2024,ATM,"1,948,829.50",00.00,"3,911,439.65"
27-Jun-2024,ATM,"11,756.71",00.00,"3,923,196.36"
27-Jun-2024,Debit Card,00.00,"1,961,598.18","1,961,598.18"
27-Jun-2024,Interest,00.00,"280,228.31","1,681,369.87"
27-Jun-2024,ATM,"1,023,960.50",00.00,"2,705,330.37"
27-Jun-2024,Interest,00.00,"1,352,665.19","1,352,665.18"
27-Jun-2024,Commission,00.00,"338,166.30","1,014,498.88"
27-Jun-2024,Cheque,"1,471,982.00",00.00,"2,486,480.88"
28-Jun-2024,Tax,00.00,"1,243,240.44","1,243,240.44"
28-Jun-2024,Debit Card,00.00,"177,605.78","1,065,634.66"
28-Jun-2024,Bill,"4,596.95",00.00,"1,070,231.61"
28-Jun-2024,Bill,00.00,"133,778.95","936,452.66"
28-Jun-2024,ATM,02.00,00.00,"936,454.66"
28-Jun-2024,Cash,"61,186.80",00.00,"997,641.46"
28-Jun-2024,Miscellaneous,"19,072.12",00.00,"1,016,713.58"
28-Jun-2024,Tax,00.00,"169,452.26","847,261.32"
28-Jun-2024,RTGS,00.00,"84,726.13","762,535.19"
28-Jun-2024,Cash,00.00,"152,507.04","610,028.15"
28-Jun-2024,Cheque,06.00,00.00,"610,034.15"
28-Jun-2024,Transfer,311.00,00.00,"610,345.15"
28-Jun-2024,Purchase,"180,000.56",00.00,"790,345.71"
28-Jun-2024,IMPS,"7,697.94",00.00,"798,043.65"
28-Jun-2024,NEFT,"92,112.00",00.00,"890,155.65"
28-Jun-2024,Bill,"1,879,929.75",00.00,"2,770,085.40"
28-Jun-2024,RTGS,00.00,"395,726.49","2,374,358.91"
28-Jun-2024,Debit Card,00.00,"296,794.86","2,077,564.05"
28-Jun-2024,Tax,369.10,00.00,"2,077,933.15"
28-Jun-2024,Reversal,06.70,00.00,"2,077,939.85"
28-Jun-2024,Tax,"3,389.70",00.00,"2,081,329.55"
28-Jun-2024,ATM,00.00,"260,166.19","1,821,163.36"
28-Jun-2024,RTGS,00.00,"202,351.48","1,618,811.88"
28-Jun-2024,IMPS,"9,216.00",00.00,"1,628,027.88"
28-Jun-2024,Bill,04.40,00.00,"1,628,032.28"
28-Jun-2024,Bill,"31,347.10",00.00,"1,659,379.38"
28-Jun-2024,Tax,05.00,00.00,"1,659,384.38"
28-Jun-2024,ATM,02.42,00.00,"1,659,386.80"
28-Jun-2024,ATM,369.00,00.00,"1,659,755.80"
28-Jun-2024,Miscellaneous,"23,283.00",00.00,"1,683,038.80"
28-Jun-2024,Purchase,04.00,00.00,"1,683,042.80"
28-Jun-2024,Bill,00.00,"420,760.70","1,262,282.10"
28-Jun-2024,NEFT,"1,038,347.50",00.00,"2,300,629.60"
28-Jun-2024,Cash,29.30,00.00,"2,300,658.90"
28-Jun-2024,Commission,"192,546.62",00.00,"2,493,205.52"
28-Jun-2024,RTGS,00.00,"415,534.25","2,077,671.27"
28-Jun-2024,Cheque,00.00,"259,708.91","1,817,962.36"
28-Jun-2024,Interest,"54,550.00",00.00,"1,872,512.36"
28-Jun-2024,Tax,160.40,00.00,"1,872,672.76"
28-Jun-2024,Purchase,"4,002.00",00.00,"1,876,674.76"
28-Jun-2024,Miscellaneous,00.00,"375,334.95","1,501,339.81"
28-Jun-2024,Cash,00.39,00.00,"1,501,340.20"
28-Jun-2024,Reversal,00.00,"750,670.10","750,670.10"
28-Jun-2024,NEFT,00.00,"187,667.53","563,002.57"
28-Jun-2024,Purchase,"1,772.70",00.00,"564,775.27"
28-Jun-2024,Debit Card,"1,351,444.20",00.00,"1,916,219.47"
29-Jun-2024,Cash,148.00,00.00,"1,916,367.47"
29-Jun-2024,NEFT,"2,976.00",00.00,"1,919,343.47"
29-Jun-2024,RTGS,40.59,00.00,"1,919,384.06"
29-Jun-2024,Bill,00.00,"239,923.01","1,679,461.05"
29-Jun-2024,Miscellaneous,00.00,"279,910.18","1,399,550.88"
29-Jun-2024,Purchase,00.00,"233,258.48","1,166,292.40"
29-Jun-2024,Reversal,00.00,"145,786.55","1,020,505.85"
30-Jun-2024,Interest,00.00,"145,786.55","874,719.30"
30-Jun-2024,Cash,00.00,"174,943.86","699,775.44"
30-Jun-2024,IMPS,00.00,"99,967.92","599,807.52"
30-Jun-2024,Reversal,34.00,00.00,"599,841.52"
30-Jun-2024,Cash,51.00,00.00,"599,892.52"
30-Jun-2024,Cash,05.00,00.00,"599,897.52"
30-Jun-2024,Cash,00.00,"149,974.38","449,923.14"
30-Jun-2024,Reversal,00.00,"64,274.73","385,648.41"
30-Jun-2024,Bill,00.00,"192,824.21","192,824.20"
30-Jun-2024,Interest,00.00,"19,282.42","173,541.78"
01-Jul-2024,Bill,00.00,"28,923.63","144,618.15"
01-Jul-2024,Cash,00.00,"16,068.68","128,549.47"
01-Jul-2024,NEFT,"2,957.50",00.00,"131,506.97"
01-Jul-2024,Reversal,00.00,"26,301.39","105,205.58"
01-Jul-2024,NEFT,00.00,"10,520.56","94,685.02"
01-Jul-2024,Cash,00.00,"13,526.43","81,158.59"
01-Jul-2024,Interest,"53,288.78",00.00,"134,447.37"
01-Jul-2024,Purchase,00.00,"26,889.47","107,557.90"
01-Jul-2024,Miscellaneous,00.00,"21,511.58","86,046.32"
01-Jul-2024,Tax,00.00,"12,292.33","73,753.99"
01-Jul-2024,Debit Card,00.00,"24,584.66","49,169.33"
01-Jul-2024,ATM,166.00,00.00,"49,335.33"
01-Jul-2024,Tax,07.02,00.00,"49,342.35"
01-Jul-2024,Bill,02.20,00.00,"49,344.55"
01-Jul-2024,Commission,00.00,"16,448.18","32,896.37"
01-Jul-2024,Cash,00.00,"3,655.15","29,241.22"
01-Jul-2024,Tax,"915,882.00",00.00,"945,123.22"
01-Jul-2024,Cash,"21,537.90",00.00,"966,661.12"
01-Jul-2024,Transfer,00.00,"193,332.22","773,328.90"
01-Jul-2024,RTGS,00.00,"85,925.43","687,403.47"
01-Jul-2024,Bill,04.10,00.00,"687,407.57"
01-Jul-2024,Reversal,"12,384.00",00.00,"699,791.57"
01-Jul-2024,IMPS,482.79,00.00,"700,274.36"
01-Jul-2024,Miscellaneous,00.00,"175,068.59","525,205.77"
01-Jul-2024,IMPS,30.00,00.00,"525,235.77"
01-Jul-2024,Interest,00.00,"75,033.68","450,202.09"
01-Jul-2024,NEFT,00.00,"64,314.58","385,887.51"
01-Jul-2024,Transfer,00.00,"55,126.79","330,760.72"
01-Jul-2024,ATM,"143,084.30",00.00,"473,845.02"
01-Jul-2024,Transfer,00.00,"473,845.02",00.00
01-Jul-2024,Cash,"279,032.20",00.00,"279,032.20"
01-Jul-2024,ATM,191.29,00.00,"279,223.49"
02-Jul-2024,Tax,502.00,00.00,"279,725.49"
02-Jul-2024,Reversal,00.00,"279,725.49",00.00
02-Jul-2024,Cash,"341,659.25",00.00,"341,659.25"
02-Jul-2024,Purchase,"260,120.60",00.00,"601,779.85"
02-Jul-2024,Interest,331.00,00.00,"602,110.85"
02-Jul-2024,Commission,"3,016.00",00.00,"605,126.85"
02-Jul-2024,Debit Card,"3,968.93",00.00,"609,095.78"
03-Jul-2024,IMPS,04.40,00.00,"609,100.18"
03-Jul-2024,Tax,00.00,"304,550.09","304,550.09"
03-Jul-2024,IMPS,"11,717.00",00.00,"316,267.09"
03-Jul-2024,IMPS,"232,952.16",00.00,"549,219.25"
03-Jul-2024,Commission,"52,731.00",00.00,"601,950.25"
03-Jul-2024,Transfer,00.00,"60,195.03","541,755.22"
03-Jul-2024,RTGS,00.00,"54,175.52","487,579.70"
03-Jul-2024,Transfer,"1,756,228.00",00.00,"2,243,807.70"
03-Jul-2024,Transfer,422.00,00.00,"2,244,229.70"
03-Jul-2024,Bill,00.00,"280,528.71","1,963,700.99"
03-Jul-2024,Transfer,45.74,00.00,"1,963,746.73"
03-Jul-2024,Cheque,00.00,"218,194.08","1,745,552.65"
03-Jul-2024,Miscellaneous,00.00,"436,388.16","1,309,164.49"
03-Jul-2024,Interest,00.00,"436,388.16","872,776.33"
03-Jul-2024,Cash,00.00,"145,462.72","727,313.61"
03-Jul-2024,Interest,00.00,"181,828.40","545,485.21"
03-Jul-2024,Interest,00.00,"136,371.30","409,113.91"
03-Jul-2024,Miscellaneous,00.00,"136,371.30","272,742.61"
03-Jul-2024,Miscellaneous,"1,321,469.50",00.00,"1,594,212.11"
03-Jul-2024,Miscellaneous,00.00,"797,106.06","797,106.06"
03-Jul-2024,NEFT,00.00,"113,872.29","683,233.77"
03-Jul-2024,ATM,337.47,00.00,"683,571.24"
03-Jul-2024,IMPS,05.70,00.00,"683,576.94"
03-Jul-2024,ATM,00.00,"136,715.39","546,861.55"
03-Jul-2024,Bill,00.00,"91,143.59","455,717.96"
03-Jul-2024,Bill,213.64,00.00,"455,931.60"
03-Jul-2024,IMPS,"1,750,036.00",00.00,"2,205,967.60"
03-Jul-2024,Bill,"2,173.10",00.00,"2,208,140.70"
03-Jul-2024,RTGS,00.00,"1,104,070.35","1,104,070.35"
03-Jul-2024,Interest,00.00,"220,814.07","883,256.28"
03-Jul-2024,Cheque,00.00,"110,407.04","772,849.24"
03-Jul-2024,Tax,00.00,"257,616.41","515,232.83"
03-Jul-2024,Reversal,07.20,00.00,"515,240.03"
03-Jul-2024,Cash,"2,743.00",00.00,"517,983.03"
03-Jul-2024,Interest,"1,262.30",00.00,"519,245.33"
03-Jul-2024,Interest,38.70,00.00,"519,284.03"
03-Jul-2024,Cash,655.30,00.00,"519,939.33"
03-Jul-2024,Miscellaneous,02.00,00.00,"519,941.33"
03-Jul-2024,Miscellaneous,111.00,00.00,"520,052.33"
03-Jul-2024,Purchase,00.00,"260,026.17","260,026.16"
03-Jul-2024,Miscellaneous,00.00,"26,002.62","234,023.54"
03-Jul-2024,Interest,31.78,00.00,"234,055.32"
03-Jul-2024,Cheque,00.00,"78,018.44","156,036.88"
03-Jul-2024,Purchase,"110,431.91",00.00,"266,468.79"
03-Jul-2024,Debit Card,00.00,"29,607.64","236,861.15"
03-Jul-2024,Interest,00.00,"23,686.12","213,175.04"
03-Jul-2024,ATM,00.00,"213,175.04",00.00
03-Jul-2024,Purchase,"184,248.28",00.00,"184,248.28"
03-Jul-2024,Bill,00.00,"92,124.14","92,124.14"
03-Jul-2024,Cheque,00.00,"46,062.07","46,062.07"
03-Jul-2024,NEFT,00.00,"15,354.02","30,708.05"
03-Jul-2024,NEFT,01.92,00.00,"30,709.97"
03-Jul-2024,Miscellaneous,"11,863.00",00.00,"42,572.97"
04-Jul-2024,NEFT,28.00,00.00,"42,600.97"
04-Jul-2024,Bill,19.61,00.00,"42,620.58"
04-Jul-2024,Tax,"3,636.00",00.00,"46,256.58"
04-Jul-2024,Commission,00.00,"15,418.86","30,837.72"
04-Jul-2024,Debit Card,"1,275,749.75",00.00,"1,306,587.47"
04-Jul-2024,Bill,00.00,"130,658.75","1,175,928.72"
04-Jul-2024,Purchase,00.00,"195,988.12","979,940.60"
04-Jul-2024,Bill,00.00,"139,991.51","839,949.09"
04-Jul-2024,Reversal,"42,491.00",00.00,"882,440.09"
04-Jul-2024,Cheque,00.00,"220,610.02","661,830.07"
04-Jul-2024,Cheque,00.00,"73,536.67","588,293.40"
04-Jul-2024,Commission,"227,976.00",00.00,"816,269.40"
04-Jul-2024,Miscellaneous,489.31,00.00,"816,758.71"
04-Jul-2024,Tax,"1,048.00",00.00,"817,806.71"
04-Jul-2024,Debit Card,00.00,"408,903.36","408,903.36"
04-Jul-2024,Commission,00.00,"408,903.36",00.00
04-Jul-2024,NEFT,"22,218.00",00.00,"22,218.00"
04-Jul-2024,Tax,00.00,"2,468.67","19,749.33"
04-Jul-2024,Debit Card,"226,094.50",00.00,"245,843.83"
04-Jul-2024,Cheque,00.00,"24,584.38","221,259.45"
05-Jul-2024,Reversal,177.00,00.00,"221,436.45"
05-Jul-2024,NEFT,00.00,"36,906.08","184,530.38"
05-Jul-2024,ATM,43.66,00.00,"184,574.04"
05-Jul-2024,Interest,00.00,"184,574.04",00.00
05-Jul-2024,NEFT,"26,399.57",00.00,"26,399.57"
05-Jul-2024,Transfer,00.00,"4,399.93","21,999.64"
05-Jul-2024,Tax,43.00,00.00,"22,042.64"
05-Jul-2024,IMPS,"1,170,348.00",00.00,"1,192,390.64"
05-Jul-2024,NEFT,"481,143.75",00.00,"1,673,534.39"
05-Jul-2024,Cash,14.00,00.00,"1,673,548.39"
05-Jul-2024,Miscellaneous,"2,190.40",00.00,"1,675,738.79"
05-Jul-2024,Commission,00.00,"335,147.76","1,340,591.03"
05-Jul-2024,Cheque,00.00,"191,513.00","1,149,078.03"
05-Jul-2024,Purchase,00.00,"164,154.00","984,924.03"
05-Jul-2024,Bill,01.10,00.00,"984,925.13"
05-Jul-2024,Purchase,00.00,"328,308.38","656,616.75"
05-Jul-2024,Transfer,00.00,"164,154.19","492,462.56"
05-Jul-2024,Cash,103.00,00.00,"492,565.56"
05-Jul-2024,Cheque,00.00,"492,565.56",00.00
05-Jul-2024,RTGS,"633,933.00",00.00,"633,933.00"
05-Jul-2024,Transfer,226.62,00.00,"634,159.62"
06-Jul-2024,IMPS,00.00,"126,831.92","507,327.70"
06-Jul-2024,Cheque,00.00,"126,831.93","380,495.78"
06-Jul-2024,Miscellaneous,36.98,00.00,"380,532.76"
06-Jul-2024,Cheque,33.30,00.00,"380,566.06"
06-Jul-2024,Commission,60.84,00.00,"380,626.90"
06-Jul-2024,NEFT,03.00,00.00,"380,629.90"
06-Jul-2024,Interest,00.00,"42,292.21","338,337.69"
06-Jul-2024,Interest,00.00,"37,593.08","300,744.61"
06-Jul-2024,Purchase,"2,153.50",00.00,"302,898.11"
06-Jul-2024,Purchase,52.00,00.00,"302,950.11"
06-Jul-2024,Cheque,"2,204.00",00.00,"305,154.11"
06-Jul-2024,Interest,00.00,"305,154.11",00.00
06-Jul-2024,Cash,"7,194.00",00.00,"7,194.00"
06-Jul-2024,Interest,35.27,00.00,"7,229.27"
06-Jul-2024,Tax,"3,133.00",00.00,"10,362.27"
06-Jul-2024,ATM,00.00,"1,480.32","8,881.95"
06-Jul-2024,Purchase,06.55,00.00,"8,888.50"
06-Jul-2024,Commission,"1,467.79",00.00,"10,356.29"
06-Jul-2024,Purchase,"8,930.06",00.00,"19,286.35"
06-Jul-2024,RTGS,"13,802.25",00.00,"33,088.60"
06-Jul-2024,ATM,00.00,"8,272.15","24,816.45"
06-Jul-2024,Interest,52.00,00.00,"24,868.45"
06-Jul-2024,Purchase,00.00,"3,108.56","21,759.89"
06-Jul-2024,Cash,00.00,"2,175.99","19,583.90"
06-Jul-2024,Transfer,00.00,"4,895.98","14,687.92"
06-Jul-2024,Tax,00.00,"1,468.79","13,219.13"
06-Jul-2024,RTGS,00.00,"6,609.57","6,609.56"
06-Jul-2024,Cheque,00.00,"2,203.19","4,406.37"
06-Jul-2024,Purchase,08.00,00.00,"4,414.37"
06-Jul-2024,Commission,00.00,630.62,"3,783.75"
06-Jul-2024,Transfer,00.00,472.97,"3,310.78"
06-Jul-2024,Reversal,"18,817.09",00.00,"22,127.87"
06-Jul-2024,Commission,04.90,00.00,"22,132.77"
06-Jul-2024,RTGS,00.00,"2,766.60","19,366.17"
06-Jul-2024,Transfer,00.00,"1,936.62","17,429.55"
06-Jul-2024,RTGS,00.00,"2,904.93","14,524.62"
06-Jul-2024,Miscellaneous,73.00,00.00,"14,597.62"
06-Jul-2024,Reversal,"1,971,745.25",00.00,"1,986,342.87"
06-Jul-2024,Miscellaneous,00.00,"662,114.29","1,324,228.58"
06-Jul-2024,Debit Card,"146,521.84",00.00,"1,470,750.42"
06-Jul-2024,ATM,04.00,00.00,"1,470,754.42"
06-Jul-2024,Purchase,00.00,"183,844.30","1,286,910.12"
06-Jul-2024,Tax,00.00,"214,485.02","1,072,425.10"
06-Jul-2024,Cheque,00.00,"214,485.02","857,940.08"
06-Jul-2024,ATM,46.00,00.00,"857,986.08"
06-Jul-2024,Miscellaneous,00.00,"142,997.68","714,988.40"
06-Jul-2024,RTGS,00.00,"89,373.55","625,614.85"
06-Jul-2024,Debit Card,00.00,"208,538.28","417,076.57"
06-Jul-2024,Bill,00.00,"59,582.37","357,494.20"
06-Jul-2024,Tax,"18,318.00",00.00,"375,812.20"
06-Jul-2024,Debit Card,"130,396.00",00.00,"506,208.20"
06-Jul-2024,IMPS,28.00,00.00,"506,236.20"
06-Jul-2024,IMPS,02.30,00.00,"506,238.50"
06-Jul-2024,IMPS,00.00,"56,248.72","449,989.78"
06-Jul-2024,Miscellaneous,"1,876,807.00",00.00,"2,326,796.78"
06-Jul-2024,Transfer,00.00,"775,598.93","1,551,197.85"
06-Jul-2024,Bill,00.00,"387,799.46","1,163,398.39"
06-Jul-2024,Interest,09.09,00.00,"1,163,407.48"
06-Jul-2024,Cash,00.00,"116,340.75","1,047,066.73"
06-Jul-2024,Miscellaneous,00.00,"349,022.24","698,044.49"
06-Jul-2024,Tax,00.00,"139,608.90","558,435.59"
06-Jul-2024,Bill,00.00,"186,145.20","372,290.39"
06-Jul-2024,Reversal,00.00,"41,365.60","330,924.79"
06-Jul-2024,Debit Card,"1,676,832.75",00.00,"2,007,757.54"
06-Jul-2024,ATM,00.00,"250,969.69","1,756,787.85"
06-Jul-2024,Transfer,"19,827.00",00.00,"1,776,614.85"
06-Jul-2024,Interest,00.00,"197,401.65","1,579,213.20"
06-Jul-2024,Miscellaneous,46.45,00.00,"1,579,259.65"
06-Jul-2024,Interest,00.00,"263,209.94","1,316,049.71"
06-Jul-2024,Tax,"160,887.16",00.00,"1,476,936.87"
06-Jul-2024,ATM,00.00,"147,693.69","1,329,243.18"
07-Jul-2024,ATM,00.00,"221,540.53","1,107,702.65"
07-Jul-2024,RTGS,00.00,"553,851.33","553,851.32"
07-Jul-2024,Reversal,"702,780.00",00.00,"1,256,631.32"
07-Jul-2024,Bill,359.00,00.00,"1,256,990.32"
08-Jul-2024,Tax,00.00,"628,495.16","628,495.16"
08-Jul-2024,Cash,"234,788.00",00.00,"863,283.16"
08-Jul-2024,Purchase,00.00,"95,920.35","767,362.81"
08-Jul-2024,Transfer,"1,323,241.00",00.00,"2,090,603.81"
09-Jul-2024,Miscellaneous,159.00,00.00,"2,090,762.81"
09-Jul-2024,Miscellaneous,00.00,"261,345.35","1,829,417.46"
09-Jul-2024,Cheque,00.00,"182,941.75","1,646,475.71"
09-Jul-2024,Interest,00.00,"235,210.82","1,411,264.89"
09-Jul-2024,Bill,00.00,"1,411,264.89",00.00
09-Jul-2024,Bill,56.00,00.00,56.00
09-Jul-2024,Purchase,"92,465.00",00.00,"92,521.00"
09-Jul-2024,Tax,00.00,"11,565.13","80,955.88"
09-Jul-2024,Tax,00.00,"40,477.94","40,477.94"
09-Jul-2024,ATM,"11,324.00",00.00,"51,801.94"
09-Jul-2024,RTGS,00.00,"12,950.49","38,851.46"
09-Jul-2024,Cheque,96.00,00.00,"38,947.46"
09-Jul-2024,Cash,00.00,"3,894.75","35,052.71"
09-Jul-2024,Bill,17.00,00.00,"35,069.71"
09-Jul-2024,ATM,00.00,"5,844.95","29,224.76"
09-Jul-2024,Commission,"10,495.33",00.00,"39,720.09"
09-Jul-2024,Tax,192.51,00.00,"39,912.60"
09-Jul-2024,ATM,00.00,"7,982.52","31,930.08"
09-Jul-2024,Cash,00.00,"3,991.26","27,938.82"
09-Jul-2024,Miscellaneous,57.80,00.00,"27,996.62"
09-Jul-2024,NEFT,"227,369.47",00.00,"255,366.09"
09-Jul-2024,Cheque,01.10,00.00,"255,367.19"
09-Jul-2024,RTGS,00.00,"127,683.60","127,683.60"
09-Jul-2024,ATM,335.00,00.00,"128,018.60"
10-Jul-2024,Bill,00.00,"21,336.43","106,682.17"
10-Jul-2024,Cheque,00.00,"15,240.31","91,441.86"
10-Jul-2024,ATM,"13,391.30",00.00,"104,833.16"
10-Jul-2024,Tax,"3,032.04",00.00,"107,865.20"
10-Jul-2024,NEFT,"11,562.22",00.00,"119,427.42"
10-Jul-2024,Interest,00.00,"29,856.86","89,570.56"
10-Jul-2024,IMPS,02.00,00.00,"89,572.56"
10-Jul-2024,Cheque,"75,032.00",00.00,"164,604.56"
10-Jul-2024,IMPS,00.00,"27,434.09","137,170.47"
10-Jul-2024,NEFT,"215,310.30",00.00,"352,480.77"
10-Jul-2024,Tax,00.00,"352,480.77",00.00
10-Jul-2024,Debit Card,444.00,00.00,444.00
10-Jul-2024,Transfer,00.00,44.40,399.60
10-Jul-2024,Tax,431.90,00.00,831.50
10-Jul-2024,Cheque,00.00,415.75,415.75
10-Jul-2024,Bill,380.00,00.00,795.75
10-Jul-2024,Cheque,00.00,159.15,636.60
10-Jul-2024,RTGS,"41,800.50",00.00,"42,437.10"
10-Jul-2024,Tax,"15,616.50",00.00,"58,053.60"
10-Jul-2024,NEFT,00.00,"7,256.70","50,796.90"
10-Jul-2024,NEFT,00.00,"25,398.45","25,398.45"
10-Jul-2024,Debit Card,00.00,"12,699.23","12,699.22"
10-Jul-2024,Cash,00.00,"6,349.61","6,349.61"
10-Jul-2024,Bill,"3,573.84",00.00,"9,923.45"
10-Jul-2024,Debit Card,"1,155,664.80",00.00,"1,165,588.25"
10-Jul-2024,Purchase,"20,402.48",00.00,"1,185,990.73"
10-Jul-2024,RTGS,00.00,"118,599.07","1,067,391.66"
10-Jul-2024,NEFT,467.00,00.00,"1,067,858.66"
10-Jul-2024,Cheque,00.00,"133,482.33","934,376.33"
10-Jul-2024,Tax,103.00,00.00,"934,479.33"
10-Jul-2024,Transfer,00.00,"233,619.83","700,859.50"
10-Jul-2024,Commission,10.40,00.00,"700,869.90"
10-Jul-2024,Debit Card,00.00,"140,173.98","560,695.92"
10-Jul-2024,Interest,120.28,00.00,"560,816.20"
10-Jul-2024,Cash,44.20,00.00,"560,860.40"
10-Jul-2024,Tax,00.00,"112,172.08","448,688.32"
10-Jul-2024,Bill,00.00,"56,086.04","392,602.28"
10-Jul-2024,Cheque,00.00,"98,150.57","294,451.71"
10-Jul-2024,Transfer,27.63,00.00,"294,479.34"
10-Jul-2024,NEFT,"886,937.00",00.00,"1,181,416.34"
10-Jul-2024,Cheque,433.90,00.00,"1,181,850.24"
10-Jul-2024,Cash,"186,713.30",00.00,"1,368,563.54"
10-Jul-2024,IMPS,"124,458.28",00.00,"1,493,021.82"
10-Jul-2024,Debit Card,00.00,"373,255.46","1,119,766.36"
10-Jul-2024,Cash,00.00,"124,418.48","995,347.88"
10-Jul-2024,Cash,07.00,00.00,"995,354.88"
10-Jul-2024,Interest,00.00,"110,594.99","884,759.89"
10-Jul-2024,RTGS,03.60,00.00,"884,763.49"
10-Jul-2024,Transfer,00.00,"88,476.35","796,287.14"
10-Jul-2024,ATM,00.00,"398,143.57","398,143.57"
10-Jul-2024,Cheque,00.00,"199,071.79","199,071.78"
10-Jul-2024,Interest,"478,042.00",00.00,"677,113.78"
10-Jul-2024,NEFT,"1,273,334.00",00.00,"1,950,447.78"
10-Jul-2024,Miscellaneous,00.00,"243,805.97","1,706,641.81"
10-Jul-2024,Commission,00.00,"1,706,641.81",00.00
10-Jul-2024,Miscellaneous,144.00,00.00,144.00
10-Jul-2024,NEFT,00.00,144.00,00.00
10-Jul-2024,Cheque,07.47,00.00,07.47
10-Jul-2024,Reversal,00.00,00.83,06.64
10-Jul-2024,Bill,00.00,00.95,05.69
10-Jul-2024,ATM,62.56,00.00,68.25
10-Jul-2024,ATM,00.00,07.58,60.67
10-Jul-2024,Transfer,00.00,06.74,53.93
10-Jul-2024,Bill,00.00,17.98,35.95
10-Jul-2024,Bill,00.00,04.49,31.46
10-Jul-2024,ATM,00.00,04.49,26.97
10-Jul-2024,ATM,"30,468.00",00.00,"30,494.97"
10-Jul-2024,NEFT,"1,007,046.00",00.00,"1,037,540.97"
10-Jul-2024,Cash,88.20,00.00,"1,037,629.17"
10-Jul-2024,Transfer,"1,716.58",00.00,"1,039,345.75"
10-Jul-2024,IMPS,80.00,00.00,"1,039,425.75"
10-Jul-2024,RTGS,00.00,"129,928.22","909,497.53"
10-Jul-2024,Reversal,00.00,"101,055.28","808,442.25"
10-Jul-2024,Transfer,00.00,"404,221.13","404,221.12"
10-Jul-2024,Tax,00.00,"404,221.12",00.00
10-Jul-2024,RTGS,"3,984.40",00.00,"3,984.40"
10-Jul-2024,RTGS,"2,625.00",00.00,"6,609.40"
10-Jul-2024,RTGS,00.00,734.38,"5,875.02"
10-Jul-2024,NEFT,00.00,"1,468.76","4,406.27"
10-Jul-2024,Transfer,00.00,489.59,"3,916.68"
10-Jul-2024,ATM,"1,500.11",00.00,"5,416.79"
10-Jul-2024,Debit Card,"16,911.88",00.00,"22,328.67"
10-Jul-2024,Cash,00.00,"11,164.34","11,164.34"
10-Jul-2024,Debit Card,00.00,"1,860.72","9,303.62"
10-Jul-2024,Debit Card,00.00,"9,303.62",00.00
10-Jul-2024,Interest,"7,130.00",00.00,"7,130.00"
10-Jul-2024,NEFT,00.00,792.22,"6,337.78"
10-Jul-2024,Tax,00.00,"2,112.59","4,225.19"
10-Jul-2024,Miscellaneous,"2,855.30",00.00,"7,080.49"
10-Jul-2024,RTGS,608.70,00.00,"7,689.19"
10-Jul-2024,Cash,145.00,00.00,"7,834.19"
10-Jul-2024,Purchase,00.00,979.27,"6,854.92"
10-Jul-2024,IMPS,228.00,00.00,"7,082.92"
10-Jul-2024,RTGS,00.00,786.99,"6,295.93"
10-Jul-2024,ATM,00.00,"1,259.19","5,036.74"
10-Jul-2024,RTGS,00.00,839.46,"4,197.28"
10-Jul-2024,Interest,"103,144.84",00.00,"107,342.12"
10-Jul-2024,NEFT,00.00,"15,334.59","92,007.53"
10-Jul-2024,NEFT,449.23,00.00,"92,456.76"
10-Jul-2024,ATM,00.00,"13,208.11","79,248.65"
10-Jul-2024,RTGS,"3,814.00",00.00,"83,062.65"
10-Jul-2024,Cash,00.00,"16,612.53","66,450.12"
10-Jul-2024,Debit Card,00.00,"33,225.06","33,225.06"
10-Jul-2024,Cash,00.00,"16,612.53","16,612.53"
10-Jul-2024,Purchase,"1,145.27",00.00,"17,757.80"
10-Jul-2024,Reversal,53.10,00.00,"17,810.90"
10-Jul-2024,Bill,04.50,00.00,"17,815.40"
10-Jul-2024,Commission,25.00,00.00,"17,840.40"
10-Jul-2024,Miscellaneous,"2,069,791.80",00.00,"2,087,632.20"
10-Jul-2024,Bill,242.30,00.00,"2,087,874.50"
10-Jul-2024,IMPS,02.34,00.00,"2,087,876.84"
10-Jul-2024,Reversal,"217,232.00",00.00,"2,305,108.84"
10-Jul-2024,Cash,00.00,"461,021.77","1,844,087.07"
10-Jul-2024,Transfer,"27,457.30",00.00,"1,871,544.37"
10-Jul-2024,Cash,00.00,"623,848.12","1,247,696.25"
10-Jul-2024,IMPS,"83,489.20",00.00,"1,331,185.45"
10-Jul-2024,Bill,00.00,"332,796.36","998,389.09"
10-Jul-2024,IMPS,00.00,"166,398.18","831,990.91"
10-Jul-2024,Purchase,00.00,"277,330.30","554,660.61"
10-Jul-2024,RTGS,43.00,00.00,"554,703.61"
10-Jul-2024,Interest,00.00,"277,351.81","277,351.80"
10-Jul-2024,Purchase,00.00,"277,351.80",00.00
10-Jul-2024,Reversal,"1,017.80",00.00,"1,017.80"
10-Jul-2024,Transfer,00.00,508.90,508.90
10-Jul-2024,IMPS,"1,797,547.80",00.00,"1,798,056.70"
10-Jul-2024,ATM,00.00,"224,757.09","1,573,299.61"
10-Jul-2024,Cash,00.00,"157,329.96","1,415,969.65"
10-Jul-2024,Cheque,00.00,"141,596.97","1,274,372.68"
10-Jul-2024,NEFT,"144,223.00",00.00,"1,418,595.68"
10-Jul-2024,Tax,"2,035,068.50",00.00,"3,453,664.18"
10-Jul-2024,Cash,145.00,00.00,"3,453,809.18"
10-Jul-2024,NEFT,06.20,00.00,"3,453,815.38"
10-Jul-2024,Purchase,"1,719,729.80",00.00,"5,173,545.18"
10-Jul-2024,Miscellaneous,00.00,"2,586,772.59","2,586,772.59"
10-Jul-2024,Transfer,16.68,00.00,"2,586,789.27"
10-Jul-2024,Commission,00.00,"862,263.09","1,724,526.18"
10-Jul-2024,Interest,61.00,00.00,"1,724,587.18"
10-Jul-2024,Commission,00.00,"287,431.20","1,437,155.98"
10-Jul-2024,Interest,00.00,"179,644.50","1,257,511.48"
10-Jul-2024,Miscellaneous,03.03,00.00,"1,257,514.51"
10-Jul-2024,Bill,"21,313.00",00.00,"1,278,827.51"
10-Jul-2024,Tax,219.00,00.00,"1,279,046.51"
10-Jul-2024,Commission,32.07,00.00,"1,279,078.58"
10-Jul-2024,Miscellaneous,"8,921.40",00.00,"1,287,999.98"
10-Jul-2024,Cash,00.00,"128,800.00","1,159,199.98"
10-Jul-2024,Bill,"229,525.10",00.00,"1,388,725.08"
10-Jul-2024,Reversal,00.00,"694,362.54","694,362.54"
10-Jul-2024,Transfer,"100,348.20",00.00,"794,710.74"
10-Jul-2024,Cash,00.00,"794,710.74",00.00
11-Jul-2024,Purchase,88.00,00.00,88.00
11-Jul-2024,NEFT,00.00,44.00,44.00
12-Jul-2024,Debit Card,00.00,22.00,22.00
12-Jul-2024,Purchase,00.00,07.33,14.67
12-Jul-2024,Miscellaneous,"1,179.00",00.00,"1,193.67"
12-Jul-2024,Reversal,00.00,149.21,"1,044.46"
12-Jul-2024,Bill,00.00,208.89,835.57
12-Jul-2024,Reversal,00.00,83.56,752.01
12-Jul-2024,ATM,"13,208.00",00.00,"13,960.01"
12-Jul-2024,NEFT,00.00,"13,960.01",00.00
13-Jul-2024,NEFT,08.70,00.00,08.70
13-Jul-2024,Reversal,00.00,01.45,07.25
13-Jul-2024,Debit Card,"104,123.00",00.00,"104,130.25"
13-Jul-2024,IMPS,00.00,"11,570.03","92,560.22"
13-Jul-2024,NEFT,00.00,"18,512.04","74,048.18"
13-Jul-2024,NEFT,00.00,"12,341.36","61,706.82"
13-Jul-2024,RTGS,"1,448.60",00.00,"63,155.42"
13-Jul-2024,Reversal,00.00,"31,577.71","31,577.71"
13-Jul-2024,Cash,00.00,"3,947.21","27,630.50"
13-Jul-2024,NEFT,00.00,"3,947.21","23,683.29"
13-Jul-2024,Cash,03.78,00.00,"23,687.07"
13-Jul-2024,Reversal,00.00,"7,895.69","15,791.38"
13-Jul-2024,Tax,00.00,"2,255.91","13,535.47"
13-Jul-2024,ATM,24.00,00.00,"13,559.47"
13-Jul-2024,NEFT,04.00,00.00,"13,563.47"
13-Jul-2024,IMPS,00.00,"1,937.64","11,625.83"
13-Jul-2024,Reversal,00.00,"1,291.76","10,334.07"
13-Jul-2024,Reversal,"2,212.00",00.00,"12,546.07"
14-Jul-2024,Bill,"12,420.00",00.00,"24,966.07"
14-Jul-2024,RTGS,00.00,"3,566.58","21,399.49"
14-Jul-2024,Reversal,03.70,00.00,"21,403.19"
14-Jul-2024,IMPS,00.00,"21,403.19",00.00
14-Jul-2024,Transfer,298.00,00.00,298.00
14-Jul-2024,IMPS,00.00,99.33,198.67
14-Jul-2024,IMPS,245.90,00.00,444.57
14-Jul-2024,Cheque,00.00,63.51,381.06
14-Jul-2024,Purchase,"23,345.35",00.00,"23,726.41"
14-Jul-2024,IMPS,00.00,"7,908.80","15,817.61"
14-Jul-2024,Debit Card,03.70,00.00,"15,821.31"
14-Jul-2024,Tax,04.00,00.00,"15,825.31"
14-Jul-2024,ATM,00.00,"2,637.55","13,187.76"
14-Jul-2024,Tax,270.20,00.00,"13,457.96"
14-Jul-2024,Tax,06.91,00.00,"13,464.87"
14-Jul-2024,RTGS,33.78,00.00,"13,498.65"
14-Jul-2024,Cash,42.50,00.00,"13,541.15"
14-Jul-2024,Reversal,"122,732.53",00.00,"136,273.68"
14-Jul-2024,Commission,05.00,00.00,"136,278.68"
14-Jul-2024,Bill,"258,812.20",00.00,"395,090.88"
14-Jul-2024,Bill,"183,760.94",00.00,"578,851.82"
14-Jul-2024,IMPS,"149,968.90",00.00,"728,820.72"
14-Jul-2024,Miscellaneous,"2,367.91",00.00,"731,188.63"
14-Jul-2024,Miscellaneous,07.84,00.00,"731,196.47"
14-Jul-2024,Bill,00.00,"731,196.47",00.00
14-Jul-2024,Commission,"238,857.28",00.00,"238,857.28"
14-Jul-2024,Interest,44.30,00.00,"238,901.58"
14-Jul-2024,RTGS,00.00,"23,890.16","215,011.42"
14-Jul-2024,NEFT,28.89,00.00,"215,040.31"
14-Jul-2024,Interest,00.00,"30,720.04","184,320.27"
14-Jul-2024,RTGS,"109,120.88",00.00,"293,441.15"
14-Jul-2024,Tax,00.00,"293,441.15",00.00
14-Jul-2024,Commission,06.00,00.00,06.00
14-Jul-2024,Cheque,00.00,01.20,04.80
14-Jul-2024,Commission,153.35,00.00,158.15
14-Jul-2024,Debit Card,"8,429.72",00.00,"8,587.87"
14-Jul-2024,Purchase,00.00,"1,431.31","7,156.56"
14-Jul-2024,RTGS,117.00,00.00,"7,273.56"
14-Jul-2024,Miscellaneous,"13,802.95",00.00,"21,076.51"
14-Jul-2024,Transfer,00.00,"10,538.26","10,538.26"
14-Jul-2024,Transfer,00.00,"10,538.26",00.00
15-Jul-2024,Miscellaneous,02.31,00.00,02.31
15-Jul-2024,IMPS,00.00,00.23,02.08
15-Jul-2024,Bill,15.65,00.00,17.73
15-Jul-2024,Reversal,63.00,00.00,80.73
15-Jul-2024,NEFT,"241,785.25",00.00,"241,865.98"
15-Jul-2024,Debit Card,00.00,"26,874.00","214,991.98"
15-Jul-2024,Bill,"1,701,798.80",00.00,"1,916,790.78"
15-Jul-2024,NEFT,00.00,"319,465.13","1,597,325.65"
15-Jul-2024,Interest,"196,031.50",00.00,"1,793,357.15"
15-Jul-2024,Interest,00.00,"199,261.91","1,594,095.24"
15-Jul-2024,Cheque,00.00,"199,261.91","1,394,833.34"
15-Jul-2024,Debit Card,"32,207.49",00.00,"1,427,040.83"
15-Jul-2024,NEFT,"640,543.25",00.00,"2,067,584.08"
15-Jul-2024,ATM,181.00,00.00,"2,067,765.08"
15-Jul-2024,Cash,00.00,"229,751.68","1,838,013.40"
15-Jul-2024,Transfer,00.00,"367,602.68","1,470,410.72"
15-Jul-2024,ATM,00.00,"294,082.14","1,176,328.58"
15-Jul-2024,Commission,02.42,00.00,"1,176,331.00"
15-Jul-2024,Debit Card,00.00,"1,176,331.00",00.00
15-Jul-2024,IMPS,11.00,00.00,11.00
15-Jul-2024,Interest,"2,009.08",00.00,"2,020.08"
15-Jul-2024,Purchase,"20,207.50",00.00,"22,227.58"
15-Jul-2024,RTGS,00.00,"7,409.19","14,818.39"
15-Jul-2024,Transfer,06.30,00.00,"14,824.69"
15-Jul-2024,IMPS,00.00,"3,706.17","11,118.52"
15-Jul-2024,RTGS,"2,670.20",00.00,"13,788.72"
15-Jul-2024,Purchase,"204,944.72",00.00,"218,733.44"
15-Jul-2024,Commission,"27,318.20",00.00,"246,051.64"
16-Jul-2024,IMPS,00.00,"27,339.07","218,712.57"
17-Jul-2024,Bill,00.00,"27,339.07","191,373.50"
17-Jul-2024,ATM,00.00,"31,895.58","159,477.92"
17-Jul-2024,Cheque,89.00,00.00,"159,566.92"
17-Jul-2024,IMPS,00.00,"26,594.49","132,972.43"
17-Jul-2024,Transfer,05.00,00.00,"132,977.43"
17-Jul-2024,NEFT,"30,312.20",00.00,"163,289.63"
17-Jul-2024,Cheque,00.00,"40,822.41","122,467.22"
17-Jul-2024,Reversal,36.30,00.00,"122,503.52"
17-Jul-2024,Cash,00.00,"12,250.35","110,253.17"
17-Jul-2024,ATM,"34,423.84",00.00,"144,677.01"
17-Jul-2024,Cash,"2,959.40",00.00,"147,636.41"
17-Jul-2024,Bill,00.00,"29,527.28","118,109.13"
17-Jul-2024,Commission,00.00,"118,109.13",00.00
17-Jul-2024,Bill,"176,706.22",00.00,"176,706.22"
17-Jul-2024,Reversal,00.00,"17,670.62","159,035.60"
17-Jul-2024,IMPS,"23,734.91",00.00,"182,770.51"
17-Jul-2024,Miscellaneous,"28,190.00",00.00,"210,960.51"
17-Jul-2024,RTGS,07.20,00.00,"210,967.71"
17-Jul-2024,RTGS,00.00,"26,370.96","184,596.75"
17-Jul-2024,Reversal,"2,884.74",00.00,"187,481.49"
17-Jul-2024,Interest,01.00,00.00,"187,482.49"
17-Jul-2024,Transfer,00.00,"37,496.50","149,985.99"
17-Jul-2024,IMPS,00.00,"14,998.60","134,987.39"
17-Jul-2024,Debit Card,"23,807.46",00.00,"158,794.85"
17-Jul-2024,Tax,120.90,00.00,"158,915.75"
17-Jul-2024,Transfer,00.00,"15,891.58","143,024.17"
17-Jul-2024,Reversal,01.00,00.00,"143,025.17"
17-Jul-2024,Cheque,00.00,"71,512.59","71,512.59"
17-Jul-2024,Tax,136.70,00.00,"71,649.29"
17-Jul-2024,IMPS,00.00,"71,649.29",00.00
17-Jul-2024,Tax,89.00,00.00,89.00
17-Jul-2024,Commission,07.90,00.00,96.90
17-Jul-2024,Debit Card,00.00,48.45,48.45
17-Jul-2024,IMPS,00.00,08.08,40.38
17-Jul-2024,Purchase,00.00,08.08,32.30
17-Jul-2024,Cash,"1,919,686.25",00.00,"1,919,718.55"
17-Jul-2024,Commission,00.00,"959,859.28","959,859.28"
17-Jul-2024,RTGS,19.10,00.00,"959,878.38"
17-Jul-2024,RTGS,"146,543.20",00.00,"1,106,421.58"
17-Jul-2024,Debit Card,"166,005.00",00.00,"1,272,426.58"
17-Jul-2024,ATM,06.00,00.00,"1,272,432.58"
17-Jul-2024,Miscellaneous,"497,623.00",00.00,"1,770,055.58"
17-Jul-2024,Tax,412.80,00.00,"1,770,468.38"
17-Jul-2024,IMPS,"903,980.00",00.00,"2,674,448.38"
17-Jul-2024,Interest,06.00,00.00,"2,674,454.38"
17-Jul-2024,Commission,00.00,"534,890.88","2,139,563.50"
17-Jul-2024,Purchase,00.00,"534,890.88","1,604,672.62"
17-Jul-2024,NEFT,05.42,00.00,"1,604,678.04"
17-Jul-2024,Miscellaneous,54.00,00.00,"1,604,732.04"
17-Jul-2024,Reversal,00.00,"160,473.20","1,444,258.84"
17-Jul-2024,Tax,00.00,"160,473.20","1,283,785.64"
18-Jul-2024,Purchase,00.00,"320,946.41","962,839.23"
19-Jul-2024,ATM,00.00,"320,946.41","641,892.82"
19-Jul-2024,Commission,00.00,"64,189.28","577,703.54"
19-Jul-2024,Reversal,00.00,"577,703.54",00.00
19-Jul-2024,Purchase,"799,093.20",00.00,"799,093.20"
19-Jul-2024,Interest,798.23,00.00,"799,891.43"
19-Jul-2024,Debit Card,00.00,"114,270.20","685,621.23"
19-Jul-2024,ATM,00.00,"685,621.23",00.00
19-Jul-2024,Transfer,"122,223.03",00.00,"122,223.03"
19-Jul-2024,Cheque,458.10,00.00,"122,681.13"
19-Jul-2024,ATM,00.00,"20,446.86","102,234.28"
19-Jul-2024,Commission,02.60,00.00,"102,236.88"
19-Jul-2024,RTGS,"536,603.20",00.00,"638,840.08"
19-Jul-2024,ATM,00.00,"159,710.02","479,130.06"
19-Jul-2024,Debit Card,"1,709,352.80",00.00,"2,188,482.86"
19-Jul-2024,ATM,00.00,"218,848.29","1,969,634.57"
20-Jul-2024,Reversal,37.70,00.00,"1,969,672.27"
20-Jul-2024,Bill,32.10,00.00,"1,969,704.37"
20-Jul-2024,Cheque,00.00,"984,852.19","984,852.18"
20-Jul-2024,Reversal,883.40,00.00,"985,735.58"
21-Jul-2024,Miscellaneous,"16,680.00",00.00,"1,002,415.58"
21-Jul-2024,ATM,00.00,"334,138.53","668,277.05"
22-Jul-2024,Bill,"230,525.84",00.00,"898,802.89"
22-Jul-2024,Commission,"4,702.20",00.00,"903,505.09"
22-Jul-2024,Tax,"87,736.53",00.00,"991,241.62"
22-Jul-2024,IMPS,"3,882.00",00.00,"995,123.62"
23-Jul-2024,Purchase,00.00,"110,569.29","884,554.33"
23-Jul-2024,Commission,"1,962,984.00",00.00,"2,847,538.33"
23-Jul-2024,Miscellaneous,"3,342.45",00.00,"2,850,880.78"
23-Jul-2024,Reversal,"2,236.80",00.00,"2,853,117.58"
23-Jul-2024,IMPS,05.69,00.00,"2,853,123.27"
23-Jul-2024,Cash,00.00,"475,520.55","2,377,602.72"
23-Jul-2024,Transfer,"20,821.28",00.00,"2,398,424.00"
23-Jul-2024,Miscellaneous,00.00,"479,684.80","1,918,739.20"
23-Jul-2024,NEFT,00.00,"639,579.73","1,279,159.47"
23-Jul-2024,Commission,494.00,00.00,"1,279,653.47"
23-Jul-2024,Reversal,397.00,00.00,"1,280,050.47"
23-Jul-2024,RTGS,374.59,00.00,"1,280,425.06"
23-Jul-2024,RTGS,00.00,"320,106.27","960,318.80"
23-Jul-2024,Interest,00.00,"480,159.40","480,159.40"
23-Jul-2024,Reversal,00.00,"240,079.70","240,079.70"
23-Jul-2024,RTGS,00.00,"80,026.57","160,053.13"
23-Jul-2024,Miscellaneous,"15,738.00",00.00,"175,791.13"
23-Jul-2024,Transfer,"1,062.00",00.00,"176,853.13"
23-Jul-2024,NEFT,00.00,"35,370.63","141,482.50"
23-Jul-2024,Tax,00.00,"47,160.83","94,321.67"
23-Jul-2024,RTGS,00.00,"31,440.56","62,881.11"
23-Jul-2024,Tax,00.00,"15,720.28","47,160.83"
23-Jul-2024,RTGS,00.00,"6,737.26","40,423.57"
23-Jul-2024,Cheque,"8,579.62",00.00,"49,003.19"
23-Jul-2024,Bill,00.00,"24,501.60","24,501.60"
23-Jul-2024,Transfer,489.00,00.00,"24,990.60"
23-Jul-2024,Miscellaneous,"19,931.39",00.00,"44,921.99"
23-Jul-2024,IMPS,"1,917,267.00",00.00,"1,962,188.99"
23-Jul-2024,Reversal,00.00,"218,021.00","1,744,167.99"
23-Jul-2024,Cash,"1,814,500.50",00.00,"3,558,668.49"
23-Jul-2024,NEFT,00.00,"355,866.85","3,202,801.64"
23-Jul-2024,NEFT,00.00,"1,067,600.55","2,135,201.09"
23-Jul-2024,Purchase,347.00,00.00,"2,135,548.09"
23-Jul-2024,Bill,00.00,"427,109.62","1,708,438.47"
23-Jul-2024,Transfer,00.00,"569,479.49","1,138,958.98"
23-Jul-2024,RTGS,"70,625.10",00.00,"1,209,584.08"
23-Jul-2024,Bill,"3,906.00",00.00,"1,213,490.08"
23-Jul-2024,Cash,"899,642.50",00.00,"2,113,132.58"
23-Jul-2024,Miscellaneous,05.88,00.00,"2,113,138.46"
23-Jul-2024,Commission,00.00,"422,627.69","1,690,510.77"
23-Jul-2024,ATM,92.87,00.00,"1,690,603.64"
23-Jul-2024,Commission,00.00,"281,767.27","1,408,836.37"
23-Jul-2024,Interest,00.00,"201,262.34","1,207,574.03"
23-Jul-2024,Bill,00.00,"603,787.02","603,787.02"
23-Jul-2024,Reversal,"3,024.50",00.00,"606,811.52"
23-Jul-2024,ATM,00.00,"303,405.76","303,405.76"
23-Jul-2024,Cash,00.00,"33,711.75","269,694.01"
23-Jul-2024,Bill,772.00,00.00,"270,466.01"
23-Jul-2024,IMPS,00.00,"67,616.50","202,849.51"
23-Jul-2024,Miscellaneous,"13,405.44",00.00,"216,254.95"
23-Jul-2024,Commission,"1,327.60",00.00,"217,582.55"
23-Jul-2024,ATM,00.00,"43,516.51","174,066.04"
23-Jul-2024,Miscellaneous,"15,941.40",00.00,"190,007.44"
23-Jul-2024,Commission,"125,772.81",00.00,"315,780.25"
23-Jul-2024,Miscellaneous,"1,066,126.25",00.00,"1,381,906.50"
23-Jul-2024,Miscellaneous,00.00,"460,635.50","921,271.00"
23-Jul-2024,Transfer,"149,100.00",00.00,"1,070,371.00"
23-Jul-2024,Bill,00.00,"1,070,371.00",00.00
23-Jul-2024,Miscellaneous,01.10,00.00,01.10
23-Jul-2024,Debit Card,335.95,00.00,337.05
24-Jul-2024,Purchase,"1,618,975.00",00.00,"1,619,312.05"
24-Jul-2024,Cash,"3,800.00",00.00,"1,623,112.05"
24-Jul-2024,Miscellaneous,08.18,00.00,"1,623,120.23"
24-Jul-2024,IMPS,00.00,"324,624.05","1,298,496.18"
24-Jul-2024,RTGS,38.80,00.00,"1,298,534.98"
25-Jul-2024,RTGS,00.00,"185,505.00","1,113,029.98"
25-Jul-2024,ATM,"196,226.91",00.00,"1,309,256.89"
25-Jul-2024,Bill,103.40,00.00,"1,309,360.29"
25-Jul-2024,RTGS,26.80,00.00,"1,309,387.09"
25-Jul-2024,Cash,"799,890.00",00.00,"2,109,277.09"
25-Jul-2024,Debit Card,150.00,00.00,"2,109,427.09"
25-Jul-2024,Cash,00.00,"2,109,427.09",00.00
25-Jul-2024,NEFT,"100,639.00",00.00,"100,639.00"
25-Jul-2024,Tax,"14,872.70",00.00,"115,511.70"
25-Jul-2024,Transfer,399.39,00.00,"115,911.09"
25-Jul-2024,Reversal,"236,706.88",00.00,"352,617.97"
25-Jul-2024,Transfer,"131,621.30",00.00,"484,239.27"
25-Jul-2024,Cash,00.00,"48,423.93","435,815.34"
25-Jul-2024,Cash,00.00,"87,163.07","348,652.27"
25-Jul-2024,NEFT,02.83,00.00,"348,655.10"
25-Jul-2024,Cheque,52.90,00.00,"348,708.00"
25-Jul-2024,RTGS,00.00,"174,354.00","174,354.00"
25-Jul-2024,Reversal,00.00,"24,907.71","149,446.29"
25-Jul-2024,Bill,"26,279.00",00.00,"175,725.29"
26-Jul-2024,Cash,177.00,00.00,"175,902.29"
26-Jul-2024,IMPS,"2,050,238.50",00.00,"2,226,140.79"
26-Jul-2024,Cheque,00.00,"445,228.16","1,780,912.63"
26-Jul-2024,Cheque,08.60,00.00,"1,780,921.23"
26-Jul-2024,Miscellaneous,00.00,"222,615.15","1,558,306.08"
27-Jul-2024,Cash,00.00,"222,615.15","1,335,690.93"
27-Jul-2024,Bill,00.00,"1,335,690.93",00.00
27-Jul-2024,Purchase,"6,292.00",00.00,"6,292.00"
27-Jul-2024,IMPS,"17,120.90",00.00,"23,412.90"
27-Jul-2024,RTGS,00.60,00.00,"23,413.50"
27-Jul-2024,RTGS,"9,622.00",00.00,"33,035.50"
27-Jul-2024,NEFT,"1,107.00",00.00,"34,142.50"
27-Jul-2024,ATM,03.00,00.00,"34,145.50"
27-Jul-2024,NEFT,00.00,"8,536.38","25,609.12"
27-Jul-2024,IMPS,00.00,"25,609.12",00.00
27-Jul-2024,Miscellaneous,"1,291,961.00",00.00,"1,291,961.00"
27-Jul-2024,Interest,"225,007.59",00.00,"1,516,968.59"
27-Jul-2024,Debit Card,57.00,00.00,"1,517,025.59"
27-Jul-2024,IMPS,"24,033.80",00.00,"1,541,059.39"
27-Jul-2024,Bill,00.00,"154,105.94","1,386,953.45"
27-Jul-2024,NEFT,41.84,00.00,"1,386,995.29"
27-Jul-2024,Debit Card,00.00,"231,165.88","1,155,829.41"
27-Jul-2024,IMPS,00.00,"128,425.49","1,027,403.92"
27-Jul-2024,Cheque,07.00,00.00,"1,027,410.92"
27-Jul-2024,Tax,03.40,00.00,"1,027,414.32"
27-Jul-2024,Transfer,00.00,"513,707.16","513,707.16"
27-Jul-2024,Bill,"162,491.00",00.00,"676,198.16"
27-Jul-2024,Debit Card,04.26,00.00,"676,202.42"
27-Jul-2024,Miscellaneous,"4,332.00",00.00,"680,534.42"
27-Jul-2024,NEFT,00.00,"680,534.42",00.00
27-Jul-2024,ATM,01.00,00.00,01.00
27-Jul-2024,Purchase,00.00,00.10,00.90
27-Jul-2024,Purchase,"1,158,536.75",00.00,"1,158,537.65"
27-Jul-2024,Transfer,40.00,00.00,"1,158,577.65"
27-Jul-2024,Purchase,00.00,"1,158,577.65",00.00
27-Jul-2024,Cheque,"24,429.75",00.00,"24,429.75"
27-Jul-2024,ATM,00.00,"3,053.72","21,376.03"
27-Jul-2024,NEFT,00.00,"2,375.11","19,000.92"
27-Jul-2024,Commission,00.00,"3,800.18","15,200.74"
27-Jul-2024,ATM,00.00,"5,066.91","10,133.83"
27-Jul-2024,Cheque,00.00,"1,125.98","9,007.85"
27-Jul-2024,IMPS,00.00,"9,007.85",00.00
27-Jul-2024,Purchase,"17,344.57",00.00,"17,344.57"
27-Jul-2024,Commission,31.12,00.00,"17,375.69"
27-Jul-2024,Cash,00.00,"1,930.63","15,445.06"
27-Jul-2024,Commission,07.90,00.00,"15,452.96"
27-Jul-2024,Cheque,"29,101.10",00.00,"44,554.06"
27-Jul-2024,ATM,"8,570.30",00.00,"53,124.36"
27-Jul-2024,Transfer,01.00,00.00,"53,125.36"
27-Jul-2024,Cash,00.00,"13,281.34","39,844.02"
27-Jul-2024,NEFT,00.00,"6,640.67","33,203.35"
27-Jul-2024,Debit Card,00.00,"3,320.34","29,883.02"
27-Jul-2024,Miscellaneous,"3,035.58",00.00,"32,918.60"
27-Jul-2024,Transfer,"1,766.00",00.00,"34,684.60"
27-Jul-2024,Purchase,"194,606.00",00.00,"229,290.60"
27-Jul-2024,Reversal,00.00,"28,661.33","200,629.28"
27-Jul-2024,Bill,"551,258.75",00.00,"751,888.03"
27-Jul-2024,Reversal,00.00,"107,412.58","644,475.45"
27-Jul-2024,Interest,00.00,"322,237.73","322,237.72"
27-Jul-2024,Cheque,03.79,00.00,"322,241.51"
27-Jul-2024,Bill,00.00,"161,120.76","161,120.76"
27-Jul-2024,Debit Card,29.70,00.00,"161,150.46"
27-Jul-2024,Bill,"16,456.30",00.00,"177,606.76"
27-Jul-2024,Reversal,399.59,00.00,"178,006.35"
27-Jul-2024,ATM,00.00,"19,778.48","158,227.87"
27-Jul-2024,Bill,750.70,00.00,"158,978.57"
27-Jul-2024,Debit Card,00.00,"52,992.86","105,985.71"
27-Jul-2024,Interest,00.00,"11,776.19","94,209.52"
27-Jul-2024,Purchase,00.00,"94,209.52",00.00
27-Jul-2024,Commission,"6,718.10",00.00,"6,718.10"
27-Jul-2024,Debit Card,"30,453.00",00.00,"37,171.10"
27-Jul-2024,Miscellaneous,330.50,00.00,"37,501.60"
27-Jul-2024,Cash,"1,564.20",00.00,"39,065.80"
27-Jul-2024,Commission,05.00,00.00,"39,070.80"
27-Jul-2024,Reversal,03.80,00.00,"39,074.60"
27-Jul-2024,Interest,00.00,"4,341.62","34,732.98"
27-Jul-2024,Commission,00.00,"4,961.85","29,771.13"
27-Jul-2024,Interest,00.00,"3,307.90","26,463.23"
27-Jul-2024,NEFT,00.00,"26,463.23",00.00
27-Jul-2024,ATM,"1,863,273.00",00.00,"1,863,273.00"
27-Jul-2024,Debit Card,00.00,"266,181.86","1,597,091.14"
27-Jul-2024,Miscellaneous,00.00,"159,709.11","1,437,382.03"
27-Jul-2024,Interest,00.00,"359,345.51","1,078,036.52"
27-Jul-2024,Interest,00.00,"134,754.57","943,281.96"
27-Jul-2024,Transfer,03.20,00.00,"943,285.16"
27-Jul-2024,Miscellaneous,"32,048.80",00.00,"975,333.96"
27-Jul-2024,IMPS,"172,805.00",00.00,"1,148,138.96"
27-Jul-2024,Debit Card,"1,237.00",00.00,"1,149,375.96"
27-Jul-2024,Purchase,389.10,00.00,"1,149,765.06"
27-Jul-2024,Bill,00.00,"1,149,765.06",00.00
27-Jul-2024,Purchase,"2,846.00",00.00,"2,846.00"
27-Jul-2024,Tax,"243,301.20",00.00,"246,147.20"
27-Jul-2024,Miscellaneous,"2,002,245.75",00.00,"2,248,392.95"
27-Jul-2024,Commission,01.80,00.00,"2,248,394.75"
27-Jul-2024,Commission,"152,501.41",00.00,"2,400,896.16"
27-Jul-2024,NEFT,00.00,"240,089.62","2,160,806.54"
27-Jul-2024,Transfer,"3,383.09",00.00,"2,164,189.63"
27-Jul-2024,Commission,00.00,"541,047.41","1,623,142.22"
27-Jul-2024,Bill,"1,578,734.00",00.00,"3,201,876.22"
27-Jul-2024,Reversal,01.00,00.00,"3,201,877.22"
27-Jul-2024,Bill,"619,212.00",00.00,"3,821,089.22"
27-Jul-2024,Commission,00.00,"636,848.20","3,184,241.02"
28-Jul-2024,Purchase,00.00,"1,061,413.67","2,122,827.35"
28-Jul-2024,Cash,32.40,00.00,"2,122,859.75"
28-Jul-2024,Debit Card,07.90,00.00,"2,122,867.65"
28-Jul-2024,Bill,04.69,00.00,"2,122,872.34"
28-Jul-2024,IMPS,"229,290.50",00.00,"2,352,162.84"
28-Jul-2024,Interest,00.00,"2,352,162.84",00.00
28-Jul-2024,ATM,39.00,00.00,39.00
28-Jul-2024,Commission,166.70,00.00,205.70
28-Jul-2024,Tax,00.00,68.57,137.13
28-Jul-2024,Interest,00.00,45.71,91.42
28-Jul-2024,Reversal,265.10,00.00,356.52
28-Jul-2024,RTGS,"15,544.00",00.00,"15,900.52"
28-Jul-2024,Cash,45.00,00.00,"15,945.52"
28-Jul-2024,Cheque,"35,217.50",00.00,"51,163.02"
28-Jul-2024,IMPS,00.00,"12,790.76","38,372.26"
28-Jul-2024,Interest,00.00,"4,263.58","34,108.68"
28-Jul-2024,RTGS,00.00,"4,872.67","29,236.01"
28-Jul-2024,Purchase,02.00,00.00,"29,238.01"
28-Jul-2024,NEFT,"1,401,227.00",00.00,"1,430,465.01"
28-Jul-2024,Cheque,00.00,"715,232.51","715,232.50"
28-Jul-2024,Commission,00.00,"357,616.25","357,616.25"
28-Jul-2024,Commission,00.00,"51,088.04","306,528.21"
28-Jul-2024,Tax,00.00,"102,176.07","204,352.14"
28-Jul-2024,Transfer,00.00,"204,352.14",00.00
28-Jul-2024,RTGS,"2,885.05",00.00,"2,885.05"
28-Jul-2024,RTGS,11.82,00.00,"2,896.87"
28-Jul-2024,Commission,"3,137.90",00.00,"6,034.77"
28-Jul-2024,Cash,00.00,"6,034.77",00.00
28-Jul-2024,Interest,"62,960.78",00.00,"62,960.78"
28-Jul-2024,ATM,143.90,00.00,"63,104.68"
28-Jul-2024,NEFT,106.10,00.00,"63,210.78"
28-Jul-2024,Cheque,00.00,"7,901.35","55,309.43"
28-Jul-2024,Bill,"577,641.25",00.00,"632,950.68"
28-Jul-2024,Cash,"576,611.00",00.00,"1,209,561.68"
29-Jul-2024,Cheque,"12,642.40",00.00,"1,222,204.08"
29-Jul-2024,RTGS,00.00,"174,600.58","1,047,603.50"
29-Jul-2024,Bill,00.00,"209,520.70","838,082.80"
30-Jul-2024,Tax,07.70,00.00,"838,090.50"
30-Jul-2024,Cash,"116,349.22",00.00,"954,439.72"
30-Jul-2024,Commission,832.70,00.00,"955,272.42"
30-Jul-2024,Miscellaneous,00.00,"318,424.14","636,848.28"
30-Jul-2024,Cash,00.00,"636,848.28",00.00
30-Jul-2024,Miscellaneous,"1,439.90",00.00,"1,439.90"
30-Jul-2024,Commission,00.00,159.99,"1,279.91"
30-Jul-2024,Debit Card,00.00,255.98,"1,023.93"
30-Jul-2024,Transfer,00.00,113.77,910.16
30-Jul-2024,Purchase,00.00,182.03,728.13
31-Jul-2024,Debit Card,"3,841.00",00.00,"4,569.13"
31-Jul-2024,Tax,"7,545.00",00.00,"12,114.13"
31-Jul-2024,Commission,00.00,"2,422.83","9,691.30"
31-Jul-2024,Purchase,"3,021.00",00.00,"12,712.30"
31-Jul-2024,Transfer,00.00,"1,589.04","11,123.26"
31-Jul-2024,NEFT,"3,328.88",00.00,"14,452.14"
31-Jul-2024,ATM,"784,602.00",00.00,"799,054.14"
31-Jul-2024,RTGS,"208,878.72",00.00,"1,007,932.86"
31-Jul-2024,RTGS,00.00,"143,990.41","863,942.45"
31-Jul-2024,RTGS,00.00,"107,992.81","755,949.64"
31-Jul-2024,NEFT,"77,729.00",00.00,"833,678.64"
31-Jul-2024,IMPS,00.00,"92,630.96","741,047.68"
31-Jul-2024,Cheque,49.07,00.00,"741,096.75"
31-Jul-2024,ATM,00.00,"148,219.35","592,877.40"
31-Jul-2024,RTGS,00.00,"296,438.70","296,438.70"
31-Jul-2024,ATM,"18,403.93",00.00,"314,842.63"
31-Jul-2024,IMPS,02.91,00.00,"314,845.54"
31-Jul-2024,ATM,"2,539.00",00.00,"317,384.54"
31-Jul-2024,Tax,02.00,00.00,"317,386.54"
31-Jul-2024,Reversal,02.50,00.00,"317,389.04"
31-Jul-2024,Debit Card,00.00,"63,477.81","253,911.23"
31-Jul-2024,RTGS,00.00,"253,911.23",00.00
31-Jul-2024,ATM,02.00,00.00,02.00
31-Jul-2024,Transfer,00.00,00.20,01.80
31-Jul-2024,RTGS,00.00,00.60,01.20
31-Jul-2024,Reversal,00.00,00.15,01.05
31-Jul-2024,Cheque,00.00,00.53,00.52
31-Jul-2024,Cheque,"3,723.00",00.00,"3,723.52"
31-Jul-2024,Bill,05.53,00.00,"3,729.05"
31-Jul-2024,Bill,204.96,00.00,"3,934.01"
31-Jul-2024,NEFT,00.00,562.00,"3,372.01"
31-Jul-2024,Cash,135.22,00.00,"3,507.23"
31-Jul-2024,Miscellaneous,"27,881.00",00.00,"31,388.23"
31-Jul-2024,Interest,"17,631.21",00.00,"49,019.44"
31-Jul-2024,Commission,"123,652.88",00.00,"172,672.32"
31-Jul-2024,Cheque,00.00,"21,584.04","151,088.28"
31-Jul-2024,Debit Card,00.00,"25,181.38","125,906.90"
31-Jul-2024,Tax,03.40,00.00,"125,910.30"
31-Jul-2024,Bill,"227,062.00",00.00,"352,972.30"
31-Jul-2024,Debit Card,00.00,"88,243.08","264,729.22"
31-Jul-2024,Transfer,"27,857.30",00.00,"292,586.52"
31-Jul-2024,Purchase,"99,854.40",00.00,"392,440.92"
31-Jul-2024,RTGS,07.55,00.00,"392,448.47"
31-Jul-2024,NEFT,35.00,00.00,"392,483.47"
31-Jul-2024,Tax,27.80,00.00,"392,511.27"
31-Jul-2024,Reversal,00.00,"130,837.09","261,674.18"
31-Jul-2024,Cash,04.44,00.00,"261,678.62"
31-Jul-2024,ATM,444.00,00.00,"262,122.62"
31-Jul-2024,IMPS,00.00,"87,374.21","174,748.41"
31-Jul-2024,Transfer,00.00,"174,748.41",00.00
31-Jul-2024,Transfer,328.00,00.00,328.00
31-Jul-2024,NEFT,00.00,54.67,273.33
31-Jul-2024,Cash,00.00,27.33,246.00
31-Jul-2024,Bill,00.00,61.50,184.50
01-Aug-2024,Debit Card,00.00,26.36,158.14
01-Aug-2024,Reversal,"1,547,801.75",00.00,"1,547,959.89"
01-Aug-2024,Purchase,02.10,00.00,"1,547,961.99"
01-Aug-2024,ATM,00.00,"221,137.43","1,326,824.56"
01-Aug-2024,Cash,00.00,"442,274.85","884,549.71"
01-Aug-2024,Transfer,"1,971,213.00",00.00,"2,855,762.71"
01-Aug-2024,Tax,"27,571.91",00.00,"2,883,334.62"
01-Aug-2024,Bill,00.00,"961,111.54","1,922,223.08"
01-Aug-2024,Bill,136.00,00.00,"1,922,359.08"
01-Aug-2024,Interest,00.00,"274,622.73","1,647,736.35"
01-Aug-2024,Commission,"101,170.69",00.00,"1,748,907.04"
01-Aug-2024,RTGS,"10,981.60",00.00,"1,759,888.64"
01-Aug-2024,Debit Card,817.00,00.00,"1,760,705.64"
01-Aug-2024,Bill,"1,472.90",00.00,"1,762,178.54"
01-Aug-2024,NEFT,"11,095.30",00.00,"1,773,273.84"
01-Aug-2024,Commission,00.00,"197,030.43","1,576,243.41"
01-Aug-2024,Interest,00.00,"175,138.16","1,401,105.25"
01-Aug-2024,Cash,337.10,00.00,"1,401,442.35"
01-Aug-2024,IMPS,176.90,00.00,"1,401,619.25"
01-Aug-2024,IMPS,"21,872.20",00.00,"1,423,491.45"
01-Aug-2024,Interest,05.70,00.00,"1,423,497.15"
01-Aug-2024,Cash,"246,297.00",00.00,"1,669,794.15"
01-Aug-2024,Miscellaneous,"1,584,422.50",00.00,"3,254,216.65"
01-Aug-2024,IMPS,00.00,"813,554.16","2,440,662.49"
01-Aug-2024,Interest,"247,936.00",00.00,"2,688,598.49"
01-Aug-2024,Transfer,00.00,"448,099.75","2,240,498.74"
01-Aug-2024,Interest,00.00,"1,120,249.37","1,120,249.37"
01-Aug-2024,Interest,00.00,"224,049.87","896,199.50"
01-Aug-2024,Cheque,"364,011.00",00.00,"1,260,210.50"
01-Aug-2024,Debit Card,00.00,"157,526.31","1,102,684.19"
01-Aug-2024,Transfer,44.60,00.00,"1,102,728.79"
01-Aug-2024,Commission,00.49,00.00,"1,102,729.28"
01-Aug-2024,Debit Card,"242,462.80",00.00,"1,345,192.08"
02-Aug-2024,Commission,00.00,"168,149.01","1,177,043.07"
02-Aug-2024,Commission,60.39,00.00,"1,177,103.46"
02-Aug-2024,Tax,"143,898.90",00.00,"1,321,002.36"
02-Aug-2024,NEFT,"260,788.10",00.00,"1,581,790.46"
02-Aug-2024,Bill,"6,376.60",00.00,"1,588,167.06"
02-Aug-2024,Commission,"42,834.50",00.00,"1,631,001.56"
02-Aug-2024,Commission,00.00,"233,000.22","1,398,001.34"
02-Aug-2024,Interest,00.00,"279,600.27","1,118,401.07"
02-Aug-2024,ATM,00.00,"223,680.21","894,720.86"
02-Aug-2024,Purchase,"614,638.00",00.00,"1,509,358.86"
02-Aug-2024,RTGS,00.00,"377,339.72","1,132,019.14"
02-Aug-2024,Bill,00.00,"283,004.79","849,014.36"
02-Aug-2024,Miscellaneous,211.10,00.00,"849,225.46"
02-Aug-2024,Transfer,53.00,00.00,"849,278.46"
02-Aug-2024,IMPS,00.00,"849,278.46",00.00
03-Aug-2024,IMPS,"4,533.50",00.00,"4,533.50"
03-Aug-2024,Cheque,03.77,00.00,"4,537.27"
03-Aug-2024,ATM,00.00,453.73,"4,083.54"
03-Aug-2024,Interest,00.00,"1,020.89","3,062.66"
03-Aug-2024,Commission,"1,108.30",00.00,"4,170.96"
03-Aug-2024,Purchase,00.00,521.37,"3,649.59"
03-Aug-2024,Bill,30.71,00.00,"3,680.30"
03-Aug-2024,RTGS,03.16,00.00,"3,683.46"
03-Aug-2024,IMPS,"165,419.00",00.00,"169,102.46"
03-Aug-2024,Cash,"1,633,859.80",00.00,"1,802,962.26"
03-Aug-2024,RTGS,"24,430.00",00.00,"1,827,392.26"
03-Aug-2024,ATM,02.71,00.00,"1,827,394.97"
03-Aug-2024,Tax,00.00,00.00,"1,827,394.97"
03-Aug-2024,Cheque,"216,862.84",00.00,"2,044,257.81"
03-Aug-2024,Tax,"2,366.00",00.00,"2,046,623.81"
03-Aug-2024,Reversal,842.00,00.00,"2,047,465.81"
03-Aug-2024,Cheque,00.00,"227,496.20","1,819,969.61"
04-Aug-2024,Cash,00.00,"303,328.27","1,516,641.34"
04-Aug-2024,Transfer,243.00,00.00,"1,516,884.34"
04-Aug-2024,Cheque,131.50,00.00,"1,517,015.84"
04-Aug-2024,NEFT,00.00,"505,671.95","1,011,343.89"
04-Aug-2024,RTGS,"1,732.12",00.00,"1,013,076.01"
04-Aug-2024,Tax,"32,038.66",00.00,"1,045,114.67"
04-Aug-2024,Cheque,04.40,00.00,"1,045,119.07"
04-Aug-2024,Cash,"32,051.06",00.00,"1,077,170.13"
04-Aug-2024,Bill,"500,943.75",00.00,"1,578,113.88"
04-Aug-2024,Reversal,00.00,"394,528.47","1,183,585.41"
04-Aug-2024,Bill,03.18,00.00,"1,183,588.59"
04-Aug-2024,Cheque,00.00,"169,084.08","1,014,504.51"
04-Aug-2024,Interest,00.00,"144,929.22","869,575.29"
04-Aug-2024,NEFT,"25,754.00",00.00,"895,329.29"
04-Aug-2024,Transfer,466.66,00.00,"895,795.95"
04-Aug-2024,ATM,00.00,"179,159.19","716,636.76"
04-Aug-2024,Commission,"17,679.34",00.00,"734,316.10"
04-Aug-2024,Cash,00.00,"244,772.03","489,544.07"
04-Aug-2024,Cash,"8,877.00",00.00,"498,421.07"
04-Aug-2024,Purchase,00.00,"124,605.27","373,815.80"
04-Aug-2024,Cash,00.00,"46,726.98","327,088.82"
04-Aug-2024,IMPS,00.00,"81,772.21","245,316.62"
04-Aug-2024,Transfer,00.00,"81,772.21","163,544.41"
04-Aug-2024,Commission,432.10,00.00,"163,976.51"
04-Aug-2024,Transfer,03.00,00.00,"163,979.51"
04-Aug-2024,Debit Card,00.00,"18,219.95","145,759.56"
04-Aug-2024,ATM,05.00,00.00,"145,764.56"
04-Aug-2024,Bill,"16,134.42",00.00,"161,898.98"
04-Aug-2024,Transfer,"845,070.80",00.00,"1,006,969.78"
04-Aug-2024,Debit Card,00.00,"335,656.59","671,313.19"
04-Aug-2024,RTGS,00.00,"67,131.32","604,181.87"
04-Aug-2024,Bill,00.00,"302,090.94","302,090.94"
04-Aug-2024,RTGS,00.00,"302,090.94",00.00
04-Aug-2024,Commission,"11,792.12",00.00,"11,792.12"
04-Aug-2024,Debit Card,00.00,"1,965.35","9,826.77"
04-Aug-2024,IMPS,00.00,"1,228.35","8,598.42"
04-Aug-2024,Cash,"786,005.00",00.00,"794,603.42"
04-Aug-2024,Transfer,"1,898.00",00.00,"796,501.42"
04-Aug-2024,Transfer,"1,159,626.25",00.00,"1,956,127.67"
04-Aug-2024,Cash,00.00,"326,021.28","1,630,106.39"
04-Aug-2024,Interest,"1,814,504.00",00.00,"3,444,610.39"
04-Aug-2024,Purchase,00.00,"1,148,203.46","2,296,406.93"
04-Aug-2024,Bill,00.00,"1,148,203.47","1,148,203.47"
04-Aug-2024,Debit Card,00.00,"127,578.16","1,020,625.31"
04-Aug-2024,Reversal,00.00,"127,578.16","893,047.15"
04-Aug-2024,Tax,"251,227.06",00.00,"1,144,274.21"
04-Aug-2024,Tax,292.59,00.00,"1,144,566.80"
04-Aug-2024,Cheque,"120,930.00",00.00,"1,265,496.80"
04-Aug-2024,RTGS,"1,284,333.75",00.00,"2,549,830.55"
04-Aug-2024,Bill,12.10,00.00,"2,549,842.65"
05-Aug-2024,Cheque,00.00,"2,549,842.65",00.00
05-Aug-2024,Purchase,08.00,00.00,08.00
05-Aug-2024,Tax,"28,065.51",00.00,"28,073.51"
05-Aug-2024,Transfer,568.00,00.00,"28,641.51"
05-Aug-2024,Tax,00.00,"4,773.59","23,867.92"
05-Aug-2024,Miscellaneous,00.00,"3,977.99","19,889.93"
05-Aug-2024,Interest,"57,486.00",00.00,"77,375.93"
05-Aug-2024,Purchase,00.00,"25,791.98","51,583.95"
05-Aug-2024,Cash,"117,241.20",00.00,"168,825.15"
05-Aug-2024,RTGS,891.72,00.00,"169,716.87"
05-Aug-2024,RTGS,"69,413.00",00.00,"239,129.87"
05-Aug-2024,ATM,00.00,"34,161.41","204,968.46"
05-Aug-2024,Cash,00.00,"34,161.41","170,807.05"
05-Aug-2024,RTGS,"20,581.97",00.00,"191,389.02"
05-Aug-2024,Commission,00.00,"21,265.45","170,123.57"
05-Aug-2024,Cheque,"19,493.00",00.00,"189,616.57"
05-Aug-2024,Tax,"2,558.00",00.00,"192,174.57"
05-Aug-2024,Cheque,00.00,"64,058.19","128,116.38"
05-Aug-2024,ATM,00.00,"14,235.15","113,881.23"
05-Aug-2024,Tax,00.00,"37,960.41","75,920.82"
05-Aug-2024,Purchase,03.64,00.00,"75,924.46"
05-Aug-2024,Cash,508.00,00.00,"76,432.46"
05-Aug-2024,ATM,00.00,"76,432.46",00.00
06-Aug-2024,IMPS,"1,566,453.50",00.00,"1,566,453.50"
06-Aug-2024,Debit Card,"109,049.00",00.00,"1,675,502.50"
06-Aug-2024,Bill,00.00,"209,437.81","1,466,064.69"
06-Aug-2024,Transfer,"17,608.79",00.00,"1,483,673.48"
06-Aug-2024,Cheque,00.00,"1,483,673.48",00.00
06-Aug-2024,Cheque,03.00,00.00,03.00
06-Aug-2024,Tax,01.10,00.00,04.10
06-Aug-2024,Tax,"1,803.00",00.00,"1,807.10"
06-Aug-2024,Bill,"13,836.18",00.00,"15,643.28"
06-Aug-2024,Purchase,00.00,"2,607.21","13,036.07"
06-Aug-2024,Tax,"31,216.00",00.00,"44,252.07"
06-Aug-2024,Debit Card,00.00,"4,916.90","39,335.17"
06-Aug-2024,IMPS,"150,225.00",00.00,"189,560.17"
06-Aug-2024,ATM,115.73,00.00,"189,675.90"
06-Aug-2024,Bill,00.00,"47,418.98","142,256.92"
06-Aug-2024,NEFT,"2,050,955.80",00.00,"2,193,212.72"
06-Aug-2024,Cash,00.00,"313,316.10","1,879,896.62"
06-Aug-2024,Purchase,"1,375.78",00.00,"1,881,272.40"
06-Aug-2024,ATM,00.00,"188,127.24","1,693,145.16"
06-Aug-2024,Cash,00.00,"846,572.58","846,572.58"
06-Aug-2024,Bill,"68,747.56",00.00,"915,320.14"
06-Aug-2024,IMPS,00.00,"152,553.36","762,766.78"
06-Aug-2024,Purchase,"31,825.00",00.00,"794,591.78"
06-Aug-2024,Debit Card,00.00,"88,287.98","706,303.80"
06-Aug-2024,Purchase,00.00,"117,717.30","588,586.50"
06-Aug-2024,NEFT,"1,449,783.00",00.00,"2,038,369.50"
06-Aug-2024,NEFT,00.00,"407,673.90","1,630,695.60"
07-Aug-2024,Bill,28.80,00.00,"1,630,724.40"
07-Aug-2024,IMPS,"5,142.30",00.00,"1,635,866.70"
07-Aug-2024,NEFT,00.00,"1,635,866.70",00.00
07-Aug-2024,NEFT,"32,333.00",00.00,"32,333.00"
07-Aug-2024,Miscellaneous,04.60,00.00,"32,337.60"
07-Aug-2024,Transfer,05.00,00.00,"32,342.60"
08-Aug-2024,Cheque,58.20,00.00,"32,400.80"
08-Aug-2024,ATM,"32,103.00",00.00,"64,503.80"
08-Aug-2024,Reversal,00.00,"8,062.98","56,440.82"
08-Aug-2024,Debit Card,"31,150.00",00.00,"87,590.82"
08-Aug-2024,Reversal,"12,793.50",00.00,"100,384.32"
08-Aug-2024,Commission,00.00,"11,153.81","89,230.51"
08-Aug-2024,IMPS,00.00,"11,153.81","78,076.70"
08-Aug-2024,Debit Card,00.00,"9,759.59","68,317.11"
08-Aug-2024,Purchase,00.00,"11,386.19","56,930.92"
08-Aug-2024,Bill,00.00,"56,930.92",00.00
08-Aug-2024,Bill,03.00,00.00,03.00
08-Aug-2024,Transfer,"107,675.80",00.00,"107,678.80"
08-Aug-2024,IMPS,00.00,"11,964.31","95,714.49"
08-Aug-2024,IMPS,00.00,"47,857.25","47,857.24"
09-Aug-2024,IMPS,03.43,00.00,"47,860.67"
09-Aug-2024,Purchase,00.00,"5,982.58","41,878.09"
09-Aug-2024,Cash,"7,540.60",00.00,"49,418.69"
09-Aug-2024,Cash,00.00,"8,236.45","41,182.24"
09-Aug-2024,RTGS,"1,775,958.75",00.00,"1,817,140.99"
09-Aug-2024,Cheque,22.40,00.00,"1,817,163.39"
09-Aug-2024,Debit Card,00.00,"201,907.04","1,615,256.35"
10-Aug-2024,Cash,60.93,00.00,"1,615,317.28"
10-Aug-2024,ATM,00.00,"201,914.66","1,413,402.62"
10-Aug-2024,Reversal,"3,558.00",00.00,"1,416,960.62"
10-Aug-2024,Reversal,00.00,"708,480.31","708,480.31"
10-Aug-2024,Tax,00.00,"354,240.16","354,240.16"
10-Aug-2024,IMPS,00.00,"354,240.16",00.00
10-Aug-2024,Interest,"19,340.20",00.00,"19,340.20"
10-Aug-2024,Transfer,00.00,"1,934.02","17,406.18"
10-Aug-2024,Tax,00.00,"4,351.55","13,054.64"
10-Aug-2024,Purchase,00.00,"6,527.32","6,527.32"
10-Aug-2024,NEFT,"172,981.00",00.00,"179,508.32"
10-Aug-2024,Debit Card,00.00,"44,877.08","134,631.24"
10-Aug-2024,Interest,00.00,"19,233.03","115,398.21"
10-Aug-2024,NEFT,"195,170.80",00.00,"310,569.01"
10-Aug-2024,Tax,"567,264.50",00.00,"877,833.51"
10-Aug-2024,Reversal,"103,672.20",00.00,"981,505.71"
10-Aug-2024,ATM,"21,822.40",00.00,"1,003,328.11"
10-Aug-2024,Transfer,02.90,00.00,"1,003,331.01"
10-Aug-2024,Transfer,07.00,00.00,"1,003,338.01"
10-Aug-2024,Commission,00.00,"167,223.00","836,115.01"
10-Aug-2024,ATM,00.00,"836,115.01",00.00
10-Aug-2024,Commission,"61,141.00",00.00,"61,141.00"
10-Aug-2024,Commission,"842,550.00",00.00,"903,691.00"
10-Aug-2024,Reversal,"78,492.00",00.00,"982,183.00"
10-Aug-2024,Cheque,00.00,"140,311.86","841,871.14"
11-Aug-2024,Tax,00.00,"210,467.79","631,403.36"
11-Aug-2024,Bill,00.00,"157,850.84","473,552.52"
11-Aug-2024,Commission,"1,024,705.20",00.00,"1,498,257.72"
11-Aug-2024,Miscellaneous,05.30,00.00,"1,498,263.02"
11-Aug-2024,Cash,00.00,"1,498,263.02",00.00
11-Aug-2024,IMPS,"1,236,236.50",00.00,"1,236,236.50"
11-Aug-2024,Purchase,00.00,"1,236,236.50",00.00
11-Aug-2024,Miscellaneous,"84,032.80",00.00,"84,032.80"
11-Aug-2024,Commission,"61,368.00",00.00,"145,400.80"
11-Aug-2024,Reversal,00.00,"29,080.16","116,320.64"
11-Aug-2024,Cheque,00.00,"116,320.64",00.00
11-Aug-2024,Cheque,00.00,00.00,00.00
11-Aug-2024,Debit Card,"1,715.00",00.00,"1,715.00"
11-Aug-2024,Tax,00.00,245.00,"1,470.00"
11-Aug-2024,Purchase,00.00,"1,470.00",00.00
11-Aug-2024,Cash,"2,874.00",00.00,"2,874.00"
11-Aug-2024,Reversal,04.00,00.00,"2,878.00"
11-Aug-2024,Reversal,"1,152,254.00",00.00,"1,155,132.00"
11-Aug-2024,Transfer,"20,114.00",00.00,"1,175,246.00"
11-Aug-2024,Reversal,00.00,"1,175,246.00",00.00
11-Aug-2024,Transfer,"11,881.90",00.00,"11,881.90"
11-Aug-2024,Cash,"1,690,680.00",00.00,"1,702,561.90"
11-Aug-2024,Commission,"10,866.03",00.00,"1,713,427.93"
11-Aug-2024,Purchase,02.10,00.00,"1,713,430.03"
12-Aug-2024,Bill,"3,902.65",00.00,"1,717,332.68"
12-Aug-2024,Reversal,"15,740.00",00.00,"1,733,072.68"
12-Aug-2024,Debit Card,318.80,00.00,"1,733,391.48"
12-Aug-2024,Cheque,"2,427.80",00.00,"1,735,819.28"
12-Aug-2024,Cash,02.00,00.00,"1,735,821.28"
12-Aug-2024,Purchase,18.95,00.00,"1,735,840.23"
12-Aug-2024,Purchase,"63,406.78",00.00,"1,799,247.01"
12-Aug-2024,Purchase,00.00,"257,035.29","1,542,211.72"
12-Aug-2024,Debit Card,00.00,"308,442.34","1,233,769.38"
12-Aug-2024,RTGS,00.00,"616,884.69","616,884.69"
12-Aug-2024,IMPS,55.10,00.00,"616,939.79"
12-Aug-2024,RTGS,29.93,00.00,"616,969.72"
12-Aug-2024,Transfer,"2,348.80",00.00,"619,318.52"
12-Aug-2024,ATM,00.00,"77,414.82","541,903.71"
12-Aug-2024,ATM,"45,532.00",00.00,"587,435.71"
12-Aug-2024,Commission,00.00,"65,270.63","522,165.08"
12-Aug-2024,Bill,"231,129.80",00.00,"753,294.88"
12-Aug-2024,IMPS,07.00,00.00,"753,301.88"
12-Aug-2024,Tax,02.73,00.00,"753,304.61"
12-Aug-2024,Debit Card,08.00,00.00,"753,312.61"
12-Aug-2024,Interest,00.00,"251,104.20","502,208.41"
12-Aug-2024,Commission,271.86,00.00,"502,480.27"
12-Aug-2024,Purchase,579.00,00.00,"503,059.27"
12-Aug-2024,ATM,"30,215.30",00.00,"533,274.57"
12-Aug-2024,Purchase,"1,064,799.80",00.00,"1,598,074.37"
12-Aug-2024,Bill,04.00,00.00,"1,598,078.37"
12-Aug-2024,RTGS,00.00,"399,519.59","1,198,558.78"
12-Aug-2024,RTGS,"217,279.00",00.00,"1,415,837.78"
12-Aug-2024,Tax,"615,058.75",00.00,"2,030,896.53"
12-Aug-2024,Cheque,00.00,"507,724.13","1,523,172.40"
12-Aug-2024,Cash,00.90,00.00,"1,523,173.30"
12-Aug-2024,Tax,00.00,"380,793.33","1,142,379.98"
13-Aug-2024,Commission,153.65,00.00,"1,142,533.63"
13-Aug-2024,Bill,"948,332.00",00.00,"2,090,865.63"
13-Aug-2024,NEFT,165.55,00.00,"2,091,031.18"
13-Aug-2024,Cheque,00.00,"348,505.20","1,742,525.98"
13-Aug-2024,ATM,00.00,"1,742,525.98",00.00
13-Aug-2024,Reversal,54.00,00.00,54.00
13-Aug-2024,Cheque,00.00,10.80,43.20
13-Aug-2024,IMPS,422.95,00.00,466.15
13-Aug-2024,IMPS,00.00,93.23,372.92
13-Aug-2024,Interest,141.50,00.00,514.42
13-Aug-2024,Miscellaneous,00.80,00.00,515.22
13-Aug-2024,Commission,"16,499.00",00.00,"17,014.22"
13-Aug-2024,Transfer,00.00,"8,507.11","8,507.11"
13-Aug-2024,Cash,"587,196.50",00.00,"595,703.61"
13-Aug-2024,Transfer,26.85,00.00,"595,730.46"
13-Aug-2024,Commission,00.00,"198,576.82","397,153.64"
13-Aug-2024,Cash,00.00,"198,576.82","198,576.82"
13-Aug-2024,Miscellaneous,00.00,"198,576.82",00.00
13-Aug-2024,RTGS,339.00,00.00,339.00
13-Aug-2024,Interest,00.00,48.43,290.57
13-Aug-2024,Miscellaneous,"74,076.60",00.00,"74,367.17"
13-Aug-2024,Transfer,03.78,00.00,"74,370.95"
13-Aug-2024,Commission,"1,357,146.00",00.00,"1,431,516.95"
13-Aug-2024,Commission,"1,504,940.00",00.00,"2,936,456.95"
13-Aug-2024,RTGS,06.00,00.00,"2,936,462.95"
13-Aug-2024,ATM,483.73,00.00,"2,936,946.68"
13-Aug-2024,NEFT,00.00,"978,982.23","1,957,964.45"
13-Aug-2024,ATM,308.16,00.00,"1,958,272.61"
13-Aug-2024,Debit Card,00.00,"279,753.23","1,678,519.38"
13-Aug-2024,RTGS,"17,204.00",00.00,"1,695,723.38"
13-Aug-2024,Purchase,00.00,"1,695,723.38",00.00
13-Aug-2024,NEFT,47.00,00.00,47.00
13-Aug-2024,Cash,78.00,00.00,125.00
13-Aug-2024,Commission,00.00,25.00,100.00
13-Aug-2024,Miscellaneous,00.00,20.00,80.00
13-Aug-2024,Reversal,00.00,13.33,66.67
13-Aug-2024,Transfer,00.00,13.33,53.34
13-Aug-2024,Bill,"208,328.00",00.00,"208,381.34"
13-Aug-2024,NEFT,44.10,00.00,"208,425.44"
13-Aug-2024,Cash,481.50,00.00,"208,906.94"
13-Aug-2024,Cheque,"329,475.80",00.00,"538,382.74"
13-Aug-2024,NEFT,00.00,"76,911.82","461,470.92"
13-Aug-2024,ATM,00.00,"46,147.09","415,323.83"
13-Aug-2024,Bill,"24,330.00",00.00,"439,653.83"
13-Aug-2024,ATM,227.61,00.00,"439,881.44"
13-Aug-2024,Tax,"1,859,092.50",00.00,"2,298,973.94"
13-Aug-2024,Purchase,00.00,"2,298,973.94",00.00
13-Aug-2024,Interest,"8,266.00",00.00,"8,266.00"
13-Aug-2024,Reversal,545.20,00.00,"8,811.20"
13-Aug-2024,RTGS,"2,584.70",00.00,"11,395.90"
13-Aug-2024,ATM,50.17,00.00,"11,446.07"
13-Aug-2024,RTGS,"188,039.10",00.00,"199,485.17"
13-Aug-2024,Purchase,"9,827.95",00.00,"209,313.12"
13-Aug-2024,Transfer,00.00,"29,901.87","179,411.25"
13-Aug-2024,Cheque,00.00,"25,630.18","153,781.07"
13-Aug-2024,Miscellaneous,07.00,00.00,"153,788.07"
13-Aug-2024,NEFT,01.00,00.00,"153,789.07"
13-Aug-2024,Cash,00.00,"15,378.91","138,410.16"
13-Aug-2024,ATM,01.70,00.00,"138,411.86"
13-Aug-2024,Reversal,"1,102.00",00.00,"139,513.86"
14-Aug-2024,Debit Card,00.00,"69,756.93","69,756.93"
14-Aug-2024,NEFT,"54,568.10",00.00,"124,325.03"
14-Aug-2024,Interest,00.00,"20,720.84","103,604.19"
14-Aug-2024,Cheque,60.00,00.00,"103,664.19"
14-Aug-2024,Cheque,00.00,"34,554.73","69,109.46"
14-Aug-2024,IMPS,"680,731.50",00.00,"749,840.96"
14-Aug-2024,Reversal,"197,887.41",00.00,"947,728.37"
14-Aug-2024,IMPS,28.21,00.00,"947,756.58"
14-Aug-2024,Purchase,144.90,00.00,"947,901.48"
14-Aug-2024,RTGS,00.00,"105,322.39","842,579.09"
14-Aug-2024,Commission,00.00,"120,368.44","722,210.65"
14-Aug-2024,IMPS,48.30,00.00,"722,258.95"
15-Aug-2024,Debit Card,"671,259.75",00.00,"1,393,518.70"
15-Aug-2024,Commission,00.00,"174,189.84","1,219,328.86"
15-Aug-2024,Miscellaneous,11.00,00.00,"1,219,339.86"
15-Aug-2024,Interest,00.00,"203,223.31","1,016,116.55"
15-Aug-2024,ATM,02.00,00.00,"1,016,118.55"
15-Aug-2024,Interest,"87,501.60",00.00,"1,103,620.15"
15-Aug-2024,Interest,00.00,"183,936.69","919,683.46"
15-Aug-2024,ATM,00.00,"131,383.35","788,300.11"
15-Aug-2024,Miscellaneous,00.00,"131,383.35","656,916.76"
15-Aug-2024,Tax,26.10,00.00,"656,942.86"
15-Aug-2024,Purchase,03.70,00.00,"656,946.56"
15-Aug-2024,ATM,00.00,"656,946.56",00.00
15-Aug-2024,Debit Card,02.62,00.00,02.62
15-Aug-2024,RTGS,03.00,00.00,05.62
15-Aug-2024,Debit Card,"220,881.28",00.00,"220,886.90"
15-Aug-2024,Cash,00.00,"220,886.90",00.00
15-Aug-2024,Commission,"632,999.80",00.00,"632,999.80"
15-Aug-2024,Miscellaneous,06.60,00.00,"633,006.40"
15-Aug-2024,Transfer,"234,334.00",00.00,"867,340.40"
15-Aug-2024,Debit Card,00.00,"96,371.16","770,969.24"
15-Aug-2024,Cash,00.00,"128,494.87","642,474.37"
15-Aug-2024,IMPS,00.00,"321,237.19","321,237.18"
15-Aug-2024,Transfer,02.72,00.00,"321,239.90"
15-Aug-2024,Miscellaneous,"8,551.30",00.00,"329,791.20"
15-Aug-2024,Bill,00.00,"82,447.80","247,343.40"
15-Aug-2024,Reversal,00.00,"30,917.93","216,425.48"
15-Aug-2024,Commission,00.00,"21,642.55","194,782.93"
15-Aug-2024,Cheque,"245,471.62",00.00,"440,254.55"
15-Aug-2024,RTGS,00.00,"220,127.28","220,127.28"
15-Aug-2024,NEFT,"3,713.00",00.00,"223,840.28"
15-Aug-2024,Purchase,00.00,"74,613.43","149,226.85"
15-Aug-2024,Transfer,80.89,00.00,"149,307.74"
15-Aug-2024,NEFT,00.00,"21,329.68","127,978.06"
15-Aug-2024,Cheque,"165,129.50",00.00,"293,107.56"
15-Aug-2024,Miscellaneous,"129,751.16",00.00,"422,858.72"
15-Aug-2024,Reversal,00.00,"60,408.39","362,450.33"
15-Aug-2024,Reversal,00.00,"72,490.07","289,960.26"
15-Aug-2024,Cash,03.00,00.00,"289,963.26"
15-Aug-2024,Debit Card,00.00,"32,218.14","257,745.12"
15-Aug-2024,Cheque,936.00,00.00,"258,681.12"
15-Aug-2024,ATM,00.00,"51,736.22","206,944.90"
16-Aug-2024,NEFT,00.00,"103,472.45","103,472.45"
16-Aug-2024,IMPS,00.00,"20,694.49","82,777.96"
16-Aug-2024,Tax,00.00,"20,694.49","62,083.47"
16-Aug-2024,Bill,16.40,00.00,"62,099.87"
16-Aug-2024,ATM,23.00,00.00,"62,122.87"
16-Aug-2024,Tax,"1,905,442.00",00.00,"1,967,564.87"
16-Aug-2024,Miscellaneous,00.00,"1,967,564.87",00.00
16-Aug-2024,Interest,02.20,00.00,02.20
16-Aug-2024,Bill,168.11,00.00,170.31
16-Aug-2024,IMPS,04.00,00.00,174.31
16-Aug-2024,Commission,00.00,87.16,87.16
16-Aug-2024,Interest,321.18,00.00,408.34
16-Aug-2024,IMPS,"254,782.06",00.00,"255,190.40"
16-Aug-2024,Reversal,01.97,00.00,"255,192.37"
16-Aug-2024,Purchase,"30,082.66",00.00,"285,275.03"
16-Aug-2024,Interest,"62,424.72",00.00,"347,699.75"
16-Aug-2024,ATM,00.00,"69,539.95","278,159.80"
16-Aug-2024,Bill,00.00,"30,906.64","247,253.16"
16-Aug-2024,Miscellaneous,"206,682.60",00.00,"453,935.76"
16-Aug-2024,Bill,00.00,"50,437.31","403,498.45"
16-Aug-2024,Tax,00.00,"67,249.74","336,248.71"
16-Aug-2024,Cheque,48.00,00.00,"336,296.71"
16-Aug-2024,Cheque,03.88,00.00,"336,300.59"
16-Aug-2024,ATM,00.00,"33,630.06","302,670.53"
16-Aug-2024,Commission,00.00,"60,534.11","242,136.42"
16-Aug-2024,Reversal,06.00,00.00,"242,142.42"
16-Aug-2024,Commission,00.00,"30,267.80","211,874.62"
16-Aug-2024,Transfer,41.42,00.00,"211,916.04"
16-Aug-2024,Cash,"3,075.56",00.00,"214,991.60"
16-Aug-2024,Tax,37.80,00.00,"215,029.40"
16-Aug-2024,Cheque,00.00,"30,718.49","184,310.91"
16-Aug-2024,Cash,"920,657.75",00.00,"1,104,968.66"
17-Aug-2024,Cheque,"2,112.73",00.00,"1,107,081.39"
17-Aug-2024,NEFT,236.00,00.00,"1,107,317.39"
17-Aug-2024,Bill,00.00,"221,463.48","885,853.91"
17-Aug-2024,Tax,"22,733.10",00.00,"908,587.01"
17-Aug-2024,Miscellaneous,00.00,"227,146.75","681,440.26"
17-Aug-2024,Cash,00.00,"97,348.61","584,091.65"
17-Aug-2024,NEFT,"2,669.02",00.00,"586,760.67"
17-Aug-2024,Reversal,00.00,"586,760.67",00.00
17-Aug-2024,Cheque,820.53,00.00,820.53
17-Aug-2024,Cheque,240.40,00.00,"1,060.93"
17-Aug-2024,Tax,00.00,132.62,928.31
17-Aug-2024,Commission,00.00,464.16,464.16
17-Aug-2024,Transfer,00.00,77.36,386.80
17-Aug-2024,ATM,00.00,38.68,348.12
17-Aug-2024,Bill,429.00,00.00,777.12
17-Aug-2024,NEFT,"1,278,941.75",00.00,"1,279,718.87"
17-Aug-2024,Debit Card,105.00,00.00,"1,279,823.87"
18-Aug-2024,Reversal,00.00,"426,607.96","853,215.91"
18-Aug-2024,Bill,00.00,"106,651.99","746,563.92"
18-Aug-2024,Interest,00.00,"248,854.64","497,709.28"
18-Aug-2024,Cash,40.40,00.00,"497,749.68"
18-Aug-2024,NEFT,00.00,"55,305.52","442,444.16"
18-Aug-2024,IMPS,00.00,"49,160.46","393,283.70"
18-Aug-2024,Tax,"3,945.70",00.00,"397,229.40"
18-Aug-2024,Interest,"2,090.00",00.00,"399,319.40"
18-Aug-2024,Purchase,00.00,"79,863.88","319,455.52"
18-Aug-2024,NEFT,05.10,00.00,"319,460.62"
18-Aug-2024,ATM,"1,301,014.75",00.00,"1,620,475.37"
18-Aug-2024,RTGS,"462,708.00",00.00,"2,083,183.37"
18-Aug-2024,Cheque,00.00,"347,197.23","1,735,986.14"
18-Aug-2024,Miscellaneous,386.87,00.00,"1,736,373.01"
18-Aug-2024,Cash,02.76,00.00,"1,736,375.77"
18-Aug-2024,Interest,00.00,"434,093.94","1,302,281.83"
18-Aug-2024,Cheque,00.00,"434,093.94","868,187.89"
18-Aug-2024,Interest,00.20,00.00,"868,188.09"
18-Aug-2024,Transfer,00.00,"434,094.05","434,094.04"
18-Aug-2024,RTGS,"366,026.50",00.00,"800,120.54"
18-Aug-2024,ATM,00.00,"100,015.07","700,105.47"
18-Aug-2024,Debit Card,"18,779.60",00.00,"718,885.07"
18-Aug-2024,Reversal,00.00,"239,628.36","479,256.71"
18-Aug-2024,ATM,12.40,00.00,"479,269.11"
18-Aug-2024,Reversal,00.00,"53,252.12","426,016.99"
18-Aug-2024,Cash,00.00,"60,859.57","365,157.42"
18-Aug-2024,IMPS,"199,524.00",00.00,"564,681.42"
18-Aug-2024,Debit Card,04.79,00.00,"564,686.21"
18-Aug-2024,Interest,"81,207.03",00.00,"645,893.24"
18-Aug-2024,Miscellaneous,00.00,"80,736.66","565,156.58"
18-Aug-2024,Reversal,00.00,"188,385.53","376,771.05"
18-Aug-2024,IMPS,00.00,"47,096.38","329,674.67"
18-Aug-2024,RTGS,05.90,00.00,"329,680.57"
18-Aug-2024,Reversal,"18,410.10",00.00,"348,090.67"
19-Aug-2024,Bill,07.30,00.00,"348,097.97"
19-Aug-2024,IMPS,"27,831.85",00.00,"375,929.82"
19-Aug-2024,Reversal,"13,542.50",00.00,"389,472.32"
19-Aug-2024,Purchase,"31,824.00",00.00,"421,296.32"
19-Aug-2024,RTGS,00.00,"105,324.08","315,972.24"
19-Aug-2024,Interest,00.00,"315,972.24",00.00
19-Aug-2024,Tax,"175,600.00",00.00,"175,600.00"
19-Aug-2024,Transfer,00.00,"175,600.00",00.00
19-Aug-2024,IMPS,531.09,00.00,531.09
19-Aug-2024,IMPS,00.00,88.52,442.58
19-Aug-2024,Miscellaneous,"111,232.53",00.00,"111,675.11"
19-Aug-2024,RTGS,"7,395.00",00.00,"119,070.11"
19-Aug-2024,Reversal,07.00,00.00,"119,077.11"
19-Aug-2024,Debit Card,"1,482.10",00.00,"120,559.21"
19-Aug-2024,Bill,00.00,"17,222.74","103,336.47"
19-Aug-2024,Reversal,00.00,"12,917.06","90,419.41"
19-Aug-2024,RTGS,01.93,00.00,"90,421.34"
19-Aug-2024,RTGS,32.00,00.00,"90,453.34"
19-Aug-2024,Interest,00.00,"9,045.33","81,408.01"
19-Aug-2024,IMPS,"18,670.90",00.00,"100,078.91"
19-Aug-2024,Bill,70.00,00.00,"100,148.91"
19-Aug-2024,Tax,00.00,"100,148.91",00.00
19-Aug-2024,Purchase,00.10,00.00,00.10
19-Aug-2024,Commission,00.00,00.03,00.08
19-Aug-2024,ATM,00.00,00.02,00.06
19-Aug-2024,RTGS,00.00,00.01,00.05
19-Aug-2024,ATM,00.00,00.01,00.05
19-Aug-2024,NEFT,00.00,00.01,00.04
19-Aug-2024,Cash,"227,521.70",00.00,"227,521.74"
19-Aug-2024,Purchase,"241,978.00",00.00,"469,499.74"
19-Aug-2024,Cheque,00.00,"234,749.87","234,749.87"
19-Aug-2024,Purchase,00.00,"23,474.99","211,274.88"
19-Aug-2024,Reversal,00.00,"30,182.13","181,092.75"
19-Aug-2024,Debit Card,62.10,00.00,"181,154.85"
19-Aug-2024,Purchase,"17,033.00",00.00,"198,187.85"
19-Aug-2024,RTGS,00.00,"33,031.31","165,156.54"
19-Aug-2024,IMPS,"5,426.50",00.00,"170,583.04"
19-Aug-2024,Cash,59.50,00.00,"170,642.54"
19-Aug-2024,Cheque,00.00,"17,064.25","153,578.29"
19-Aug-2024,Interest,06.80,00.00,"153,585.09"
19-Aug-2024,Cheque,"3,789.10",00.00,"157,374.19"
19-Aug-2024,Commission,"113,412.56",00.00,"270,786.75"
19-Aug-2024,ATM,00.00,"270,786.75",00.00
19-Aug-2024,IMPS,"1,747,870.00",00.00,"1,747,870.00"
19-Aug-2024,Bill,"3,255.80",00.00,"1,751,125.80"
19-Aug-2024,Miscellaneous,00.00,"437,781.45","1,313,344.35"
19-Aug-2024,RTGS,02.80,00.00,"1,313,347.15"
19-Aug-2024,Tax,33.96,00.00,"1,313,381.11"
19-Aug-2024,Commission,00.00,"145,931.23","1,167,449.88"
19-Aug-2024,Interest,00.00,"583,724.94","583,724.94"
19-Aug-2024,Commission,08.00,00.00,"583,732.94"
19-Aug-2024,Bill,00.00,"145,933.24","437,799.70"
19-Aug-2024,Interest,05.00,00.00,"437,804.70"
19-Aug-2024,NEFT,00.00,"72,967.45","364,837.25"
19-Aug-2024,Commission,00.00,"52,119.61","312,717.64"
19-Aug-2024,Bill,"3,359.75",00.00,"316,077.39"
19-Aug-2024,Cheque,04.32,00.00,"316,081.71"
19-Aug-2024,Interest,"187,216.50",00.00,"503,298.21"
20-Aug-2024,Cash,00.00,"62,912.28","440,385.93"
20-Aug-2024,Cash,344.75,00.00,"440,730.68"
20-Aug-2024,Purchase,"66,660.70",00.00,"507,391.38"
20-Aug-2024,Bill,"1,521.60",00.00,"508,912.98"
20-Aug-2024,RTGS,"76,465.00",00.00,"585,377.98"
20-Aug-2024,ATM,"3,117.10",00.00,"588,495.08"
20-Aug-2024,IMPS,00.00,"147,123.77","441,371.31"
20-Aug-2024,Bill,00.00,"55,171.41","386,199.90"
20-Aug-2024,Debit Card,"235,098.00",00.00,"621,297.90"
20-Aug-2024,Interest,00.00,"155,324.48","465,973.43"
20-Aug-2024,Miscellaneous,"19,266.68",00.00,"485,240.11"
20-Aug-2024,Purchase,48.70,00.00,"485,288.81"
20-Aug-2024,Cash,441.00,00.00,"485,729.81"
20-Aug-2024,NEFT,41.34,00.00,"485,771.15"
20-Aug-2024,NEFT,06.05,00.00,"485,777.20"
20-Aug-2024,Bill,00.00,"69,396.74","416,380.46"
20-Aug-2024,RTGS,"188,724.25",00.00,"605,104.71"
20-Aug-2024,NEFT,"86,222.80",00.00,"691,327.51"
20-Aug-2024,NEFT,54.00,00.00,"691,381.51"
20-Aug-2024,Reversal,484.40,00.00,"691,865.91"
20-Aug-2024,Bill,00.00,"691,865.91",00.00
20-Aug-2024,Transfer,"37,665.00",00.00,"37,665.00"
20-Aug-2024,Tax,"2,798.00",00.00,"40,463.00"
20-Aug-2024,Cheque,47.00,00.00,"40,510.00"
20-Aug-2024,Debit Card,00.00,"4,051.00","36,459.00"
20-Aug-2024,Tax,50.00,00.00,"36,509.00"
20-Aug-2024,Cheque,00.00,"7,301.80","29,207.20"
21-Aug-2024,Tax,"13,402.00",00.00,"42,609.20"
21-Aug-2024,Cash,00.00,"8,521.84","34,087.36"
21-Aug-2024,Bill,00.00,"4,869.62","29,217.74"
21-Aug-2024,Interest,01.40,00.00,"29,219.14"
21-Aug-2024,Interest,00.00,"29,219.14",00.00
21-Aug-2024,Transfer,"9,078.00",00.00,"9,078.00"
21-Aug-2024,Miscellaneous,"37,724.25",00.00,"46,802.25"
21-Aug-2024,Transfer,00.00,"23,401.13","23,401.12"
21-Aug-2024,ATM,00.00,"2,600.12","20,801.00"
21-Aug-2024,Cash,00.00,"2,311.22","18,489.78"
21-Aug-2024,Commission,"21,144.20",00.00,"39,633.98"
21-Aug-2024,Commission,04.34,00.00,"39,638.32"
21-Aug-2024,RTGS,59.00,00.00,"39,697.32"
21-Aug-2024,IMPS,00.00,"13,232.44","26,464.88"
21-Aug-2024,NEFT,00.50,00.00,"26,465.38"
21-Aug-2024,Debit Card,"3,472.00",00.00,"29,937.38"
21-Aug-2024,Miscellaneous,"708,889.50",00.00,"738,826.88"
21-Aug-2024,RTGS,00.00,"82,091.88","656,735.00"
21-Aug-2024,IMPS,00.00,"218,911.67","437,823.33"
21-Aug-2024,Purchase,"1,533.23",00.00,"439,356.56"
21-Aug-2024,RTGS,32.00,00.00,"439,388.56"
21-Aug-2024,Bill,"11,791.19",00.00,"451,179.75"
21-Aug-2024,Debit Card,30.00,00.00,"451,209.75"
21-Aug-2024,Interest,06.10,00.00,"451,215.85"
21-Aug-2024,Commission,497.00,00.00,"451,712.85"
21-Aug-2024,Purchase,00.00,"64,530.41","387,182.44"
21-Aug-2024,RTGS,"258,655.10",00.00,"645,837.54"
21-Aug-2024,Reversal,250.60,00.00,"646,088.14"
21-Aug-2024,Debit Card,74.95,00.00,"646,163.09"
21-Aug-2024,Cash,451.35,00.00,"646,614.44"
21-Aug-2024,IMPS,"16,745.10",00.00,"663,359.54"
21-Aug-2024,NEFT,"90,826.00",00.00,"754,185.54"
21-Aug-2024,Interest,"1,602.89",00.00,"755,788.43"
21-Aug-2024,Debit Card,"11,320.00",00.00,"767,108.43"
21-Aug-2024,RTGS,"22,572.70",00.00,"789,681.13"
21-Aug-2024,Reversal,00.00,"78,968.11","710,713.02"
21-Aug-2024,Debit Card,"928,768.00",00.00,"1,639,481.02"
21-Aug-2024,Commission,03.46,00.00,"1,639,484.48"
21-Aug-2024,Commission,00.00,"234,212.07","1,405,272.41"
21-Aug-2024,Bill,149.30,00.00,"1,405,421.71"
21-Aug-2024,Cheque,806.90,00.00,"1,406,228.61"
21-Aug-2024,Tax,"18,067.00",00.00,"1,424,295.61"
21-Aug-2024,Miscellaneous,"12,648.00",00.00,"1,436,943.61"
21-Aug-2024,Miscellaneous,"245,704.75",00.00,"1,682,648.36"
21-Aug-2024,Cash,129.50,00.00,"1,682,777.86"
21-Aug-2024,Miscellaneous,"969,726.20",00.00,"2,652,504.06"
21-Aug-2024,Interest,"1,003,440.00",00.00,"3,655,944.06"
21-Aug-2024,Bill,00.00,"609,324.01","3,046,620.05"
21-Aug-2024,IMPS,00.00,"609,324.01","2,437,296.04"
21-Aug-2024,Transfer,00.00,"2,437,296.04",00.00
21-Aug-2024,Interest,"1,519.55",00.00,"1,519.55"
21-Aug-2024,Interest,00.00,253.26,"1,266.29"
21-Aug-2024,Debit Card,01.00,00.00,"1,267.29"
21-Aug-2024,NEFT,00.00,211.22,"1,056.08"
21-Aug-2024,Tax,"2,061,350.00",00.00,"2,062,406.08"
21-Aug-2024,Tax,"10,476.00",00.00,"2,072,882.08"
21-Aug-2024,IMPS,00.00,"690,960.69","1,381,921.39"
21-Aug-2024,ATM,00.00,"172,740.17","1,209,181.22"
21-Aug-2024,Miscellaneous,00.00,"604,590.61","604,590.61"
21-Aug-2024,Debit Card,00.20,00.00,"604,590.81"
21-Aug-2024,Interest,00.00,"604,590.81",00.00
21-Aug-2024,RTGS,28.46,00.00,28.46
21-Aug-2024,NEFT,00.00,07.12,21.34
21-Aug-2024,ATM,00.00,21.34,00.00
21-Aug-2024,Debit Card,"8,052.00",00.00,"8,052.00"
21-Aug-2024,Tax,00.00,805.20,"7,246.80"
21-Aug-2024,Transfer,"1,314,055.00",00.00,"1,321,301.80"
21-Aug-2024,IMPS,"21,806.40",00.00,"1,343,108.20"
21-Aug-2024,Commission,00.00,"1,343,108.20",00.00
22-Aug-2024,Purchase,58.90,00.00,58.90
22-Aug-2024,Bill,"3,576.30",00.00,"3,635.20"
22-Aug-2024,Cheque,00.00,727.04,"2,908.16"
22-Aug-2024,Miscellaneous,00.00,"2,908.16",00.00
22-Aug-2024,Reversal,"6,433.30",00.00,"6,433.30"
22-Aug-2024,Cash,"3,002.90",00.00,"9,436.20"
22-Aug-2024,Bill,00.00,"1,179.53","8,256.68"
22-Aug-2024,NEFT,"1,994.80",00.00,"10,251.48"
22-Aug-2024,Tax,00.00,"5,125.74","5,125.74"
23-Aug-2024,Reversal,00.00,"1,281.44","3,844.30"
23-Aug-2024,Debit Card,"116,414.47",00.00,"120,258.77"
23-Aug-2024,Cash,00.00,"15,032.35","105,226.42"
23-Aug-2024,Interest,15.78,00.00,"105,242.20"
23-Aug-2024,Cheque,51.16,00.00,"105,293.36"
23-Aug-2024,Bill,00.00,"10,529.34","94,764.02"
23-Aug-2024,Cash,00.00,"9,476.40","85,287.62"
23-Aug-2024,NEFT,00.00,"14,214.60","71,073.02"
23-Aug-2024,RTGS,00.00,"10,153.29","60,919.73"
23-Aug-2024,Commission,"66,687.22",00.00,"127,606.95"
23-Aug-2024,NEFT,"119,771.94",00.00,"247,378.89"
23-Aug-2024,NEFT,00.00,"123,689.45","123,689.44"
23-Aug-2024,Debit Card,"772,777.00",00.00,"896,466.44"
23-Aug-2024,NEFT,00.00,"896,466.44",00.00
23-Aug-2024,Purchase,02.00,00.00,02.00
23-Aug-2024,Cheque,00.00,00.29,01.71
23-Aug-2024,NEFT,"1,952,756.00",00.00,"1,952,757.71"
23-Aug-2024,Purchase,"1,322.20",00.00,"1,954,079.91"
23-Aug-2024,Bill,"189,327.00",00.00,"2,143,406.91"
23-Aug-2024,Commission,01.00,00.00,"2,143,407.91"
23-Aug-2024,Reversal,00.00,"714,469.30","1,428,938.61"
23-Aug-2024,Interest,"7,798.30",00.00,"1,436,736.91"
23-Aug-2024,IMPS,00.00,"205,248.13","1,231,488.78"
23-Aug-2024,Transfer,"16,101.10",00.00,"1,247,589.88"
23-Aug-2024,Debit Card,40.40,00.00,"1,247,630.28"
23-Aug-2024,Debit Card,"1,427.80",00.00,"1,249,058.08"
23-Aug-2024,Tax,00.00,"416,352.69","832,705.39"
23-Aug-2024,Miscellaneous,"2,121.96",00.00,"834,827.35"
23-Aug-2024,Transfer,00.00,"166,965.47","667,861.88"
23-Aug-2024,Cash,02.50,00.00,"667,864.38"
23-Aug-2024,Commission,00.00,"166,966.10","500,898.28"
23-Aug-2024,NEFT,00.90,00.00,"500,899.18"
23-Aug-2024,Cash,03.29,00.00,"500,902.47"
23-Aug-2024,RTGS,00.00,"166,967.49","333,934.98"
23-Aug-2024,Transfer,00.40,00.00,"333,935.38"
23-Aug-2024,RTGS,00.00,"83,483.85","250,451.54"
23-Aug-2024,NEFT,"71,257.38",00.00,"321,708.92"
23-Aug-2024,Reversal,00.00,"64,341.78","257,367.14"
23-Aug-2024,Transfer,00.00,"257,367.14",00.00
23-Aug-2024,IMPS,"30,062.32",00.00,"30,062.32"
23-Aug-2024,RTGS,"49,210.80",00.00,"79,273.12"
23-Aug-2024,Transfer,00.00,"19,818.28","59,454.84"
23-Aug-2024,Cash,00.00,"14,863.71","44,591.13"
23-Aug-2024,RTGS,00.00,"7,431.86","37,159.27"
23-Aug-2024,Commission,"73,808.10",00.00,"110,967.37"
23-Aug-2024,Transfer,"8,208.07",00.00,"119,175.44"
23-Aug-2024,Cash,00.00,"19,862.57","99,312.87"
23-Aug-2024,Reversal,00.00,"16,552.15","82,760.72"
23-Aug-2024,Cheque,00.00,"41,380.36","41,380.36"
23-Aug-2024,Cheque,00.00,"4,138.04","37,242.32"
23-Aug-2024,Miscellaneous,"1,197,005.50",00.00,"1,234,247.82"
23-Aug-2024,IMPS,00.00,"308,561.96","925,685.86"
23-Aug-2024,Miscellaneous,00.00,"308,561.95","617,123.91"
23-Aug-2024,Transfer,06.40,00.00,"617,130.31"
23-Aug-2024,Tax,"3,960.52",00.00,"621,090.83"
23-Aug-2024,Reversal,00.00,"69,010.09","552,080.74"
23-Aug-2024,ATM,"2,675.13",00.00,"554,755.87"
23-Aug-2024,Purchase,06.07,00.00,"554,761.94"
23-Aug-2024,Miscellaneous,"2,077.00",00.00,"556,838.94"
23-Aug-2024,Purchase,"558,979.00",00.00,"1,115,817.94"
23-Aug-2024,Cash,"64,685.62",00.00,"1,180,503.56"
23-Aug-2024,ATM,03.00,00.00,"1,180,506.56"
23-Aug-2024,Tax,00.00,"168,643.79","1,011,862.77"
23-Aug-2024,Purchase,00.00,"1,011,862.77",00.00
23-Aug-2024,Debit Card,"112,199.00",00.00,"112,199.00"
23-Aug-2024,Cash,415.00,00.00,"112,614.00"
23-Aug-2024,Commission,07.60,00.00,"112,621.60"
23-Aug-2024,Miscellaneous,"2,523.00",00.00,"115,144.60"
23-Aug-2024,Miscellaneous,04.30,00.00,"115,148.90"
23-Aug-2024,NEFT,361.70,00.00,"115,510.60"
23-Aug-2024,Tax,00.00,"38,503.53","77,007.07"
23-Aug-2024,ATM,00.00,"12,834.51","64,172.56"
23-Aug-2024,IMPS,"1,522.34",00.00,"65,694.90"
23-Aug-2024,Reversal,"8,632.70",00.00,"74,327.60"
23-Aug-2024,RTGS,"20,870.20",00.00,"95,197.80"
23-Aug-2024,Bill,402.00,00.00,"95,599.80"
23-Aug-2024,Tax,"1,417,817.00",00.00,"1,513,416.80"
23-Aug-2024,Cheque,00.00,"302,683.36","1,210,733.44"
23-Aug-2024,Transfer,00.00,"201,788.91","1,008,944.53"
23-Aug-2024,Interest,00.00,"112,104.95","896,839.58"
23-Aug-2024,RTGS,"170,932.50",00.00,"1,067,772.08"
23-Aug-2024,Purchase,36.40,00.00,"1,067,808.48"
23-Aug-2024,Miscellaneous,"17,740.59",00.00,"1,085,549.07"
23-Aug-2024,Miscellaneous,05.20,00.00,"1,085,554.27"
23-Aug-2024,Miscellaneous,00.00,"217,110.85","868,443.42"
23-Aug-2024,Interest,380.00,00.00,"868,823.42"
23-Aug-2024,Cash,00.00,"108,602.93","760,220.49"
23-Aug-2024,Miscellaneous,452.00,00.00,"760,672.49"
23-Aug-2024,Purchase,00.00,"108,667.50","652,004.99"
23-Aug-2024,Cheque,217.61,00.00,"652,222.60"
23-Aug-2024,RTGS,00.00,"108,703.77","543,518.83"
23-Aug-2024,Cash,785.60,00.00,"544,304.43"
23-Aug-2024,Cash,00.00,"54,430.44","489,873.99"
23-Aug-2024,Tax,"1,890,344.75",00.00,"2,380,218.74"
23-Aug-2024,Interest,448.00,00.00,"2,380,666.74"
23-Aug-2024,Debit Card,00.00,"264,518.53","2,116,148.21"
23-Aug-2024,Commission,74.00,00.00,"2,116,222.21"
23-Aug-2024,Bill,06.30,00.00,"2,116,228.51"
23-Aug-2024,Bill,"1,429,970.00",00.00,"3,546,198.51"
23-Aug-2024,Reversal,00.00,"1,773,099.26","1,773,099.26"
23-Aug-2024,Reversal,"730,747.00",00.00,"2,503,846.26"
23-Aug-2024,Purchase,00.00,"417,307.71","2,086,538.55"
23-Aug-2024,Debit Card,00.00,"695,512.85","1,391,025.70"
23-Aug-2024,Tax,00.00,"1,391,025.70",00.00
23-Aug-2024,Commission,"3,863.76",00.00,"3,863.76"
23-Aug-2024,NEFT,"1,756,994.00",00.00,"1,760,857.76"
23-Aug-2024,ATM,00.00,"880,428.88","880,428.88"
23-Aug-2024,Cash,"2,376.00",00.00,"882,804.88"
23-Aug-2024,RTGS,00.00,"220,701.22","662,103.66"
23-Aug-2024,Debit Card,24.10,00.00,"662,127.76"
23-Aug-2024,Debit Card,00.00,"331,063.88","331,063.88"
23-Aug-2024,IMPS,00.00,"110,354.63","220,709.25"
23-Aug-2024,Debit Card,00.00,"73,569.75","147,139.50"
23-Aug-2024,Tax,03.00,00.00,"147,142.50"
23-Aug-2024,NEFT,"100,688.00",00.00,"247,830.50"
23-Aug-2024,Cash,359.90,00.00,"248,190.40"
23-Aug-2024,Bill,"18,577.61",00.00,"266,768.01"
23-Aug-2024,Interest,38.00,00.00,"266,806.01"
23-Aug-2024,IMPS,"191,031.00",00.00,"457,837.01"
23-Aug-2024,Transfer,00.00,"152,612.34","305,224.67"
23-Aug-2024,Reversal,00.00,"61,044.93","244,179.74"
23-Aug-2024,Purchase,00.00,"244,179.74",00.00
23-Aug-2024,Cheque,"373,907.50",00.00,"373,907.50"
23-Aug-2024,IMPS,00.00,"373,907.50",00.00
23-Aug-2024,Interest,01.00,00.00,01.00
23-Aug-2024,Bill,00.00,00.20,00.80
23-Aug-2024,Bill,29.20,00.00,30.00
23-Aug-2024,Reversal,00.00,15.00,15.00
23-Aug-2024,ATM,159.74,00.00,174.74
23-Aug-2024,Commission,00.00,17.47,157.27
23-Aug-2024,Debit Card,"1,031,465.50",00.00,"1,031,622.77"
23-Aug-2024,Transfer,"764,377.20",00.00,"1,795,999.97"
23-Aug-2024,Reversal,00.00,"359,199.99","1,436,799.98"
23-Aug-2024,RTGS,37.70,00.00,"1,436,837.68"
23-Aug-2024,ATM,"1,915,620.50",00.00,"3,352,458.18"
23-Aug-2024,RTGS,00.00,"838,114.55","2,514,343.64"
23-Aug-2024,Bill,00.00,"359,191.95","2,155,151.69"
23-Aug-2024,Reversal,"25,953.00",00.00,"2,181,104.69"
23-Aug-2024,IMPS,00.00,"363,517.45","1,817,587.24"
23-Aug-2024,Bill,"22,174.00",00.00,"1,839,761.24"
23-Aug-2024,Transfer,"3,725.00",00.00,"1,843,486.24"
23-Aug-2024,Debit Card,"202,953.60",00.00,"2,046,439.84"
23-Aug-2024,Purchase,488.33,00.00,"2,046,928.17"
23-Aug-2024,Cash,281.64,00.00,"2,047,209.81"
23-Aug-2024,Reversal,43.10,00.00,"2,047,252.91"
23-Aug-2024,ATM,00.00,"2,047,252.91",00.00
23-Aug-2024,Tax,06.80,00.00,06.80
23-Aug-2024,Cash,123.98,00.00,130.78
23-Aug-2024,Bill,02.80,00.00,133.58
23-Aug-2024,Commission,"3,216.30",00.00,"3,349.88"
23-Aug-2024,ATM,"2,799.03",00.00,"6,148.91"
23-Aug-2024,Tax,00.00,878.42,"5,270.49"
23-Aug-2024,Miscellaneous,00.00,658.81,"4,611.68"
23-Aug-2024,Purchase,"1,092,582.00",00.00,"1,097,193.68"
23-Aug-2024,Cash,00.83,00.00,"1,097,194.51"
23-Aug-2024,Transfer,"18,761.20",00.00,"1,115,955.71"
23-Aug-2024,ATM,52.00,00.00,"1,116,007.71"
23-Aug-2024,Commission,56.66,00.00,"1,116,064.37"
23-Aug-2024,ATM,00.00,"223,212.87","892,851.50"
23-Aug-2024,RTGS,00.00,"127,550.21","765,301.29"
23-Aug-2024,Transfer,00.00,"109,328.76","655,972.53"
23-Aug-2024,Reversal,"108,907.80",00.00,"764,880.33"
23-Aug-2024,Debit Card,00.00,"254,960.11","509,920.22"
23-Aug-2024,Debit Card,00.00,"101,984.04","407,936.18"
23-Aug-2024,Bill,04.81,00.00,"407,940.99"
23-Aug-2024,Commission,00.00,"50,992.62","356,948.37"
23-Aug-2024,Bill,"3,613.62",00.00,"360,561.99"
23-Aug-2024,NEFT,00.00,"360,561.99",00.00
23-Aug-2024,Bill,"523,574.00",00.00,"523,574.00"
23-Aug-2024,Purchase,00.00,"58,174.89","465,399.11"
23-Aug-2024,Tax,00.00,"66,485.59","398,913.52"
23-Aug-2024,Transfer,422.44,00.00,"399,335.96"
23-Aug-2024,Cheque,"1,016.90",00.00,"400,352.86"
23-Aug-2024,Tax,"103,820.59",00.00,"504,173.45"
23-Aug-2024,Miscellaneous,415.97,00.00,"504,589.42"
23-Aug-2024,Interest,00.00,"84,098.24","420,491.18"
23-Aug-2024,Cash,00.00,"60,070.17","360,421.01"
23-Aug-2024,Miscellaneous,00.00,"72,084.20","288,336.81"
23-Aug-2024,Miscellaneous,00.00,"41,190.97","247,145.84"
23-Aug-2024,Commission,"43,325.00",00.00,"290,470.84"
23-Aug-2024,Commission,00.00,"48,411.81","242,059.03"
23-Aug-2024,Bill,00.00,"242,059.03",00.00
23-Aug-2024,Commission,"1,449.20",00.00,"1,449.20"
23-Aug-2024,Reversal,00.00,161.02,"1,288.18"
24-Aug-2024,RTGS,00.00,322.05,966.14
24-Aug-2024,Miscellaneous,00.00,193.23,772.91
24-Aug-2024,IMPS,00.00,772.91,00.00
24-Aug-2024,ATM,"17,303.55",00.00,"17,303.55"
24-Aug-2024,RTGS,00.00,"2,883.93","14,419.62"
24-Aug-2024,Reversal,58.00,00.00,"14,477.62"
24-Aug-2024,Debit Card,00.00,"1,608.62","12,869.00"
24-Aug-2024,Interest,109.00,00.00,"12,978.00"
24-Aug-2024,Transfer,00.00,"1,297.80","11,680.20"
24-Aug-2024,RTGS,"27,874.06",00.00,"39,554.26"
24-Aug-2024,Cash,"27,951.40",00.00,"67,505.66"
25-Aug-2024,Transfer,00.00,"33,752.83","33,752.83"
25-Aug-2024,Miscellaneous,"142,336.00",00.00,"176,088.83"
25-Aug-2024,NEFT,39.50,00.00,"176,128.33"
25-Aug-2024,Cheque,00.00,"17,612.83","158,515.50"
25-Aug-2024,Miscellaneous,00.00,"158,515.50",00.00
25-Aug-2024,Cash,"1,015,822.00",00.00,"1,015,822.00"
25-Aug-2024,Reversal,00.00,"112,869.11","902,952.89"
25-Aug-2024,Reversal,"55,518.00",00.00,"958,470.89"
25-Aug-2024,NEFT,"3,175.30",00.00,"961,646.19"
25-Aug-2024,NEFT,"17,975.10",00.00,"979,621.29"
25-Aug-2024,Purchase,"259,920.00",00.00,"1,239,541.29"
25-Aug-2024,Cheque,00.00,"247,908.26","991,633.03"
25-Aug-2024,Cheque,"28,206.00",00.00,"1,019,839.03"
25-Aug-2024,Purchase,64.00,00.00,"1,019,903.03"
25-Aug-2024,Bill,55.62,00.00,"1,019,958.65"
25-Aug-2024,Reversal,"1,351,814.00",00.00,"2,371,772.65"
25-Aug-2024,IMPS,00.00,"296,471.58","2,075,301.07"
25-Aug-2024,Reversal,00.00,"207,530.11","1,867,770.96"
25-Aug-2024,Reversal,00.00,"1,867,770.96",00.00
25-Aug-2024,Commission,31.37,00.00,31.37
25-Aug-2024,ATM,00.00,04.48,26.89
25-Aug-2024,NEFT,"1,992,826.00",00.00,"1,992,852.89"
25-Aug-2024,Cash,00.00,"284,693.27","1,708,159.62"
25-Aug-2024,Bill,56.00,00.00,"1,708,215.62"
25-Aug-2024,Interest,00.00,"244,030.80","1,464,184.82"
25-Aug-2024,IMPS,00.00,"732,092.41","732,092.41"
25-Aug-2024,Interest,02.00,00.00,"732,094.41"
25-Aug-2024,ATM,27.00,00.00,"732,121.41"
25-Aug-2024,Cash,34.88,00.00,"732,156.29"
25-Aug-2024,Reversal,"30,320.00",00.00,"762,476.29"
25-Aug-2024,Cash,00.00,"762,476.29",00.00
25-Aug-2024,Bill,"237,030.00",00.00,"237,030.00"
25-Aug-2024,IMPS,09.77,00.00,"237,039.77"
25-Aug-2024,RTGS,00.23,00.00,"237,040.00"
25-Aug-2024,Bill,03.80,00.00,"237,043.80"
25-Aug-2024,IMPS,431.00,00.00,"237,474.80"
25-Aug-2024,Debit Card,00.00,"26,386.09","211,088.71"
25-Aug-2024,Reversal,07.00,00.00,"211,095.71"
25-Aug-2024,Interest,"113,780.22",00.00,"324,875.93"
25-Aug-2024,Commission,"3,858.00",00.00,"328,733.93"
25-Aug-2024,ATM,"72,648.90",00.00,"401,382.83"
25-Aug-2024,RTGS,00.00,"200,691.42","200,691.42"
25-Aug-2024,RTGS,"1,272.00",00.00,"201,963.42"
25-Aug-2024,Interest,"2,518.13",00.00,"204,481.55"
25-Aug-2024,ATM,184.00,00.00,"204,665.55"
25-Aug-2024,Miscellaneous,00.00,"51,166.39","153,499.16"
25-Aug-2024,Miscellaneous,00.00,"76,749.58","76,749.58"
25-Aug-2024,Cheque,03.80,00.00,"76,753.38"
25-Aug-2024,Tax,"619,629.20",00.00,"696,382.58"
25-Aug-2024,Bill,00.00,"232,127.53","464,255.05"
25-Aug-2024,RTGS,00.00,"464,255.05",00.00
25-Aug-2024,Cheque,"3,449.55",00.00,"3,449.55"
25-Aug-2024,RTGS,00.00,383.28,"3,066.27"
25-Aug-2024,Cheque,00.00,"1,022.09","2,044.18"
25-Aug-2024,Commission,00.00,227.13,"1,817.05"
25-Aug-2024,Reversal,965.00,00.00,"2,782.05"
25-Aug-2024,NEFT,00.00,347.76,"2,434.29"
25-Aug-2024,Purchase,00.00,608.57,"1,825.72"
25-Aug-2024,Transfer,"2,973.00",00.00,"4,798.72"
25-Aug-2024,Debit Card,"28,834.00",00.00,"33,632.72"
25-Aug-2024,Debit Card,"13,029.00",00.00,"46,661.72"
25-Aug-2024,RTGS,00.00,"9,332.34","37,329.38"
25-Aug-2024,IMPS,00.00,"6,221.56","31,107.82"
25-Aug-2024,Bill,00.00,"10,369.27","20,738.55"
25-Aug-2024,Reversal,19.90,00.00,"20,758.45"
25-Aug-2024,Cheque,"26,510.80",00.00,"47,269.25"
25-Aug-2024,Bill,00.00,"5,908.66","41,360.59"
26-Aug-2024,ATM,00.00,"10,340.15","31,020.44"
26-Aug-2024,Tax,255.40,00.00,"31,275.84"
26-Aug-2024,Interest,"3,550.90",00.00,"34,826.74"
26-Aug-2024,Commission,26.10,00.00,"34,852.84"
26-Aug-2024,Debit Card,"1,272,224.00",00.00,"1,307,076.84"
26-Aug-2024,Purchase,"169,439.25",00.00,"1,476,516.09"
26-Aug-2024,Cash,"40,237.12",00.00,"1,516,753.21"
26-Aug-2024,NEFT,00.00,"758,376.61","758,376.60"
26-Aug-2024,Tax,00.00,"758,376.60",00.00
26-Aug-2024,Commission,385.79,00.00,385.79
26-Aug-2024,Cash,00.00,55.11,330.68
26-Aug-2024,Tax,00.00,33.07,297.61
26-Aug-2024,RTGS,475.50,00.00,773.11
26-Aug-2024,Bill,"76,480.70",00.00,"77,253.81"
26-Aug-2024,Commission,00.00,"38,626.91","38,626.90"
26-Aug-2024,Debit Card,"24,402.00",00.00,"63,028.90"
26-Aug-2024,ATM,10.00,00.00,"63,038.90"
26-Aug-2024,RTGS,00.00,"63,038.90",00.00
26-Aug-2024,Bill,"41,413.20",00.00,"41,413.20"
26-Aug-2024,Commission,"1,617,990.00",00.00,"1,659,403.20"
26-Aug-2024,Miscellaneous,"3,682.00",00.00,"1,663,085.20"
27-Aug-2024,Bill,29.00,00.00,"1,663,114.20"
27-Aug-2024,Reversal,57.44,00.00,"1,663,171.64"
27-Aug-2024,RTGS,18.80,00.00,"1,663,190.44"
27-Aug-2024,Interest,00.00,"166,319.04","1,496,871.40"
27-Aug-2024,Commission,33.30,00.00,"1,496,904.70"
28-Aug-2024,Purchase,00.00,"748,452.35","748,452.35"
28-Aug-2024,Cheque,07.00,00.00,"748,459.35"
28-Aug-2024,Transfer,00.00,"149,691.87","598,767.48"
28-Aug-2024,Cash,00.00,"149,691.87","449,075.61"
28-Aug-2024,RTGS,00.00,"64,153.66","384,921.95"
28-Aug-2024,Cheque,"2,268.00",00.00,"387,189.95"
28-Aug-2024,Cash,00.00,"193,594.98","193,594.98"
28-Aug-2024,IMPS,00.00,"32,265.83","161,329.15"
28-Aug-2024,Tax,00.00,"26,888.19","134,440.96"
28-Aug-2024,Reversal,"1,072,593.75",00.00,"1,207,034.71"
28-Aug-2024,Bill,"250,590.90",00.00,"1,457,625.61"
28-Aug-2024,Cheque,00.00,"145,762.56","1,311,863.05"
28-Aug-2024,Interest,00.00,"131,186.31","1,180,676.75"
28-Aug-2024,Tax,01.00,00.00,"1,180,677.75"
28-Aug-2024,Tax,271.60,00.00,"1,180,949.35"
28-Aug-2024,Tax,"3,249.00",00.00,"1,184,198.35"
28-Aug-2024,Interest,00.00,"236,839.67","947,358.68"
28-Aug-2024,Bill,"1,697.00",00.00,"949,055.68"
28-Aug-2024,Tax,"3,087.28",00.00,"952,142.96"
28-Aug-2024,Miscellaneous,00.00,"158,690.49","793,452.47"
28-Aug-2024,Cheque,"17,885.86",00.00,"811,338.33"
28-Aug-2024,RTGS,00.00,"90,148.70","721,189.63"
29-Aug-2024,Debit Card,"406,472.50",00.00,"1,127,662.13"
29-Aug-2024,Reversal,"3,826.50",00.00,"1,131,488.63"
29-Aug-2024,Tax,00.00,"377,162.88","754,325.75"
29-Aug-2024,Debit Card,00.00,"251,441.92","502,883.83"
29-Aug-2024,Purchase,00.00,"71,840.55","431,043.28"
29-Aug-2024,RTGS,00.00,"61,577.61","369,465.67"
29-Aug-2024,Transfer,286.00,00.00,"369,751.67"
29-Aug-2024,Miscellaneous,484.00,00.00,"370,235.67"
29-Aug-2024,Interest,00.00,"61,705.95","308,529.72"
29-Aug-2024,Cheque,00.00,"44,075.67","264,454.05"
29-Aug-2024,Interest,06.00,00.00,"264,460.05"
29-Aug-2024,Cash,"254,108.50",00.00,"518,568.55"
29-Aug-2024,Tax,04.00,00.00,"518,572.55"
29-Aug-2024,Tax,08.00,00.00,"518,580.55"
29-Aug-2024,Cash,00.00,"172,860.18","345,720.37"
29-Aug-2024,Bill,54.00,00.00,"345,774.37"
29-Aug-2024,Tax,06.00,00.00,"345,780.37"
29-Aug-2024,Interest,00.00,"38,420.04","307,360.33"
29-Aug-2024,RTGS,"209,774.00",00.00,"517,134.33"
29-Aug-2024,Tax,00.00,"103,426.87","413,707.46"
29-Aug-2024,Transfer,00.00,"51,713.43","361,994.03"
29-Aug-2024,RTGS,04.75,00.00,"361,998.78"
29-Aug-2024,IMPS,672.55,00.00,"362,671.33"
29-Aug-2024,Cash,00.00,"181,335.67","181,335.66"
29-Aug-2024,IMPS,"1,637,194.00",00.00,"1,818,529.66"
29-Aug-2024,Purchase,934.90,00.00,"1,819,464.56"
29-Aug-2024,Purchase,00.00,"303,244.09","1,516,220.47"
29-Aug-2024,RTGS,"64,878.00",00.00,"1,581,098.47"
29-Aug-2024,RTGS,00.00,"197,637.31","1,383,461.16"
29-Aug-2024,NEFT,00.00,"172,932.65","1,210,528.51"
29-Aug-2024,NEFT,00.00,"1,210,528.51",00.00
29-Aug-2024,Cash,17.79,00.00,17.79
29-Aug-2024,RTGS,00.00,02.54,15.25
29-Aug-2024,RTGS,393.00,00.00,408.25
29-Aug-2024,Miscellaneous,00.00,81.65,326.60
29-Aug-2024,Bill,474.15,00.00,800.75
29-Aug-2024,Cash,01.20,00.00,801.95
29-Aug-2024,Tax,00.00,80.20,721.76
29-Aug-2024,Interest,316.01,00.00,"1,037.77"
29-Aug-2024,Cheque,00.00,345.92,691.85
29-Aug-2024,Reversal,93.20,00.00,785.05
29-Aug-2024,Interest,00.00,130.84,654.21
29-Aug-2024,Miscellaneous,00.00,654.21,00.00
29-Aug-2024,Transfer,30.72,00.00,30.72
29-Aug-2024,IMPS,00.00,30.72,00.00
29-Aug-2024,Cash,496.60,00.00,496.60
29-Aug-2024,Bill,00.00,99.32,397.28
29-Aug-2024,Cheque,02.00,00.00,399.28
29-Aug-2024,Commission,00.00,44.36,354.92
29-Aug-2024,Interest,02.98,00.00,357.90
29-Aug-2024,Miscellaneous,242.00,00.00,599.90
29-Aug-2024,Transfer,07.00,00.00,606.90
29-Aug-2024,Cheque,"1,485,223.50",00.00,"1,485,830.40"
29-Aug-2024,Bill,410.79,00.00,"1,486,241.19"
29-Aug-2024,Miscellaneous,"168,222.12",00.00,"1,654,463.31"
29-Aug-2024,Debit Card,"215,838.59",00.00,"1,870,301.90"
29-Aug-2024,Bill,00.00,"311,716.98","1,558,584.92"
29-Aug-2024,ATM,00.00,"173,176.10","1,385,408.82"
29-Aug-2024,Interest,00.00,"173,176.10","1,212,232.72"
29-Aug-2024,Transfer,00.00,"404,077.57","808,155.15"
29-Aug-2024,Tax,266.33,00.00,"808,421.48"
29-Aug-2024,Purchase,"1,501,901.20",00.00,"2,310,322.68"
29-Aug-2024,Debit Card,"2,281.60",00.00,"2,312,604.28"
29-Aug-2024,Bill,00.00,"1,156,302.14","1,156,302.14"
29-Aug-2024,Transfer,00.00,"231,260.43","925,041.71"
29-Aug-2024,Transfer,"24,647.30",00.00,"949,689.01"
29-Aug-2024,NEFT,00.00,"237,422.25","712,266.76"
29-Aug-2024,Miscellaneous,00.00,"101,752.39","610,514.37"
29-Aug-2024,IMPS,00.00,"203,504.79","407,009.58"
29-Aug-2024,Reversal,00.00,"135,669.86","271,339.72"
29-Aug-2024,Commission,00.00,"90,446.57","180,893.15"
29-Aug-2024,Tax,"147,040.00",00.00,"327,933.15"
29-Aug-2024,Reversal,00.00,"40,991.64","286,941.51"
30-Aug-2024,Purchase,00.10,00.00,"286,941.61"
30-Aug-2024,Interest,"1,794,728.00",00.00,"2,081,669.61"
30-Aug-2024,Tax,93.70,00.00,"2,081,763.31"
30-Aug-2024,Interest,00.00,"231,307.03","1,850,456.28"
30-Aug-2024,IMPS,00.00,"1,850,456.28",00.00
30-Aug-2024,Commission,"1,821,459.00",00.00,"1,821,459.00"
30-Aug-2024,Debit Card,289.74,00.00,"1,821,748.74"
30-Aug-2024,RTGS,01.70,00.00,"1,821,750.44"
30-Aug-2024,Transfer,00.00,"182,175.04","1,639,575.40"
30-Aug-2024,Interest,"596,254.00",00.00,"2,235,829.40"
30-Aug-2024,Purchase,00.00,"1,117,914.70","1,117,914.70"
30-Aug-2024,Purchase,"20,028.00",00.00,"1,137,942.70"
30-Aug-2024,Cheque,00.00,"284,485.68","853,457.02"
30-Aug-2024,ATM,00.00,"426,728.51","426,728.51"
30-Aug-2024,Commission,348.20,00.00,"427,076.71"
30-Aug-2024,Cheque,00.00,"61,010.96","366,065.75"
30-Aug-2024,IMPS,00.00,"122,021.92","244,043.83"
30-Aug-2024,Miscellaneous,00.00,"30,505.48","213,538.35"
30-Aug-2024,Transfer,"1,763,743.80",00.00,"1,977,282.15"
30-Aug-2024,Miscellaneous,"31,506.34",00.00,"2,008,788.49"
30-Aug-2024,Cash,00.00,"1,004,394.25","1,004,394.24"
30-Aug-2024,Cash,00.00,"143,484.89","860,909.35"
30-Aug-2024,Commission,"2,032,850.75",00.00,"2,893,760.10"
30-Aug-2024,RTGS,00.00,"2,893,760.10",00.00
30-Aug-2024,NEFT,52.40,00.00,52.40
30-Aug-2024,NEFT,371.60,00.00,424.00
30-Aug-2024,Reversal,00.00,212.00,212.00
30-Aug-2024,Cheque,00.00,30.29,181.71
30-Aug-2024,Commission,01.30,00.00,183.01
30-Aug-2024,Miscellaneous,00.00,26.14,156.87
30-Aug-2024,Purchase,"25,108.39",00.00,"25,265.26"
31-Aug-2024,Purchase,00.00,"2,526.53","22,738.73"
31-Aug-2024,Debit Card,46.00,00.00,"22,784.73"
31-Aug-2024,Transfer,00.00,"2,531.64","20,253.09"
31-Aug-2024,Debit Card,00.00,"2,250.34","18,002.75"
31-Aug-2024,Bill,00.00,"2,571.82","15,430.93"
31-Aug-2024,NEFT,00.00,"15,430.93",00.00
31-Aug-2024,Commission,"772,331.00",00.00,"772,331.00"
31-Aug-2024,Bill,"2,045,919.00",00.00,"2,818,250.00"
31-Aug-2024,Cash,462.00,00.00,"2,818,712.00"
31-Aug-2024,Cash,00.00,"704,678.00","2,114,034.00"
31-Aug-2024,Tax,00.00,"211,403.40","1,902,630.60"
31-Aug-2024,Cheque,"58,950.00",00.00,"1,961,580.60"
31-Aug-2024,ATM,"6,513.00",00.00,"1,968,093.60"
31-Aug-2024,Interest,00.00,"218,677.07","1,749,416.53"
31-Aug-2024,Miscellaneous,149.00,00.00,"1,749,565.53"
31-Aug-2024,Transfer,"13,813.00",00.00,"1,763,378.53"
01-Sep-2024,Bill,"22,985.29",00.00,"1,786,363.82"
01-Sep-2024,Tax,26.00,00.00,"1,786,389.82"
01-Sep-2024,Miscellaneous,23.60,00.00,"1,786,413.42"
01-Sep-2024,Debit Card,"3,026.40",00.00,"1,789,439.82"
01-Sep-2024,Cheque,00.00,"223,679.98","1,565,759.84"
01-Sep-2024,Purchase,00.00,"173,973.32","1,391,786.52"
01-Sep-2024,Commission,00.00,"463,928.84","927,857.68"
01-Sep-2024,Interest,01.40,00.00,"927,859.08"
01-Sep-2024,Tax,00.00,"185,571.82","742,287.26"
01-Sep-2024,Transfer,"188,640.03",00.00,"930,927.29"
01-Sep-2024,Commission,00.00,"232,731.82","698,195.47"
01-Sep-2024,Debit Card,284.90,00.00,"698,480.37"
01-Sep-2024,IMPS,00.00,"349,240.19","349,240.18"
01-Sep-2024,IMPS,34.00,00.00,"349,274.18"
01-Sep-2024,Miscellaneous,"70,769.60",00.00,"420,043.78"
01-Sep-2024,NEFT,"149,478.00",00.00,"569,521.78"
01-Sep-2024,Bill,"2,515.20",00.00,"572,036.98"
01-Sep-2024,RTGS,00.00,"114,407.40","457,629.58"
01-Sep-2024,RTGS,"24,369.00",00.00,"481,998.58"
01-Sep-2024,Debit Card,85.00,00.00,"482,083.58"
01-Sep-2024,Tax,00.00,"241,041.79","241,041.79"
01-Sep-2024,Reversal,00.00,"34,434.54","206,607.25"
01-Sep-2024,NEFT,00.00,"29,515.32","177,091.93"
01-Sep-2024,NEFT,"5,615.86",00.00,"182,707.79"
01-Sep-2024,RTGS,00.00,"26,101.11","156,606.68"
01-Sep-2024,Bill,00.00,"15,660.67","140,946.01"
02-Sep-2024,RTGS,00.00,"35,236.50","105,709.51"
02-Sep-2024,IMPS,14.60,00.00,"105,724.11"
02-Sep-2024,Commission,01.80,00.00,"105,725.91"
02-Sep-2024,NEFT,00.00,"35,241.97","70,483.94"
02-Sep-2024,Reversal,"2,019,449.00",00.00,"2,089,932.94"
02-Sep-2024,Purchase,"26,412.90",00.00,"2,116,345.84"
02-Sep-2024,Reversal,00.00,"352,724.31","1,763,621.53"
03-Sep-2024,Cheque,00.00,"176,362.15","1,587,259.38"
03-Sep-2024,Purchase,"77,048.00",00.00,"1,664,307.38"
03-Sep-2024,ATM,00.00,"208,038.42","1,456,268.96"
03-Sep-2024,Commission,00.00,"182,033.62","1,274,235.34"
03-Sep-2024,Reversal,00.00,"212,372.56","1,061,862.78"
03-Sep-2024,Debit Card,494.50,00.00,"1,062,357.28"
03-Sep-2024,NEFT,00.00,"177,059.55","885,297.73"
03-Sep-2024,NEFT,"1,433.00",00.00,"886,730.73"
03-Sep-2024,Reversal,12.98,00.00,"886,743.71"
03-Sep-2024,Bill,05.50,00.00,"886,749.21"
03-Sep-2024,Bill,00.00,"295,583.07","591,166.14"
03-Sep-2024,Miscellaneous,"795,483.50",00.00,"1,386,649.64"
03-Sep-2024,Debit Card,"21,447.41",00.00,"1,408,097.05"
03-Sep-2024,Purchase,00.00,"176,012.13","1,232,084.92"
03-Sep-2024,Commission,00.00,"154,010.62","1,078,074.30"
03-Sep-2024,Interest,00.00,"269,518.58","808,555.73"
03-Sep-2024,Debit Card,00.00,"80,855.57","727,700.16"
03-Sep-2024,Reversal,"95,142.00",00.00,"822,842.16"
03-Sep-2024,RTGS,"248,075.50",00.00,"1,070,917.66"
03-Sep-2024,Interest,"6,824.00",00.00,"1,077,741.66"
03-Sep-2024,Transfer,00.00,"153,963.09","923,778.57"
03-Sep-2024,Cheque,"16,370.00",00.00,"940,148.57"
03-Sep-2024,Commission,07.20,00.00,"940,155.77"
03-Sep-2024,Cash,"82,646.00",00.00,"1,022,801.77"
03-Sep-2024,IMPS,00.00,"170,466.96","852,334.81"
03-Sep-2024,Miscellaneous,00.00,"852,334.81",00.00
03-Sep-2024,Cheque,"3,526.20",00.00,"3,526.20"
03-Sep-2024,Cheque,00.00,705.24,"2,820.96"
03-Sep-2024,Purchase,637.50,00.00,"3,458.46"
03-Sep-2024,Commission,00.00,384.27,"3,074.19"
03-Sep-2024,Debit Card,468.10,00.00,"3,542.29"
03-Sep-2024,Bill,00.00,354.23,"3,188.06"
03-Sep-2024,ATM,00.00,531.34,"2,656.72"
03-Sep-2024,Cash,02.40,00.00,"2,659.12"
03-Sep-2024,Miscellaneous,00.00,531.82,"2,127.30"
03-Sep-2024,Reversal,"16,970.00",00.00,"19,097.30"
03-Sep-2024,Transfer,00.00,"1,909.73","17,187.57"
03-Sep-2024,Cheque,"2,485.26",00.00,"19,672.83"
03-Sep-2024,Transfer,00.00,"2,185.87","17,486.96"
03-Sep-2024,Debit Card,"1,754.90",00.00,"19,241.86"
03-Sep-2024,Tax,00.00,"19,241.86",00.00
03-Sep-2024,IMPS,274.00,00.00,274.00
03-Sep-2024,Reversal,"1,096,686.00",00.00,"1,096,960.00"
03-Sep-2024,Purchase,00.00,"365,653.33","731,306.67"
03-Sep-2024,Transfer,35.51,00.00,"731,342.18"
03-Sep-2024,Purchase,391.20,00.00,"731,733.38"
03-Sep-2024,Interest,62.00,00.00,"731,795.38"
03-Sep-2024,Commission,"22,374.00",00.00,"754,169.38"
03-Sep-2024,Miscellaneous,"3,919.04",00.00,"758,088.42"
03-Sep-2024,Transfer,"1,771.00",00.00,"759,859.42"
03-Sep-2024,Commission,"1,927,027.80",00.00,"2,686,887.22"
04-Sep-2024,Purchase,00.00,"537,377.44","2,149,509.78"
04-Sep-2024,IMPS,00.00,"307,072.83","1,842,436.95"
04-Sep-2024,Miscellaneous,05.00,00.00,"1,842,441.95"
04-Sep-2024,Miscellaneous,00.00,"184,244.20","1,658,197.76"
04-Sep-2024,Reversal,00.00,"276,366.29","1,381,831.47"
04-Sep-2024,Cash,00.00,"172,728.93","1,209,102.54"
04-Sep-2024,Interest,00.00,"120,910.25","1,088,192.29"
04-Sep-2024,Cheque,55.92,00.00,"1,088,248.21"
04-Sep-2024,Interest,00.00,"181,374.70","906,873.51"
04-Sep-2024,Debit Card,"97,875.90",00.00,"1,004,749.41"
04-Sep-2024,RTGS,00.00,"125,593.68","879,155.73"
04-Sep-2024,Bill,00.00,"175,831.15","703,324.58"
04-Sep-2024,Tax,05.00,00.00,"703,329.58"
04-Sep-2024,Reversal,00.00,"351,664.79","351,664.79"
04-Sep-2024,Cash,00.00,"175,832.40","175,832.40"
04-Sep-2024,Debit Card,00.00,"19,536.93","156,295.47"
04-Sep-2024,Debit Card,"1,987,061.50",00.00,"2,143,356.97"
04-Sep-2024,Interest,00.00,"238,150.77","1,905,206.20"
04-Sep-2024,RTGS,00.00,"190,520.62","1,714,685.58"
04-Sep-2024,Commission,49.40,00.00,"1,714,734.98"
04-Sep-2024,Miscellaneous,00.00,"342,947.00","1,371,787.98"
04-Sep-2024,ATM,00.00,"137,178.80","1,234,609.18"
04-Sep-2024,Reversal,00.00,"246,921.84","987,687.34"
04-Sep-2024,Interest,"132,896.70",00.00,"1,120,584.04"
04-Sep-2024,Miscellaneous,00.00,"280,146.01","840,438.03"
04-Sep-2024,Bill,00.00,"105,054.75","735,383.28"
04-Sep-2024,Purchase,00.00,"367,691.64","367,691.64"
04-Sep-2024,Reversal,04.73,00.00,"367,696.37"
04-Sep-2024,Purchase,27.26,00.00,"367,723.63"
04-Sep-2024,Bill,02.00,00.00,"367,725.63"
04-Sep-2024,RTGS,00.00,"45,965.70","321,759.93"
04-Sep-2024,Transfer,00.00,"35,751.10","286,008.83"
04-Sep-2024,Reversal,00.00,"35,751.10","250,257.73"
04-Sep-2024,Tax,04.99,00.00,"250,262.72"
04-Sep-2024,Purchase,413.00,00.00,"250,675.72"
04-Sep-2024,Purchase,00.00,"25,067.57","225,608.15"
04-Sep-2024,Tax,00.00,"225,608.15",00.00
04-Sep-2024,Bill,"2,082.54",00.00,"2,082.54"
04-Sep-2024,Tax,05.00,00.00,"2,087.54"
04-Sep-2024,Cheque,00.00,"2,087.54",00.00
04-Sep-2024,Bill,"12,934.90",00.00,"12,934.90"
04-Sep-2024,Miscellaneous,00.00,"1,847.84","11,087.06"
04-Sep-2024,Purchase,188.00,00.00,"11,275.06"
04-Sep-2024,Tax,19.29,00.00,"11,294.35"
04-Sep-2024,Interest,"10,670.79",00.00,"21,965.14"
04-Sep-2024,Commission,"730,618.20",00.00,"752,583.34"
04-Sep-2024,Debit Card,266.90,00.00,"752,850.24"
04-Sep-2024,RTGS,00.00,"125,475.04","627,375.20"
04-Sep-2024,Debit Card,06.00,00.00,"627,381.20"
04-Sep-2024,Commission,00.00,"627,381.20",00.00
04-Sep-2024,Transfer,"21,145.00",00.00,"21,145.00"
04-Sep-2024,IMPS,00.00,"10,572.50","10,572.50"
04-Sep-2024,Cash,00.00,"3,524.17","7,048.33"
04-Sep-2024,Debit Card,00.00,"1,006.90","6,041.43"
04-Sep-2024,Miscellaneous,00.00,755.18,"5,286.25"
04-Sep-2024,Transfer,"2,088,477.75",00.00,"2,093,764.00"
05-Sep-2024,Miscellaneous,00.00,"348,960.67","1,744,803.33"
05-Sep-2024,Commission,00.00,"581,601.11","1,163,202.22"
05-Sep-2024,Cash,00.00,"166,171.75","997,030.47"
05-Sep-2024,Transfer,49.00,00.00,"997,079.47"
05-Sep-2024,Bill,00.00,"498,539.74","498,539.74"
05-Sep-2024,Miscellaneous,00.00,"83,089.96","415,449.78"
06-Sep-2024,ATM,00.00,"41,544.98","373,904.80"
06-Sep-2024,Interest,"115,636.47",00.00,"489,541.27"
06-Sep-2024,Cash,"202,879.20",00.00,"692,420.47"
06-Sep-2024,Interest,00.00,"346,210.24","346,210.24"
06-Sep-2024,Tax,00.00,"43,276.28","302,933.96"
06-Sep-2024,NEFT,"1,711,190.80",00.00,"2,014,124.76"
06-Sep-2024,Purchase,"1,554,356.50",00.00,"3,568,481.26"
07-Sep-2024,Purchase,28.10,00.00,"3,568,509.36"
07-Sep-2024,RTGS,00.00,00.00,"3,568,509.36"
07-Sep-2024,Commission,00.00,"3,568,509.36",00.00
07-Sep-2024,IMPS,42.00,00.00,42.00
07-Sep-2024,Tax,00.00,05.25,36.75
07-Sep-2024,Reversal,03.70,00.00,40.45
07-Sep-2024,Transfer,"21,107.60",00.00,"21,148.05"
07-Sep-2024,Purchase,"3,287.00",00.00,"24,435.05"
07-Sep-2024,Tax,"1,987,218.00",00.00,"2,011,653.05"
07-Sep-2024,RTGS,00.00,"670,551.02","1,341,102.03"
07-Sep-2024,Interest,"500,783.80",00.00,"1,841,885.83"
07-Sep-2024,Commission,"176,404.69",00.00,"2,018,290.52"
07-Sep-2024,Transfer,"5,368.00",00.00,"2,023,658.52"
07-Sep-2024,Cash,34.80,00.00,"2,023,693.32"
07-Sep-2024,Cash,05.00,00.00,"2,023,698.32"
07-Sep-2024,IMPS,"963,296.50",00.00,"2,986,994.82"
07-Sep-2024,IMPS,"2,025,464.00",00.00,"5,012,458.82"
07-Sep-2024,ATM,00.00,"501,245.88","4,511,212.94"
08-Sep-2024,Cash,00.00,"563,901.62","3,947,311.32"
08-Sep-2024,Debit Card,"146,199.40",00.00,"4,093,510.72"
08-Sep-2024,ATM,00.00,"4,093,510.72",00.00
08-Sep-2024,Reversal,"1,755.08",00.00,"1,755.08"
08-Sep-2024,Commission,00.00,195.01,"1,560.07"
08-Sep-2024,Reversal,00.00,"1,560.07",00.00
08-Sep-2024,Bill,"1,320,926.20",00.00,"1,320,926.20"
08-Sep-2024,Commission,00.00,"146,769.58","1,174,156.62"
08-Sep-2024,Interest,03.93,00.00,"1,174,160.55"
08-Sep-2024,Reversal,"9,501.30",00.00,"1,183,661.85"
08-Sep-2024,ATM,"185,793.00",00.00,"1,369,454.85"
08-Sep-2024,Cheque,02.30,00.00,"1,369,457.15"
08-Sep-2024,Reversal,00.00,"684,728.58","684,728.58"
08-Sep-2024,ATM,118.50,00.00,"684,847.08"
08-Sep-2024,Cheque,00.00,"171,211.77","513,635.31"
08-Sep-2024,Reversal,417.81,00.00,"514,053.12"
08-Sep-2024,Transfer,44.26,00.00,"514,097.38"
08-Sep-2024,Interest,00.00,"257,048.69","257,048.69"
08-Sep-2024,Cheque,"706,919.20",00.00,"963,967.89"
08-Sep-2024,ATM,00.00,"120,495.99","843,471.90"
08-Sep-2024,RTGS,04.67,00.00,"843,476.57"
08-Sep-2024,Reversal,"3,308.19",00.00,"846,784.76"
08-Sep-2024,IMPS,00.00,"120,969.25","725,815.51"
08-Sep-2024,Cheque,25.00,00.00,"725,840.51"
08-Sep-2024,Interest,"25,917.12",00.00,"751,757.63"
08-Sep-2024,Reversal,00.00,"150,351.53","601,406.10"
08-Sep-2024,Transfer,03.00,00.00,"601,409.10"
08-Sep-2024,RTGS,23.01,00.00,"601,432.11"
08-Sep-2024,Interest,01.00,00.00,"601,433.11"
08-Sep-2024,RTGS,00.00,"60,143.31","541,289.80"
08-Sep-2024,Cash,00.00,"77,327.11","463,962.69"
08-Sep-2024,Cash,00.00,"46,396.27","417,566.42"
08-Sep-2024,Tax,00.00,"83,513.28","334,053.14"
08-Sep-2024,RTGS,00.00,"167,026.57","167,026.57"
09-Sep-2024,Interest,00.00,"20,878.32","146,148.25"
09-Sep-2024,Tax,00.00,"146,148.25",00.00
09-Sep-2024,Cheque,"253,048.09",00.00,"253,048.09"
09-Sep-2024,Miscellaneous,"28,434.20",00.00,"281,482.29"
09-Sep-2024,RTGS,"7,489.80",00.00,"288,972.09"
10-Sep-2024,Debit Card,00.00,"96,324.03","192,648.06"
10-Sep-2024,Commission,00.00,"24,081.01","168,567.05"
10-Sep-2024,Debit Card,217.33,00.00,"168,784.38"
10-Sep-2024,Miscellaneous,00.00,"84,392.19","84,392.19"
10-Sep-2024,Purchase,00.00,"84,392.19",00.00
10-Sep-2024,Debit Card,07.00,00.00,07.00
10-Sep-2024,RTGS,20.00,00.00,27.00
10-Sep-2024,Miscellaneous,00.00,02.70,24.30
10-Sep-2024,Tax,"2,983.93",00.00,"3,008.23"
10-Sep-2024,RTGS,00.00,376.03,"2,632.20"
10-Sep-2024,Bill,00.00,526.44,"2,105.76"
10-Sep-2024,Commission,00.00,701.92,"1,403.84"
10-Sep-2024,ATM,00.00,701.92,701.92
10-Sep-2024,Interest,"1,173,452.75",00.00,"1,174,154.67"
10-Sep-2024,RTGS,00.00,"1,174,154.67",00.00
10-Sep-2024,Purchase,"1,361.88",00.00,"1,361.88"
10-Sep-2024,Commission,00.00,194.55,"1,167.33"
10-Sep-2024,Cheque,"238,667.97",00.00,"239,835.30"
10-Sep-2024,Transfer,56.70,00.00,"239,892.00"
10-Sep-2024,Tax,00.00,"47,978.40","191,913.60"
10-Sep-2024,Transfer,00.00,"21,323.73","170,589.87"
10-Sep-2024,Debit Card,"5,014.00",00.00,"175,603.87"
10-Sep-2024,Purchase,00.00,"43,900.97","131,702.90"
10-Sep-2024,ATM,"11,317.00",00.00,"143,019.90"
10-Sep-2024,RTGS,00.00,"28,603.98","114,415.92"
10-Sep-2024,Purchase,00.00,"11,441.59","102,974.33"
10-Sep-2024,Purchase,00.00,"102,974.33",00.00
10-Sep-2024,Transfer,01.00,00.00,01.00
10-Sep-2024,Purchase,00.00,00.25,00.75
10-Sep-2024,Bill,"251,579.09",00.00,"251,579.84"
11-Sep-2024,Interest,00.00,"62,894.96","188,684.88"
11-Sep-2024,Debit Card,"25,633.80",00.00,"214,318.68"
11-Sep-2024,Reversal,00.00,"26,789.84","187,528.84"
11-Sep-2024,Tax,469.68,00.00,"187,998.52"
11-Sep-2024,Commission,"3,331.00",00.00,"191,329.52"
11-Sep-2024,Tax,"2,846.16",00.00,"194,175.68"
11-Sep-2024,Interest,00.00,"19,417.57","174,758.11"
11-Sep-2024,Commission,35.00,00.00,"174,793.11"
11-Sep-2024,Cheque,00.00,"21,849.14","152,943.97"
11-Sep-2024,Commission,"31,998.00",00.00,"184,941.97"
11-Sep-2024,Bill,270.67,00.00,"185,212.64"
11-Sep-2024,Reversal,00.00,"20,579.18","164,633.46"
11-Sep-2024,Bill,"2,227.55",00.00,"166,861.01"
12-Sep-2024,Commission,976.30,00.00,"167,837.31"
12-Sep-2024,Tax,01.20,00.00,"167,838.51"
12-Sep-2024,Bill,"1,592,805.00",00.00,"1,760,643.51"
12-Sep-2024,Cheque,03.00,00.00,"1,760,646.51"
12-Sep-2024,Miscellaneous,"2,532.00",00.00,"1,763,178.51"
12-Sep-2024,NEFT,"229,941.50",00.00,"1,993,120.01"
12-Sep-2024,Tax,00.00,"498,280.00","1,494,840.01"
12-Sep-2024,Transfer,346.42,00.00,"1,495,186.43"
12-Sep-2024,Bill,523.00,00.00,"1,495,709.43"
12-Sep-2024,Bill,384.00,00.00,"1,496,093.43"
12-Sep-2024,NEFT,00.00,"213,727.63","1,282,365.80"
12-Sep-2024,IMPS,"14,175.63",00.00,"1,296,541.43"
12-Sep-2024,Cash,"29,807.00",00.00,"1,326,348.43"
13-Sep-2024,Miscellaneous,"515,874.00",00.00,"1,842,222.43"
14-Sep-2024,Interest,00.00,"1,842,222.43",00.00
14-Sep-2024,ATM,60.30,00.00,60.30
14-Sep-2024,Commission,"3,503.69",00.00,"3,563.99"
14-Sep-2024,NEFT,06.00,00.00,"3,569.99"
14-Sep-2024,Transfer,"1,159,153.00",00.00,"1,162,722.99"
14-Sep-2024,Reversal,00.00,"581,361.50","581,361.50"
14-Sep-2024,RTGS,"258,868.78",00.00,"840,230.28"
14-Sep-2024,Commission,"1,242.00",00.00,"841,472.28"
14-Sep-2024,Debit Card,00.00,"105,184.04","736,288.24"
14-Sep-2024,Commission,00.00,"184,072.06","552,216.18"
14-Sep-2024,Cheque,00.00,"92,036.03","460,180.15"
14-Sep-2024,RTGS,38.00,00.00,"460,218.15"
14-Sep-2024,Bill,158.00,00.00,"460,376.15"
14-Sep-2024,Interest,00.00,"153,458.72","306,917.43"
14-Sep-2024,Purchase,"7,816.19",00.00,"314,733.62"
14-Sep-2024,Cash,"31,670.22",00.00,"346,403.84"
14-Sep-2024,Cheque,07.43,00.00,"346,411.27"
14-Sep-2024,Purchase,22.00,00.00,"346,433.27"
14-Sep-2024,Bill,00.10,00.00,"346,433.37"
14-Sep-2024,IMPS,05.36,00.00,"346,438.73"
14-Sep-2024,Commission,00.00,"34,643.87","311,794.86"
14-Sep-2024,Cash,00.00,"62,358.97","249,435.89"
14-Sep-2024,IMPS,"1,226.50",00.00,"250,662.39"
14-Sep-2024,IMPS,"1,655.00",00.00,"252,317.39"
14-Sep-2024,Debit Card,00.00,"28,035.27","224,282.12"
14-Sep-2024,Purchase,00.00,"37,380.35","186,901.77"
14-Sep-2024,Tax,"1,283,157.20",00.00,"1,470,058.97"
14-Sep-2024,Debit Card,00.00,"163,339.89","1,306,719.08"
14-Sep-2024,Reversal,00.00,"326,679.77","980,039.31"
14-Sep-2024,Bill,00.00,"980,039.31",00.00
14-Sep-2024,Reversal,233.00,00.00,233.00
14-Sep-2024,Interest,00.00,233.00,00.00
14-Sep-2024,Cheque,17.00,00.00,17.00
14-Sep-2024,Cheque,"180,675.44",00.00,"180,692.44"
14-Sep-2024,Reversal,00.00,"20,076.94","160,615.50"
14-Sep-2024,Bill,00.00,"160,615.50",00.00
14-Sep-2024,Debit Card,"1,036,808.75",00.00,"1,036,808.75"
14-Sep-2024,Debit Card,00.00,"518,404.38","518,404.38"
14-Sep-2024,ATM,"2,653.12",00.00,"521,057.50"
14-Sep-2024,Tax,00.00,"86,842.92","434,214.58"
14-Sep-2024,Reversal,"237,851.80",00.00,"672,066.38"
14-Sep-2024,Tax,00.00,"168,016.60","504,049.78"
14-Sep-2024,Transfer,00.00,"126,012.45","378,037.34"
14-Sep-2024,Purchase,00.00,"47,254.67","330,782.67"
14-Sep-2024,NEFT,00.00,"330,782.67",00.00
14-Sep-2024,NEFT,307.59,00.00,307.59
14-Sep-2024,Reversal,00.00,61.52,246.07
14-Sep-2024,Commission,50.70,00.00,296.77
14-Sep-2024,Interest,"19,669.00",00.00,"19,965.77"
14-Sep-2024,Debit Card,05.80,00.00,"19,971.57"
14-Sep-2024,Debit Card,00.00,"4,992.89","14,978.68"
14-Sep-2024,Transfer,03.40,00.00,"14,982.08"
14-Sep-2024,Debit Card,00.00,"1,664.68","13,317.40"
14-Sep-2024,IMPS,07.14,00.00,"13,324.54"
14-Sep-2024,Purchase,01.01,00.00,"13,325.55"
14-Sep-2024,Interest,00.00,"13,325.55",00.00
14-Sep-2024,NEFT,709.83,00.00,709.83
14-Sep-2024,Purchase,00.00,177.46,532.37
14-Sep-2024,Bill,484.87,00.00,"1,017.24"
14-Sep-2024,IMPS,"213,801.00",00.00,"214,818.24"
14-Sep-2024,Commission,450.90,00.00,"215,269.14"
14-Sep-2024,Transfer,"27,106.40",00.00,"242,375.54"
14-Sep-2024,ATM,00.00,"40,395.92","201,979.62"
14-Sep-2024,RTGS,"2,394.00",00.00,"204,373.62"
14-Sep-2024,NEFT,04.00,00.00,"204,377.62"
14-Sep-2024,Cheque,00.00,"20,437.76","183,939.86"
14-Sep-2024,Transfer,00.00,"22,992.48","160,947.38"
14-Sep-2024,NEFT,511.00,00.00,"161,458.38"
14-Sep-2024,Commission,"2,190.06",00.00,"163,648.44"
14-Sep-2024,IMPS,"216,558.50",00.00,"380,206.94"
14-Sep-2024,Transfer,00.00,"42,245.22","337,961.72"
14-Sep-2024,NEFT,"6,387.12",00.00,"344,348.84"
14-Sep-2024,Bill,00.00,"49,192.69","295,156.15"
14-Sep-2024,IMPS,00.00,"49,192.69","245,963.46"
14-Sep-2024,Debit Card,00.00,"61,490.87","184,472.60"
14-Sep-2024,Purchase,"8,709.00",00.00,"193,181.60"
14-Sep-2024,Bill,02.90,00.00,"193,184.50"
14-Sep-2024,IMPS,00.00,"32,197.42","160,987.08"
14-Sep-2024,RTGS,"1,584.00",00.00,"162,571.08"
14-Sep-2024,Bill,"24,749.00",00.00,"187,320.08"
14-Sep-2024,Tax,00.00,"26,760.01","160,560.07"
14-Sep-2024,ATM,00.00,"40,140.02","120,420.05"
14-Sep-2024,Cheque,501.00,00.00,"120,921.05"
14-Sep-2024,IMPS,00.00,"60,460.53","60,460.52"
14-Sep-2024,ATM,00.00,"20,153.51","40,307.01"
14-Sep-2024,RTGS,01.00,00.00,"40,308.01"
15-Sep-2024,NEFT,00.00,"4,478.67","35,829.34"
15-Sep-2024,Debit Card,"14,209.00",00.00,"50,038.34"
15-Sep-2024,Reversal,00.50,00.00,"50,038.84"
15-Sep-2024,Bill,"3,190.40",00.00,"53,229.24"
15-Sep-2024,Debit Card,"25,278.00",00.00,"78,507.24"
15-Sep-2024,Miscellaneous,00.00,"15,701.45","62,805.79"
15-Sep-2024,Interest,07.17,00.00,"62,812.96"
15-Sep-2024,Cash,00.00,"10,468.83","52,344.13"
15-Sep-2024,NEFT,"3,294.00",00.00,"55,638.13"
15-Sep-2024,Miscellaneous,00.00,"7,948.30","47,689.83"
15-Sep-2024,Cheque,00.00,"7,948.31","39,741.52"
15-Sep-2024,Commission,04.90,00.00,"39,746.42"
15-Sep-2024,Miscellaneous,17.08,00.00,"39,763.50"
15-Sep-2024,Transfer,"538,069.00",00.00,"577,832.50"
15-Sep-2024,Bill,"1,735.10",00.00,"579,567.60"
15-Sep-2024,Debit Card,00.00,"82,795.37","496,772.23"
15-Sep-2024,Interest,00.00,"165,590.74","331,181.49"
15-Sep-2024,NEFT,"17,332.00",00.00,"348,513.49"
15-Sep-2024,ATM,"165,708.00",00.00,"514,221.49"
15-Sep-2024,RTGS,00.00,"57,135.72","457,085.77"
15-Sep-2024,NEFT,"474,961.00",00.00,"932,046.77"
15-Sep-2024,Cash,00.00,"116,505.85","815,540.92"
15-Sep-2024,IMPS,05.68,00.00,"815,546.60"
15-Sep-2024,Tax,00.00,"90,616.29","724,930.31"
15-Sep-2024,Debit Card,"202,554.50",00.00,"927,484.81"
15-Sep-2024,RTGS,00.00,"132,497.83","794,986.98"
15-Sep-2024,Purchase,06.67,00.00,"794,993.65"
15-Sep-2024,Cash,00.00,"113,570.52","681,423.13"
15-Sep-2024,Debit Card,00.00,"97,346.16","584,076.97"
15-Sep-2024,ATM,"20,603.02",00.00,"604,679.99"
15-Sep-2024,Miscellaneous,00.00,"75,585.00","529,094.99"
15-Sep-2024,Bill,00.00,"52,909.50","476,185.49"
15-Sep-2024,ATM,00.00,"158,728.50","317,456.99"
15-Sep-2024,Cash,"1,786.52",00.00,"319,243.51"
15-Sep-2024,Tax,00.00,"106,414.50","212,829.01"
15-Sep-2024,RTGS,00.00,"35,471.50","177,357.51"
15-Sep-2024,Transfer,00.00,"19,706.39","157,651.12"
15-Sep-2024,Interest,00.00,"26,275.19","131,375.93"
15-Sep-2024,RTGS,48.00,00.00,"131,423.93"
15-Sep-2024,Purchase,00.00,"131,423.93",00.00
15-Sep-2024,Interest,"2,035.06",00.00,"2,035.06"
15-Sep-2024,Miscellaneous,62.00,00.00,"2,097.06"
16-Sep-2024,NEFT,00.00,"2,097.06",00.00
16-Sep-2024,Debit Card,148.00,00.00,148.00
16-Sep-2024,Cash,16.00,00.00,164.00
16-Sep-2024,Bill,00.00,23.43,140.57
16-Sep-2024,IMPS,"29,857.00",00.00,"29,997.57"
16-Sep-2024,NEFT,00.00,"4,285.37","25,712.20"
16-Sep-2024,Debit Card,00.00,"3,214.03","22,498.18"
16-Sep-2024,Cash,00.00,"2,499.80","19,998.38"
16-Sep-2024,IMPS,00.00,"6,666.13","13,332.25"
16-Sep-2024,Reversal,"214,999.19",00.00,"228,331.44"
16-Sep-2024,Cheque,353.80,00.00,"228,685.24"
16-Sep-2024,Interest,"29,852.38",00.00,"258,537.62"
16-Sep-2024,ATM,06.72,00.00,"258,544.34"
16-Sep-2024,ATM,"6,761.80",00.00,"265,306.14"
16-Sep-2024,Tax,"769,132.00",00.00,"1,034,438.14"
16-Sep-2024,NEFT,00.00,"1,034,438.14",00.00
16-Sep-2024,ATM,"3,668.21",00.00,"3,668.21"
16-Sep-2024,RTGS,"1,568.90",00.00,"5,237.11"
16-Sep-2024,Debit Card,00.00,"2,618.56","2,618.55"
16-Sep-2024,ATM,"151,507.10",00.00,"154,125.65"
16-Sep-2024,Transfer,"1,490.20",00.00,"155,615.85"
16-Sep-2024,Purchase,05.10,00.00,"155,620.95"
16-Sep-2024,Debit Card,"2,053,970.20",00.00,"2,209,591.15"
16-Sep-2024,ATM,48.90,00.00,"2,209,640.05"
16-Sep-2024,IMPS,00.00,"368,273.34","1,841,366.71"
16-Sep-2024,Transfer,00.00,"368,273.34","1,473,093.37"
16-Sep-2024,Transfer,00.00,"163,677.04","1,309,416.33"
16-Sep-2024,Cash,52.00,00.00,"1,309,468.33"
16-Sep-2024,Interest,00.00,"218,244.72","1,091,223.61"
16-Sep-2024,Cheque,00.00,"1,091,223.61",00.00
16-Sep-2024,RTGS,03.81,00.00,03.81
16-Sep-2024,ATM,00.00,00.95,02.86
16-Sep-2024,Purchase,07.00,00.00,09.86
16-Sep-2024,Interest,"25,357.90",00.00,"25,367.76"
16-Sep-2024,Debit Card,00.00,"5,073.55","20,294.21"
16-Sep-2024,Commission,00.00,"2,254.91","18,039.30"
16-Sep-2024,Reversal,00.00,"2,254.91","15,784.39"
16-Sep-2024,Bill,00.00,"1,973.05","13,811.34"
16-Sep-2024,Reversal,00.00,"1,381.13","12,430.21"
16-Sep-2024,Purchase,00.00,"2,486.04","9,944.17"
16-Sep-2024,Commission,"3,334.70",00.00,"13,278.87"
16-Sep-2024,ATM,00.00,"3,319.72","9,959.15"
16-Sep-2024,IMPS,33.00,00.00,"9,992.15"
16-Sep-2024,Cash,00.00,999.22,"8,992.94"
16-Sep-2024,Transfer,"1,059,118.75",00.00,"1,068,111.69"
16-Sep-2024,RTGS,00.00,"213,622.34","854,489.35"
16-Sep-2024,Interest,"240,864.53",00.00,"1,095,353.88"
16-Sep-2024,Tax,00.00,"109,535.39","985,818.49"
16-Sep-2024,IMPS,"153,904.00",00.00,"1,139,722.49"
16-Sep-2024,NEFT,"1,247.60",00.00,"1,140,970.09"
16-Sep-2024,Commission,00.00,"570,485.05","570,485.05"
16-Sep-2024,ATM,"1,590,897.00",00.00,"2,161,382.05"
16-Sep-2024,Cheque,00.00,"308,768.86","1,852,613.19"
16-Sep-2024,Miscellaneous,444.70,00.00,"1,853,057.89"
16-Sep-2024,Commission,00.00,"205,895.32","1,647,162.57"
16-Sep-2024,NEFT,00.00,"823,581.29","823,581.28"
16-Sep-2024,Interest,41.00,00.00,"823,622.28"
16-Sep-2024,Reversal,"7,530.96",00.00,"831,153.24"
16-Sep-2024,Commission,00.00,"118,736.18","712,417.06"
16-Sep-2024,Tax,07.80,00.00,"712,424.86"
16-Sep-2024,ATM,00.00,"237,474.95","474,949.91"
16-Sep-2024,Commission,"432,632.00",00.00,"907,581.91"
16-Sep-2024,Cheque,50.46,00.00,"907,632.37"
16-Sep-2024,RTGS,00.00,"181,526.47","726,105.90"
16-Sep-2024,Tax,00.00,"103,729.41","622,376.49"
16-Sep-2024,Cash,"214,682.00",00.00,"837,058.49"
16-Sep-2024,Reversal,00.00,"139,509.75","697,548.74"
16-Sep-2024,IMPS,00.00,"99,649.82","597,898.92"
16-Sep-2024,Commission,349.28,00.00,"598,248.20"
16-Sep-2024,Reversal,00.00,"74,781.03","523,467.17"
16-Sep-2024,Tax,00.00,"65,433.40","458,033.77"
16-Sep-2024,IMPS,24.38,00.00,"458,058.15"
16-Sep-2024,NEFT,00.00,"76,343.03","381,715.12"
16-Sep-2024,IMPS,00.00,"381,715.12",00.00
16-Sep-2024,Reversal,"970,777.20",00.00,"970,777.20"
16-Sep-2024,Cheque,00.00,"485,388.60","485,388.60"
16-Sep-2024,Cash,00.00,"97,077.72","388,310.88"
17-Sep-2024,IMPS,945.60,00.00,"389,256.48"
17-Sep-2024,Debit Card,00.00,"194,628.24","194,628.24"
17-Sep-2024,Cash,07.90,00.00,"194,636.14"
17-Sep-2024,Tax,"2,697.30",00.00,"197,333.44"
17-Sep-2024,RTGS,10.00,00.00,"197,343.44"
17-Sep-2024,Reversal,"17,142.99",00.00,"214,486.43"
17-Sep-2024,Miscellaneous,00.00,"21,448.64","193,037.79"
17-Sep-2024,Cheque,00.00,"38,607.56","154,430.23"
17-Sep-2024,Tax,00.00,"38,607.56","115,822.67"
17-Sep-2024,Cheque,00.00,"16,546.10","99,276.57"
17-Sep-2024,RTGS,00.00,"24,819.14","74,457.43"
17-Sep-2024,Purchase,02.00,00.00,"74,459.43"
17-Sep-2024,Reversal,"163,651.00",00.00,"238,110.43"
17-Sep-2024,ATM,00.00,"23,811.04","214,299.39"
17-Sep-2024,Cash,06.50,00.00,"214,305.89"
17-Sep-2024,Interest,"1,361,490.80",00.00,"1,575,796.69"
17-Sep-2024,RTGS,00.00,"393,949.17","1,181,847.52"
17-Sep-2024,Cash,"6,023.63",00.00,"1,187,871.15"
17-Sep-2024,Cash,00.00,"1,187,871.15",00.00
17-Sep-2024,RTGS,803.07,00.00,803.07
17-Sep-2024,Commission,711.00,00.00,"1,514.07"
17-Sep-2024,RTGS,00.00,504.69,"1,009.38"
18-Sep-2024,Miscellaneous,"223,911.00",00.00,"224,920.38"
18-Sep-2024,Miscellaneous,"1,907.30",00.00,"226,827.68"
18-Sep-2024,Interest,00.00,"45,365.54","181,462.14"
18-Sep-2024,RTGS,00.00,"22,682.77","158,779.37"
18-Sep-2024,Purchase,00.00,"26,463.23","132,316.14"
18-Sep-2024,Purchase,00.00,"33,079.04","99,237.11"
18-Sep-2024,Reversal,"3,232.00",00.00,"102,469.11"
18-Sep-2024,Cash,00.00,"34,156.37","68,312.74"
18-Sep-2024,Purchase,"11,161.70",00.00,"79,474.44"
18-Sep-2024,NEFT,00.00,"15,894.89","63,579.55"
18-Sep-2024,Purchase,00.00,"15,894.89","47,684.66"
18-Sep-2024,Bill,00.00,"5,298.30","42,386.36"
18-Sep-2024,IMPS,00.00,"4,709.60","37,676.76"
18-Sep-2024,Cheque,"3,522.00",00.00,"41,198.76"
18-Sep-2024,Commission,359.10,00.00,"41,557.86"
18-Sep-2024,Debit Card,00.00,"4,155.79","37,402.07"
18-Sep-2024,Debit Card,"1,707,553.00",00.00,"1,744,955.07"
18-Sep-2024,Bill,00.00,"348,991.01","1,395,964.06"
18-Sep-2024,IMPS,00.00,"139,596.41","1,256,367.65"
18-Sep-2024,RTGS,72.80,00.00,"1,256,440.45"
18-Sep-2024,RTGS,812.21,00.00,"1,257,252.66"
18-Sep-2024,RTGS,00.00,"419,084.22","838,168.44"
18-Sep-2024,Tax,00.00,"209,542.11","628,626.33"
18-Sep-2024,Transfer,00.00,"125,725.27","502,901.06"
18-Sep-2024,NEFT,"142,423.00",00.00,"645,324.06"
18-Sep-2024,Cheque,00.00,"129,064.81","516,259.25"
18-Sep-2024,Reversal,00.00,"258,129.63","258,129.62"
18-Sep-2024,ATM,00.00,"51,625.92","206,503.70"
18-Sep-2024,Miscellaneous,00.00,"20,650.37","185,853.33"
18-Sep-2024,Bill,02.00,00.00,"185,855.33"
18-Sep-2024,Commission,"2,408.00",00.00,"188,263.33"
18-Sep-2024,Purchase,00.00,"37,652.67","150,610.66"
18-Sep-2024,Cash,74.00,00.00,"150,684.66"
18-Sep-2024,Cheque,"27,778.76",00.00,"178,463.42"
18-Sep-2024,Miscellaneous,04.45,00.00,"178,467.87"
18-Sep-2024,Commission,00.00,"19,829.76","158,638.11"
18-Sep-2024,Miscellaneous,00.00,"22,662.59","135,975.52"
18-Sep-2024,Cash,00.00,"16,996.94","118,978.58"
18-Sep-2024,Tax,00.00,"39,659.53","79,319.05"
18-Sep-2024,Bill,00.00,"11,331.29","67,987.76"
18-Sep-2024,RTGS,00.00,"16,996.94","50,990.82"
18-Sep-2024,ATM,"458,102.80",00.00,"509,093.62"
18-Sep-2024,Commission,00.00,"72,727.66","436,365.96"
18-Sep-2024,Reversal,06.58,00.00,"436,372.54"
18-Sep-2024,Cheque,00.00,"87,274.51","349,098.03"
18-Sep-2024,Debit Card,"30,835.00",00.00,"379,933.03"
18-Sep-2024,Debit Card,00.00,"54,276.15","325,656.88"
18-Sep-2024,NEFT,"3,475.74",00.00,"329,132.62"
18-Sep-2024,Purchase,96.87,00.00,"329,229.49"
18-Sep-2024,RTGS,00.00,"82,307.37","246,922.12"
18-Sep-2024,Commission,00.00,"82,307.37","164,614.75"
18-Sep-2024,Transfer,63.20,00.00,"164,677.95"
18-Sep-2024,Transfer,20.92,00.00,"164,698.87"
18-Sep-2024,Cash,"1,277.00",00.00,"165,975.87"
18-Sep-2024,Debit Card,"73,240.69",00.00,"239,216.56"
18-Sep-2024,Reversal,"260,130.70",00.00,"499,347.26"
18-Sep-2024,Transfer,252.40,00.00,"499,599.66"
18-Sep-2024,Reversal,"1,575.30",00.00,"501,174.96"
18-Sep-2024,Tax,00.00,"83,529.16","417,645.80"
18-Sep-2024,Debit Card,00.00,"139,215.27","278,430.53"
18-Sep-2024,Tax,00.00,"34,803.82","243,626.71"
19-Sep-2024,Reversal,"17,889.30",00.00,"261,516.01"
19-Sep-2024,Cheque,00.00,"29,057.33","232,458.68"
19-Sep-2024,Miscellaneous,06.90,00.00,"232,465.58"
19-Sep-2024,RTGS,00.00,"77,488.53","154,977.05"
19-Sep-2024,Reversal,00.00,"25,829.51","129,147.54"
19-Sep-2024,IMPS,00.00,"16,143.44","113,004.10"
19-Sep-2024,Purchase,00.00,"16,143.44","96,860.66"
19-Sep-2024,IMPS,00.00,"19,372.13","77,488.53"
19-Sep-2024,Purchase,"19,431.00",00.00,"96,919.53"
19-Sep-2024,RTGS,00.00,"32,306.51","64,613.02"
19-Sep-2024,NEFT,244.55,00.00,"64,857.57"
19-Sep-2024,Interest,00.00,"7,206.40","57,651.17"
19-Sep-2024,Cheque,"2,165.00",00.00,"59,816.17"
19-Sep-2024,Reversal,"183,173.60",00.00,"242,989.77"
19-Sep-2024,Tax,00.00,"30,373.72","212,616.05"
19-Sep-2024,RTGS,00.00,"53,154.01","159,462.04"
19-Sep-2024,Interest,00.00,"22,780.29","136,681.75"
19-Sep-2024,Cheque,00.00,"15,186.86","121,494.89"
19-Sep-2024,Cheque,00.00,"13,499.43","107,995.46"
19-Sep-2024,Miscellaneous,00.00,"13,499.43","94,496.03"
19-Sep-2024,Cash,00.00,"94,496.03",00.00
19-Sep-2024,Commission,01.00,00.00,01.00
19-Sep-2024,ATM,"256,457.28",00.00,"256,458.28"
19-Sep-2024,Commission,00.00,"42,743.05","213,715.23"
19-Sep-2024,Miscellaneous,00.00,"106,857.62","106,857.62"
19-Sep-2024,Miscellaneous,00.00,"106,857.62",00.00
19-Sep-2024,Purchase,"506,541.25",00.00,"506,541.25"
19-Sep-2024,RTGS,53.56,00.00,"506,594.81"
19-Sep-2024,Miscellaneous,00.00,"168,864.94","337,729.87"
19-Sep-2024,Interest,"10,091.06",00.00,"347,820.93"
19-Sep-2024,Cheque,00.00,"86,955.23","260,865.70"
19-Sep-2024,Cash,"1,830.00",00.00,"262,695.70"
19-Sep-2024,Miscellaneous,"223,661.72",00.00,"486,357.42"
19-Sep-2024,Cash,00.00,"81,059.57","405,297.85"
19-Sep-2024,IMPS,"342,867.25",00.00,"748,165.10"
19-Sep-2024,Reversal,23.00,00.00,"748,188.10"
19-Sep-2024,Debit Card,208.80,00.00,"748,396.90"
19-Sep-2024,Bill,00.00,"74,839.69","673,557.21"
19-Sep-2024,RTGS,"3,315.00",00.00,"676,872.21"
19-Sep-2024,IMPS,00.00,"84,609.03","592,263.18"
19-Sep-2024,Interest,00.00,"84,609.03","507,654.15"
19-Sep-2024,Miscellaneous,"1,010,377.50",00.00,"1,518,031.65"
19-Sep-2024,ATM,193.40,00.00,"1,518,225.05"
19-Sep-2024,Transfer,00.00,"189,778.13","1,328,446.92"
19-Sep-2024,Bill,"4,086.60",00.00,"1,332,533.52"
19-Sep-2024,Purchase,00.00,"333,133.38","999,400.14"
19-Sep-2024,Reversal,00.00,"333,133.38","666,266.76"
19-Sep-2024,ATM,"109,632.00",00.00,"775,898.76"
19-Sep-2024,Purchase,"1,558,266.00",00.00,"2,334,164.76"
19-Sep-2024,Cash,"1,952,223.50",00.00,"4,286,388.26"
20-Sep-2024,NEFT,00.00,"476,265.36","3,810,122.90"
20-Sep-2024,Cheque,00.00,"952,530.73","2,857,592.18"
20-Sep-2024,ATM,112.06,00.00,"2,857,704.24"
20-Sep-2024,Cheque,00.00,"952,568.08","1,905,136.16"
20-Sep-2024,Miscellaneous,00.00,"211,681.80","1,693,454.36"
20-Sep-2024,Interest,"18,331.80",00.00,"1,711,786.16"
21-Sep-2024,Miscellaneous,"157,423.97",00.00,"1,869,210.13"
21-Sep-2024,Reversal,00.00,"373,842.03","1,495,368.10"
21-Sep-2024,Reversal,"2,055,237.00",00.00,"3,550,605.10"
21-Sep-2024,NEFT,00.00,"394,511.68","3,156,093.42"
21-Sep-2024,Cheque,00.00,"394,511.68","2,761,581.74"
21-Sep-2024,Interest,00.00,"460,263.62","2,301,318.12"
21-Sep-2024,Tax,00.00,"383,553.02","1,917,765.10"
21-Sep-2024,Reversal,00.00,"273,966.44","1,643,798.66"
21-Sep-2024,Tax,00.00,"164,379.87","1,479,418.79"
21-Sep-2024,Purchase,00.00,"211,345.54","1,268,073.25"
21-Sep-2024,Purchase,"4,635.68",00.00,"1,272,708.93"
22-Sep-2024,IMPS,79.29,00.00,"1,272,788.22"
22-Sep-2024,Bill,351.00,00.00,"1,273,139.22"
22-Sep-2024,Purchase,00.00,"159,142.40","1,113,996.82"
22-Sep-2024,ATM,00.00,"159,142.40","954,854.42"
22-Sep-2024,Commission,02.00,00.00,"954,856.42"
22-Sep-2024,Interest,00.00,"136,408.06","818,448.36"
22-Sep-2024,Miscellaneous,00.00,"102,306.05","716,142.32"
22-Sep-2024,Debit Card,09.10,00.00,"716,151.42"
22-Sep-2024,Cheque,303.00,00.00,"716,454.42"
22-Sep-2024,RTGS,48.50,00.00,"716,502.92"
22-Sep-2024,Purchase,00.00,"179,125.73","537,377.19"
22-Sep-2024,Cheque,"1,431.29",00.00,"538,808.48"
22-Sep-2024,Debit Card,00.00,"134,702.12","404,106.36"
22-Sep-2024,Cash,00.00,"40,410.64","363,695.72"
22-Sep-2024,Transfer,363.45,00.00,"364,059.17"
22-Sep-2024,Tax,00.00,"36,405.92","327,653.25"
22-Sep-2024,Bill,00.00,"40,956.66","286,696.59"
22-Sep-2024,Purchase,00.00,"40,956.66","245,739.93"
22-Sep-2024,IMPS,181.00,00.00,"245,920.93"
22-Sep-2024,Reversal,"12,989.90",00.00,"258,910.83"
22-Sep-2024,RTGS,00.00,"129,455.42","129,455.42"
22-Sep-2024,Debit Card,177.00,00.00,"129,632.42"
22-Sep-2024,Bill,00.00,"64,816.21","64,816.21"
22-Sep-2024,Purchase,00.00,"6,481.62","58,334.59"
22-Sep-2024,NEFT,"590,775.00",00.00,"649,109.59"
22-Sep-2024,Miscellaneous,00.00,"92,729.94","556,379.65"
22-Sep-2024,Cash,"196,481.10",00.00,"752,860.75"
22-Sep-2024,Tax,00.00,"107,551.54","645,309.21"
22-Sep-2024,Commission,00.00,"645,309.21",00.00
22-Sep-2024,Interest,03.90,00.00,03.90
22-Sep-2024,ATM,00.00,00.43,03.47
22-Sep-2024,NEFT,"143,184.41",00.00,"143,187.88"
22-Sep-2024,Tax,00.00,"35,796.97","107,390.91"
22-Sep-2024,Cheque,"11,876.26",00.00,"119,267.17"
22-Sep-2024,Commission,00.00,"11,926.72","107,340.45"
22-Sep-2024,Bill,00.00,"35,780.15","71,560.30"
22-Sep-2024,RTGS,340.80,00.00,"71,901.10"
22-Sep-2024,NEFT,00.00,"17,975.28","53,925.82"
22-Sep-2024,ATM,00.00,"7,703.69","46,222.13"
22-Sep-2024,Interest,"2,132.83",00.00,"48,354.96"
22-Sep-2024,Tax,17.00,00.00,"48,371.96"
22-Sep-2024,Purchase,00.00,"24,185.98","24,185.98"
22-Sep-2024,Bill,"1,982.60",00.00,"26,168.58"
22-Sep-2024,Cheque,00.00,"3,738.37","22,430.21"
22-Sep-2024,Reversal,00.00,"2,243.02","20,187.19"
22-Sep-2024,Miscellaneous,33.07,00.00,"20,220.26"
22-Sep-2024,RTGS,00.00,"2,022.03","18,198.23"
22-Sep-2024,Miscellaneous,00.00,"2,022.03","16,176.20"
22-Sep-2024,Cash,00.00,"2,696.03","13,480.17"
22-Sep-2024,NEFT,00.00,"1,348.02","12,132.15"
22-Sep-2024,IMPS,"74,353.30",00.00,"86,485.45"
22-Sep-2024,Reversal,00.00,"21,621.36","64,864.09"
22-Sep-2024,Interest,00.00,"64,864.09",00.00
22-Sep-2024,NEFT,"333,231.75",00.00,"333,231.75"
22-Sep-2024,Transfer,00.00,00.00,"333,231.75"
22-Sep-2024,NEFT,00.00,"33,323.18","299,908.58"
22-Sep-2024,Debit Card,00.00,"33,323.18","266,585.40"
22-Sep-2024,IMPS,00.00,"33,323.18","233,262.23"
22-Sep-2024,Purchase,00.00,"46,652.45","186,609.78"
22-Sep-2024,Miscellaneous,00.00,"62,203.26","124,406.52"
22-Sep-2024,Cheque,00.00,"24,881.30","99,525.22"
22-Sep-2024,Transfer,"79,766.70",00.00,"179,291.92"
22-Sep-2024,Debit Card,"3,287.12",00.00,"182,579.04"
22-Sep-2024,IMPS,00.00,"91,289.52","91,289.52"
22-Sep-2024,Bill,"930,885.00",00.00,"1,022,174.52"
22-Sep-2024,ATM,00.00,"102,217.45","919,957.07"
22-Sep-2024,ATM,"1,125.90",00.00,"921,082.97"
22-Sep-2024,IMPS,00.00,"131,583.28","789,499.69"
22-Sep-2024,Cheque,00.00,"98,687.46","690,812.23"
22-Sep-2024,Debit Card,230.00,00.00,"691,042.23"
22-Sep-2024,Cash,606.41,00.00,"691,648.64"
22-Sep-2024,Commission,00.00,"230,549.55","461,099.09"
22-Sep-2024,Purchase,"1,968.70",00.00,"463,067.79"
22-Sep-2024,RTGS,08.00,00.00,"463,075.79"
22-Sep-2024,Purchase,00.00,"92,615.16","370,460.63"
22-Sep-2024,Interest,"3,373.88",00.00,"373,834.51"
22-Sep-2024,ATM,480.66,00.00,"374,315.17"
22-Sep-2024,Transfer,"208,456.20",00.00,"582,771.37"
22-Sep-2024,Purchase,00.00,"145,692.84","437,078.53"
22-Sep-2024,Miscellaneous,00.00,"109,269.63","327,808.90"
22-Sep-2024,Debit Card,04.30,00.00,"327,813.20"
22-Sep-2024,Transfer,00.00,"327,813.20",00.00
22-Sep-2024,Reversal,379.90,00.00,379.90
22-Sep-2024,Bill,"831,658.00",00.00,"832,037.90"
22-Sep-2024,IMPS,00.78,00.00,"832,038.68"
22-Sep-2024,Transfer,50.50,00.00,"832,089.18"
22-Sep-2024,Interest,411.00,00.00,"832,500.18"
22-Sep-2024,Reversal,00.00,"118,928.60","713,571.58"
22-Sep-2024,Tax,03.20,00.00,"713,574.78"
22-Sep-2024,Transfer,00.00,"89,196.85","624,377.93"
22-Sep-2024,Reversal,21.00,00.00,"624,398.93"
22-Sep-2024,Cheque,00.00,"208,132.98","416,265.95"
22-Sep-2024,NEFT,05.46,00.00,"416,271.41"
22-Sep-2024,Cheque,00.00,"208,135.71","208,135.70"
22-Sep-2024,Debit Card,20.75,00.00,"208,156.45"
22-Sep-2024,IMPS,00.00,"29,736.64","178,419.81"
22-Sep-2024,Commission,00.98,00.00,"178,420.79"
22-Sep-2024,Commission,"2,915.00",00.00,"181,335.79"
22-Sep-2024,Purchase,33.80,00.00,"181,369.59"
22-Sep-2024,NEFT,00.00,"30,228.27","151,141.33"
22-Sep-2024,IMPS,"759,528.00",00.00,"910,669.33"
22-Sep-2024,Transfer,"1,615,188.00",00.00,"2,525,857.33"
22-Sep-2024,IMPS,"3,540.08",00.00,"2,529,397.41"
22-Sep-2024,Debit Card,62.00,00.00,"2,529,459.41"
22-Sep-2024,Cash,08.00,00.00,"2,529,467.41"
22-Sep-2024,Cheque,00.00,"632,366.85","1,897,100.56"
22-Sep-2024,Transfer,"252,093.00",00.00,"2,149,193.56"
23-Sep-2024,Bill,00.00,"268,649.20","1,880,544.36"
23-Sep-2024,Transfer,"14,251.80",00.00,"1,894,796.16"
23-Sep-2024,NEFT,00.00,"189,479.62","1,705,316.54"
23-Sep-2024,Debit Card,00.00,"243,616.65","1,461,699.89"
23-Sep-2024,NEFT,00.00,"1,461,699.89",00.00
23-Sep-2024,Purchase,35.20,00.00,35.20
24-Sep-2024,Tax,00.00,05.87,29.33
24-Sep-2024,Tax,00.00,05.87,23.46
24-Sep-2024,Reversal,00.00,05.87,17.60
24-Sep-2024,Miscellaneous,07.42,00.00,25.02
24-Sep-2024,NEFT,07.89,00.00,32.91
24-Sep-2024,Purchase,"5,715.00",00.00,"5,747.91"
24-Sep-2024,Debit Card,00.00,638.66,"5,109.25"
24-Sep-2024,Bill,00.00,851.54,"4,257.71"
24-Sep-2024,Tax,00.00,851.54,"3,406.17"
24-Sep-2024,ATM,00.00,"1,703.09","1,703.08"
24-Sep-2024,Miscellaneous,21.43,00.00,"1,724.51"
24-Sep-2024,ATM,03.00,00.00,"1,727.51"
24-Sep-2024,Interest,"186,844.70",00.00,"188,572.21"
24-Sep-2024,Miscellaneous,79.56,00.00,"188,651.77"
24-Sep-2024,ATM,00.00,"20,961.31","167,690.46"
24-Sep-2024,ATM,00.00,"83,845.23","83,845.23"
24-Sep-2024,Bill,"9,309.00",00.00,"93,154.23"
24-Sep-2024,Purchase,00.00,"18,630.85","74,523.38"
24-Sep-2024,Cheque,00.00,"9,315.42","65,207.96"
24-Sep-2024,Transfer,"4,447.00",00.00,"69,654.96"
24-Sep-2024,Interest,"68,716.00",00.00,"138,370.96"
24-Sep-2024,Interest,"2,365.75",00.00,"140,736.71"
24-Sep-2024,Cash,"3,449.20",00.00,"144,185.91"
24-Sep-2024,Cheque,"17,876.67",00.00,"162,062.58"
24-Sep-2024,Transfer,00.00,"23,151.80","138,910.78"
24-Sep-2024,Commission,"3,427.00",00.00,"142,337.78"
24-Sep-2024,Bill,00.00,"71,168.89","71,168.89"
24-Sep-2024,Reversal,00.00,"71,168.89",00.00
25-Sep-2024,Purchase,09.35,00.00,09.35
25-Sep-2024,Commission,43.00,00.00,52.35
25-Sep-2024,Commission,"1,890,839.25",00.00,"1,890,891.60"
25-Sep-2024,RTGS,"77,212.00",00.00,"1,968,103.60"
25-Sep-2024,Commission,190.96,00.00,"1,968,294.56"
25-Sep-2024,RTGS,00.00,"656,098.19","1,312,196.37"
25-Sep-2024,Cash,"256,571.28",00.00,"1,568,767.65"
25-Sep-2024,Cash,02.70,00.00,"1,568,770.35"
25-Sep-2024,Bill,04.00,00.00,"1,568,774.35"
25-Sep-2024,NEFT,"240,517.69",00.00,"1,809,292.04"
25-Sep-2024,Tax,"1,070.10",00.00,"1,810,362.14"
25-Sep-2024,Interest,00.00,"905,181.07","905,181.07"
25-Sep-2024,Debit Card,"17,500.70",00.00,"922,681.77"
25-Sep-2024,ATM,"1,596,776.00",00.00,"2,519,457.77"
25-Sep-2024,NEFT,14.54,00.00,"2,519,472.31"
25-Sep-2024,Tax,"98,708.00",00.00,"2,618,180.31"
25-Sep-2024,Commission,00.00,"327,272.54","2,290,907.77"
25-Sep-2024,NEFT,"96,835.50",00.00,"2,387,743.27"
25-Sep-2024,Bill,"14,179.55",00.00,"2,401,922.82"
25-Sep-2024,IMPS,00.00,"600,480.71","1,801,442.11"
25-Sep-2024,Cash,"954,736.80",00.00,"2,756,178.91"
25-Sep-2024,Reversal,00.00,"344,522.36","2,411,656.55"
26-Sep-2024,RTGS,06.20,00.00,"2,411,662.75"
26-Sep-2024,Miscellaneous,00.00,"267,962.53","2,143,700.22"
26-Sep-2024,Transfer,"2,071,428.00",00.00,"4,215,128.22"
26-Sep-2024,Cash,00.00,"4,215,128.22",00.00
26-Sep-2024,Cash,01.40,00.00,01.40
26-Sep-2024,NEFT,"1,874,691.00",00.00,"1,874,692.40"
26-Sep-2024,Debit Card,00.00,"234,336.55","1,640,355.85"
26-Sep-2024,Tax,06.42,00.00,"1,640,362.27"
26-Sep-2024,Cash,00.00,"205,045.28","1,435,316.99"
27-Sep-2024,Bill,"2,861.50",00.00,"1,438,178.49"
27-Sep-2024,Purchase,"8,726.15",00.00,"1,446,904.64"
27-Sep-2024,RTGS,01.00,00.00,"1,446,905.64"
27-Sep-2024,ATM,00.00,"241,150.94","1,205,754.70"
27-Sep-2024,Bill,00.00,"200,959.12","1,004,795.58"
27-Sep-2024,IMPS,"4,086.00",00.00,"1,008,881.58"
27-Sep-2024,Transfer,402.81,00.00,"1,009,284.39"
27-Sep-2024,Reversal,"4,047.00",00.00,"1,013,331.39"
27-Sep-2024,Cash,00.00,"1,013,331.39",00.00
27-Sep-2024,Miscellaneous,00.70,00.00,00.70
27-Sep-2024,Purchase,"3,206.00",00.00,"3,206.70"
27-Sep-2024,IMPS,44.00,00.00,"3,250.70"
27-Sep-2024,Tax,00.00,325.07,"2,925.63"
27-Sep-2024,Debit Card,"3,160.00",00.00,"6,085.63"
27-Sep-2024,Bill,00.00,676.18,"5,409.45"
27-Sep-2024,Interest,"1,473,496.00",00.00,"1,478,905.45"
27-Sep-2024,Cash,"12,045.90",00.00,"1,490,951.35"
27-Sep-2024,Miscellaneous,00.00,"745,475.68","745,475.68"
27-Sep-2024,Reversal,00.00,"93,184.46","652,291.22"
27-Sep-2024,NEFT,00.00,"217,430.41","434,860.81"
27-Sep-2024,Debit Card,00.00,"144,953.60","289,907.21"
27-Sep-2024,Reversal,00.00,"28,990.72","260,916.49"
27-Sep-2024,IMPS,13.40,00.00,"260,929.89"
27-Sep-2024,NEFT,00.00,00.00,"260,929.89"
27-Sep-2024,Interest,02.27,00.00,"260,932.16"
27-Sep-2024,Purchase,"100,947.47",00.00,"361,879.63"
27-Sep-2024,Transfer,"4,077.10",00.00,"365,956.73"
27-Sep-2024,Miscellaneous,"1,840,545.20",00.00,"2,206,501.93"
28-Sep-2024,Commission,00.00,"275,812.74","1,930,689.19"
28-Sep-2024,ATM,02.50,00.00,"1,930,691.69"
28-Sep-2024,IMPS,"2,495.46",00.00,"1,933,187.15"
28-Sep-2024,Commission,"8,793.00",00.00,"1,941,980.15"
28-Sep-2024,Miscellaneous,372.37,00.00,"1,942,352.52"
28-Sep-2024,Cheque,00.00,"1,942,352.52",00.00
28-Sep-2024,Commission,"1,593,160.00",00.00,"1,593,160.00"
28-Sep-2024,IMPS,00.00,"227,594.29","1,365,565.71"
28-Sep-2024,Interest,501.30,00.00,"1,366,067.01"
28-Sep-2024,Transfer,"19,662.00",00.00,"1,385,729.01"
28-Sep-2024,Debit Card,06.87,00.00,"1,385,735.88"
28-Sep-2024,Debit Card,00.00,"692,867.94","692,867.94"
28-Sep-2024,Interest,00.00,"76,985.33","615,882.61"
28-Sep-2024,Miscellaneous,"126,885.00",00.00,"742,767.61"
28-Sep-2024,ATM,"17,035.50",00.00,"759,803.11"
28-Sep-2024,Commission,06.80,00.00,"759,809.91"
28-Sep-2024,IMPS,"21,979.11",00.00,"781,789.02"
28-Sep-2024,Cash,00.00,"78,178.90","703,610.12"
28-Sep-2024,NEFT,00.50,00.00,"703,610.62"
28-Sep-2024,ATM,00.00,"117,268.44","586,342.18"
28-Sep-2024,Cheque,00.00,"293,171.09","293,171.09"
28-Sep-2024,Miscellaneous,04.00,00.00,"293,175.09"
28-Sep-2024,Purchase,00.00,"293,175.09",00.00
28-Sep-2024,Transfer,"30,688.30",00.00,"30,688.30"
28-Sep-2024,NEFT,00.00,"3,068.83","27,619.47"
28-Sep-2024,Commission,"155,572.00",00.00,"183,191.47"
28-Sep-2024,Interest,00.00,"30,531.91","152,659.56"
29-Sep-2024,Debit Card,33.00,00.00,"152,692.56"
29-Sep-2024,NEFT,00.00,"76,346.28","76,346.28"
29-Sep-2024,Debit Card,499.11,00.00,"76,845.39"
29-Sep-2024,Cash,00.00,"38,422.70","38,422.70"
29-Sep-2024,Bill,00.00,"5,488.96","32,933.74"
29-Sep-2024,NEFT,00.00,"3,293.37","29,640.37"
29-Sep-2024,Reversal,00.00,"14,820.19","14,820.18"
29-Sep-2024,Tax,00.00,"14,820.18",00.00
29-Sep-2024,Purchase,"17,186.90",00.00,"17,186.90"
29-Sep-2024,Tax,00.00,"1,909.66","15,277.24"
29-Sep-2024,Commission,00.00,"7,638.62","7,638.62"
29-Sep-2024,Purchase,169.30,00.00,"7,807.92"
29-Sep-2024,Commission,00.00,"3,903.96","3,903.96"
29-Sep-2024,Purchase,"13,713.64",00.00,"17,617.60"
29-Sep-2024,Cash,00.00,"2,936.27","14,681.33"
29-Sep-2024,RTGS,00.00,"4,893.78","9,787.55"
29-Sep-2024,Miscellaneous,"50,676.30",00.00,"60,463.85"
29-Sep-2024,Debit Card,"130,486.50",00.00,"190,950.35"
29-Sep-2024,IMPS,"946,239.80",00.00,"1,137,190.15"
30-Sep-2024,Miscellaneous,00.00,"126,354.46","1,010,835.69"
30-Sep-2024,Miscellaneous,00.00,"168,472.62","842,363.08"
30-Sep-2024,Cash,144.31,00.00,"842,507.39"
30-Sep-2024,Tax,00.00,"105,313.42","737,193.97"
30-Sep-2024,Reversal,00.00,"245,731.32","491,462.65"
30-Sep-2024,IMPS,"844,040.20",00.00,"1,335,502.85"
01-Oct-2024,Purchase,"12,708.66",00.00,"1,348,211.51"
01-Oct-2024,Bill,"1,233,734.00",00.00,"2,581,945.51"
01-Oct-2024,Transfer,00.00,"430,324.25","2,151,621.26"
01-Oct-2024,RTGS,00.00,"537,905.32","1,613,715.94"
01-Oct-2024,RTGS,00.00,"179,301.77","1,434,414.17"
01-Oct-2024,Miscellaneous,"126,904.75",00.00,"1,561,318.92"
01-Oct-2024,Interest,"156,473.00",00.00,"1,717,791.92"
01-Oct-2024,Miscellaneous,"9,459.72",00.00,"1,727,251.64"
01-Oct-2024,ATM,949.60,00.00,"1,728,201.24"
01-Oct-2024,Bill,32.00,00.00,"1,728,233.24"
01-Oct-2024,ATM,"1,644.00",00.00,"1,729,877.24"
01-Oct-2024,IMPS,02.96,00.00,"1,729,880.20"
01-Oct-2024,Purchase,00.00,"576,626.73","1,153,253.47"
01-Oct-2024,Miscellaneous,00.00,"576,626.74","576,626.74"
01-Oct-2024,ATM,00.00,"72,078.34","504,548.40"
01-Oct-2024,NEFT,"500,564.00",00.00,"1,005,112.40"
01-Oct-2024,Purchase,"3,881.79",00.00,"1,008,994.19"
01-Oct-2024,Purchase,00.00,"201,798.84","807,195.35"
01-Oct-2024,Cash,37.50,00.00,"807,232.85"
02-Oct-2024,RTGS,00.00,"115,318.98","691,913.87"
02-Oct-2024,Commission,"2,414.10",00.00,"694,327.97"
02-Oct-2024,RTGS,"1,513,413.00",00.00,"2,207,740.97"
02-Oct-2024,Commission,00.00,"367,956.83","1,839,784.14"
02-Oct-2024,Miscellaneous,00.00,"204,420.46","1,635,363.68"
02-Oct-2024,IMPS,"1,475,212.00",00.00,"3,110,575.68"
02-Oct-2024,Miscellaneous,00.00,"388,821.96","2,721,753.72"
02-Oct-2024,Purchase,04.88,00.00,"2,721,758.60"
03-Oct-2024,IMPS,00.00,"680,439.65","2,041,318.95"
03-Oct-2024,Bill,00.00,"226,813.22","1,814,505.73"
03-Oct-2024,Interest,00.00,"181,450.57","1,633,055.16"
03-Oct-2024,Debit Card,00.00,"544,351.72","1,088,703.44"
03-Oct-2024,Miscellaneous,"4,158.50",00.00,"1,092,861.94"
03-Oct-2024,Purchase,07.00,00.00,"1,092,868.94"
03-Oct-2024,Bill,00.00,"546,434.47","546,434.47"
03-Oct-2024,Transfer,00.00,"182,144.82","364,289.65"
03-Oct-2024,RTGS,"309,059.00",00.00,"673,348.65"
03-Oct-2024,Purchase,00.00,"67,334.87","606,013.78"
04-Oct-2024,Cheque,08.00,00.00,"606,021.78"
04-Oct-2024,Debit Card,84.00,00.00,"606,105.78"
04-Oct-2024,Cash,00.00,"606,105.78",00.00
04-Oct-2024,IMPS,"537,592.00",00.00,"537,592.00"
04-Oct-2024,Purchase,05.90,00.00,"537,597.90"
05-Oct-2024,NEFT,00.00,"134,399.48","403,198.43"
05-Oct-2024,Interest,00.00,"57,599.78","345,598.65"
05-Oct-2024,Cash,"7,433.50",00.00,"353,032.15"
05-Oct-2024,Debit Card,00.00,"39,225.79","313,806.36"
05-Oct-2024,Miscellaneous,00.00,"52,301.06","261,505.30"
05-Oct-2024,Reversal,00.00,"130,752.65","130,752.65"
05-Oct-2024,NEFT,"2,619.00",00.00,"133,371.65"
05-Oct-2024,Transfer,"17,895.70",00.00,"151,267.35"
05-Oct-2024,ATM,00.00,"50,422.45","100,844.90"
05-Oct-2024,Cheque,"3,896.03",00.00,"104,740.93"
05-Oct-2024,IMPS,00.00,"34,913.64","69,827.29"
05-Oct-2024,Commission,00.00,"7,758.59","62,068.70"
05-Oct-2024,Miscellaneous,00.00,"7,758.59","54,310.11"
05-Oct-2024,Miscellaneous,"4,016.41",00.00,"58,326.52"
05-Oct-2024,Cheque,"491,364.00",00.00,"549,690.52"
05-Oct-2024,RTGS,00.00,"549,690.52",00.00
05-Oct-2024,Commission,"973,029.50",00.00,"973,029.50"
05-Oct-2024,Miscellaneous,"1,122.10",00.00,"974,151.60"
05-Oct-2024,Interest,00.00,"121,768.95","852,382.65"
05-Oct-2024,NEFT,21.00,00.00,"852,403.65"
05-Oct-2024,Reversal,00.00,"121,771.95","730,631.70"
05-Oct-2024,Tax,00.00,"146,126.34","584,505.36"
05-Oct-2024,Tax,00.00,"116,901.07","467,604.29"
05-Oct-2024,Interest,"116,085.75",00.00,"583,690.04"
05-Oct-2024,IMPS,00.00,"83,384.29","500,305.75"
05-Oct-2024,Commission,00.00,"250,152.88","250,152.88"
05-Oct-2024,Debit Card,00.00,"27,794.76","222,358.12"
05-Oct-2024,Reversal,"2,213.95",00.00,"224,572.07"
05-Oct-2024,Tax,"2,447.00",00.00,"227,019.07"
05-Oct-2024,ATM,00.00,"32,431.30","194,587.77"
05-Oct-2024,Cash,00.00,"19,458.78","175,128.99"
05-Oct-2024,Commission,"835,323.75",00.00,"1,010,452.74"
05-Oct-2024,IMPS,00.00,"126,306.59","884,146.15"
05-Oct-2024,Bill,00.00,"221,036.54","663,109.61"
05-Oct-2024,RTGS,"208,391.38",00.00,"871,500.99"
05-Oct-2024,ATM,00.50,00.00,"871,501.49"
05-Oct-2024,Cash,02.00,00.00,"871,503.49"
05-Oct-2024,Transfer,00.00,"871,503.49",00.00
05-Oct-2024,Bill,"2,945.00",00.00,"2,945.00"
05-Oct-2024,Miscellaneous,00.00,736.25,"2,208.75"
05-Oct-2024,Tax,00.00,"1,104.38","1,104.38"
05-Oct-2024,IMPS,"26,751.00",00.00,"27,855.38"
05-Oct-2024,Commission,64.20,00.00,"27,919.58"
05-Oct-2024,NEFT,47.20,00.00,"27,966.78"
05-Oct-2024,Bill,219.04,00.00,"28,185.82"
05-Oct-2024,Interest,"456,042.20",00.00,"484,228.02"
05-Oct-2024,Debit Card,00.00,"53,803.11","430,424.91"
05-Oct-2024,Tax,"539,015.80",00.00,"969,440.71"
05-Oct-2024,IMPS,02.00,00.00,"969,442.71"
05-Oct-2024,IMPS,57.00,00.00,"969,499.71"
05-Oct-2024,RTGS,00.00,"138,499.96","830,999.75"
05-Oct-2024,Debit Card,00.00,"118,714.25","712,285.50"
05-Oct-2024,Commission,00.00,"237,428.50","474,857.00"
05-Oct-2024,Cash,00.00,"474,857.00",00.00
05-Oct-2024,Reversal,"200,118.20",00.00,"200,118.20"
05-Oct-2024,Interest,00.00,"20,011.82","180,106.38"
05-Oct-2024,Tax,"21,033.30",00.00,"201,139.68"
05-Oct-2024,Debit Card,00.52,00.00,"201,140.20"
05-Oct-2024,Debit Card,"101,852.00",00.00,"302,992.20"
05-Oct-2024,Debit Card,03.42,00.00,"302,995.62"
05-Oct-2024,Cheque,00.00,"302,995.62",00.00
05-Oct-2024,Debit Card,"196,567.00",00.00,"196,567.00"
05-Oct-2024,Debit Card,00.00,"98,283.50","98,283.50"
05-Oct-2024,Debit Card,132.00,00.00,"98,415.50"
05-Oct-2024,Debit Card,00.00,"19,683.10","78,732.40"
05-Oct-2024,Tax,46.60,00.00,"78,779.00"
05-Oct-2024,Bill,00.00,"11,254.14","67,524.86"
05-Oct-2024,Transfer,"19,579.00",00.00,"87,103.86"
05-Oct-2024,RTGS,32.30,00.00,"87,136.16"
05-Oct-2024,RTGS,00.00,"12,448.02","74,688.14"
05-Oct-2024,IMPS,00.00,"7,468.81","67,219.33"
05-Oct-2024,Debit Card,"975,897.80",00.00,"1,043,117.13"
05-Oct-2024,Bill,00.00,"104,311.71","938,805.42"
05-Oct-2024,Miscellaneous,"257,767.90",00.00,"1,196,573.32"
05-Oct-2024,Transfer,00.00,"119,657.33","1,076,915.99"
06-Oct-2024,Purchase,05.20,00.00,"1,076,921.19"
06-Oct-2024,RTGS,00.00,"269,230.30","807,690.89"
06-Oct-2024,Transfer,"91,712.30",00.00,"899,403.19"
06-Oct-2024,NEFT,"8,900.30",00.00,"908,303.49"
06-Oct-2024,NEFT,"4,070.31",00.00,"912,373.80"
06-Oct-2024,Cheque,274.97,00.00,"912,648.77"
06-Oct-2024,IMPS,00.00,"912,648.77",00.00
07-Oct-2024,Tax,"47,871.90",00.00,"47,871.90"
07-Oct-2024,Miscellaneous,00.00,"7,978.65","39,893.25"
07-Oct-2024,Interest,07.00,00.00,"39,900.25"
07-Oct-2024,Commission,"3,269.70",00.00,"43,169.95"
07-Oct-2024,Commission,297.28,00.00,"43,467.23"
07-Oct-2024,IMPS,00.00,"7,244.54","36,222.69"
07-Oct-2024,Commission,00.00,"3,622.27","32,600.42"
07-Oct-2024,NEFT,"2,721.00",00.00,"35,321.42"
07-Oct-2024,ATM,"72,279.00",00.00,"107,600.42"
07-Oct-2024,Bill,"1,700.00",00.00,"109,300.42"
07-Oct-2024,Debit Card,108.20,00.00,"109,408.62"
07-Oct-2024,Miscellaneous,"3,645.00",00.00,"113,053.62"
07-Oct-2024,IMPS,"17,402.00",00.00,"130,455.62"
08-Oct-2024,ATM,00.00,"130,455.62",00.00
08-Oct-2024,Cash,731.00,00.00,731.00
08-Oct-2024,Interest,00.00,91.38,639.62
08-Oct-2024,RTGS,00.00,106.60,533.02
08-Oct-2024,Debit Card,669.40,00.00,"1,202.42"
08-Oct-2024,Reversal,"3,491.95",00.00,"4,694.37"
08-Oct-2024,Transfer,346.00,00.00,"5,040.37"
09-Oct-2024,ATM,00.00,"5,040.37",00.00
09-Oct-2024,IMPS,"3,051.00",00.00,"3,051.00"
09-Oct-2024,Tax,29.06,00.00,"3,080.06"
09-Oct-2024,Commission,00.00,"1,026.69","2,053.37"
09-Oct-2024,Bill,00.00,342.23,"1,711.14"
09-Oct-2024,Cash,"2,656.10",00.00,"4,367.24"
09-Oct-2024,Cash,195.80,00.00,"4,563.04"
09-Oct-2024,Purchase,"4,186.00",00.00,"8,749.04"
09-Oct-2024,ATM,00.00,"2,916.35","5,832.69"
09-Oct-2024,Cheque,00.00,"5,832.69",00.00
09-Oct-2024,Bill,"1,051.00",00.00,"1,051.00"
09-Oct-2024,Tax,00.00,262.75,788.25
09-Oct-2024,Miscellaneous,00.00,394.13,394.12
09-Oct-2024,Bill,"247,549.34",00.00,"247,943.46"
09-Oct-2024,IMPS,"37,893.10",00.00,"285,836.56"
09-Oct-2024,Tax,00.00,"71,459.14","214,377.42"
09-Oct-2024,NEFT,00.00,"30,625.35","183,752.07"
09-Oct-2024,NEFT,"1,399,998.00",00.00,"1,583,750.07"
09-Oct-2024,RTGS,00.00,"395,937.52","1,187,812.55"
09-Oct-2024,Transfer,00.00,"169,687.51","1,018,125.04"
09-Oct-2024,Debit Card,02.20,00.00,"1,018,127.24"
09-Oct-2024,Cheque,"98,374.09",00.00,"1,116,501.33"
09-Oct-2024,Bill,00.00,"139,562.67","976,938.66"
09-Oct-2024,Cash,"16,159.60",00.00,"993,098.26"
09-Oct-2024,Tax,"28,061.38",00.00,"1,021,159.64"
09-Oct-2024,Reversal,00.00,"170,193.27","850,966.37"
09-Oct-2024,Miscellaneous,39.00,00.00,"851,005.37"
09-Oct-2024,Purchase,00.00,"85,100.54","765,904.83"
09-Oct-2024,Miscellaneous,"551,363.00",00.00,"1,317,267.83"
09-Oct-2024,Cash,00.00,"219,544.64","1,097,723.19"
09-Oct-2024,IMPS,00.00,"137,215.40","960,507.79"
09-Oct-2024,IMPS,00.00,"96,050.78","864,457.01"
09-Oct-2024,Miscellaneous,00.00,"108,057.13","756,399.88"
09-Oct-2024,NEFT,57.86,00.00,"756,457.74"
09-Oct-2024,Tax,00.00,"189,114.44","567,343.30"
09-Oct-2024,RTGS,00.00,"189,114.43","378,228.87"
09-Oct-2024,RTGS,"1,395,577.00",00.00,"1,773,805.87"
09-Oct-2024,Bill,00.00,"886,902.94","886,902.94"
09-Oct-2024,Cheque,00.00,"443,451.47","443,451.47"
09-Oct-2024,Debit Card,"1,233.60",00.00,"444,685.07"
09-Oct-2024,Tax,"1,278,660.00",00.00,"1,723,345.07"
09-Oct-2024,Commission,10.83,00.00,"1,723,355.90"
09-Oct-2024,Interest,50.39,00.00,"1,723,406.29"
09-Oct-2024,Cheque,00.00,"246,200.90","1,477,205.39"
09-Oct-2024,ATM,"8,846.73",00.00,"1,486,052.12"
09-Oct-2024,Interest,00.00,"297,210.42","1,188,841.70"
09-Oct-2024,IMPS,00.00,"118,884.17","1,069,957.53"
09-Oct-2024,Tax,04.00,00.00,"1,069,961.53"
09-Oct-2024,Miscellaneous,385.60,00.00,"1,070,347.13"
09-Oct-2024,IMPS,00.00,"1,070,347.13",00.00
09-Oct-2024,RTGS,"2,023.18",00.00,"2,023.18"
09-Oct-2024,Miscellaneous,"234,023.40",00.00,"236,046.58"
09-Oct-2024,Bill,489.00,00.00,"236,535.58"
09-Oct-2024,ATM,"1,434,696.80",00.00,"1,671,232.38"
10-Oct-2024,Debit Card,00.00,"334,246.48","1,336,985.90"
11-Oct-2024,NEFT,00.00,"190,997.99","1,145,987.91"
11-Oct-2024,Transfer,451.51,00.00,"1,146,439.42"
11-Oct-2024,Reversal,00.00,"229,287.88","917,151.54"
11-Oct-2024,Cash,"2,250.47",00.00,"919,402.01"
12-Oct-2024,Reversal,00.00,"153,233.67","766,168.34"
12-Oct-2024,Bill,00.00,"127,694.72","638,473.62"
12-Oct-2024,Bill,00.00,"127,694.72","510,778.90"
12-Oct-2024,Tax,00.00,"127,694.73","383,084.18"
12-Oct-2024,NEFT,"37,212.50",00.00,"420,296.68"
12-Oct-2024,NEFT,07.30,00.00,"420,303.98"
12-Oct-2024,Tax,00.00,"60,043.43","360,260.55"
12-Oct-2024,IMPS,00.00,"72,052.11","288,208.44"
12-Oct-2024,Reversal,"1,666,567.20",00.00,"1,954,775.64"
12-Oct-2024,IMPS,00.00,"195,477.56","1,759,298.08"
12-Oct-2024,Reversal,00.00,"351,859.62","1,407,438.46"
12-Oct-2024,ATM,03.60,00.00,"1,407,442.06"
12-Oct-2024,Cash,00.00,"201,063.15","1,206,378.91"
12-Oct-2024,RTGS,"4,339.50",00.00,"1,210,718.41"
12-Oct-2024,ATM,"28,349.00",00.00,"1,239,067.41"
12-Oct-2024,NEFT,00.00,"137,674.16","1,101,393.25"
12-Oct-2024,Cash,00.00,"137,674.16","963,719.09"
12-Oct-2024,Cheque,00.00,"240,929.77","722,789.32"
12-Oct-2024,Debit Card,58.13,00.00,"722,847.45"
12-Oct-2024,Bill,460.10,00.00,"723,307.55"
12-Oct-2024,Tax,"253,414.03",00.00,"976,721.58"
12-Oct-2024,Tax,"1,276,178.00",00.00,"2,252,899.58"
12-Oct-2024,NEFT,00.00,"450,579.92","1,802,319.66"
12-Oct-2024,RTGS,118.00,00.00,"1,802,437.66"
12-Oct-2024,Miscellaneous,00.00,"1,802,437.66",00.00
12-Oct-2024,RTGS,"150,983.62",00.00,"150,983.62"
12-Oct-2024,Commission,00.00,"150,983.62",00.00
13-Oct-2024,Bill,00.00,00.00,00.00
13-Oct-2024,ATM,163.07,00.00,163.07
13-Oct-2024,Transfer,"1,465.00",00.00,"1,628.07"
13-Oct-2024,Reversal,"1,297,011.75",00.00,"1,298,639.82"
13-Oct-2024,Bill,06.00,00.00,"1,298,645.82"
13-Oct-2024,IMPS,163.00,00.00,"1,298,808.82"
13-Oct-2024,IMPS,182.72,00.00,"1,298,991.54"
13-Oct-2024,RTGS,00.00,"216,498.59","1,082,492.95"
13-Oct-2024,Purchase,"14,952.07",00.00,"1,097,445.02"
13-Oct-2024,RTGS,00.00,"1,097,445.02",00.00
13-Oct-2024,Miscellaneous,93.00,00.00,93.00
13-Oct-2024,IMPS,"226,063.22",00.00,"226,156.22"
13-Oct-2024,Cash,"142,315.90",00.00,"368,472.12"
13-Oct-2024,Tax,00.00,"52,638.87","315,833.25"
13-Oct-2024,Reversal,00.00,"105,277.75","210,555.50"
13-Oct-2024,Transfer,00.00,"105,277.75","105,277.75"
13-Oct-2024,Tax,"56,410.00",00.00,"161,687.75"
13-Oct-2024,ATM,00.00,"17,965.31","143,722.44"
13-Oct-2024,IMPS,"521,332.00",00.00,"665,054.44"
13-Oct-2024,Cheque,"161,056.00",00.00,"826,110.44"
13-Oct-2024,Reversal,00.00,"413,055.22","413,055.22"
13-Oct-2024,NEFT,02.68,00.00,"413,057.90"
13-Oct-2024,IMPS,"69,471.00",00.00,"482,528.90"
13-Oct-2024,Bill,"1,798.30",00.00,"484,327.20"
13-Oct-2024,Commission,"222,630.06",00.00,"706,957.26"
13-Oct-2024,IMPS,00.00,"117,826.21","589,131.05"
13-Oct-2024,Cheque,00.00,"58,913.11","530,217.95"
13-Oct-2024,Reversal,04.59,00.00,"530,222.54"
13-Oct-2024,IMPS,00.00,"176,740.85","353,481.69"
13-Oct-2024,Interest,00.00,"39,275.74","314,205.95"
13-Oct-2024,Cash,00.00,"78,551.49","235,654.46"
13-Oct-2024,Bill,03.00,00.00,"235,657.46"
13-Oct-2024,Interest,00.00,"78,552.49","157,104.97"
13-Oct-2024,Cheque,00.00,"52,368.32","104,736.65"
13-Oct-2024,Cash,00.00,00.00,"104,736.65"
13-Oct-2024,Interest,00.00,"14,962.38","89,774.27"
13-Oct-2024,IMPS,00.00,"8,977.43","80,796.84"
13-Oct-2024,Commission,"29,846.27",00.00,"110,643.11"
13-Oct-2024,Reversal,00.00,"15,806.16","94,836.95"
13-Oct-2024,Tax,00.00,"11,854.62","82,982.33"
13-Oct-2024,Interest,00.00,"8,298.23","74,684.10"
13-Oct-2024,Commission,"115,458.50",00.00,"190,142.60"
13-Oct-2024,Commission,"1,381.00",00.00,"191,523.60"
13-Oct-2024,Miscellaneous,10.32,00.00,"191,533.92"
13-Oct-2024,Bill,00.00,"63,844.64","127,689.28"
13-Oct-2024,Bill,"155,814.91",00.00,"283,504.19"
13-Oct-2024,Reversal,00.00,"94,501.40","189,002.79"
13-Oct-2024,Tax,00.00,"94,501.40","94,501.40"
14-Oct-2024,Debit Card,"2,587.30",00.00,"97,088.70"
14-Oct-2024,NEFT,"2,844.50",00.00,"99,933.20"
14-Oct-2024,Transfer,00.00,"99,933.20",00.00
14-Oct-2024,Cheque,"918,552.00",00.00,"918,552.00"
14-Oct-2024,IMPS,"1,795,149.50",00.00,"2,713,701.50"
14-Oct-2024,Purchase,00.00,"1,356,850.75","1,356,850.75"
14-Oct-2024,Commission,86.08,00.00,"1,356,936.83"
14-Oct-2024,Commission,00.00,"226,156.14","1,130,780.69"
14-Oct-2024,Tax,264.10,00.00,"1,131,044.79"
14-Oct-2024,RTGS,"1,909,856.00",00.00,"3,040,900.79"
14-Oct-2024,Transfer,00.00,"434,414.40","2,606,486.39"
14-Oct-2024,Interest,897.00,00.00,"2,607,383.39"
14-Oct-2024,Tax,"12,521.55",00.00,"2,619,904.94"
14-Oct-2024,Transfer,250.00,00.00,"2,620,154.94"
14-Oct-2024,Debit Card,00.00,"655,038.74","1,965,116.20"
14-Oct-2024,IMPS,103.70,00.00,"1,965,219.90"
14-Oct-2024,NEFT,"3,805.00",00.00,"1,969,024.90"
14-Oct-2024,Purchase,"473,670.25",00.00,"2,442,695.15"
14-Oct-2024,Transfer,00.00,"348,956.45","2,093,738.70"
14-Oct-2024,Cheque,00.00,"418,747.74","1,674,990.96"
14-Oct-2024,ATM,"218,591.19",00.00,"1,893,582.15"
14-Oct-2024,Transfer,08.00,00.00,"1,893,590.15"
14-Oct-2024,Miscellaneous,00.00,00.00,"1,893,590.15"
14-Oct-2024,Cheque,"1,646,422.80",00.00,"3,540,012.95"
14-Oct-2024,Transfer,30.50,00.00,"3,540,043.45"
14-Oct-2024,Miscellaneous,13.70,00.00,"3,540,057.15"
14-Oct-2024,Purchase,00.00,"1,770,028.58","1,770,028.58"
14-Oct-2024,IMPS,"1,393.00",00.00,"1,771,421.58"
14-Oct-2024,Commission,"926,224.00",00.00,"2,697,645.58"
14-Oct-2024,RTGS,03.00,00.00,"2,697,648.58"
14-Oct-2024,Debit Card,406.00,00.00,"2,698,054.58"
14-Oct-2024,Interest,00.70,00.00,"2,698,055.28"
14-Oct-2024,IMPS,00.00,"2,698,055.28",00.00
14-Oct-2024,IMPS,60.79,00.00,60.79
14-Oct-2024,ATM,00.00,30.40,30.40
14-Oct-2024,Transfer,21.00,00.00,51.40
14-Oct-2024,Cash,00.00,07.34,44.06
14-Oct-2024,Reversal,59.90,00.00,103.96
14-Oct-2024,Debit Card,"15,468.20",00.00,"15,572.16"
14-Oct-2024,Purchase,01.50,00.00,"15,573.66"
14-Oct-2024,Transfer,00.00,"2,224.81","13,348.85"
14-Oct-2024,Interest,"1,850,104.00",00.00,"1,863,452.85"
14-Oct-2024,Debit Card,02.01,00.00,"1,863,454.86"
14-Oct-2024,Commission,00.00,"931,727.43","931,727.43"
14-Oct-2024,IMPS,"1,217.90",00.00,"932,945.33"
14-Oct-2024,Bill,00.00,"186,589.07","746,356.26"
15-Oct-2024,Purchase,"2,759.08",00.00,"749,115.34"
15-Oct-2024,Commission,"13,299.00",00.00,"762,414.34"
15-Oct-2024,Reversal,00.00,"95,301.79","667,112.55"
15-Oct-2024,IMPS,00.00,"66,711.26","600,401.30"
15-Oct-2024,Purchase,"258,418.00",00.00,"858,819.30"
15-Oct-2024,Commission,"1,382,331.75",00.00,"2,241,151.05"
15-Oct-2024,Debit Card,00.00,"747,050.35","1,494,100.70"
15-Oct-2024,Tax,06.00,00.00,"1,494,106.70"
15-Oct-2024,ATM,59.00,00.00,"1,494,165.70"
15-Oct-2024,IMPS,00.00,"373,541.43","1,120,624.27"
15-Oct-2024,Cheque,00.00,"124,513.81","996,110.46"
15-Oct-2024,Bill,00.00,"166,018.41","830,092.05"
15-Oct-2024,Commission,00.00,"207,523.01","622,569.04"
15-Oct-2024,ATM,00.00,"311,284.52","311,284.52"
15-Oct-2024,Bill,406.00,00.00,"311,690.52"
15-Oct-2024,Transfer,00.00,"44,527.22","267,163.30"
15-Oct-2024,NEFT,00.00,"44,527.22","222,636.08"
15-Oct-2024,Commission,00.00,"27,829.51","194,806.57"
15-Oct-2024,Cheque,474.20,00.00,"195,280.77"
15-Oct-2024,Debit Card,00.00,"48,820.19","146,460.58"
15-Oct-2024,Commission,00.00,"36,615.15","109,845.44"
15-Oct-2024,Bill,00.00,"109,845.44",00.00
15-Oct-2024,Commission,"813,822.00",00.00,"813,822.00"
15-Oct-2024,Cheque,00.00,"162,764.40","651,057.60"
15-Oct-2024,Cheque,00.00,"93,008.23","558,049.37"
15-Oct-2024,Purchase,"3,152.24",00.00,"561,201.61"
16-Oct-2024,Purchase,00.00,"56,120.16","505,081.45"
16-Oct-2024,Transfer,96.00,00.00,"505,177.45"
16-Oct-2024,IMPS,00.00,"72,168.21","433,009.24"
16-Oct-2024,Tax,00.00,"433,009.24",00.00
16-Oct-2024,Transfer,49.41,00.00,49.41
16-Oct-2024,NEFT,52.00,00.00,101.41
16-Oct-2024,NEFT,00.00,20.28,81.13
16-Oct-2024,Interest,00.00,10.14,70.99
16-Oct-2024,Cash,04.00,00.00,74.99
16-Oct-2024,IMPS,00.00,25.00,49.99
16-Oct-2024,Interest,"24,977.60",00.00,"25,027.59"
16-Oct-2024,Purchase,04.00,00.00,"25,031.59"
16-Oct-2024,Commission,"3,790.83",00.00,"28,822.42"
16-Oct-2024,Purchase,"783,961.25",00.00,"812,783.67"
16-Oct-2024,Bill,00.00,"406,391.84","406,391.84"
16-Oct-2024,ATM,00.00,"203,195.92","203,195.92"
16-Oct-2024,Interest,00.00,"22,577.32","180,618.60"
17-Oct-2024,Bill,00.00,"20,068.73","160,549.87"
17-Oct-2024,Purchase,"2,581.00",00.00,"163,130.87"
17-Oct-2024,IMPS,00.00,"40,782.72","122,348.15"
17-Oct-2024,Reversal,"2,578.99",00.00,"124,927.14"
17-Oct-2024,Miscellaneous,00.00,"62,463.57","62,463.57"
17-Oct-2024,ATM,00.00,"20,821.19","41,642.38"
17-Oct-2024,Interest,00.00,"4,626.93","37,015.45"
17-Oct-2024,Cheque,59.36,00.00,"37,074.81"
17-Oct-2024,RTGS,331.00,00.00,"37,405.81"
18-Oct-2024,IMPS,00.00,"7,481.16","29,924.65"
18-Oct-2024,Bill,"10,261.50",00.00,"40,186.15"
18-Oct-2024,IMPS,00.00,"5,023.27","35,162.88"
18-Oct-2024,Commission,00.00,"7,032.58","28,130.30"
18-Oct-2024,RTGS,00.00,"4,688.38","23,441.92"
18-Oct-2024,Purchase,06.54,00.00,"23,448.46"
18-Oct-2024,Cheque,00.00,"5,862.12","17,586.34"
18-Oct-2024,Miscellaneous,36.75,00.00,"17,623.09"
18-Oct-2024,NEFT,00.00,"2,937.18","14,685.91"
18-Oct-2024,ATM,00.00,"2,097.99","12,587.92"
18-Oct-2024,Purchase,284.90,00.00,"12,872.82"
18-Oct-2024,Tax,00.00,"1,430.31","11,442.51"
18-Oct-2024,Cheque,00.00,"3,814.17","7,628.34"
18-Oct-2024,Miscellaneous,00.00,847.59,"6,780.75"
18-Oct-2024,Purchase,06.40,00.00,"6,787.15"
18-Oct-2024,ATM,"3,034.00",00.00,"9,821.15"
18-Oct-2024,Cash,00.00,"1,227.64","8,593.51"
18-Oct-2024,Cheque,"104,381.47",00.00,"112,974.98"
18-Oct-2024,Miscellaneous,"19,396.00",00.00,"132,370.98"
19-Oct-2024,Cash,472.70,00.00,"132,843.68"
19-Oct-2024,Tax,"823,979.00",00.00,"956,822.68"
19-Oct-2024,Purchase,07.90,00.00,"956,830.58"
19-Oct-2024,Interest,00.00,"478,415.29","478,415.29"
19-Oct-2024,Tax,00.00,"79,735.88","398,679.41"
19-Oct-2024,IMPS,"219,318.80",00.00,"617,998.21"
19-Oct-2024,Cash,335.90,00.00,"618,334.11"
19-Oct-2024,NEFT,00.00,"618,334.11",00.00
19-Oct-2024,Cheque,"26,702.00",00.00,"26,702.00"
19-Oct-2024,Bill,00.00,"3,814.57","22,887.43"
19-Oct-2024,NEFT,00.00,"7,629.14","15,258.29"
19-Oct-2024,Debit Card,00.00,"3,814.57","11,443.72"
19-Oct-2024,Cheque,37.71,00.00,"11,481.43"
19-Oct-2024,Commission,00.00,"11,481.43",00.00
19-Oct-2024,Reversal,58.00,00.00,58.00
19-Oct-2024,Interest,209.10,00.00,267.10
19-Oct-2024,Miscellaneous,"24,790.96",00.00,"25,058.06"
19-Oct-2024,Cheque,57.44,00.00,"25,115.50"
19-Oct-2024,IMPS,00.00,"3,587.93","21,527.57"
19-Oct-2024,NEFT,00.00,"5,381.89","16,145.68"
19-Oct-2024,IMPS,06.40,00.00,"16,152.08"
19-Oct-2024,Tax,"198,468.00",00.00,"214,620.08"
19-Oct-2024,Cheque,00.00,"23,846.68","190,773.40"
19-Oct-2024,Purchase,"839,619.50",00.00,"1,030,392.90"
19-Oct-2024,Tax,"545,379.00",00.00,"1,575,771.90"
19-Oct-2024,Tax,"1,653.20",00.00,"1,577,425.10"
19-Oct-2024,Transfer,38.90,00.00,"1,577,464.00"
19-Oct-2024,Debit Card,00.00,"262,910.67","1,314,553.33"
19-Oct-2024,Tax,00.00,"438,184.44","876,368.89"
19-Oct-2024,NEFT,"174,531.00",00.00,"1,050,899.89"
19-Oct-2024,Debit Card,"1,767.00",00.00,"1,052,666.89"
19-Oct-2024,NEFT,00.00,"1,052,666.89",00.00
19-Oct-2024,Transfer,44.60,00.00,44.60
19-Oct-2024,IMPS,00.00,08.92,35.68
19-Oct-2024,Transfer,"2,591.90",00.00,"2,627.58"
19-Oct-2024,Reversal,00.00,375.37,"2,252.21"
19-Oct-2024,Purchase,00.00,450.44,"1,801.77"
20-Oct-2024,Cheque,"22,306.20",00.00,"24,107.97"
20-Oct-2024,NEFT,"3,500.00",00.00,"27,607.97"
20-Oct-2024,Tax,03.60,00.00,"27,611.57"
20-Oct-2024,Cheque,"523,055.20",00.00,"550,666.77"
20-Oct-2024,ATM,00.00,"78,666.68","472,000.09"
20-Oct-2024,Debit Card,"2,319.00",00.00,"474,319.09"
20-Oct-2024,Reversal,00.00,"118,579.77","355,739.32"
20-Oct-2024,Tax,00.00,"35,573.93","320,165.39"
20-Oct-2024,Interest,00.00,"32,016.54","288,148.85"
20-Oct-2024,Transfer,00.00,"48,024.81","240,124.04"
20-Oct-2024,Interest,14.51,00.00,"240,138.55"
20-Oct-2024,ATM,00.00,"240,138.55",00.00
20-Oct-2024,RTGS,193.20,00.00,193.20
20-Oct-2024,Bill,30.90,00.00,224.10
20-Oct-2024,Reversal,"219,112.00",00.00,"219,336.10"
20-Oct-2024,Miscellaneous,"19,605.40",00.00,"238,941.50"
20-Oct-2024,IMPS,"1,995,002.00",00.00,"2,233,943.50"
20-Oct-2024,Cheque,00.00,"744,647.83","1,489,295.67"
20-Oct-2024,Reversal,220.60,00.00,"1,489,516.27"
20-Oct-2024,Miscellaneous,00.00,"165,501.81","1,324,014.46"
20-Oct-2024,Miscellaneous,385.10,00.00,"1,324,399.56"
20-Oct-2024,Commission,"2,890.50",00.00,"1,327,290.06"
20-Oct-2024,Commission,"15,722.40",00.00,"1,343,012.46"
20-Oct-2024,Purchase,"1,264,958.25",00.00,"2,607,970.71"
20-Oct-2024,Cheque,00.00,"869,323.57","1,738,647.14"
20-Oct-2024,Purchase,00.00,"173,864.71","1,564,782.43"
20-Oct-2024,Bill,"30,014.80",00.00,"1,594,797.23"
20-Oct-2024,Cheque,00.00,"227,828.18","1,366,969.05"
20-Oct-2024,NEFT,00.00,"1,366,969.05",00.00
20-Oct-2024,IMPS,"1,698,766.75",00.00,"1,698,766.75"
20-Oct-2024,Interest,00.00,"188,751.86","1,510,014.89"
20-Oct-2024,Transfer,00.00,"377,503.72","1,132,511.17"
20-Oct-2024,IMPS,00.00,"113,251.12","1,019,260.05"
20-Oct-2024,Bill,43.70,00.00,"1,019,303.75"
20-Oct-2024,Tax,00.00,"1,019,303.75",00.00
20-Oct-2024,Interest,120.67,00.00,120.67
20-Oct-2024,Interest,"205,378.00",00.00,"205,498.67"
20-Oct-2024,Cheque,00.00,"29,356.95","176,141.72"
20-Oct-2024,Debit Card,55.00,00.00,"176,196.72"
20-Oct-2024,Transfer,00.00,"35,239.34","140,957.38"
20-Oct-2024,Transfer,"256,459.50",00.00,"397,416.88"
20-Oct-2024,Commission,00.00,"397,416.88",00.00
20-Oct-2024,Debit Card,469.50,00.00,469.50
20-Oct-2024,NEFT,00.00,469.50,00.00
20-Oct-2024,Bill,"203,400.88",00.00,"203,400.88"
20-Oct-2024,ATM,"438,490.75",00.00,"641,891.63"
20-Oct-2024,Interest,"143,475.10",00.00,"785,366.73"
20-Oct-2024,RTGS,"1,541,104.20",00.00,"2,326,470.93"
20-Oct-2024,Transfer,00.00,"232,647.09","2,093,823.84"
21-Oct-2024,Miscellaneous,00.00,"299,117.69","1,794,706.15"
21-Oct-2024,NEFT,"559,731.50",00.00,"2,354,437.65"
21-Oct-2024,ATM,"110,130.41",00.00,"2,464,568.06"
21-Oct-2024,RTGS,00.00,"2,464,568.06",00.00
21-Oct-2024,Cheque,461.90,00.00,461.90
21-Oct-2024,IMPS,"1,228.47",00.00,"1,690.37"
21-Oct-2024,Purchase,00.00,338.07,"1,352.30"
21-Oct-2024,Purchase,00.00,338.08,"1,014.22"
21-Oct-2024,Miscellaneous,04.60,00.00,"1,018.82"
22-Oct-2024,Tax,00.60,00.00,"1,019.42"
22-Oct-2024,IMPS,00.00,339.81,679.61
22-Oct-2024,NEFT,00.00,67.96,611.65
22-Oct-2024,IMPS,"71,676.80",00.00,"72,288.45"
22-Oct-2024,ATM,00.00,"9,036.06","63,252.39"
22-Oct-2024,Commission,00.00,"6,325.24","56,927.15"
22-Oct-2024,Cheque,"73,927.80",00.00,"130,854.95"
22-Oct-2024,Debit Card,00.00,"14,539.44","116,315.51"
22-Oct-2024,Cheque,290.60,00.00,"116,606.11"
22-Oct-2024,Commission,"137,291.91",00.00,"253,898.02"
22-Oct-2024,Transfer,"1,941,993.00",00.00,"2,195,891.02"
22-Oct-2024,Reversal,09.40,00.00,"2,195,900.42"
22-Oct-2024,Interest,00.00,"313,700.06","1,882,200.36"
22-Oct-2024,Reversal,00.00,"235,275.05","1,646,925.32"
22-Oct-2024,IMPS,06.50,00.00,"1,646,931.82"
22-Oct-2024,Cheque,00.72,00.00,"1,646,932.54"
22-Oct-2024,Bill,00.00,"548,977.51","1,097,955.03"
22-Oct-2024,Miscellaneous,04.00,00.00,"1,097,959.03"
22-Oct-2024,Cheque,00.00,"121,995.45","975,963.58"
22-Oct-2024,Commission,00.00,"162,660.60","813,302.98"
22-Oct-2024,Purchase,00.00,"271,100.99","542,201.99"
22-Oct-2024,Tax,00.00,"54,220.20","487,981.79"
22-Oct-2024,Cash,00.00,"121,995.45","365,986.34"
22-Oct-2024,Cash,00.00,"40,665.15","325,321.19"
22-Oct-2024,Cash,00.00,"40,665.15","284,656.04"
22-Oct-2024,NEFT,00.00,"40,665.15","243,990.89"
22-Oct-2024,Debit Card,05.80,00.00,"243,996.69"
22-Oct-2024,Purchase,00.00,"24,399.67","219,597.02"
22-Oct-2024,Bill,00.00,"27,449.63","192,147.39"
22-Oct-2024,Cash,00.00,"32,024.57","160,122.83"
22-Oct-2024,Cash,"2,652.00",00.00,"162,774.83"
22-Oct-2024,ATM,"6,057.18",00.00,"168,832.01"
23-Oct-2024,ATM,"7,481.52",00.00,"176,313.53"
23-Oct-2024,Bill,"25,033.30",00.00,"201,346.83"
23-Oct-2024,Transfer,07.00,00.00,"201,353.83"
23-Oct-2024,Interest,00.00,"25,169.23","176,184.60"
23-Oct-2024,Transfer,"238,500.00",00.00,"414,684.60"
23-Oct-2024,Bill,488.80,00.00,"415,173.40"
23-Oct-2024,Reversal,"2,208.50",00.00,"417,381.90"
23-Oct-2024,Interest,117.14,00.00,"417,499.04"
23-Oct-2024,Tax,397.47,00.00,"417,896.51"
23-Oct-2024,Cheque,"226,366.90",00.00,"644,263.41"
23-Oct-2024,Interest,"3,276.90",00.00,"647,540.31"
24-Oct-2024,ATM,07.00,00.00,"647,547.31"
24-Oct-2024,NEFT,03.90,00.00,"647,551.21"
24-Oct-2024,Miscellaneous,00.00,"71,950.13","575,601.08"
24-Oct-2024,RTGS,904.00,00.00,"576,505.08"
24-Oct-2024,RTGS,04.00,00.00,"576,509.08"
24-Oct-2024,Reversal,00.00,"57,650.91","518,858.17"
24-Oct-2024,Transfer,"6,576.00",00.00,"525,434.17"
24-Oct-2024,Interest,"86,526.90",00.00,"611,961.07"
24-Oct-2024,ATM,202.60,00.00,"612,163.67"
24-Oct-2024,Transfer,00.00,"87,451.95","524,711.72"
24-Oct-2024,IMPS,"14,624.00",00.00,"539,335.72"
24-Oct-2024,NEFT,00.00,"269,667.86","269,667.86"
24-Oct-2024,ATM,"2,276.93",00.00,"271,944.79"
24-Oct-2024,Debit Card,00.00,"67,986.20","203,958.59"
24-Oct-2024,Reversal,"75,288.40",00.00,"279,246.99"
24-Oct-2024,Tax,"2,030.30",00.00,"281,277.29"
25-Oct-2024,Transfer,00.00,"46,879.55","234,397.74"
25-Oct-2024,ATM,00.00,"33,485.39","200,912.35"
25-Oct-2024,Miscellaneous,"2,768.00",00.00,"203,680.35"
25-Oct-2024,RTGS,00.00,"22,631.15","181,049.20"
25-Oct-2024,Transfer,00.00,"36,209.84","144,839.36"
25-Oct-2024,Transfer,"272,825.50",00.00,"417,664.86"
25-Oct-2024,Bill,"1,855,465.00",00.00,"2,273,129.86"
25-Oct-2024,NEFT,"19,328.00",00.00,"2,292,457.86"
25-Oct-2024,NEFT,00.00,"2,292,457.86",00.00
25-Oct-2024,Reversal,12.30,00.00,12.30
25-Oct-2024,NEFT,00.00,04.10,08.20
25-Oct-2024,Purchase,"14,223.70",00.00,"14,231.90"
25-Oct-2024,Transfer,"936,809.75",00.00,"951,041.65"
25-Oct-2024,ATM,"1,718.40",00.00,"952,760.05"
25-Oct-2024,NEFT,00.00,"952,760.05",00.00
25-Oct-2024,Tax,09.90,00.00,09.90
25-Oct-2024,Miscellaneous,00.00,01.41,08.49
25-Oct-2024,Bill,00.00,08.49,00.00
25-Oct-2024,Cheque,949.20,00.00,949.20
25-Oct-2024,ATM,00.00,94.92,854.28
25-Oct-2024,Commission,00.00,94.92,759.36
25-Oct-2024,Commission,00.00,94.92,664.44
25-Oct-2024,Cheque,00.00,66.44,598.00
25-Oct-2024,IMPS,00.00,59.80,538.20
25-Oct-2024,Cheque,00.00,134.55,403.65
25-Oct-2024,Miscellaneous,244.04,00.00,647.69
25-Oct-2024,Debit Card,00.00,92.53,555.16
26-Oct-2024,RTGS,54.70,00.00,609.86
26-Oct-2024,Debit Card,00.00,121.97,487.89
26-Oct-2024,Debit Card,"25,017.93",00.00,"25,505.82"
26-Oct-2024,Interest,"29,067.41",00.00,"54,573.23"
26-Oct-2024,Interest,"258,181.00",00.00,"312,754.23"
26-Oct-2024,Debit Card,299.00,00.00,"313,053.23"
26-Oct-2024,Miscellaneous,05.40,00.00,"313,058.63"
26-Oct-2024,Commission,00.00,"52,176.44","260,882.19"
26-Oct-2024,Purchase,"26,313.25",00.00,"287,195.44"
26-Oct-2024,Cheque,00.00,"95,731.81","191,463.63"
26-Oct-2024,Interest,"17,332.27",00.00,"208,795.90"
26-Oct-2024,Cheque,00.00,"52,198.98","156,596.92"
26-Oct-2024,Commission,"28,214.92",00.00,"184,811.84"
26-Oct-2024,Tax,00.00,"20,534.65","164,277.19"
26-Oct-2024,Bill,00.00,"41,069.30","123,207.89"
27-Oct-2024,Purchase,"866,820.20",00.00,"990,028.09"
27-Oct-2024,Reversal,00.00,"123,753.51","866,274.58"
27-Oct-2024,Commission,"1,206.00",00.00,"867,480.58"
27-Oct-2024,Cash,"1,013.00",00.00,"868,493.58"
27-Oct-2024,Cheque,"183,076.91",00.00,"1,051,570.49"
27-Oct-2024,Bill,"1,556,849.00",00.00,"2,608,419.49"
27-Oct-2024,Tax,"2,294.00",00.00,"2,610,713.49"
27-Oct-2024,RTGS,971.10,00.00,"2,611,684.59"
27-Oct-2024,Reversal,"208,861.28",00.00,"2,820,545.87"
27-Oct-2024,ATM,"200,247.50",00.00,"3,020,793.37"
27-Oct-2024,Reversal,"273,160.00",00.00,"3,293,953.37"
27-Oct-2024,Cheque,00.00,"823,488.34","2,470,465.03"
28-Oct-2024,Cheque,"11,741.21",00.00,"2,482,206.24"
29-Oct-2024,Purchase,35.84,00.00,"2,482,242.08"
29-Oct-2024,NEFT,928.61,00.00,"2,483,170.69"
29-Oct-2024,Debit Card,35.29,00.00,"2,483,205.98"
29-Oct-2024,Miscellaneous,39.00,00.00,"2,483,244.98"
29-Oct-2024,Bill,00.00,"620,811.25","1,862,433.74"
29-Oct-2024,Transfer,"1,798.00",00.00,"1,864,231.74"
29-Oct-2024,ATM,"187,386.40",00.00,"2,051,618.14"
29-Oct-2024,Tax,00.00,"227,957.57","1,823,660.57"
29-Oct-2024,Debit Card,00.00,"455,915.14","1,367,745.43"
29-Oct-2024,Interest,00.00,"195,392.20","1,172,353.23"
29-Oct-2024,Purchase,"2,513.00",00.00,"1,174,866.23"
29-Oct-2024,Reversal,00.00,"117,486.62","1,057,379.61"
29-Oct-2024,ATM,741.60,00.00,"1,058,121.21"
29-Oct-2024,ATM,"5,566.00",00.00,"1,063,687.21"
29-Oct-2024,ATM,"45,837.19",00.00,"1,109,524.40"
29-Oct-2024,Interest,07.75,00.00,"1,109,532.15"
29-Oct-2024,Cash,"111,730.40",00.00,"1,221,262.55"
29-Oct-2024,Commission,08.00,00.00,"1,221,270.55"
29-Oct-2024,Reversal,00.00,"1,221,270.55",00.00
29-Oct-2024,Cheque,02.60,00.00,02.60
29-Oct-2024,Purchase,70.00,00.00,72.60
30-Oct-2024,Commission,"2,138.80",00.00,"2,211.40"
30-Oct-2024,Transfer,00.60,00.00,"2,212.00"
30-Oct-2024,NEFT,00.00,316.00,"1,896.00"
30-Oct-2024,NEFT,00.00,474.00,"1,422.00"
30-Oct-2024,NEFT,"2,079,629.00",00.00,"2,081,051.00"
30-Oct-2024,Purchase,"171,279.31",00.00,"2,252,330.31"
30-Oct-2024,NEFT,00.00,"750,776.77","1,501,553.54"
30-Oct-2024,NEFT,00.00,"375,388.39","1,126,165.16"
30-Oct-2024,NEFT,60.49,00.00,"1,126,225.65"
31-Oct-2024,RTGS,00.00,"160,889.38","965,336.27"
31-Oct-2024,Tax,00.00,"321,778.76","643,557.51"
31-Oct-2024,Debit Card,00.00,"71,506.39","572,051.12"
31-Oct-2024,Cash,00.00,"71,506.39","500,544.73"
31-Oct-2024,ATM,00.00,"83,424.12","417,120.61"
31-Oct-2024,Cash,00.00,"59,588.66","357,531.95"
31-Oct-2024,RTGS,00.00,"89,382.99","268,148.96"
31-Oct-2024,Cash,09.00,00.00,"268,157.96"
31-Oct-2024,Cheque,00.00,"26,815.80","241,342.16"
31-Oct-2024,Cash,"9,454.00",00.00,"250,796.16"
31-Oct-2024,Tax,00.00,"25,079.62","225,716.54"
31-Oct-2024,Purchase,00.00,"32,245.22","193,471.32"
01-Nov-2024,Commission,"420,006.50",00.00,"613,477.82"
01-Nov-2024,Interest,"178,969.78",00.00,"792,447.60"
01-Nov-2024,IMPS,00.00,"99,055.95","693,391.65"
02-Nov-2024,Debit Card,00.00,00.00,"693,391.65"
02-Nov-2024,ATM,00.00,"77,043.52","616,348.13"
02-Nov-2024,Cash,00.00,"123,269.63","493,078.50"
02-Nov-2024,Interest,00.00,"493,078.50",00.00
02-Nov-2024,NEFT,08.50,00.00,08.50
02-Nov-2024,RTGS,01.00,00.00,09.50
02-Nov-2024,Tax,00.00,01.19,08.31
02-Nov-2024,IMPS,228.00,00.00,236.31
02-Nov-2024,Commission,"230,614.22",00.00,"230,850.53"
02-Nov-2024,Interest,00.00,"46,170.11","184,680.42"
02-Nov-2024,Tax,379.02,00.00,"185,059.44"
02-Nov-2024,IMPS,"1,280,289.00",00.00,"1,465,348.44"
02-Nov-2024,RTGS,70.00,00.00,"1,465,418.44"
02-Nov-2024,Tax,"3,211.29",00.00,"1,468,629.73"
02-Nov-2024,Reversal,23.25,00.00,"1,468,652.98"
02-Nov-2024,ATM,00.00,"209,807.57","1,258,845.41"
02-Nov-2024,Miscellaneous,00.00,"1,258,845.41",00.00
02-Nov-2024,Interest,191.00,00.00,191.00
02-Nov-2024,Bill,03.78,00.00,194.78
02-Nov-2024,Miscellaneous,03.70,00.00,198.48
02-Nov-2024,Cash,00.00,24.81,173.67
02-Nov-2024,Transfer,00.00,43.42,130.25
02-Nov-2024,IMPS,00.00,21.71,108.54
02-Nov-2024,Reversal,"174,620.25",00.00,"174,728.79"
02-Nov-2024,ATM,00.00,"43,682.20","131,046.59"
02-Nov-2024,Cash,00.00,"43,682.20","87,364.39"
02-Nov-2024,Tax,00.00,"43,682.20","43,682.20"
02-Nov-2024,Cheque,00.00,"6,240.31","37,441.89"
02-Nov-2024,NEFT,00.00,"18,720.95","18,720.94"
02-Nov-2024,RTGS,00.00,"9,360.47","9,360.47"
02-Nov-2024,NEFT,00.00,"2,340.12","7,020.35"
03-Nov-2024,Tax,00.00,"2,340.12","4,680.23"
03-Nov-2024,Tax,"2,546.90",00.00,"7,227.13"
03-Nov-2024,Cash,00.00,"2,409.04","4,818.09"
03-Nov-2024,Commission,00.00,803.02,"4,015.08"
03-Nov-2024,Bill,00.00,803.02,"3,212.06"
03-Nov-2024,Reversal,00.00,"3,212.06",00.00
03-Nov-2024,Debit Card,01.83,00.00,01.83
03-Nov-2024,Cheque,00.00,00.61,01.22
03-Nov-2024,Transfer,"819,022.00",00.00,"819,023.22"
03-Nov-2024,Bill,07.50,00.00,"819,030.72"
03-Nov-2024,RTGS,"88,645.94",00.00,"907,676.66"
03-Nov-2024,Transfer,"154,365.91",00.00,"1,062,042.57"
03-Nov-2024,Tax,"821,497.00",00.00,"1,883,539.57"
03-Nov-2024,Transfer,00.00,"627,846.52","1,255,693.05"
03-Nov-2024,Purchase,00.00,"313,923.26","941,769.79"
03-Nov-2024,Purchase,"1,813,682.25",00.00,"2,755,452.04"
03-Nov-2024,Bill,00.00,"1,377,726.02","1,377,726.02"
03-Nov-2024,RTGS,02.22,00.00,"1,377,728.24"
03-Nov-2024,Bill,01.30,00.00,"1,377,729.54"
03-Nov-2024,Bill,"1,340,437.25",00.00,"2,718,166.79"
03-Nov-2024,Bill,00.00,"906,055.60","1,812,111.19"
04-Nov-2024,Reversal,00.00,"201,345.69","1,610,765.50"
04-Nov-2024,NEFT,00.00,"268,460.92","1,342,304.58"
04-Nov-2024,RTGS,"3,907.00",00.00,"1,346,211.58"
04-Nov-2024,Purchase,"31,518.90",00.00,"1,377,730.48"
04-Nov-2024,Cheque,00.00,"153,081.16","1,224,649.32"
04-Nov-2024,Debit Card,00.00,"244,929.86","979,719.46"
04-Nov-2024,ATM,00.00,"489,859.73","489,859.73"
04-Nov-2024,Transfer,00.00,"244,929.87","244,929.86"
04-Nov-2024,Interest,00.00,"244,929.86",00.00
04-Nov-2024,ATM,"699,734.00",00.00,"699,734.00"
05-Nov-2024,ATM,07.00,00.00,"699,741.00"
05-Nov-2024,Miscellaneous,"1,082,800.00",00.00,"1,782,541.00"
05-Nov-2024,RTGS,00.00,"254,648.71","1,527,892.29"
05-Nov-2024,Bill,00.00,"1,527,892.29",00.00
05-Nov-2024,Bill,"249,724.20",00.00,"249,724.20"
05-Nov-2024,Interest,"1,578.55",00.00,"251,302.75"
05-Nov-2024,Cash,00.00,"41,883.79","209,418.96"
05-Nov-2024,Tax,00.00,"69,806.32","139,612.64"
05-Nov-2024,Cheque,00.00,"15,512.52","124,100.12"
05-Nov-2024,NEFT,00.00,"15,512.52","108,587.60"
05-Nov-2024,Commission,00.00,"10,858.76","97,728.84"
05-Nov-2024,Commission,00.00,"19,545.77","78,183.07"
05-Nov-2024,Miscellaneous,"4,051.76",00.00,"82,234.83"
05-Nov-2024,Miscellaneous,"13,251.00",00.00,"95,485.83"
05-Nov-2024,Bill,"206,293.00",00.00,"301,778.83"
05-Nov-2024,Miscellaneous,36.97,00.00,"301,815.80"
05-Nov-2024,Reversal,32.76,00.00,"301,848.56"
05-Nov-2024,Cash,"1,578,268.00",00.00,"1,880,116.56"
05-Nov-2024,Interest,150.50,00.00,"1,880,267.06"
05-Nov-2024,Commission,00.00,"208,918.56","1,671,348.50"
05-Nov-2024,RTGS,00.00,"278,558.08","1,392,790.42"
05-Nov-2024,Miscellaneous,00.00,"1,392,790.42",00.00
05-Nov-2024,Bill,52.60,00.00,52.60
05-Nov-2024,Tax,00.00,52.60,00.00
05-Nov-2024,Purchase,"3,340.30",00.00,"3,340.30"
05-Nov-2024,Debit Card,666.00,00.00,"4,006.30"
06-Nov-2024,Reversal,00.00,"1,335.43","2,670.87"
06-Nov-2024,Reversal,00.00,"1,335.44","1,335.44"
06-Nov-2024,Commission,08.40,00.00,"1,343.84"
06-Nov-2024,IMPS,23.00,00.00,"1,366.84"
06-Nov-2024,Tax,104.00,00.00,"1,470.84"
06-Nov-2024,Miscellaneous,03.00,00.00,"1,473.84"
06-Nov-2024,ATM,06.99,00.00,"1,480.83"
06-Nov-2024,Reversal,99.91,00.00,"1,580.74"
06-Nov-2024,IMPS,"221,054.50",00.00,"222,635.24"
06-Nov-2024,Purchase,117.00,00.00,"222,752.24"
06-Nov-2024,Tax,"16,677.89",00.00,"239,430.13"
06-Nov-2024,Miscellaneous,40.00,00.00,"239,470.13"
06-Nov-2024,Purchase,00.00,"79,823.38","159,646.75"
06-Nov-2024,Interest,"207,856.60",00.00,"367,503.35"
06-Nov-2024,Cash,"19,679.53",00.00,"387,182.88"
06-Nov-2024,Miscellaneous,12.50,00.00,"387,195.38"
07-Nov-2024,IMPS,01.90,00.00,"387,197.28"
07-Nov-2024,Bill,03.00,00.00,"387,200.28"
07-Nov-2024,IMPS,05.50,00.00,"387,205.78"
07-Nov-2024,Miscellaneous,25.50,00.00,"387,231.28"
07-Nov-2024,Cheque,00.00,"77,446.26","309,785.02"
07-Nov-2024,Purchase,"26,683.31",00.00,"336,468.33"
07-Nov-2024,Interest,"14,268.30",00.00,"350,736.63"
07-Nov-2024,ATM,96.00,00.00,"350,832.63"
07-Nov-2024,IMPS,"1,841,792.00",00.00,"2,192,624.63"
07-Nov-2024,Debit Card,00.00,"1,096,312.32","1,096,312.32"
07-Nov-2024,Miscellaneous,00.00,"109,631.23","986,681.09"
07-Nov-2024,Tax,00.00,"197,336.22","789,344.87"
07-Nov-2024,IMPS,"1,046,962.80",00.00,"1,836,307.67"
07-Nov-2024,Cheque,03.30,00.00,"1,836,310.97"
07-Nov-2024,NEFT,"2,863.60",00.00,"1,839,174.57"
07-Nov-2024,Purchase,"2,422.70",00.00,"1,841,597.27"
07-Nov-2024,NEFT,03.90,00.00,"1,841,601.17"
07-Nov-2024,IMPS,00.00,"920,800.59","920,800.58"
07-Nov-2024,Debit Card,00.00,"115,100.07","805,700.51"
07-Nov-2024,Tax,"228,850.62",00.00,"1,034,551.13"
07-Nov-2024,Commission,00.00,"114,950.13","919,601.00"
07-Nov-2024,ATM,00.00,"919,601.00",00.00
07-Nov-2024,Debit Card,74.70,00.00,74.70
07-Nov-2024,ATM,04.70,00.00,79.40
07-Nov-2024,Miscellaneous,08.00,00.00,87.40
07-Nov-2024,Miscellaneous,"94,500.00",00.00,"94,587.40"
07-Nov-2024,Interest,00.00,"9,458.74","85,128.66"
07-Nov-2024,Miscellaneous,"238,873.40",00.00,"324,002.06"
07-Nov-2024,Debit Card,00.00,"324,002.06",00.00
07-Nov-2024,Debit Card,05.69,00.00,05.69
07-Nov-2024,Commission,00.00,00.71,04.98
07-Nov-2024,Interest,"2,267.90",00.00,"2,272.88"
07-Nov-2024,Commission,"1,276,689.75",00.00,"1,278,962.63"
07-Nov-2024,Purchase,00.00,"1,278,962.63",00.00
07-Nov-2024,Reversal,28.49,00.00,28.49
07-Nov-2024,Cash,00.00,14.25,14.24
07-Nov-2024,Cheque,00.00,01.42,12.82
07-Nov-2024,ATM,00.00,06.41,06.41
07-Nov-2024,Miscellaneous,00.00,02.14,04.27
07-Nov-2024,Commission,"415,436.00",00.00,"415,440.27"
07-Nov-2024,ATM,"204,467.00",00.00,"619,907.27"
07-Nov-2024,NEFT,00.00,"77,488.41","542,418.86"
08-Nov-2024,Interest,"150,299.66",00.00,"692,718.52"
08-Nov-2024,Purchase,00.00,"173,179.63","519,538.89"
09-Nov-2024,Reversal,"153,913.00",00.00,"673,451.89"
09-Nov-2024,ATM,34.00,00.00,"673,485.89"
09-Nov-2024,RTGS,00.00,"134,697.18","538,788.71"
10-Nov-2024,Cash,"111,496.00",00.00,"650,284.71"
10-Nov-2024,Transfer,00.00,"216,761.57","433,523.14"
10-Nov-2024,Cash,"364,515.50",00.00,"798,038.64"
10-Nov-2024,Transfer,"27,062.00",00.00,"825,100.64"
10-Nov-2024,Miscellaneous,"16,238.00",00.00,"841,338.64"
10-Nov-2024,Miscellaneous,00.00,"280,446.21","560,892.43"
10-Nov-2024,Miscellaneous,00.00,"280,446.22","280,446.22"
10-Nov-2024,Tax,00.00,"56,089.24","224,356.98"
10-Nov-2024,Commission,00.00,"22,435.70","201,921.28"
10-Nov-2024,Debit Card,00.00,"22,435.70","179,485.58"
10-Nov-2024,Purchase,00.00,"59,828.53","119,657.05"
10-Nov-2024,Purchase,61.72,00.00,"119,718.77"
10-Nov-2024,Cash,63.40,00.00,"119,782.17"
10-Nov-2024,Commission,41.00,00.00,"119,823.17"
10-Nov-2024,Bill,00.00,"14,977.90","104,845.27"
10-Nov-2024,Transfer,"182,406.00",00.00,"287,251.27"
10-Nov-2024,Cash,00.00,"47,875.21","239,376.06"
10-Nov-2024,Transfer,00.00,"26,597.34","212,778.72"
10-Nov-2024,Cash,01.70,00.00,"212,780.42"
10-Nov-2024,NEFT,202.00,00.00,"212,982.42"
10-Nov-2024,Cheque,00.00,"53,245.61","159,736.82"
10-Nov-2024,RTGS,"15,328.45",00.00,"175,065.27"
10-Nov-2024,Tax,00.00,"17,506.53","157,558.74"
10-Nov-2024,Cheque,00.00,"17,506.53","140,052.21"
10-Nov-2024,Transfer,273.00,00.00,"140,325.21"
10-Nov-2024,Miscellaneous,"24,546.75",00.00,"164,871.96"
10-Nov-2024,Cheque,00.00,"27,478.66","137,393.30"
11-Nov-2024,Tax,00.00,"68,696.65","68,696.65"
11-Nov-2024,IMPS,02.50,00.00,"68,699.15"
11-Nov-2024,Miscellaneous,"3,424.90",00.00,"72,124.05"
11-Nov-2024,Interest,00.94,00.00,"72,124.99"
11-Nov-2024,Reversal,45.78,00.00,"72,170.77"
11-Nov-2024,Purchase,00.00,"24,056.92","48,113.85"
11-Nov-2024,Reversal,00.00,"24,056.93","24,056.92"
11-Nov-2024,Commission,00.00,"24,056.92",00.00
11-Nov-2024,ATM,"16,675.00",00.00,"16,675.00"
11-Nov-2024,Interest,499.00,00.00,"17,174.00"
11-Nov-2024,Interest,00.00,"17,174.00",00.00
11-Nov-2024,Interest,225.00,00.00,225.00
11-Nov-2024,Bill,"2,050.00",00.00,"2,275.00"
11-Nov-2024,NEFT,00.00,455.00,"1,820.00"
11-Nov-2024,Tax,00.00,910.00,910.00
11-Nov-2024,Debit Card,00.00,130.00,780.00
11-Nov-2024,Interest,"1,489.13",00.00,"2,269.13"
11-Nov-2024,ATM,00.00,324.16,"1,944.97"
11-Nov-2024,Cash,00.00,243.12,"1,701.85"
11-Nov-2024,Miscellaneous,291.50,00.00,"1,993.35"
11-Nov-2024,Interest,"1,191,620.25",00.00,"1,193,613.60"
11-Nov-2024,Tax,478.30,00.00,"1,194,091.90"
11-Nov-2024,Tax,00.00,"149,261.49","1,044,830.41"
11-Nov-2024,Miscellaneous,"16,852.00",00.00,"1,061,682.41"
11-Nov-2024,Cash,00.00,"530,841.21","530,841.20"
11-Nov-2024,Interest,00.00,"66,355.15","464,486.05"
11-Nov-2024,Reversal,00.00,"58,060.76","406,425.29"
11-Nov-2024,Bill,"94,492.31",00.00,"500,917.60"
11-Nov-2024,Miscellaneous,00.00,"83,486.27","417,431.33"
11-Nov-2024,RTGS,"3,868.00",00.00,"421,299.33"
11-Nov-2024,Cash,00.00,"70,216.56","351,082.78"
11-Nov-2024,ATM,"58,384.00",00.00,"409,466.78"
11-Nov-2024,Cash,00.00,"68,244.46","341,222.32"
11-Nov-2024,Commission,122.00,00.00,"341,344.32"
11-Nov-2024,NEFT,08.00,00.00,"341,352.32"
11-Nov-2024,RTGS,00.00,"34,135.23","307,217.09"
11-Nov-2024,ATM,"11,404.25",00.00,"318,621.34"
11-Nov-2024,Tax,56.00,00.00,"318,677.34"
11-Nov-2024,Bill,"5,459.21",00.00,"324,136.55"
11-Nov-2024,ATM,00.00,"64,827.31","259,309.24"
11-Nov-2024,Cash,01.80,00.00,"259,311.04"
11-Nov-2024,Miscellaneous,00.00,00.00,"259,311.04"
11-Nov-2024,Transfer,"250,120.09",00.00,"509,431.13"
11-Nov-2024,RTGS,00.00,"72,775.88","436,655.25"
11-Nov-2024,Tax,01.00,00.00,"436,656.25"
12-Nov-2024,RTGS,"1,688.95",00.00,"438,345.20"
12-Nov-2024,ATM,"19,489.30",00.00,"457,834.50"
12-Nov-2024,RTGS,00.00,"152,611.50","305,223.00"
12-Nov-2024,ATM,"28,735.39",00.00,"333,958.39"
12-Nov-2024,Transfer,33.89,00.00,"333,992.28"
12-Nov-2024,Tax,00.00,"166,996.14","166,996.14"
12-Nov-2024,Commission,"2,589.00",00.00,"169,585.14"
12-Nov-2024,Commission,608.68,00.00,"170,193.82"
12-Nov-2024,IMPS,00.00,"34,038.76","136,155.06"
12-Nov-2024,Bill,00.00,"136,155.06",00.00
12-Nov-2024,Reversal,"1,579,583.50",00.00,"1,579,583.50"
12-Nov-2024,Miscellaneous,33.00,00.00,"1,579,616.50"
13-Nov-2024,Cheque,00.00,"789,808.25","789,808.25"
13-Nov-2024,Debit Card,00.00,"157,961.65","631,846.60"
13-Nov-2024,Commission,00.00,"631,846.60",00.00
13-Nov-2024,IMPS,01.44,00.00,01.44
13-Nov-2024,Transfer,"378,196.00",00.00,"378,197.44"
13-Nov-2024,NEFT,455.00,00.00,"378,652.44"
13-Nov-2024,Cash,04.00,00.00,"378,656.44"
13-Nov-2024,Commission,00.00,"75,731.29","302,925.15"
13-Nov-2024,Bill,"218,248.00",00.00,"521,173.15"
13-Nov-2024,Bill,06.50,00.00,"521,179.65"
13-Nov-2024,ATM,"2,810.00",00.00,"523,989.65"
13-Nov-2024,ATM,00.00,"523,989.65",00.00
13-Nov-2024,Purchase,793.25,00.00,793.25
13-Nov-2024,Miscellaneous,00.00,79.33,713.92
13-Nov-2024,Cash,"6,799.68",00.00,"7,513.60"
13-Nov-2024,Cash,00.00,"7,513.60",00.00
13-Nov-2024,Debit Card,32.10,00.00,32.10
13-Nov-2024,RTGS,43.70,00.00,75.80
13-Nov-2024,Reversal,"108,397.00",00.00,"108,472.80"
13-Nov-2024,Bill,"245,682.00",00.00,"354,154.80"
13-Nov-2024,Cheque,"155,224.00",00.00,"509,378.80"
13-Nov-2024,Bill,00.00,"509,378.80",00.00
13-Nov-2024,IMPS,"1,795,713.50",00.00,"1,795,713.50"
13-Nov-2024,Tax,00.00,"598,571.17","1,197,142.33"
13-Nov-2024,Purchase,251.01,00.00,"1,197,393.34"
13-Nov-2024,NEFT,"153,508.00",00.00,"1,350,901.34"
13-Nov-2024,Transfer,00.00,"168,862.67","1,182,038.67"
13-Nov-2024,Miscellaneous,12.00,00.00,"1,182,050.67"
13-Nov-2024,Debit Card,00.00,"131,338.96","1,050,711.71"
13-Nov-2024,Purchase,"109,038.20",00.00,"1,159,749.91"
13-Nov-2024,Transfer,"2,771.80",00.00,"1,162,521.71"
13-Nov-2024,Bill,"4,006.50",00.00,"1,166,528.21"
13-Nov-2024,Miscellaneous,02.73,00.00,"1,166,530.94"
13-Nov-2024,Transfer,00.00,"291,632.74","874,898.20"
13-Nov-2024,Transfer,00.00,"124,985.46","749,912.74"
13-Nov-2024,Transfer,00.00,"149,982.55","599,930.19"
13-Nov-2024,Cash,00.00,"59,993.02","539,937.17"
13-Nov-2024,IMPS,00.00,"89,989.53","449,947.64"
13-Nov-2024,Purchase,00.00,"224,973.82","224,973.82"
13-Nov-2024,RTGS,00.00,"37,495.64","187,478.18"
13-Nov-2024,Bill,06.77,00.00,"187,484.95"
13-Nov-2024,Interest,00.00,"187,484.95",00.00
13-Nov-2024,Bill,692.20,00.00,692.20
13-Nov-2024,Tax,05.00,00.00,697.20
13-Nov-2024,Miscellaneous,03.10,00.00,700.30
13-Nov-2024,Bill,00.00,350.15,350.15
13-Nov-2024,Debit Card,00.30,00.00,350.45
13-Nov-2024,Transfer,"11,056.00",00.00,"11,406.45"
13-Nov-2024,NEFT,"13,145.60",00.00,"24,552.05"
13-Nov-2024,Reversal,337.80,00.00,"24,889.85"
13-Nov-2024,Bill,00.00,"3,555.69","21,334.16"
13-Nov-2024,Debit Card,00.00,"2,370.46","18,963.70"
13-Nov-2024,Reversal,46.00,00.00,"19,009.70"
14-Nov-2024,Purchase,08.00,00.00,"19,017.70"
14-Nov-2024,Cash,"58,427.19",00.00,"77,444.89"
14-Nov-2024,Reversal,00.00,"25,814.96","51,629.93"
14-Nov-2024,Tax,00.00,"17,209.98","34,419.95"
14-Nov-2024,Cheque,"3,297.00",00.00,"37,716.95"
14-Nov-2024,NEFT,05.31,00.00,"37,722.26"
14-Nov-2024,Miscellaneous,00.00,"7,544.45","30,177.81"
14-Nov-2024,Interest,00.00,"3,017.78","27,160.03"
14-Nov-2024,ATM,"2,836.27",00.00,"29,996.30"
14-Nov-2024,Cheque,00.00,"29,996.30",00.00
14-Nov-2024,ATM,15.00,00.00,15.00
14-Nov-2024,Miscellaneous,498.00,00.00,513.00
14-Nov-2024,ATM,"1,056.20",00.00,"1,569.20"
14-Nov-2024,Transfer,00.00,784.60,784.60
14-Nov-2024,Tax,472.72,00.00,"1,257.32"
14-Nov-2024,IMPS,00.00,628.66,628.66
14-Nov-2024,NEFT,"627,983.80",00.00,"628,612.46"
14-Nov-2024,ATM,00.00,"62,861.25","565,751.21"
14-Nov-2024,IMPS,00.00,"94,291.87","471,459.34"
14-Nov-2024,Purchase,00.00,"471,459.34",00.00
14-Nov-2024,Cash,28.00,00.00,28.00
15-Nov-2024,Cash,00.00,14.00,14.00
15-Nov-2024,IMPS,"24,379.00",00.00,"24,393.00"
15-Nov-2024,Purchase,"3,215.20",00.00,"27,608.20"
15-Nov-2024,RTGS,00.00,"3,944.03","23,664.17"
15-Nov-2024,Debit Card,"160,211.44",00.00,"183,875.61"
15-Nov-2024,Commission,400.47,00.00,"184,276.08"
15-Nov-2024,Miscellaneous,00.00,"36,855.22","147,420.86"
15-Nov-2024,Transfer,00.00,"21,060.12","126,360.74"
15-Nov-2024,RTGS,00.00,"126,360.74",00.00
15-Nov-2024,Debit Card,"956,094.25",00.00,"956,094.25"
15-Nov-2024,Bill,00.00,"159,349.04","796,745.21"
15-Nov-2024,Interest,347.00,00.00,"797,092.21"
15-Nov-2024,Cash,00.69,00.00,"797,092.90"
15-Nov-2024,RTGS,00.00,"113,870.41","683,222.49"
15-Nov-2024,Cheque,"2,225.90",00.00,"685,448.39"
15-Nov-2024,Interest,00.00,"114,241.40","571,206.99"
16-Nov-2024,IMPS,00.00,"142,801.75","428,405.24"
16-Nov-2024,RTGS,40.82,00.00,"428,446.06"
16-Nov-2024,Transfer,00.00,"107,111.52","321,334.54"
16-Nov-2024,Cash,"1,255,841.80",00.00,"1,577,176.34"
16-Nov-2024,Commission,36.96,00.00,"1,577,213.30"
16-Nov-2024,Cash,00.00,"1,577,213.30",00.00
16-Nov-2024,Transfer,"27,454.30",00.00,"27,454.30"
16-Nov-2024,RTGS,"233,171.00",00.00,"260,625.30"
16-Nov-2024,RTGS,00.00,"130,312.65","130,312.65"
16-Nov-2024,Cheque,"30,360.00",00.00,"160,672.65"
16-Nov-2024,Purchase,00.00,"40,168.16","120,504.49"
16-Nov-2024,Miscellaneous,00.00,"13,389.39","107,115.10"
16-Nov-2024,NEFT,289.00,00.00,"107,404.10"
16-Nov-2024,Miscellaneous,00.00,"21,480.82","85,923.28"
16-Nov-2024,Cheque,01.00,00.00,"85,924.28"
16-Nov-2024,NEFT,06.00,00.00,"85,930.28"
16-Nov-2024,RTGS,00.00,"28,643.43","57,286.85"
16-Nov-2024,Miscellaneous,"6,837.75",00.00,"64,124.60"
16-Nov-2024,Debit Card,07.56,00.00,"64,132.16"
16-Nov-2024,Debit Card,"38,693.70",00.00,"102,825.86"
16-Nov-2024,NEFT,398.00,00.00,"103,223.86"
16-Nov-2024,Tax,09.84,00.00,"103,233.70"
16-Nov-2024,Miscellaneous,"15,274.00",00.00,"118,507.70"
16-Nov-2024,Bill,30.00,00.00,"118,537.70"
16-Nov-2024,NEFT,"8,953.73",00.00,"127,491.43"
16-Nov-2024,ATM,00.00,"18,213.06","109,278.37"
16-Nov-2024,Transfer,00.00,"12,142.04","97,136.33"
16-Nov-2024,Transfer,03.00,00.00,"97,139.33"
16-Nov-2024,ATM,00.00,"48,569.67","48,569.66"
16-Nov-2024,IMPS,00.00,"48,569.66",00.00
16-Nov-2024,RTGS,01.09,00.00,01.09
16-Nov-2024,Cheque,"1,261,927.00",00.00,"1,261,928.09"
16-Nov-2024,Cheque,00.00,"180,275.44","1,081,652.65"
16-Nov-2024,IMPS,"1,153,980.20",00.00,"2,235,632.85"
16-Nov-2024,Tax,00.00,"223,563.29","2,012,069.57"
16-Nov-2024,Commission,"1,856,186.00",00.00,"3,868,255.57"
16-Nov-2024,Reversal,00.00,"3,868,255.57",00.00
16-Nov-2024,Cheque,"44,924.00",00.00,"44,924.00"
16-Nov-2024,Interest,00.00,"6,417.71","38,506.29"
16-Nov-2024,Purchase,00.00,"3,850.63","34,655.66"
16-Nov-2024,ATM,00.00,"8,663.92","25,991.75"
17-Nov-2024,Transfer,324.00,00.00,"26,315.75"
17-Nov-2024,Commission,"98,582.00",00.00,"124,897.75"
17-Nov-2024,Transfer,00.00,"12,489.78","112,407.98"
17-Nov-2024,RTGS,00.00,"12,489.78","99,918.20"
17-Nov-2024,ATM,"23,280.10",00.00,"123,198.30"
17-Nov-2024,Cheque,00.00,"12,319.83","110,878.47"
17-Nov-2024,ATM,00.00,"13,859.81","97,018.66"
17-Nov-2024,RTGS,211.34,00.00,"97,230.00"
17-Nov-2024,ATM,06.10,00.00,"97,236.10"
17-Nov-2024,RTGS,"2,530.08",00.00,"99,766.18"
17-Nov-2024,Cash,"849,477.80",00.00,"949,243.98"
17-Nov-2024,Debit Card,00.00,"316,414.66","632,829.32"
17-Nov-2024,IMPS,00.00,"210,943.11","421,886.21"
17-Nov-2024,Cheque,"3,415.00",00.00,"425,301.21"
17-Nov-2024,Cash,"2,762.89",00.00,"428,064.10"
18-Nov-2024,Tax,00.00,"214,032.05","214,032.05"
18-Nov-2024,Debit Card,00.00,"214,032.05",00.00
18-Nov-2024,Reversal,"82,116.00",00.00,"82,116.00"
18-Nov-2024,Cheque,07.20,00.00,"82,123.20"
18-Nov-2024,Cash,02.44,00.00,"82,125.64"
18-Nov-2024,ATM,00.00,"16,425.13","65,700.51"
18-Nov-2024,Tax,00.00,"8,212.56","57,487.95"
18-Nov-2024,Commission,00.00,"8,212.56","49,275.39"
18-Nov-2024,Cheque,00.00,"12,318.85","36,956.54"
18-Nov-2024,ATM,00.00,"3,695.65","33,260.89"
18-Nov-2024,Cash,00.00,"8,315.22","24,945.67"
18-Nov-2024,Debit Card,19.28,00.00,"24,964.95"
18-Nov-2024,ATM,"7,091.90",00.00,"32,056.85"
18-Nov-2024,Miscellaneous,00.00,"8,014.21","24,042.64"
18-Nov-2024,Reversal,"68,328.12",00.00,"92,370.76"
18-Nov-2024,NEFT,"10,603.00",00.00,"102,973.76"
18-Nov-2024,Transfer,00.00,"14,710.54","88,263.22"
18-Nov-2024,ATM,08.00,00.00,"88,271.22"
18-Nov-2024,Miscellaneous,00.00,"8,827.12","79,444.10"
18-Nov-2024,NEFT,03.00,00.00,"79,447.10"
18-Nov-2024,RTGS,00.00,"15,889.42","63,557.68"
18-Nov-2024,Commission,00.00,"21,185.89","42,371.79"
18-Nov-2024,Debit Card,00.00,"42,371.79",00.00
18-Nov-2024,Miscellaneous,"23,889.34",00.00,"23,889.34"
18-Nov-2024,Debit Card,00.00,"7,963.11","15,926.23"
19-Nov-2024,Miscellaneous,00.00,"7,963.12","7,963.12"
19-Nov-2024,IMPS,"2,265.50",00.00,"10,228.62"
19-Nov-2024,Cheque,00.00,"5,114.31","5,114.31"
19-Nov-2024,Purchase,00.00,639.29,"4,475.02"
19-Nov-2024,RTGS,00.00,639.29,"3,835.73"
19-Nov-2024,Transfer,00.00,958.93,"2,876.80"
19-Nov-2024,Debit Card,19.60,00.00,"2,896.40"
19-Nov-2024,RTGS,"17,356.00",00.00,"20,252.40"
19-Nov-2024,Interest,33.00,00.00,"20,285.40"
19-Nov-2024,Reversal,"195,039.00",00.00,"215,324.40"
19-Nov-2024,Tax,"2,021.40",00.00,"217,345.80"
19-Nov-2024,Miscellaneous,81.95,00.00,"217,427.75"
19-Nov-2024,Interest,03.00,00.00,"217,430.75"
19-Nov-2024,Cash,"425,315.00",00.00,"642,745.75"
19-Nov-2024,Tax,00.00,"107,124.29","535,621.46"
19-Nov-2024,Debit Card,00.00,"535,621.46",00.00
19-Nov-2024,Transfer,"130,845.50",00.00,"130,845.50"
19-Nov-2024,Cheque,04.00,00.00,"130,849.50"
19-Nov-2024,NEFT,00.00,"21,808.25","109,041.25"
19-Nov-2024,Cash,"213,065.90",00.00,"322,107.15"
19-Nov-2024,Tax,00.00,"80,526.79","241,580.36"
19-Nov-2024,NEFT,163.44,00.00,"241,743.80"
19-Nov-2024,NEFT,00.00,"34,534.83","207,208.97"
19-Nov-2024,Purchase,00.00,"25,901.12","181,307.85"
19-Nov-2024,Cash,"24,015.30",00.00,"205,323.15"
20-Nov-2024,Bill,"1,940,068.00",00.00,"2,145,391.15"
20-Nov-2024,Cash,"243,246.00",00.00,"2,388,637.15"
20-Nov-2024,Cheque,00.00,"796,212.38","1,592,424.77"
20-Nov-2024,Purchase,00.00,"199,053.10","1,393,371.67"
20-Nov-2024,Debit Card,00.00,"278,674.33","1,114,697.34"
20-Nov-2024,Debit Card,00.00,"159,242.48","955,454.86"
20-Nov-2024,IMPS,"1,197,600.50",00.00,"2,153,055.36"
20-Nov-2024,Reversal,00.00,"1,076,527.68","1,076,527.68"
20-Nov-2024,RTGS,00.00,"179,421.28","897,106.40"
20-Nov-2024,Reversal,00.00,"448,553.20","448,553.20"
20-Nov-2024,ATM,00.00,"224,276.60","224,276.60"
20-Nov-2024,Transfer,00.00,"56,069.15","168,207.45"
20-Nov-2024,Bill,00.00,"24,029.64","144,177.81"
20-Nov-2024,Tax,"28,731.60",00.00,"172,909.41"
21-Nov-2024,Cash,"3,374.81",00.00,"176,284.22"
21-Nov-2024,Tax,06.00,00.00,"176,290.22"
21-Nov-2024,Reversal,00.00,"19,587.80","156,702.42"
21-Nov-2024,Bill,"1,297.00",00.00,"157,999.42"
21-Nov-2024,Cash,32.80,00.00,"158,032.22"
21-Nov-2024,Commission,00.00,"22,576.03","135,456.19"
21-Nov-2024,Cash,"5,804.92",00.00,"141,261.11"
21-Nov-2024,Cash,00.00,"14,126.11","127,135.00"
21-Nov-2024,Transfer,00.00,"18,162.14","108,972.86"
21-Nov-2024,NEFT,18.00,00.00,"108,990.86"
21-Nov-2024,IMPS,"252,809.00",00.00,"361,799.86"
21-Nov-2024,Reversal,"137,152.22",00.00,"498,952.08"
21-Nov-2024,IMPS,"155,636.90",00.00,"654,588.98"
21-Nov-2024,Cheque,00.00,"72,732.11","581,856.87"
21-Nov-2024,Tax,00.00,"83,122.41","498,734.46"
21-Nov-2024,Cash,"2,671.00",00.00,"501,405.46"
21-Nov-2024,Purchase,00.00,"167,135.15","334,270.31"
21-Nov-2024,IMPS,"164,109.30",00.00,"498,379.61"
21-Nov-2024,Purchase,00.00,"49,837.96","448,541.65"
21-Nov-2024,NEFT,00.00,"149,513.88","299,027.77"
21-Nov-2024,Cheque,00.00,"33,225.31","265,802.46"
21-Nov-2024,Cheque,37.05,00.00,"265,839.51"
21-Nov-2024,Commission,00.00,"33,229.94","232,609.57"
21-Nov-2024,Bill,05.00,00.00,"232,614.57"
21-Nov-2024,Tax,00.00,"232,614.57",00.00
21-Nov-2024,Interest,"13,023.00",00.00,"13,023.00"
21-Nov-2024,Purchase,13.57,00.00,"13,036.57"
21-Nov-2024,RTGS,00.00,"4,345.52","8,691.05"
21-Nov-2024,Transfer,02.40,00.00,"8,693.45"
21-Nov-2024,RTGS,00.00,869.35,"7,824.10"
21-Nov-2024,RTGS,"1,206,749.00",00.00,"1,214,573.10"
21-Nov-2024,Purchase,00.00,"202,428.85","1,012,144.25"
21-Nov-2024,NEFT,00.00,"253,036.06","759,108.19"
21-Nov-2024,Commission,"1,992.86",00.00,"761,101.05"
21-Nov-2024,Purchase,00.00,"152,220.21","608,880.84"
21-Nov-2024,Purchase,21.00,00.00,"608,901.84"
21-Nov-2024,Purchase,07.10,00.00,"608,908.94"
21-Nov-2024,Cheque,00.00,"608,908.94",00.00
21-Nov-2024,Cash,"14,596.30",00.00,"14,596.30"
21-Nov-2024,Commission,"1,319,366.80",00.00,"1,333,963.10"
21-Nov-2024,Purchase,00.00,"148,218.12","1,185,744.98"
21-Nov-2024,Reversal,00.00,"395,248.33","790,496.65"
21-Nov-2024,Miscellaneous,300.94,00.00,"790,797.59"
21-Nov-2024,Interest,00.00,"87,866.40","702,931.19"
21-Nov-2024,Bill,"10,132.00",00.00,"713,063.19"
21-Nov-2024,Reversal,"171,336.00",00.00,"884,399.19"
21-Nov-2024,Interest,00.00,"98,266.58","786,132.61"
21-Nov-2024,IMPS,"39,841.59",00.00,"825,974.20"
21-Nov-2024,Reversal,"43,455.30",00.00,"869,429.50"
21-Nov-2024,Interest,212.31,00.00,"869,641.81"
21-Nov-2024,Bill,"203,138.00",00.00,"1,072,779.81"
21-Nov-2024,Purchase,00.00,"536,389.91","536,389.90"
21-Nov-2024,ATM,00.90,00.00,"536,390.80"
21-Nov-2024,NEFT,"27,465.58",00.00,"563,856.38"
21-Nov-2024,Miscellaneous,"1,413,887.00",00.00,"1,977,743.38"
21-Nov-2024,Debit Card,00.00,"988,871.69","988,871.69"
21-Nov-2024,Miscellaneous,"155,354.00",00.00,"1,144,225.69"
21-Nov-2024,IMPS,"203,725.00",00.00,"1,347,950.69"
21-Nov-2024,Cash,00.00,"269,590.14","1,078,360.55"
21-Nov-2024,Interest,00.00,"107,836.06","970,524.50"
21-Nov-2024,Purchase,"528,044.00",00.00,"1,498,568.50"
21-Nov-2024,Commission,01.00,00.00,"1,498,569.50"
21-Nov-2024,Cash,"3,558.85",00.00,"1,502,128.35"
21-Nov-2024,Tax,04.09,00.00,"1,502,132.44"
21-Nov-2024,Interest,"14,393.00",00.00,"1,516,525.44"
21-Nov-2024,Interest,32.00,00.00,"1,516,557.44"
21-Nov-2024,Bill,00.00,"505,519.15","1,011,038.29"
21-Nov-2024,IMPS,00.00,"337,012.76","674,025.53"
21-Nov-2024,NEFT,45.00,00.00,"674,070.53"
21-Nov-2024,NEFT,00.00,"168,517.63","505,552.90"
21-Nov-2024,ATM,"24,827.70",00.00,"530,380.60"
21-Nov-2024,Bill,02.81,00.00,"530,383.41"
21-Nov-2024,IMPS,"652,284.50",00.00,"1,182,667.91"
21-Nov-2024,Bill,"32,195.00",00.00,"1,214,862.91"
21-Nov-2024,Interest,00.00,"1,214,862.91",00.00
21-Nov-2024,Bill,135.50,00.00,135.50
21-Nov-2024,Cheque,"185,930.90",00.00,"186,066.40"
21-Nov-2024,Commission,271.00,00.00,"186,337.40"
21-Nov-2024,IMPS,00.00,"20,704.16","165,633.24"
21-Nov-2024,Commission,00.00,"18,403.69","147,229.55"
21-Nov-2024,ATM,04.10,00.00,"147,233.65"
21-Nov-2024,RTGS,00.00,"16,359.29","130,874.36"
21-Nov-2024,Cash,00.00,"65,437.18","65,437.18"
21-Nov-2024,Transfer,00.00,"16,359.30","49,077.88"
21-Nov-2024,Debit Card,378.10,00.00,"49,455.98"
21-Nov-2024,Interest,00.00,"5,495.11","43,960.87"
22-Nov-2024,Debit Card,00.00,"43,960.87",00.00
22-Nov-2024,Cash,364.00,00.00,364.00
22-Nov-2024,Miscellaneous,00.00,40.44,323.56
22-Nov-2024,IMPS,00.00,32.36,291.20
22-Nov-2024,Interest,00.00,29.12,262.08
22-Nov-2024,IMPS,135.98,00.00,398.06
22-Nov-2024,Bill,00.00,66.34,331.72
22-Nov-2024,Bill,"221,460.00",00.00,"221,791.72"
22-Nov-2024,NEFT,"1,100.80",00.00,"222,892.52"
22-Nov-2024,Commission,"47,270.00",00.00,"270,162.52"
22-Nov-2024,Purchase,07.06,00.00,"270,169.58"
22-Nov-2024,Cash,00.00,"45,028.26","225,141.32"
22-Nov-2024,Reversal,00.00,"22,514.13","202,627.19"
22-Nov-2024,Tax,00.00,"20,262.72","182,364.47"
22-Nov-2024,Debit Card,00.40,00.00,"182,364.87"
23-Nov-2024,ATM,"9,663.14",00.00,"192,028.01"
23-Nov-2024,Purchase,00.00,"21,336.45","170,691.56"
23-Nov-2024,Bill,00.00,"18,965.73","151,725.83"
23-Nov-2024,ATM,00.00,"15,172.58","136,553.25"
23-Nov-2024,Cheque,00.00,"15,172.58","121,380.67"
23-Nov-2024,IMPS,126.80,00.00,"121,507.47"
23-Nov-2024,ATM,00.00,"20,251.25","101,256.22"
23-Nov-2024,RTGS,00.00,"16,876.04","84,380.18"
23-Nov-2024,Tax,13.10,00.00,"84,393.28"
23-Nov-2024,Cheque,00.00,"21,098.32","63,294.96"
23-Nov-2024,Tax,00.00,"10,549.16","52,745.80"
24-Nov-2024,NEFT,"1,551,018.50",00.00,"1,603,764.30"
24-Nov-2024,Debit Card,"22,232.80",00.00,"1,625,997.10"
24-Nov-2024,Commission,00.00,"162,599.71","1,463,397.39"
24-Nov-2024,Cash,00.00,"209,056.77","1,254,340.62"
24-Nov-2024,Tax,00.00,"250,868.12","1,003,472.50"
24-Nov-2024,IMPS,"219,570.70",00.00,"1,223,043.20"
24-Nov-2024,NEFT,"150,486.00",00.00,"1,373,529.20"
24-Nov-2024,ATM,00.00,"343,382.30","1,030,146.90"
24-Nov-2024,Cash,00.00,"206,029.38","824,117.52"
24-Nov-2024,Purchase,"1,647,512.00",00.00,"2,471,629.52"
24-Nov-2024,IMPS,00.00,"494,325.90","1,977,303.62"
24-Nov-2024,Cheque,00.00,"219,700.40","1,757,603.22"
24-Nov-2024,Transfer,00.00,"251,086.17","1,506,517.05"
24-Nov-2024,Interest,"184,455.40",00.00,"1,690,972.45"
24-Nov-2024,Tax,269.00,00.00,"1,691,241.45"
24-Nov-2024,Bill,41.31,00.00,"1,691,282.76"
24-Nov-2024,Purchase,"15,691.00",00.00,"1,706,973.76"
24-Nov-2024,IMPS,00.00,"426,743.44","1,280,230.32"
24-Nov-2024,Cheque,"105,062.00",00.00,"1,385,292.32"
24-Nov-2024,NEFT,00.00,"1,385,292.32",00.00
24-Nov-2024,Cheque,456.00,00.00,456.00
24-Nov-2024,Tax,00.00,76.00,380.00
24-Nov-2024,Debit Card,00.00,63.33,316.67
24-Nov-2024,Cash,00.00,31.67,285.00
24-Nov-2024,Reversal,00.00,71.25,213.75
24-Nov-2024,Debit Card,00.00,26.72,187.03
24-Nov-2024,Bill,00.00,23.38,163.65
24-Nov-2024,NEFT,00.00,27.28,136.38
24-Nov-2024,Purchase,"2,306.50",00.00,"2,442.88"
24-Nov-2024,NEFT,00.00,488.58,"1,954.30"
25-Nov-2024,Commission,"2,745.27",00.00,"4,699.57"
25-Nov-2024,Bill,00.00,469.96,"4,229.61"
25-Nov-2024,Reversal,"1,979,650.00",00.00,"1,983,879.61"
25-Nov-2024,Bill,"171,353.00",00.00,"2,155,232.61"
25-Nov-2024,Purchase,"3,025.30",00.00,"2,158,257.91"
25-Nov-2024,RTGS,06.00,00.00,"2,158,263.91"
25-Nov-2024,Bill,00.00,"1,079,131.96","1,079,131.96"
26-Nov-2024,Commission,05.00,00.00,"1,079,136.96"
26-Nov-2024,Cheque,"57,479.00",00.00,"1,136,615.96"
26-Nov-2024,NEFT,"4,041.55",00.00,"1,140,657.51"
26-Nov-2024,Cheque,00.00,"285,164.38","855,493.13"
26-Nov-2024,Tax,00.00,"85,549.31","769,943.82"
26-Nov-2024,Miscellaneous,00.00,"109,991.97","659,951.85"
26-Nov-2024,Tax,00.00,"164,987.96","494,963.89"
26-Nov-2024,RTGS,00.00,"164,987.96","329,975.93"
26-Nov-2024,Reversal,"128,250.00",00.00,"458,225.93"
26-Nov-2024,Cash,00.00,"114,556.48","343,669.45"
26-Nov-2024,Reversal,00.00,"114,556.48","229,112.97"
27-Nov-2024,RTGS,501.00,00.00,"229,613.97"
28-Nov-2024,RTGS,00.00,"32,802.00","196,811.97"
28-Nov-2024,Transfer,00.00,"65,603.99","131,207.98"
28-Nov-2024,Transfer,00.00,"32,802.00","98,405.99"
28-Nov-2024,Tax,"2,050,889.50",00.00,"2,149,295.49"
28-Nov-2024,IMPS,00.00,"214,929.55","1,934,365.94"
28-Nov-2024,Commission,00.00,"386,873.19","1,547,492.75"
28-Nov-2024,Miscellaneous,00.00,"515,830.92","1,031,661.83"
29-Nov-2024,ATM,00.00,"257,915.46","773,746.37"
29-Nov-2024,Purchase,"88,591.53",00.00,"862,337.90"
29-Nov-2024,ATM,29.30,00.00,"862,367.20"
29-Nov-2024,Purchase,00.00,"95,818.58","766,548.62"
29-Nov-2024,Transfer,"2,117.19",00.00,"768,665.81"
29-Nov-2024,ATM,00.00,"76,866.58","691,799.23"
29-Nov-2024,NEFT,"1,637,929.00",00.00,"2,329,728.23"
29-Nov-2024,Cash,07.10,00.00,"2,329,735.33"
29-Nov-2024,Tax,00.00,"465,947.07","1,863,788.26"
29-Nov-2024,Purchase,268.50,00.00,"1,864,056.76"
29-Nov-2024,NEFT,00.00,"466,014.19","1,398,042.57"
29-Nov-2024,Miscellaneous,00.00,"349,510.64","1,048,531.93"
29-Nov-2024,Bill,00.00,"262,132.98","786,398.95"
29-Nov-2024,Commission,50.80,00.00,"786,449.75"
29-Nov-2024,ATM,00.00,"393,224.88","393,224.88"
29-Nov-2024,Cash,15.50,00.00,"393,240.38"
29-Nov-2024,Tax,"7,392.80",00.00,"400,633.18"
29-Nov-2024,RTGS,00.00,"200,316.59","200,316.59"
29-Nov-2024,NEFT,00.00,"40,063.32","160,253.27"
29-Nov-2024,Miscellaneous,00.00,"22,893.32","137,359.95"
29-Nov-2024,Tax,834.00,00.00,"138,193.95"
29-Nov-2024,Commission,00.00,"13,819.40","124,374.56"
29-Nov-2024,NEFT,310.82,00.00,"124,685.38"
29-Nov-2024,IMPS,00.00,"17,812.20","106,873.18"
29-Nov-2024,Miscellaneous,"34,545.00",00.00,"141,418.18"
29-Nov-2024,RTGS,00.00,"47,139.39","94,278.79"
29-Nov-2024,IMPS,00.00,"23,569.70","70,709.09"
29-Nov-2024,RTGS,00.00,"11,784.85","58,924.24"
29-Nov-2024,Interest,00.00,"58,924.24",00.00
29-Nov-2024,Miscellaneous,01.60,00.00,01.60
29-Nov-2024,ATM,"1,827.15",00.00,"1,828.75"
29-Nov-2024,Commission,00.00,261.25,"1,567.50"
29-Nov-2024,Commission,00.00,195.94,"1,371.56"
29-Nov-2024,Transfer,03.00,00.00,"1,374.56"
29-Nov-2024,Miscellaneous,"42,326.00",00.00,"43,700.56"
30-Nov-2024,Reversal,02.40,00.00,"43,702.96"
30-Nov-2024,Tax,"325,559.50",00.00,"369,262.46"
30-Nov-2024,IMPS,"143,110.91",00.00,"512,373.37"
30-Nov-2024,ATM,"6,872.00",00.00,"519,245.37"
30-Nov-2024,Interest,00.00,"519,245.37",00.00
30-Nov-2024,Purchase,480.11,00.00,480.11
30-Nov-2024,Commission,"84,986.25",00.00,"85,466.36"
30-Nov-2024,Reversal,00.00,"14,244.39","71,221.97"
01-Dec-2024,Bill,"780,055.75",00.00,"851,277.72"
01-Dec-2024,RTGS,"2,019,149.50",00.00,"2,870,427.22"
01-Dec-2024,ATM,"537,181.25",00.00,"3,407,608.47"
01-Dec-2024,Purchase,44.22,00.00,"3,407,652.69"
01-Dec-2024,NEFT,00.00,"340,765.27","3,066,887.42"
01-Dec-2024,Miscellaneous,00.00,"383,360.93","2,683,526.49"
01-Dec-2024,Interest,00.00,"1,341,763.25","1,341,763.25"
01-Dec-2024,Cheque,00.00,"268,352.65","1,073,410.60"
01-Dec-2024,RTGS,00.00,"214,682.12","858,728.48"
01-Dec-2024,Cash,110.00,00.00,"858,838.48"
01-Dec-2024,NEFT,00.00,"95,426.50","763,411.98"
01-Dec-2024,Miscellaneous,00.00,"76,341.20","687,070.78"
01-Dec-2024,Interest,00.00,"98,152.97","588,917.81"
01-Dec-2024,Reversal,00.00,"84,131.12","504,786.69"
01-Dec-2024,Cheque,00.00,"50,478.67","454,308.02"
01-Dec-2024,Commission,"13,015.00",00.00,"467,323.02"
01-Dec-2024,RTGS,00.00,"93,464.60","373,858.42"
01-Dec-2024,Cheque,"234,303.00",00.00,"608,161.42"
01-Dec-2024,NEFT,00.00,"608,161.42",00.00
01-Dec-2024,Debit Card,"7,473.00",00.00,"7,473.00"
01-Dec-2024,Commission,"1,581,655.00",00.00,"1,589,128.00"
01-Dec-2024,RTGS,00.00,"529,709.33","1,059,418.67"
01-Dec-2024,NEFT,00.00,"151,345.52","908,073.15"
01-Dec-2024,Purchase,00.00,"302,691.05","605,382.10"
01-Dec-2024,Reversal,"168,117.00",00.00,"773,499.10"
01-Dec-2024,NEFT,934.53,00.00,"774,433.63"
01-Dec-2024,IMPS,"243,706.00",00.00,"1,018,139.63"
01-Dec-2024,IMPS,00.00,"509,069.82","509,069.82"
01-Dec-2024,Cash,00.00,"509,069.82",00.00
01-Dec-2024,ATM,14.53,00.00,14.53
01-Dec-2024,Transfer,"3,900.30",00.00,"3,914.83"
01-Dec-2024,Transfer,00.00,"1,957.42","1,957.42"
01-Dec-2024,ATM,00.00,391.48,"1,565.94"
01-Dec-2024,Miscellaneous,"22,906.60",00.00,"24,472.54"
01-Dec-2024,Interest,00.00,"3,059.07","21,413.47"
01-Dec-2024,Commission,00.00,"4,282.69","17,130.78"
01-Dec-2024,Bill,47.00,00.00,"17,177.78"
01-Dec-2024,Tax,"27,428.00",00.00,"44,605.78"
01-Dec-2024,ATM,"1,674,744.25",00.00,"1,719,350.03"
01-Dec-2024,Debit Card,00.00,"286,558.34","1,432,791.69"
02-Dec-2024,ATM,"16,324.84",00.00,"1,449,116.53"
02-Dec-2024,RTGS,02.37,00.00,"1,449,118.90"
02-Dec-2024,Cheque,"3,713.30",00.00,"1,452,832.20"
02-Dec-2024,ATM,00.00,"726,416.10","726,416.10"
02-Dec-2024,Reversal,00.00,"72,641.61","653,774.49"
02-Dec-2024,Reversal,25.00,00.00,"653,799.49"
02-Dec-2024,Cheque,00.00,"217,933.16","435,866.33"
02-Dec-2024,NEFT,66.40,00.00,"435,932.73"
02-Dec-2024,Commission,00.00,"48,436.97","387,495.76"
02-Dec-2024,Cash,910.70,00.00,"388,406.46"
02-Dec-2024,Debit Card,18.47,00.00,"388,424.93"
02-Dec-2024,Cash,00.00,"64,737.49","323,687.44"
02-Dec-2024,Interest,00.00,"64,737.49","258,949.95"
02-Dec-2024,Transfer,00.00,"43,158.33","215,791.62"
02-Dec-2024,Debit Card,"3,340.00",00.00,"219,131.62"
02-Dec-2024,Commission,00.00,"24,347.96","194,783.66"
02-Dec-2024,Cash,00.00,"27,826.24","166,957.42"
02-Dec-2024,RTGS,04.00,00.00,"166,961.42"
02-Dec-2024,Transfer,"1,814,375.25",00.00,"1,981,336.67"
02-Dec-2024,Cash,00.00,"660,445.56","1,320,891.11"
02-Dec-2024,ATM,58.37,00.00,"1,320,949.48"
02-Dec-2024,IMPS,00.00,"1,320,949.48",00.00
03-Dec-2024,Transfer,308.66,00.00,308.66
03-Dec-2024,RTGS,"1,558,012.00",00.00,"1,558,320.66"
03-Dec-2024,RTGS,00.00,"519,440.22","1,038,880.44"
03-Dec-2024,Commission,00.00,"259,720.11","779,160.33"
03-Dec-2024,Cheque,07.00,00.00,"779,167.33"
03-Dec-2024,Interest,"63,463.00",00.00,"842,630.33"
03-Dec-2024,NEFT,"992,122.80",00.00,"1,834,753.13"
03-Dec-2024,Tax,00.00,"1,834,753.13",00.00
03-Dec-2024,Bill,48.60,00.00,48.60
03-Dec-2024,NEFT,23.00,00.00,71.60
03-Dec-2024,Interest,"1,173,070.00",00.00,"1,173,141.60"
03-Dec-2024,Bill,00.00,"234,628.32","938,513.28"
03-Dec-2024,Reversal,58.00,00.00,"938,571.28"
03-Dec-2024,Commission,"1,894,557.00",00.00,"2,833,128.28"
03-Dec-2024,RTGS,00.00,"566,625.66","2,266,502.62"
03-Dec-2024,Commission,45.28,00.00,"2,266,547.90"
03-Dec-2024,ATM,00.00,"755,515.97","1,511,031.93"
03-Dec-2024,Cash,00.00,"377,757.98","1,133,273.95"
03-Dec-2024,ATM,196.00,00.00,"1,133,469.95"
03-Dec-2024,RTGS,00.00,"141,683.74","991,786.21"
03-Dec-2024,Debit Card,00.00,"141,683.74","850,102.47"
03-Dec-2024,Bill,00.00,"425,051.24","425,051.24"
03-Dec-2024,IMPS,00.00,"85,010.25","340,040.99"
03-Dec-2024,Cheque,03.30,00.00,"340,044.29"
03-Dec-2024,NEFT,"1,518,300.25",00.00,"1,858,344.54"
03-Dec-2024,Cash,"2,178.93",00.00,"1,860,523.47"
03-Dec-2024,ATM,61.00,00.00,"1,860,584.47"
03-Dec-2024,Debit Card,00.00,"265,797.78","1,594,786.69"
03-Dec-2024,Debit Card,00.00,"797,393.35","797,393.34"
03-Dec-2024,NEFT,"100,785.00",00.00,"898,178.34"
03-Dec-2024,Commission,"6,583.20",00.00,"904,761.54"
03-Dec-2024,Interest,00.00,"452,380.77","452,380.77"
03-Dec-2024,RTGS,00.00,"45,238.08","407,142.69"
03-Dec-2024,Miscellaneous,"47,706.50",00.00,"454,849.19"
03-Dec-2024,Debit Card,00.00,"56,856.15","397,993.04"
03-Dec-2024,Interest,00.00,"66,332.17","331,660.87"
03-Dec-2024,Transfer,05.00,00.00,"331,665.87"
03-Dec-2024,Transfer,00.00,"82,916.47","248,749.40"
03-Dec-2024,Miscellaneous,"1,829,778.80",00.00,"2,078,528.20"
04-Dec-2024,Purchase,00.00,"519,632.05","1,558,896.15"
04-Dec-2024,Interest,"210,533.00",00.00,"1,769,429.15"
04-Dec-2024,Cheque,00.00,"252,775.59","1,516,653.56"
04-Dec-2024,Reversal,"1,537.70",00.00,"1,518,191.26"
04-Dec-2024,RTGS,06.95,00.00,"1,518,198.21"
04-Dec-2024,Cash,00.00,"253,033.04","1,265,165.18"
04-Dec-2024,Purchase,00.00,"1,265,165.18",00.00
04-Dec-2024,NEFT,"198,523.10",00.00,"198,523.10"
04-Dec-2024,Cash,"9,092.00",00.00,"207,615.10"
04-Dec-2024,NEFT,00.00,"51,903.78","155,711.33"
04-Dec-2024,Miscellaneous,356.00,00.00,"156,067.33"
04-Dec-2024,Cash,00.00,"17,340.81","138,726.52"
05-Dec-2024,Transfer,00.00,"34,681.63","104,044.89"
05-Dec-2024,ATM,07.00,00.00,"104,051.89"
05-Dec-2024,Tax,00.00,"11,561.32","92,490.57"
05-Dec-2024,NEFT,"112,596.00",00.00,"205,086.57"
05-Dec-2024,RTGS,329.42,00.00,"205,415.99"
05-Dec-2024,Purchase,00.00,"205,415.99",00.00
05-Dec-2024,Debit Card,74.00,00.00,74.00
05-Dec-2024,Miscellaneous,"1,744.00",00.00,"1,818.00"
05-Dec-2024,Transfer,00.00,303.00,"1,515.00"
05-Dec-2024,IMPS,"12,826.40",00.00,"14,341.40"
05-Dec-2024,Purchase,"7,829.52",00.00,"22,170.92"
05-Dec-2024,Miscellaneous,45.66,00.00,"22,216.58"
05-Dec-2024,Debit Card,00.00,"7,405.53","14,811.05"
05-Dec-2024,ATM,"146,891.28",00.00,"161,702.33"
05-Dec-2024,NEFT,00.00,"80,851.17","80,851.16"
05-Dec-2024,Transfer,00.00,"16,170.23","64,680.93"
05-Dec-2024,Purchase,00.00,"32,340.47","32,340.46"
05-Dec-2024,NEFT,00.00,"6,468.09","25,872.37"
05-Dec-2024,RTGS,00.00,00.00,"25,872.37"
05-Dec-2024,Cash,43.70,00.00,"25,916.07"
05-Dec-2024,Debit Card,"1,015.00",00.00,"26,931.07"
05-Dec-2024,NEFT,00.00,"3,847.30","23,083.77"
05-Dec-2024,Cash,"1,099.00",00.00,"24,182.77"
05-Dec-2024,Cash,356.53,00.00,"24,539.30"
05-Dec-2024,Miscellaneous,"225,112.44",00.00,"249,651.74"
05-Dec-2024,Purchase,00.00,"35,664.53","213,987.21"
05-Dec-2024,Cheque,19.19,00.00,"214,006.40"
05-Dec-2024,Transfer,00.00,"30,572.34","183,434.06"
05-Dec-2024,IMPS,60.62,00.00,"183,494.68"
05-Dec-2024,Reversal,00.00,"30,582.45","152,912.23"
05-Dec-2024,Interest,"59,672.00",00.00,"212,584.23"
05-Dec-2024,Debit Card,04.38,00.00,"212,588.61"
05-Dec-2024,Interest,00.00,"30,369.80","182,218.81"
05-Dec-2024,Miscellaneous,00.00,"26,031.26","156,187.55"
05-Dec-2024,ATM,00.00,"52,062.52","104,125.03"
05-Dec-2024,Cash,00.00,"34,708.34","69,416.69"
05-Dec-2024,Miscellaneous,00.00,"6,941.67","62,475.02"
06-Dec-2024,Purchase,05.30,00.00,"62,480.32"
06-Dec-2024,Interest,00.00,"15,620.08","46,860.24"
06-Dec-2024,Cash,00.00,"5,857.53","41,002.71"
06-Dec-2024,Interest,"1,815,152.00",00.00,"1,856,154.71"
06-Dec-2024,Purchase,"126,406.00",00.00,"1,982,560.71"
06-Dec-2024,Transfer,00.00,"330,426.79","1,652,133.92"
06-Dec-2024,RTGS,"418,300.75",00.00,"2,070,434.67"
06-Dec-2024,IMPS,00.00,"1,035,217.34","1,035,217.34"
06-Dec-2024,Miscellaneous,284.00,00.00,"1,035,501.34"
06-Dec-2024,Debit Card,00.00,"172,583.56","862,917.78"
06-Dec-2024,Commission,00.00,"287,639.26","575,278.52"
06-Dec-2024,Miscellaneous,55.30,00.00,"575,333.82"
06-Dec-2024,Tax,00.00,"115,066.76","460,267.06"
06-Dec-2024,Commission,00.00,"46,026.71","414,240.35"
06-Dec-2024,IMPS,"2,682.00",00.00,"416,922.35"
06-Dec-2024,ATM,00.00,"59,560.34","357,362.01"
06-Dec-2024,Transfer,"36,619.00",00.00,"393,981.01"
06-Dec-2024,Miscellaneous,00.00,"43,775.67","350,205.34"
06-Dec-2024,Cheque,00.00,"116,735.11","233,470.23"
06-Dec-2024,Tax,214.30,00.00,"233,684.53"
06-Dec-2024,Miscellaneous,"30,723.93",00.00,"264,408.46"
06-Dec-2024,ATM,"1,670.00",00.00,"266,078.46"
06-Dec-2024,RTGS,00.00,"26,607.85","239,470.61"
06-Dec-2024,RTGS,00.00,"29,933.83","209,536.78"
06-Dec-2024,Miscellaneous,00.00,"34,922.80","174,613.98"
06-Dec-2024,Cash,04.00,00.00,"174,617.98"
06-Dec-2024,ATM,06.00,00.00,"174,623.98"
06-Dec-2024,RTGS,00.00,"29,104.00","145,519.98"
06-Dec-2024,Debit Card,00.00,"16,168.89","129,351.09"
06-Dec-2024,Cheque,00.00,"43,117.03","86,234.06"
06-Dec-2024,Cash,36.00,00.00,"86,270.06"
06-Dec-2024,NEFT,00.00,"43,135.03","43,135.03"
07-Dec-2024,Debit Card,00.00,"21,567.52","21,567.52"
07-Dec-2024,Miscellaneous,17.00,00.00,"21,584.52"
07-Dec-2024,Cash,"1,604,385.75",00.00,"1,625,970.27"
07-Dec-2024,Debit Card,00.00,"406,492.57","1,219,477.70"
07-Dec-2024,IMPS,00.00,"609,738.85","609,738.85"
08-Dec-2024,RTGS,"4,660.27",00.00,"614,399.12"
08-Dec-2024,Cheque,209.50,00.00,"614,608.62"
08-Dec-2024,Transfer,00.00,"102,434.77","512,173.85"
08-Dec-2024,Cash,00.00,"73,167.69","439,006.16"
08-Dec-2024,IMPS,00.00,"43,900.62","395,105.54"
08-Dec-2024,NEFT,00.00,"39,510.55","355,594.99"
08-Dec-2024,Tax,00.00,"71,119.00","284,475.99"
08-Dec-2024,Miscellaneous,217.96,00.00,"284,693.95"
08-Dec-2024,Commission,00.00,"35,586.74","249,107.21"
08-Dec-2024,Bill,00.00,"41,517.87","207,589.34"
08-Dec-2024,RTGS,00.00,"69,196.45","138,392.89"
08-Dec-2024,Tax,"244,446.00",00.00,"382,838.89"
08-Dec-2024,Purchase,00.00,"127,612.96","255,225.93"
08-Dec-2024,Bill,"3,493.30",00.00,"258,719.23"
08-Dec-2024,RTGS,"140,974.40",00.00,"399,693.63"
08-Dec-2024,Cash,"287,891.00",00.00,"687,584.63"
08-Dec-2024,Tax,00.00,"343,792.32","343,792.32"
08-Dec-2024,Cash,17.27,00.00,"343,809.59"
08-Dec-2024,Cash,00.00,"68,761.92","275,047.67"
08-Dec-2024,Cheque,00.41,00.00,"275,048.08"
08-Dec-2024,Interest,34.90,00.00,"275,082.98"
08-Dec-2024,NEFT,00.00,"45,847.16","229,235.82"
08-Dec-2024,Miscellaneous,00.00,"38,205.97","191,029.85"
09-Dec-2024,Bill,"36,343.00",00.00,"227,372.85"
09-Dec-2024,Miscellaneous,00.00,"37,895.48","189,477.38"
09-Dec-2024,Cheque,00.00,"94,738.69","94,738.69"
09-Dec-2024,Debit Card,"233,721.00",00.00,"328,459.69"
09-Dec-2024,Cheque,04.00,00.00,"328,463.69"
09-Dec-2024,Purchase,"1,696,062.00",00.00,"2,024,525.69"
09-Dec-2024,Tax,00.00,"1,012,262.85","1,012,262.84"
09-Dec-2024,Transfer,405.30,00.00,"1,012,668.14"
09-Dec-2024,Bill,04.40,00.00,"1,012,672.54"
09-Dec-2024,Tax,00.00,"144,667.51","868,005.03"
09-Dec-2024,Purchase,00.00,"868,005.03",00.00
09-Dec-2024,Transfer,157.60,00.00,157.60
09-Dec-2024,Cash,"1,526,818.25",00.00,"1,526,975.85"
09-Dec-2024,Purchase,00.00,"763,487.93","763,487.92"
09-Dec-2024,ATM,00.94,00.00,"763,488.86"
09-Dec-2024,Bill,"178,263.00",00.00,"941,751.86"
09-Dec-2024,Interest,97.00,00.00,"941,848.86"
09-Dec-2024,ATM,00.00,"313,949.62","627,899.24"
09-Dec-2024,Reversal,00.00,"627,899.24",00.00
09-Dec-2024,Tax,07.00,00.00,07.00
09-Dec-2024,Cheque,00.00,00.78,06.22
09-Dec-2024,Commission,00.00,03.11,03.11
09-Dec-2024,Interest,96.49,00.00,99.60
09-Dec-2024,Transfer,00.00,09.96,89.64
09-Dec-2024,Bill,"28,715.20",00.00,"28,804.84"
09-Dec-2024,NEFT,12.34,00.00,"28,817.18"
09-Dec-2024,Purchase,"123,527.10",00.00,"152,344.28"
09-Dec-2024,Cheque,00.00,"16,927.14","135,417.14"
09-Dec-2024,Debit Card,06.52,00.00,"135,423.66"
09-Dec-2024,Purchase,00.00,"45,141.22","90,282.44"
09-Dec-2024,Debit Card,00.00,"30,094.15","60,188.29"
09-Dec-2024,Miscellaneous,"165,676.00",00.00,"225,864.29"
09-Dec-2024,Transfer,00.00,"56,466.07","169,398.22"
09-Dec-2024,Bill,00.00,"16,939.82","152,458.40"
09-Dec-2024,Debit Card,00.00,"16,939.82","135,518.58"
09-Dec-2024,IMPS,00.00,"13,551.86","121,966.72"
09-Dec-2024,Cheque,"286,676.20",00.00,"408,642.92"
09-Dec-2024,NEFT,03.78,00.00,"408,646.70"
10-Dec-2024,Reversal,"2,554.66",00.00,"411,201.36"
10-Dec-2024,Transfer,00.00,"41,120.14","370,081.22"
10-Dec-2024,Transfer,00.00,"370,081.22",00.00
10-Dec-2024,NEFT,497.30,00.00,497.30
10-Dec-2024,Purchase,00.00,49.73,447.57
10-Dec-2024,Miscellaneous,00.00,447.57,00.00
10-Dec-2024,Tax,"1,672.40",00.00,"1,672.40"
10-Dec-2024,Bill,21.50,00.00,"1,693.90"
10-Dec-2024,NEFT,326.00,00.00,"2,019.90"
10-Dec-2024,NEFT,00.00,673.30,"1,346.60"
10-Dec-2024,Miscellaneous,00.00,224.43,"1,122.17"
10-Dec-2024,Commission,"26,974.88",00.00,"28,097.05"
10-Dec-2024,Reversal,00.00,"28,097.05",00.00
10-Dec-2024,Purchase,77.00,00.00,77.00
11-Dec-2024,Reversal,264.76,00.00,341.76
11-Dec-2024,Tax,01.97,00.00,343.73
11-Dec-2024,ATM,00.00,343.73,00.00
11-Dec-2024,Debit Card,29.13,00.00,29.13
11-Dec-2024,Cash,162.24,00.00,191.37
11-Dec-2024,Tax,00.00,47.84,143.53
11-Dec-2024,Bill,"1,111.16",00.00,"1,254.69"
11-Dec-2024,Cheque,05.00,00.00,"1,259.69"
11-Dec-2024,Commission,38.00,00.00,"1,297.69"
11-Dec-2024,Purchase,"3,534.23",00.00,"4,831.92"
11-Dec-2024,Bill,06.00,00.00,"4,837.92"
11-Dec-2024,Cheque,04.00,00.00,"4,841.92"
11-Dec-2024,Debit Card,321.46,00.00,"5,163.38"
11-Dec-2024,Interest,00.00,"5,163.38",00.00
11-Dec-2024,NEFT,"1,137.54",00.00,"1,137.54"
11-Dec-2024,Bill,00.00,568.77,568.77
11-Dec-2024,Miscellaneous,"1,417.69",00.00,"1,986.46"
11-Dec-2024,Reversal,00.00,248.31,"1,738.15"
11-Dec-2024,Commission,"4,087.21",00.00,"5,825.36"
11-Dec-2024,Reversal,00.00,"1,165.07","4,660.29"
11-Dec-2024,IMPS,00.00,517.81,"4,142.48"
11-Dec-2024,Debit Card,"24,018.40",00.00,"28,160.88"
12-Dec-2024,Reversal,"28,841.00",00.00,"57,001.88"
12-Dec-2024,Tax,00.00,"9,500.31","47,501.57"
12-Dec-2024,Miscellaneous,00.00,"9,500.31","38,001.26"
12-Dec-2024,ATM,74.00,00.00,"38,075.26"
12-Dec-2024,NEFT,00.00,"12,691.75","25,383.51"
12-Dec-2024,Bill,00.00,"2,538.35","22,845.16"
12-Dec-2024,ATM,"3,816.00",00.00,"26,661.16"
12-Dec-2024,NEFT,84.30,00.00,"26,745.46"
12-Dec-2024,RTGS,"320,546.80",00.00,"347,292.26"
12-Dec-2024,Reversal,00.00,"34,729.23","312,563.03"
12-Dec-2024,Reversal,00.00,"34,729.23","277,833.80"
12-Dec-2024,Tax,00.00,"69,458.45","208,375.35"
12-Dec-2024,Commission,07.95,00.00,"208,383.30"
12-Dec-2024,Purchase,"24,677.90",00.00,"233,061.20"
12-Dec-2024,Cash,51.00,00.00,"233,112.20"
12-Dec-2024,Tax,25.80,00.00,"233,138.00"
12-Dec-2024,Cash,00.00,"46,627.60","186,510.40"
12-Dec-2024,ATM,00.00,"31,085.07","155,425.33"
12-Dec-2024,Commission,"324,254.00",00.00,"479,679.33"
12-Dec-2024,RTGS,806.70,00.00,"480,486.03"
13-Dec-2024,IMPS,"170,607.50",00.00,"651,093.53"
13-Dec-2024,NEFT,"1,562,642.00",00.00,"2,213,735.53"
13-Dec-2024,Interest,00.00,"737,911.84","1,475,823.69"
13-Dec-2024,ATM,"1,558,715.00",00.00,"3,034,538.69"
13-Dec-2024,Cash,"536,366.80",00.00,"3,570,905.49"
13-Dec-2024,Interest,00.00,"1,190,301.83","2,380,603.66"
13-Dec-2024,NEFT,07.00,00.00,"2,380,610.66"
13-Dec-2024,Cheque,00.00,"476,122.13","1,904,488.53"
13-Dec-2024,NEFT,00.12,00.00,"1,904,488.65"
13-Dec-2024,RTGS,779.00,00.00,"1,905,267.65"
13-Dec-2024,NEFT,00.00,"635,089.22","1,270,178.43"
13-Dec-2024,Transfer,00.00,"158,772.30","1,111,406.13"
13-Dec-2024,NEFT,00.00,"222,281.23","889,124.90"
13-Dec-2024,Miscellaneous,"158,756.30",00.00,"1,047,881.20"
13-Dec-2024,Miscellaneous,06.00,00.00,"1,047,887.20"
13-Dec-2024,Debit Card,00.00,"261,971.80","785,915.40"
13-Dec-2024,Miscellaneous,"164,288.97",00.00,"950,204.37"
14-Dec-2024,IMPS,00.00,"158,367.40","791,836.98"
14-Dec-2024,IMPS,00.00,"791,836.98",00.00
14-Dec-2024,Cash,74.00,00.00,74.00
14-Dec-2024,NEFT,00.00,37.00,37.00
14-Dec-2024,RTGS,00.00,04.11,32.89
14-Dec-2024,Commission,00.00,06.58,26.31
14-Dec-2024,Interest,159.39,00.00,185.70
14-Dec-2024,NEFT,00.00,61.90,123.80
14-Dec-2024,Transfer,"160,090.40",00.00,"160,214.20"
14-Dec-2024,Purchase,00.00,"53,404.73","106,809.47"
14-Dec-2024,Transfer,00.00,"106,809.47",00.00
14-Dec-2024,Tax,342.00,00.00,342.00
14-Dec-2024,ATM,28.00,00.00,370.00
14-Dec-2024,Transfer,00.00,123.33,246.67
14-Dec-2024,Cheque,00.00,24.67,222.00
14-Dec-2024,Debit Card,00.00,27.75,194.25
14-Dec-2024,Debit Card,"623,465.50",00.00,"623,659.75"
14-Dec-2024,Bill,30.40,00.00,"623,690.15"
14-Dec-2024,Tax,00.00,"77,961.27","545,728.88"
14-Dec-2024,Debit Card,"1,090,375.00",00.00,"1,636,103.88"
14-Dec-2024,Cash,00.00,"181,789.32","1,454,314.56"
14-Dec-2024,Transfer,00.00,"290,862.91","1,163,451.65"
14-Dec-2024,Bill,"9,458.47",00.00,"1,172,910.12"
14-Dec-2024,Miscellaneous,"1,580.00",00.00,"1,174,490.12"
14-Dec-2024,RTGS,55.00,00.00,"1,174,545.12"
14-Dec-2024,Tax,00.00,"130,505.01","1,044,040.11"
14-Dec-2024,Purchase,"22,961.14",00.00,"1,067,001.25"
14-Dec-2024,Purchase,00.00,"177,833.54","889,167.71"
14-Dec-2024,Cash,"1,946,490.50",00.00,"2,835,658.21"
14-Dec-2024,RTGS,"3,367.30",00.00,"2,839,025.51"
14-Dec-2024,Debit Card,00.00,"567,805.10","2,271,220.41"
14-Dec-2024,Cheque,38.30,00.00,"2,271,258.71"
14-Dec-2024,Debit Card,397.01,00.00,"2,271,655.72"
14-Dec-2024,Cheque,00.00,"324,522.25","1,947,133.47"
14-Dec-2024,Miscellaneous,00.00,"243,391.68","1,703,741.79"
14-Dec-2024,Cheque,"227,722.00",00.00,"1,931,463.79"
14-Dec-2024,Miscellaneous,00.00,"214,607.09","1,716,856.70"
14-Dec-2024,RTGS,00.00,"858,428.35","858,428.35"
14-Dec-2024,Purchase,00.00,"107,303.54","751,124.81"
14-Dec-2024,IMPS,00.00,"751,124.81",00.00
14-Dec-2024,NEFT,"3,186.08",00.00,"3,186.08"
14-Dec-2024,Cash,"9,402.20",00.00,"12,588.28"
14-Dec-2024,Cash,00.00,"12,588.28",00.00
14-Dec-2024,Debit Card,"1,600,664.80",00.00,"1,600,664.80"
14-Dec-2024,Reversal,"30,414.60",00.00,"1,631,079.40"
14-Dec-2024,Cheque,00.00,"271,846.57","1,359,232.83"
14-Dec-2024,Debit Card,00.00,"135,923.28","1,223,309.55"
14-Dec-2024,Interest,00.00,"152,913.69","1,070,395.86"
14-Dec-2024,Purchase,06.77,00.00,"1,070,402.63"
14-Dec-2024,Cash,38.10,00.00,"1,070,440.73"
14-Dec-2024,Miscellaneous,00.00,"133,805.09","936,635.64"
14-Dec-2024,NEFT,00.00,"104,070.63","832,565.01"
14-Dec-2024,Cash,00.00,"104,070.63","728,494.38"
14-Dec-2024,Interest,00.00,"121,415.73","607,078.65"
14-Dec-2024,IMPS,00.00,00.00,"607,078.65"
14-Dec-2024,Bill,07.20,00.00,"607,085.85"
14-Dec-2024,Tax,867.92,00.00,"607,953.77"
14-Dec-2024,ATM,"18,573.40",00.00,"626,527.17"
15-Dec-2024,Purchase,"853,025.00",00.00,"1,479,552.17"
15-Dec-2024,Cash,00.00,"164,394.69","1,315,157.48"
15-Dec-2024,Miscellaneous,00.00,"438,385.83","876,771.65"
15-Dec-2024,NEFT,00.00,"146,128.61","730,643.04"
15-Dec-2024,Miscellaneous,00.00,"730,643.04",00.00
15-Dec-2024,IMPS,07.09,00.00,07.09
15-Dec-2024,Interest,"11,614.00",00.00,"11,621.09"
15-Dec-2024,Debit Card,00.00,"2,324.22","9,296.87"
15-Dec-2024,Bill,00.00,"1,032.99","8,263.88"
16-Dec-2024,Interest,"31,729.70",00.00,"39,993.58"
16-Dec-2024,Debit Card,00.00,"6,665.60","33,327.98"
16-Dec-2024,Purchase,349.00,00.00,"33,676.98"
16-Dec-2024,Reversal,00.00,"6,735.40","26,941.58"
16-Dec-2024,Commission,"921,917.80",00.00,"948,859.38"
16-Dec-2024,Cheque,150.05,00.00,"949,009.43"
16-Dec-2024,Commission,00.00,"118,626.18","830,383.25"
16-Dec-2024,Tax,"300,813.00",00.00,"1,131,196.25"
16-Dec-2024,Purchase,"15,002.76",00.00,"1,146,199.01"
16-Dec-2024,Miscellaneous,00.00,"127,355.45","1,018,843.56"
16-Dec-2024,Interest,00.00,"101,884.36","916,959.20"
16-Dec-2024,IMPS,461.00,00.00,"917,420.20"
16-Dec-2024,Miscellaneous,"2,084.40",00.00,"919,504.60"
16-Dec-2024,Debit Card,00.00,"459,752.30","459,752.30"
16-Dec-2024,Miscellaneous,"10,789.00",00.00,"470,541.30"
16-Dec-2024,Interest,00.00,"78,423.55","392,117.75"
16-Dec-2024,Purchase,"29,709.86",00.00,"421,827.61"
16-Dec-2024,RTGS,"220,218.56",00.00,"642,046.17"
16-Dec-2024,IMPS,06.00,00.00,"642,052.17"
16-Dec-2024,Miscellaneous,23.00,00.00,"642,075.17"
16-Dec-2024,Transfer,"76,889.00",00.00,"718,964.17"
16-Dec-2024,Commission,00.00,"71,896.42","647,067.75"
16-Dec-2024,Tax,00.00,"647,067.75",00.00
16-Dec-2024,Interest,"2,434.00",00.00,"2,434.00"
16-Dec-2024,Bill,71.00,00.00,"2,505.00"
16-Dec-2024,ATM,26.00,00.00,"2,531.00"
16-Dec-2024,Cheque,00.00,316.38,"2,214.62"
16-Dec-2024,NEFT,"31,405.00",00.00,"33,619.62"
16-Dec-2024,Purchase,"63,466.00",00.00,"97,085.62"
16-Dec-2024,Transfer,227.00,00.00,"97,312.62"
16-Dec-2024,IMPS,"599,829.20",00.00,"697,141.82"
17-Dec-2024,ATM,"26,502.00",00.00,"723,643.82"
17-Dec-2024,Commission,00.00,"241,214.61","482,429.21"
17-Dec-2024,Commission,"166,304.00",00.00,"648,733.21"
17-Dec-2024,Commission,51.60,00.00,"648,784.81"
17-Dec-2024,Cash,08.00,00.00,"648,792.81"
17-Dec-2024,IMPS,00.44,00.00,"648,793.25"
17-Dec-2024,Debit Card,"10,715.44",00.00,"659,508.69"
17-Dec-2024,RTGS,31.00,00.00,"659,539.69"
17-Dec-2024,Purchase,"3,372.00",00.00,"662,911.69"
17-Dec-2024,Tax,256.50,00.00,"663,168.19"
17-Dec-2024,Debit Card,"28,641.00",00.00,"691,809.19"
17-Dec-2024,Commission,00.00,"691,809.19",00.00
17-Dec-2024,Purchase,"140,310.00",00.00,"140,310.00"
17-Dec-2024,Cash,00.00,"20,044.29","120,265.71"
17-Dec-2024,Interest,00.00,"12,026.57","108,239.14"
17-Dec-2024,Miscellaneous,218.93,00.00,"108,458.07"
18-Dec-2024,Commission,00.00,"12,050.90","96,407.17"
18-Dec-2024,Interest,"138,738.00",00.00,"235,145.17"
18-Dec-2024,Cash,00.00,"29,393.15","205,752.02"
18-Dec-2024,RTGS,"248,045.00",00.00,"453,797.02"
18-Dec-2024,Debit Card,00.00,"453,797.02",00.00
18-Dec-2024,Miscellaneous,20.30,00.00,20.30
18-Dec-2024,Purchase,00.00,02.03,18.27
18-Dec-2024,Commission,65.70,00.00,83.97
18-Dec-2024,Miscellaneous,00.00,83.97,00.00
18-Dec-2024,Reversal,"288,981.00",00.00,"288,981.00"
18-Dec-2024,Transfer,"2,154.00",00.00,"291,135.00"
18-Dec-2024,Bill,00.00,"291,135.00",00.00
18-Dec-2024,Miscellaneous,62.40,00.00,62.40
18-Dec-2024,RTGS,27.00,00.00,89.40
18-Dec-2024,Bill,"20,600.00",00.00,"20,689.40"
18-Dec-2024,IMPS,00.00,"2,298.82","18,390.58"
18-Dec-2024,Cash,00.00,"6,130.19","12,260.39"
18-Dec-2024,ATM,00.00,"2,452.08","9,808.31"
18-Dec-2024,Tax,"4,008.70",00.00,"13,817.01"
18-Dec-2024,Transfer,00.00,"4,605.67","9,211.34"
18-Dec-2024,Miscellaneous,"155,698.25",00.00,"164,909.59"
18-Dec-2024,Commission,00.00,"23,558.51","141,351.08"
18-Dec-2024,NEFT,00.00,"20,193.01","121,158.07"
18-Dec-2024,ATM,401.00,00.00,"121,559.07"
18-Dec-2024,Interest,05.00,00.00,"121,564.07"
18-Dec-2024,NEFT,00.00,"17,366.30","104,197.77"
18-Dec-2024,ATM,00.00,"11,577.53","92,620.24"
18-Dec-2024,Transfer,"3,014.80",00.00,"95,635.04"
18-Dec-2024,IMPS,"1,300,872.00",00.00,"1,396,507.04"
18-Dec-2024,Reversal,00.00,"1,396,507.04",00.00
18-Dec-2024,Cheque,"32,003.15",00.00,"32,003.15"
18-Dec-2024,ATM,"1,342,585.25",00.00,"1,374,588.40"
19-Dec-2024,Reversal,00.00,"229,098.07","1,145,490.33"
19-Dec-2024,Purchase,"1,793.80",00.00,"1,147,284.13"
19-Dec-2024,Reversal,885.26,00.00,"1,148,169.39"
19-Dec-2024,Miscellaneous,"1,784,316.20",00.00,"2,932,485.59"
19-Dec-2024,Tax,"31,839.97",00.00,"2,964,325.56"
19-Dec-2024,Cheque,46.10,00.00,"2,964,371.66"
19-Dec-2024,Interest,56.00,00.00,"2,964,427.66"
19-Dec-2024,IMPS,00.00,"592,885.53","2,371,542.13"
19-Dec-2024,Reversal,00.00,"474,308.43","1,897,233.70"
19-Dec-2024,Miscellaneous,00.00,"271,033.39","1,626,200.31"
19-Dec-2024,Cheque,00.00,00.00,"1,626,200.31"
19-Dec-2024,Bill,01.95,00.00,"1,626,202.26"
19-Dec-2024,Tax,07.00,00.00,"1,626,209.26"
20-Dec-2024,Interest,00.00,"813,104.63","813,104.63"
20-Dec-2024,IMPS,"1,727,862.00",00.00,"2,540,966.63"
20-Dec-2024,Transfer,00.00,"282,329.63","2,258,637.00"
20-Dec-2024,Cheque,"2,719.00",00.00,"2,261,356.00"
20-Dec-2024,Tax,00.00,"753,785.33","1,507,570.67"
20-Dec-2024,RTGS,00.00,"502,523.56","1,005,047.11"
20-Dec-2024,Miscellaneous,00.00,"111,671.90","893,375.21"
20-Dec-2024,ATM,05.00,00.00,"893,380.21"
21-Dec-2024,Commission,"102,534.00",00.00,"995,914.21"
21-Dec-2024,ATM,35.00,00.00,"995,949.21"
21-Dec-2024,Interest,"101,789.00",00.00,"1,097,738.21"
22-Dec-2024,Cheque,00.00,"182,956.37","914,781.84"
22-Dec-2024,Cheque,00.00,"130,683.12","784,098.72"
22-Dec-2024,Miscellaneous,"908,550.50",00.00,"1,692,649.22"
22-Dec-2024,Cheque,"2,719.09",00.00,"1,695,368.31"
22-Dec-2024,Tax,00.00,"169,536.83","1,525,831.48"
22-Dec-2024,ATM,00.00,"381,457.87","1,144,373.61"
22-Dec-2024,Reversal,00.00,"1,144,373.61",00.00
22-Dec-2024,Cash,45.90,00.00,45.90
22-Dec-2024,Interest,118.24,00.00,164.14
22-Dec-2024,Interest,"12,543.00",00.00,"12,707.14"
22-Dec-2024,Tax,00.00,"12,707.14",00.00
22-Dec-2024,RTGS,13.70,00.00,13.70
22-Dec-2024,Cash,00.00,01.71,11.99
22-Dec-2024,ATM,130.00,00.00,141.99
22-Dec-2024,Cheque,00.00,28.40,113.59
22-Dec-2024,Transfer,"29,382.86",00.00,"29,496.45"
22-Dec-2024,ATM,00.00,"4,916.08","24,580.38"
22-Dec-2024,Bill,02.45,00.00,"24,582.83"
22-Dec-2024,Debit Card,08.00,00.00,"24,590.83"
22-Dec-2024,Miscellaneous,00.00,"24,590.83",00.00
22-Dec-2024,ATM,15.00,00.00,15.00
22-Dec-2024,NEFT,00.00,05.00,10.00
22-Dec-2024,Miscellaneous,25.04,00.00,35.04
22-Dec-2024,Miscellaneous,12.10,00.00,47.14
22-Dec-2024,Reversal,"1,341.00",00.00,"1,388.14"
22-Dec-2024,Reversal,00.00,277.63,"1,110.51"
22-Dec-2024,Miscellaneous,00.00,277.63,832.88
22-Dec-2024,NEFT,11.00,00.00,843.88
22-Dec-2024,Transfer,00.00,93.76,750.12
22-Dec-2024,ATM,00.00,75.01,675.11
22-Dec-2024,Tax,04.10,00.00,679.21
22-Dec-2024,Commission,00.00,339.61,339.60
22-Dec-2024,ATM,00.00,48.51,291.09
22-Dec-2024,Commission,00.00,97.03,194.06
22-Dec-2024,Cheque,00.00,38.81,155.25
22-Dec-2024,Interest,"2,507.39",00.00,"2,662.64"
22-Dec-2024,Debit Card,577.60,00.00,"3,240.24"
22-Dec-2024,Cheque,"11,348.60",00.00,"14,588.84"
22-Dec-2024,Reversal,"3,271.70",00.00,"17,860.54"
22-Dec-2024,IMPS,03.27,00.00,"17,863.81"
22-Dec-2024,Debit Card,00.00,"2,232.98","15,630.83"
22-Dec-2024,Cheque,00.00,"7,815.42","7,815.42"
22-Dec-2024,Bill,61.20,00.00,"7,876.62"
22-Dec-2024,Reversal,401.40,00.00,"8,278.02"
22-Dec-2024,Miscellaneous,"36,533.75",00.00,"44,811.77"
22-Dec-2024,Cheque,00.00,"6,401.68","38,410.09"
22-Dec-2024,IMPS,00.00,"7,682.02","30,728.07"
22-Dec-2024,Bill,00.00,"15,364.04","15,364.04"
22-Dec-2024,Commission,"332,633.00",00.00,"347,997.04"
22-Dec-2024,Bill,499.70,00.00,"348,496.74"
22-Dec-2024,Transfer,"2,900.77",00.00,"351,397.51"
22-Dec-2024,ATM,00.00,"87,849.38","263,548.13"
22-Dec-2024,NEFT,00.00,"26,354.81","237,193.32"
22-Dec-2024,Tax,00.00,"59,298.33","177,894.99"
22-Dec-2024,Debit Card,00.00,"177,894.99",00.00
22-Dec-2024,Transfer,"15,349.83",00.00,"15,349.83"
23-Dec-2024,Purchase,"1,553,295.00",00.00,"1,568,644.83"
23-Dec-2024,Purchase,00.00,"174,293.87","1,394,350.96"
23-Dec-2024,Miscellaneous,"3,303.00",00.00,"1,397,653.96"
23-Dec-2024,Commission,00.00,"698,826.98","698,826.98"
24-Dec-2024,Cheque,00.00,"698,826.98",00.00
24-Dec-2024,Interest,32.17,00.00,32.17
24-Dec-2024,RTGS,00.00,10.72,21.45
24-Dec-2024,Debit Card,00.00,02.15,19.30
24-Dec-2024,Miscellaneous,"1,059,397.00",00.00,"1,059,416.30"
24-Dec-2024,NEFT,00.00,"529,708.15","529,708.15"
24-Dec-2024,NEFT,00.00,"75,672.59","454,035.56"
24-Dec-2024,Reversal,00.00,"113,508.89","340,526.67"
24-Dec-2024,RTGS,314.00,00.00,"340,840.67"
24-Dec-2024,ATM,00.00,"42,605.08","298,235.59"
24-Dec-2024,Miscellaneous,00.00,"298,235.59",00.00
24-Dec-2024,Interest,04.00,00.00,04.00
24-Dec-2024,Commission,"24,413.90",00.00,"24,417.90"
24-Dec-2024,IMPS,"99,837.80",00.00,"124,255.70"
24-Dec-2024,NEFT,45.50,00.00,"124,301.20"
25-Dec-2024,Interest,00.00,"31,075.30","93,225.90"
25-Dec-2024,Debit Card,476.00,00.00,"93,701.90"
25-Dec-2024,Cash,00.00,"11,712.74","81,989.16"
25-Dec-2024,NEFT,"1,482,728.00",00.00,"1,564,717.16"
25-Dec-2024,Reversal,00.00,"173,857.46","1,390,859.70"
25-Dec-2024,IMPS,14.00,00.00,"1,390,873.70"
25-Dec-2024,Interest,00.00,"347,718.43","1,043,155.27"
25-Dec-2024,IMPS,63.00,00.00,"1,043,218.27"
25-Dec-2024,NEFT,00.00,"130,402.28","912,815.99"
25-Dec-2024,Tax,"207,471.50",00.00,"1,120,287.49"
25-Dec-2024,Commission,00.00,"373,429.16","746,858.33"
25-Dec-2024,Tax,41.00,00.00,"746,899.33"
25-Dec-2024,Miscellaneous,00.00,"149,379.87","597,519.46"
25-Dec-2024,Reversal,"19,116.88",00.00,"616,636.34"
25-Dec-2024,Purchase,00.00,"308,318.17","308,318.17"
25-Dec-2024,Cheque,04.00,00.00,"308,322.17"
25-Dec-2024,NEFT,"882,192.20",00.00,"1,190,514.37"
25-Dec-2024,Cheque,326.50,00.00,"1,190,840.87"
25-Dec-2024,Debit Card,103.50,00.00,"1,190,944.37"
25-Dec-2024,NEFT,00.00,"170,134.91","1,020,809.46"
25-Dec-2024,RTGS,"3,359.85",00.00,"1,024,169.31"
25-Dec-2024,Transfer,08.00,00.00,"1,024,177.31"
25-Dec-2024,Debit Card,"412,481.00",00.00,"1,436,658.31"
25-Dec-2024,Cash,05.38,00.00,"1,436,663.69"
25-Dec-2024,Cheque,"2,336.00",00.00,"1,438,999.69"
25-Dec-2024,Bill,03.70,00.00,"1,439,003.39"
25-Dec-2024,Cash,00.00,"287,800.68","1,151,202.71"
25-Dec-2024,Tax,00.00,"164,457.53","986,745.18"
25-Dec-2024,IMPS,05.10,00.00,"986,750.28"
25-Dec-2024,Purchase,00.00,"986,750.28",00.00
25-Dec-2024,NEFT,59.78,00.00,59.78
25-Dec-2024,Bill,"15,228.56",00.00,"15,288.34"
25-Dec-2024,Transfer,"18,001.00",00.00,"33,289.34"
25-Dec-2024,Tax,00.00,"3,698.82","29,590.52"
25-Dec-2024,Transfer,68.00,00.00,"29,658.52"
25-Dec-2024,Tax,00.00,"3,295.39","26,363.13"
25-Dec-2024,Purchase,00.00,"2,636.31","23,726.82"
25-Dec-2024,Bill,00.00,"2,636.31","21,090.51"
25-Dec-2024,Tax,00.00,"7,030.17","14,060.34"
25-Dec-2024,Miscellaneous,00.00,"2,343.39","11,716.95"
25-Dec-2024,Commission,00.00,"1,171.70","10,545.26"
25-Dec-2024,Debit Card,"113,674.50",00.00,"124,219.76"
25-Dec-2024,NEFT,00.00,"15,527.47","108,692.29"
25-Dec-2024,NEFT,00.00,"12,076.92","96,615.37"
25-Dec-2024,RTGS,"32,610.60",00.00,"129,225.97"
25-Dec-2024,Bill,"2,429.00",00.00,"131,654.97"
25-Dec-2024,Purchase,00.00,"65,827.49","65,827.48"
25-Dec-2024,Debit Card,00.00,"32,913.74","32,913.74"
25-Dec-2024,RTGS,406.00,00.00,"33,319.74"
25-Dec-2024,Reversal,00.00,"4,759.96","28,559.78"
25-Dec-2024,Debit Card,00.00,"28,559.78",00.00
25-Dec-2024,Reversal,"544,492.00",00.00,"544,492.00"
25-Dec-2024,Tax,20.30,00.00,"544,512.30"
25-Dec-2024,Debit Card,"221,503.00",00.00,"766,015.30"
25-Dec-2024,NEFT,00.00,"766,015.30",00.00
25-Dec-2024,ATM,"12,826.00",00.00,"12,826.00"
25-Dec-2024,Debit Card,"168,078.25",00.00,"180,904.25"
25-Dec-2024,Debit Card,00.00,"180,904.25",00.00
25-Dec-2024,RTGS,"260,685.00",00.00,"260,685.00"
25-Dec-2024,Reversal,00.00,"130,342.50","130,342.50"
25-Dec-2024,Miscellaneous,"174,862.16",00.00,"305,204.66"
25-Dec-2024,Transfer,"912,171.00",00.00,"1,217,375.66"
25-Dec-2024,Purchase,00.00,"202,895.94","1,014,479.72"
25-Dec-2024,ATM,00.00,"126,809.97","887,669.76"
25-Dec-2024,IMPS,00.00,"295,889.92","591,779.84"
25-Dec-2024,Cash,05.00,00.00,"591,784.84"
25-Dec-2024,Bill,00.00,"84,540.69","507,244.15"
25-Dec-2024,ATM,"178,771.00",00.00,"686,015.15"
25-Dec-2024,Cash,00.40,00.00,"686,015.55"
25-Dec-2024,IMPS,198.20,00.00,"686,213.75"
25-Dec-2024,Debit Card,00.00,"171,553.44","514,660.31"
25-Dec-2024,Purchase,"27,666.31",00.00,"542,326.62"
25-Dec-2024,Tax,"1,931,226.25",00.00,"2,473,552.87"
25-Dec-2024,Cash,"1,365,292.00",00.00,"3,838,844.87"
25-Dec-2024,Transfer,00.00,"548,406.41","3,290,438.46"
25-Dec-2024,Commission,"99,909.70",00.00,"3,390,348.16"
26-Dec-2024,IMPS,00.00,"423,793.52","2,966,554.64"
26-Dec-2024,Purchase,00.00,"593,310.93","2,373,243.71"
26-Dec-2024,IMPS,00.00,"395,540.62","1,977,703.09"
26-Dec-2024,Miscellaneous,00.00,"329,617.18","1,648,085.91"
26-Dec-2024,Cheque,"2,091,840.25",00.00,"3,739,926.16"
26-Dec-2024,Debit Card,00.00,"934,981.54","2,804,944.62"
27-Dec-2024,RTGS,04.00,00.00,"2,804,948.62"
27-Dec-2024,Transfer,00.00,"280,494.86","2,524,453.76"
27-Dec-2024,IMPS,00.00,"841,484.59","1,682,969.17"
27-Dec-2024,Debit Card,00.00,"210,371.15","1,472,598.02"
27-Dec-2024,Cash,00.00,"245,433.00","1,227,165.02"
27-Dec-2024,IMPS,00.00,"204,527.50","1,022,637.52"
27-Dec-2024,Reversal,00.00,"146,091.07","876,546.45"
27-Dec-2024,Commission,00.00,"146,091.08","730,455.38"
27-Dec-2024,Transfer,00.00,"243,485.13","486,970.25"
27-Dec-2024,IMPS,00.00,"97,394.05","389,576.20"
27-Dec-2024,NEFT,"661,001.20",00.00,"1,050,577.40"
27-Dec-2024,Transfer,00.00,"175,096.23","875,481.17"
27-Dec-2024,Transfer,00.00,"97,275.69","778,205.48"
27-Dec-2024,Reversal,00.00,"129,700.91","648,504.57"
27-Dec-2024,Cash,00.00,"324,252.29","324,252.28"
27-Dec-2024,Miscellaneous,00.00,"162,126.14","162,126.14"
27-Dec-2024,Reversal,00.00,"81,063.07","81,063.07"
27-Dec-2024,Tax,"248,062.00",00.00,"329,125.07"
27-Dec-2024,Debit Card,00.00,"32,912.51","296,212.56"
27-Dec-2024,IMPS,27.00,00.00,"296,239.56"
27-Dec-2024,Transfer,"1,601.70",00.00,"297,841.26"
27-Dec-2024,Miscellaneous,"1,889.50",00.00,"299,730.76"
27-Dec-2024,RTGS,124.30,00.00,"299,855.06"
27-Dec-2024,ATM,"406,020.00",00.00,"705,875.06"
27-Dec-2024,Bill,"134,914.00",00.00,"840,789.06"
27-Dec-2024,Miscellaneous,00.00,"840,789.06",00.00
27-Dec-2024,NEFT,"1,004,501.20",00.00,"1,004,501.20"
27-Dec-2024,IMPS,00.00,"1,004,501.20",00.00
27-Dec-2024,Bill,"243,011.00",00.00,"243,011.00"
27-Dec-2024,ATM,"113,144.06",00.00,"356,155.06"
27-Dec-2024,Miscellaneous,00.00,"44,519.38","311,635.68"
27-Dec-2024,Tax,104.00,00.00,"311,739.68"
27-Dec-2024,Miscellaneous,00.00,"155,869.84","155,869.84"
27-Dec-2024,RTGS,00.00,"31,173.97","124,695.87"
27-Dec-2024,IMPS,22.00,00.00,"124,717.87"
27-Dec-2024,Interest,00.00,"17,816.84","106,901.03"
27-Dec-2024,Debit Card,00.00,"26,725.26","80,175.77"
27-Dec-2024,Tax,00.00,"10,021.97","70,153.80"
27-Dec-2024,Transfer,00.00,"7,015.38","63,138.42"
27-Dec-2024,RTGS,00.00,"7,015.38","56,123.04"
27-Dec-2024,Reversal,"2,037,916.00",00.00,"2,094,039.04"
27-Dec-2024,Commission,00.00,"1,047,019.52","1,047,019.52"
27-Dec-2024,Cheque,167.70,00.00,"1,047,187.22"
27-Dec-2024,IMPS,00.00,"261,796.81","785,390.42"
27-Dec-2024,IMPS,"212,490.00",00.00,"997,880.42"
27-Dec-2024,Cash,586.50,00.00,"998,466.92"
27-Dec-2024,Debit Card,00.00,"998,466.92",00.00
27-Dec-2024,Debit Card,"3,965.90",00.00,"3,965.90"
27-Dec-2024,Interest,01.00,00.00,"3,966.90"
27-Dec-2024,Interest,00.00,991.73,"2,975.18"
27-Dec-2024,Purchase,00.00,595.04,"2,380.14"
27-Dec-2024,ATM,00.00,340.02,"2,040.12"
27-Dec-2024,Miscellaneous,01.00,00.00,"2,041.12"
27-Dec-2024,Commission,22.10,00.00,"2,063.22"
27-Dec-2024,Transfer,00.00,257.90,"1,805.32"
27-Dec-2024,IMPS,00.00,200.59,"1,604.73"
27-Dec-2024,Miscellaneous,00.00,534.91,"1,069.82"
27-Dec-2024,Cash,00.00,152.83,916.99
27-Dec-2024,Debit Card,00.00,91.70,825.29
27-Dec-2024,Commission,00.00,137.55,687.74
27-Dec-2024,ATM,05.00,00.00,692.74
27-Dec-2024,Tax,00.00,115.46,577.28
27-Dec-2024,Tax,07.00,00.00,584.28
27-Dec-2024,Debit Card,00.00,73.04,511.24
27-Dec-2024,NEFT,"3,310.09",00.00,"3,821.33"
27-Dec-2024,Miscellaneous,"17,963.80",00.00,"21,785.13"
27-Dec-2024,IMPS,00.00,"5,446.28","16,338.85"
27-Dec-2024,Tax,"7,344.00",00.00,"23,682.85"
27-Dec-2024,Cash,"1,346.00",00.00,"25,028.85"
27-Dec-2024,Commission,"254,253.80",00.00,"279,282.65"
27-Dec-2024,ATM,375.00,00.00,"279,657.65"
27-Dec-2024,Interest,00.00,"46,609.61","233,048.04"
27-Dec-2024,Commission,"1,832,884.00",00.00,"2,065,932.04"
27-Dec-2024,Transfer,00.00,"1,032,966.02","1,032,966.02"
27-Dec-2024,Cheque,00.00,"206,593.20","826,372.82"
27-Dec-2024,Tax,00.00,"275,457.61","550,915.21"
27-Dec-2024,NEFT,00.53,00.00,"550,915.74"
27-Dec-2024,RTGS,00.00,"137,728.94","413,186.80"
27-Dec-2024,Debit Card,36.90,00.00,"413,223.70"
27-Dec-2024,Tax,484.90,00.00,"413,708.60"
27-Dec-2024,Interest,319.36,00.00,"414,027.96"
27-Dec-2024,NEFT,00.00,"51,753.50","362,274.46"
27-Dec-2024,IMPS,"56,796.00",00.00,"419,070.46"
27-Dec-2024,Reversal,00.00,"41,907.05","377,163.41"
27-Dec-2024,Tax,03.50,00.00,"377,166.91"
27-Dec-2024,Transfer,00.00,"62,861.15","314,305.76"
27-Dec-2024,Debit Card,"19,124.30",00.00,"333,430.06"
27-Dec-2024,Purchase,00.00,"111,143.35","222,286.71"
28-Dec-2024,Tax,"1,062,463.75",00.00,"1,284,750.46"
28-Dec-2024,Miscellaneous,00.00,"160,593.81","1,124,156.65"
28-Dec-2024,Purchase,00.00,"112,415.67","1,011,740.98"
28-Dec-2024,Tax,"3,147.31",00.00,"1,014,888.29"
28-Dec-2024,Interest,"22,902.00",00.00,"1,037,790.29"
28-Dec-2024,Cheque,00.00,"172,965.05","864,825.24"
28-Dec-2024,Debit Card,00.00,"432,412.62","432,412.62"
28-Dec-2024,Cash,00.00,"48,045.85","384,366.77"
28-Dec-2024,NEFT,00.00,"128,122.26","256,244.51"
28-Dec-2024,ATM,00.00,"25,624.45","230,620.06"
28-Dec-2024,Debit Card,00.00,"230,620.06",00.00
28-Dec-2024,Tax,51.30,00.00,51.30
28-Dec-2024,Reversal,06.90,00.00,58.20
28-Dec-2024,Tax,06.00,00.00,64.20
28-Dec-2024,IMPS,00.00,07.13,57.07
28-Dec-2024,Purchase,00.00,14.27,42.80
29-Dec-2024,Purchase,00.00,05.35,37.45
29-Dec-2024,Bill,"54,748.20",00.00,"54,785.65"
29-Dec-2024,Cheque,00.00,"10,957.13","43,828.52"
29-Dec-2024,Interest,00.00,"10,957.13","32,871.39"
29-Dec-2024,Tax,"63,504.00",00.00,"96,375.39"
29-Dec-2024,Reversal,00.00,"9,637.54","86,737.85"
29-Dec-2024,ATM,05.00,00.00,"86,742.85"
29-Dec-2024,IMPS,00.00,"9,638.09","77,104.76"
29-Dec-2024,Commission,"411,345.80",00.00,"488,450.56"
29-Dec-2024,Transfer,06.80,00.00,"488,457.36"
29-Dec-2024,IMPS,"85,623.20",00.00,"574,080.56"
29-Dec-2024,Miscellaneous,00.00,"57,408.06","516,672.50"
29-Dec-2024,Cheque,474.00,00.00,"517,146.50"
29-Dec-2024,Debit Card,00.00,"73,878.07","443,268.43"
29-Dec-2024,RTGS,00.00,"443,268.43",00.00
29-Dec-2024,Purchase,"571,532.00",00.00,"571,532.00"
30-Dec-2024,Purchase,00.00,"285,766.00","285,766.00"
30-Dec-2024,Cash,"1,327.80",00.00,"287,093.80"
30-Dec-2024,NEFT,00.00,"143,546.90","143,546.90"
30-Dec-2024,Tax,23.32,00.00,"143,570.22"
30-Dec-2024,Debit Card,118.80,00.00,"143,689.02"
30-Dec-2024,ATM,"76,441.06",00.00,"220,130.08"
30-Dec-2024,Transfer,00.00,"110,065.04","110,065.04"
30-Dec-2024,ATM,"396,802.00",00.00,"506,867.04"
30-Dec-2024,Purchase,00.00,"253,433.52","253,433.52"
30-Dec-2024,Transfer,03.00,00.00,"253,436.52"
30-Dec-2024,RTGS,00.00,"84,478.84","168,957.68"
30-Dec-2024,Purchase,00.00,"24,136.81","144,820.87"
30-Dec-2024,NEFT,03.89,00.00,"144,824.76"
30-Dec-2024,Reversal,00.00,"144,824.76",00.00
30-Dec-2024,Cheque,479.72,00.00,479.72
30-Dec-2024,RTGS,948.98,00.00,"1,428.70"
30-Dec-2024,Commission,"67,004.50",00.00,"68,433.20"
30-Dec-2024,Purchase,00.00,"6,843.32","61,589.88"
30-Dec-2024,Commission,03.20,00.00,"61,593.08"
30-Dec-2024,IMPS,00.00,"30,796.54","30,796.54"
30-Dec-2024,ATM,"1,074.29",00.00,"31,870.83"
30-Dec-2024,IMPS,"2,235.00",00.00,"34,105.83"
30-Dec-2024,Cheque,00.00,"3,789.54","30,316.29"
30-Dec-2024,Reversal,"83,342.00",00.00,"113,658.29"
30-Dec-2024,Bill,"2,656.00",00.00,"116,314.29"
30-Dec-2024,Bill,22.00,00.00,"116,336.29"
30-Dec-2024,ATM,"2,731.00",00.00,"119,067.29"
30-Dec-2024,NEFT,00.00,"29,766.82","89,300.47"
30-Dec-2024,Interest,00.00,"22,325.12","66,975.35"
30-Dec-2024,Cheque,"174,985.31",00.00,"241,960.66"
30-Dec-2024,Commission,"15,899.29",00.00,"257,859.95"
30-Dec-2024,Debit Card,05.00,00.00,"257,864.95"
31-Dec-2024,Cash,00.00,"32,233.12","225,631.83"
31-Dec-2024,Cash,506.90,00.00,"226,138.73"
31-Dec-2024,Debit Card,162.60,00.00,"226,301.33"
31-Dec-2024,Bill,00.00,"113,150.67","113,150.66"
31-Dec-2024,Transfer,00.00,"11,315.07","101,835.59"
31-Dec-2024,Interest,"2,088.60",00.00,"103,924.19"
31-Dec-2024,Cheque,"3,142.11",00.00,"107,066.30"
31-Dec-2024,ATM,00.00,"17,844.38","89,221.92"
31-Dec-2024,Transfer,00.00,"22,305.48","66,916.44"
31-Dec-2024,Debit Card,"2,551.50",00.00,"69,467.94"
31-Dec-2024,Debit Card,00.00,"11,577.99","57,889.95"
31-Dec-2024,Transfer,00.00,"11,577.99","46,311.96"
31-Dec-2024,Cash,"55,869.00",00.00,"102,180.96"
31-Dec-2024,ATM,"898,166.50",00.00,"1,000,347.46"
31-Dec-2024,ATM,06.60,00.00,"1,000,354.06"
31-Dec-2024,IMPS,00.00,"125,044.26","875,309.80"
31-Dec-2024,Cash,15.00,00.00,"875,324.80"
31-Dec-2024,Cash,00.00,"291,774.93","583,549.87"
31-Dec-2024,Transfer,"41,473.25",00.00,"625,023.12"
31-Dec-2024,NEFT,00.00,"104,170.52","520,852.60"
31-Dec-2024,Bill,00.00,"57,872.51","462,980.09"
31-Dec-2024,Tax,14.39,00.00,"462,994.48"
31-Dec-2024,Purchase,00.00,"462,994.48",00.00
31-Dec-2024,Transfer,"440,134.00",00.00,"440,134.00"
31-Dec-2024,Reversal,00.00,"55,016.75","385,117.25"
31-Dec-2024,Miscellaneous,00.00,"385,117.25",00.00
31-Dec-2024,Commission,54.04,00.00,54.04
31-Dec-2024,Purchase,00.00,54.04,00.00
31-Dec-2024,RTGS,"148,542.59",00.00,"148,542.59"
31-Dec-2024,Purchase,"5,403.00",00.00,"153,945.59"
31-Dec-2024,Reversal,00.00,"153,945.59",00.00
31-Dec-2024,Transfer,"9,032.00",00.00,"9,032.00"
31-Dec-2024,Reversal,"1,024.00",00.00,"10,056.00"
31-Dec-2024,Commission,00.00,"1,676.00","8,380.00"
31-Dec-2024,Reversal,"8,207.20",00.00,"16,587.20"
31-Dec-2024,ATM,52.00,00.00,"16,639.20"
31-Dec-2024,Debit Card,272.40,00.00,"16,911.60"
31-Dec-2024,RTGS,"247,471.06",00.00,"264,382.66"
31-Dec-2024,Debit Card,06.00,00.00,"264,388.66"
31-Dec-2024,ATM,00.00,"37,769.81","226,618.85"
31-Dec-2024,NEFT,00.00,"45,323.77","181,295.08"
31-Dec-2024,IMPS,00.00,"36,259.02","145,036.06"
31-Dec-2024,Commission,"3,070.23",00.00,"148,106.29"
31-Dec-2024,Commission,00.00,"18,513.29","129,593.00"
31-Dec-2024,Transfer,00.00,"129,593.00",00.00
31-Dec-2024,Cash,"1,512,142.00",00.00,"1,512,142.00"
31-Dec-2024,RTGS,00.00,"504,047.33","1,008,094.67"
31-Dec-2024,Reversal,00.00,"126,011.83","882,082.84"
31-Dec-2024,Transfer,26.03,00.00,"882,108.87"
31-Dec-2024,Transfer,"1,538,282.00",00.00,"2,420,390.87"
31-Dec-2024,Cash,00.00,"1,210,195.44","1,210,195.44"
31-Dec-2024,ATM,00.00,"403,398.48","806,796.96"
31-Dec-2024,Tax,00.00,"115,256.71","691,540.25"
31-Dec-2024,Purchase,00.00,"345,770.13","345,770.12"
31-Dec-2024,IMPS,00.00,"34,577.01","311,193.11"
31-Dec-2024,Purchase,02.00,00.00,"311,195.11"
31-Dec-2024,IMPS,"403,993.75",00.00,"715,188.86"
31-Dec-2024,Tax,05.00,00.00,"715,193.86"
31-Dec-2024,Interest,00.00,"178,798.47","536,395.40"
31-Dec-2024,Purchase,00.00,"67,049.43","469,345.98"
31-Dec-2024,Cheque,114.00,00.00,"469,459.98"
31-Dec-2024,NEFT,"3,852.50",00.00,"473,312.48"
31-Dec-2024,RTGS,00.00,"94,662.50","378,649.98"
31-Dec-2024,Miscellaneous,00.00,"126,216.66","252,433.32"
31-Dec-2024,Commission,"9,802.00",00.00,"262,235.32"
31-Dec-2024,NEFT,"1,443,221.50",00.00,"1,705,456.82"
31-Dec-2024,Debit Card,00.00,"243,636.69","1,461,820.13"
31-Dec-2024,Debit Card,00.00,"730,910.07","730,910.06"
31-Dec-2024,IMPS,00.00,"91,363.76","639,546.30"
01-Jan-2025,ATM,00.00,"159,886.58","479,659.72"
01-Jan-2025,Commission,00.00,"59,957.47","419,702.26"
01-Jan-2025,Miscellaneous,"1,189.00",00.00,"420,891.26"
01-Jan-2025,ATM,00.00,"84,178.25","336,713.01"
01-Jan-2025,NEFT,"2,268.80",00.00,"338,981.81"
01-Jan-2025,NEFT,"2,708.00",00.00,"341,689.81"
01-Jan-2025,Tax,00.00,"68,337.96","273,351.85"
01-Jan-2025,Commission,00.00,"34,168.98","239,182.87"
01-Jan-2025,IMPS,00.00,"34,168.98","205,013.89"
01-Jan-2025,Bill,"29,397.00",00.00,"234,410.89"
01-Jan-2025,Reversal,483.28,00.00,"234,894.17"
01-Jan-2025,RTGS,00.00,"39,149.03","195,745.14"
01-Jan-2025,Cheque,01.90,00.00,"195,747.04"
01-Jan-2025,Commission,"107,825.25",00.00,"303,572.29"
01-Jan-2025,Miscellaneous,"3,901.00",00.00,"307,473.29"
01-Jan-2025,Debit Card,"17,667.00",00.00,"325,140.29"
01-Jan-2025,Interest,04.00,00.00,"325,144.29"
01-Jan-2025,ATM,00.00,"108,381.43","216,762.86"
01-Jan-2025,ATM,"328,950.00",00.00,"545,712.86"
01-Jan-2025,Reversal,00.00,"68,214.11","477,498.75"
01-Jan-2025,Purchase,494.00,00.00,"477,992.75"
01-Jan-2025,Reversal,55.00,00.00,"478,047.75"
01-Jan-2025,Transfer,"377,249.00",00.00,"855,296.75"
01-Jan-2025,NEFT,00.00,"427,648.38","427,648.38"
01-Jan-2025,Miscellaneous,"1,561,426.50",00.00,"1,989,074.88"
01-Jan-2025,IMPS,00.00,"331,512.48","1,657,562.40"
01-Jan-2025,Tax,06.00,00.00,"1,657,568.40"
01-Jan-2025,Miscellaneous,05.00,00.00,"1,657,573.40"
01-Jan-2025,Tax,02.00,00.00,"1,657,575.40"
01-Jan-2025,Commission,00.00,"414,393.85","1,243,181.55"
01-Jan-2025,NEFT,"30,719.40",00.00,"1,273,900.95"
01-Jan-2025,NEFT,00.00,"254,780.19","1,019,120.76"
01-Jan-2025,Bill,29.40,00.00,"1,019,150.16"
01-Jan-2025,Transfer,05.00,00.00,"1,019,155.16"
01-Jan-2025,ATM,00.00,"509,577.58","509,577.58"
02-Jan-2025,RTGS,"226,391.70",00.00,"735,969.28"
02-Jan-2025,Interest,00.00,"91,996.16","643,973.12"
02-Jan-2025,ATM,00.00,"64,397.31","579,575.81"
02-Jan-2025,Cash,00.00,"193,191.94","386,383.87"
02-Jan-2025,Purchase,00.00,"38,638.39","347,745.48"
02-Jan-2025,Purchase,00.00,"347,745.48",00.00
02-Jan-2025,IMPS,04.70,00.00,04.70
02-Jan-2025,Cheque,00.00,04.70,00.00
02-Jan-2025,Cash,"686,659.75",00.00,"686,659.75"
02-Jan-2025,Cash,00.00,"137,331.95","549,327.80"
02-Jan-2025,Reversal,00.00,"78,475.40","470,852.40"
03-Jan-2025,Debit Card,"121,848.40",00.00,"592,700.80"
03-Jan-2025,Interest,00.00,"197,566.93","395,133.87"
03-Jan-2025,Cheque,83.70,00.00,"395,217.57"
03-Jan-2025,Commission,00.00,"43,913.06","351,304.51"
03-Jan-2025,Interest,45.60,00.00,"351,350.11"
03-Jan-2025,Cheque,131.27,00.00,"351,481.38"
03-Jan-2025,IMPS,00.00,"43,935.17","307,546.21"
03-Jan-2025,Miscellaneous,"394,351.25",00.00,"701,897.46"
03-Jan-2025,Tax,00.60,00.00,"701,898.06"
03-Jan-2025,Interest,00.00,"70,189.81","631,708.25"
03-Jan-2025,RTGS,"85,685.31",00.00,"717,393.56"
03-Jan-2025,ATM,00.00,"717,393.56",00.00
03-Jan-2025,Miscellaneous,124.00,00.00,124.00
03-Jan-2025,Transfer,408.00,00.00,532.00
03-Jan-2025,Bill,"1,834,054.00",00.00,"1,834,586.00"
03-Jan-2025,Bill,00.00,"183,458.60","1,651,127.40"
03-Jan-2025,IMPS,00.00,"183,458.60","1,467,668.80"
03-Jan-2025,Tax,00.00,"366,917.20","1,100,751.60"
03-Jan-2025,RTGS,"10,832.06",00.00,"1,111,583.66"
03-Jan-2025,IMPS,"20,179.00",00.00,"1,131,762.66"
03-Jan-2025,Tax,00.00,"1,131,762.66",00.00
03-Jan-2025,Reversal,"2,280.00",00.00,"2,280.00"
03-Jan-2025,Purchase,00.00,285.00,"1,995.00"
03-Jan-2025,RTGS,"134,887.00",00.00,"136,882.00"
03-Jan-2025,Interest,00.00,"13,688.20","123,193.80"
03-Jan-2025,Transfer,"19,881.00",00.00,"143,074.80"
04-Jan-2025,Miscellaneous,"1,088,982.50",00.00,"1,232,057.30"
04-Jan-2025,RTGS,00.00,"1,232,057.30",00.00
04-Jan-2025,ATM,59.00,00.00,59.00
04-Jan-2025,Interest,00.00,09.83,49.17
04-Jan-2025,Tax,14.84,00.00,64.01
04-Jan-2025,RTGS,00.00,10.67,53.34
04-Jan-2025,Tax,00.00,08.89,44.45
04-Jan-2025,ATM,00.00,08.89,35.56
04-Jan-2025,Debit Card,"11,998.70",00.00,"12,034.26"
04-Jan-2025,Cheque,00.00,"3,008.57","9,025.70"
04-Jan-2025,Miscellaneous,"21,450.59",00.00,"30,476.29"
04-Jan-2025,Commission,"1,466.70",00.00,"31,942.99"
05-Jan-2025,Commission,00.00,"4,563.28","27,379.71"
05-Jan-2025,Bill,"2,384.10",00.00,"29,763.81"
05-Jan-2025,IMPS,12.00,00.00,"29,775.81"
05-Jan-2025,IMPS,00.00,"4,962.64","24,813.18"
05-Jan-2025,RTGS,00.00,"4,962.64","19,850.54"
05-Jan-2025,Commission,"180,153.28",00.00,"200,003.82"
05-Jan-2025,Bill,00.00,"40,000.76","160,003.06"
05-Jan-2025,Interest,00.00,"40,000.77","120,002.30"
05-Jan-2025,Miscellaneous,25.70,00.00,"120,028.00"
05-Jan-2025,ATM,"1,533.10",00.00,"121,561.10"
05-Jan-2025,Transfer,00.00,"15,195.14","106,365.96"
05-Jan-2025,Cash,"17,091.34",00.00,"123,457.30"
05-Jan-2025,Purchase,00.00,"13,717.48","109,739.82"
05-Jan-2025,Bill,00.00,"12,193.31","97,546.51"
05-Jan-2025,ATM,48.00,00.00,"97,594.51"
05-Jan-2025,Debit Card,00.00,"32,531.50","65,063.01"
05-Jan-2025,Cash,"8,918.80",00.00,"73,981.81"
05-Jan-2025,Commission,00.00,"7,398.18","66,583.63"
05-Jan-2025,IMPS,102.30,00.00,"66,685.93"
05-Jan-2025,Reversal,00.00,"16,671.48","50,014.45"
05-Jan-2025,NEFT,"30,321.00",00.00,"80,335.45"
05-Jan-2025,Interest,"87,830.00",00.00,"168,165.45"
05-Jan-2025,Transfer,851.52,00.00,"169,016.97"
05-Jan-2025,Cheque,00.00,"169,016.97",00.00
05-Jan-2025,Interest,"59,081.20",00.00,"59,081.20"
05-Jan-2025,NEFT,00.00,"9,846.87","49,234.33"
05-Jan-2025,ATM,00.00,"5,470.48","43,763.85"
05-Jan-2025,Cash,00.00,"4,862.65","38,901.20"
05-Jan-2025,Reversal,155.00,00.00,"39,056.20"
05-Jan-2025,Bill,39.00,00.00,"39,095.20"
05-Jan-2025,Cash,00.00,"4,886.90","34,208.30"
05-Jan-2025,Commission,06.70,00.00,"34,215.00"
05-Jan-2025,Tax,00.00,"6,843.00","27,372.00"
05-Jan-2025,Interest,00.00,"9,124.00","18,248.00"
05-Jan-2025,Tax,02.40,00.00,"18,250.40"
05-Jan-2025,Interest,"152,845.60",00.00,"171,096.00"
05-Jan-2025,Interest,"27,081.41",00.00,"198,177.41"
05-Jan-2025,Miscellaneous,02.00,00.00,"198,179.41"
06-Jan-2025,NEFT,258.70,00.00,"198,438.11"
06-Jan-2025,Reversal,00.00,"99,219.06","99,219.06"
06-Jan-2025,IMPS,00.00,"16,536.51","82,682.55"
06-Jan-2025,Cash,00.00,"27,560.85","55,121.70"
06-Jan-2025,Debit Card,00.00,"18,373.90","36,747.80"
06-Jan-2025,ATM,"124,870.30",00.00,"161,618.10"
06-Jan-2025,Purchase,"2,465.59",00.00,"164,083.69"
06-Jan-2025,Bill,00.00,"20,510.46","143,573.23"
06-Jan-2025,RTGS,"245,437.00",00.00,"389,010.23"
06-Jan-2025,Transfer,00.00,"48,626.28","340,383.95"
06-Jan-2025,Transfer,00.00,"170,191.98","170,191.98"
06-Jan-2025,Reversal,00.00,"170,191.98",00.00
06-Jan-2025,Debit Card,53.00,00.00,53.00
06-Jan-2025,Transfer,00.00,05.89,47.11
06-Jan-2025,Debit Card,63.02,00.00,110.13
06-Jan-2025,Reversal,00.00,36.71,73.42
06-Jan-2025,ATM,00.00,10.49,62.93
06-Jan-2025,ATM,25.68,00.00,88.61
06-Jan-2025,ATM,00.00,29.54,59.07
06-Jan-2025,Cheque,"15,918.30",00.00,"15,977.37"
06-Jan-2025,Purchase,"1,088.65",00.00,"17,066.02"
06-Jan-2025,Miscellaneous,00.00,"3,413.20","13,652.82"
06-Jan-2025,Reversal,37.00,00.00,"13,689.82"
06-Jan-2025,ATM,00.00,"3,422.46","10,267.36"
06-Jan-2025,Cheque,45.00,00.00,"10,312.36"
06-Jan-2025,Interest,00.00,"2,062.47","8,249.89"
06-Jan-2025,Interest,"1,163.00",00.00,"9,412.89"
06-Jan-2025,Transfer,00.00,"1,882.58","7,530.31"
06-Jan-2025,Purchase,00.00,"3,765.16","3,765.16"
06-Jan-2025,Interest,55.00,00.00,"3,820.16"
06-Jan-2025,Transfer,00.00,"1,273.39","2,546.77"
06-Jan-2025,NEFT,00.00,636.69,"1,910.08"
07-Jan-2025,Interest,"32,746.00",00.00,"34,656.08"
07-Jan-2025,Debit Card,"641,559.75",00.00,"676,215.83"
07-Jan-2025,Bill,00.00,"676,215.83",00.00
07-Jan-2025,Miscellaneous,"97,452.00",00.00,"97,452.00"
07-Jan-2025,IMPS,"448,311.00",00.00,"545,763.00"
07-Jan-2025,Tax,00.00,"181,921.00","363,842.00"
07-Jan-2025,ATM,00.65,00.00,"363,842.65"
07-Jan-2025,Cheque,220.65,00.00,"364,063.30"
07-Jan-2025,ATM,"795,842.00",00.00,"1,159,905.30"
07-Jan-2025,ATM,00.00,"165,700.76","994,204.54"
07-Jan-2025,ATM,00.39,00.00,"994,204.93"
07-Jan-2025,Purchase,39.70,00.00,"994,244.63"
07-Jan-2025,Tax,00.00,"165,707.44","828,537.19"
07-Jan-2025,Cheque,00.00,"828,537.19",00.00
07-Jan-2025,RTGS,28.63,00.00,28.63
07-Jan-2025,Tax,"150,536.78",00.00,"150,565.41"
07-Jan-2025,Tax,"4,419.00",00.00,"154,984.41"
07-Jan-2025,Reversal,00.00,"30,996.88","123,987.53"
07-Jan-2025,Miscellaneous,00.00,"12,398.75","111,588.78"
07-Jan-2025,Bill,"10,537.25",00.00,"122,126.03"
07-Jan-2025,Cash,00.00,"24,425.21","97,700.82"
07-Jan-2025,Bill,"1,516,886.75",00.00,"1,614,587.57"
07-Jan-2025,Miscellaneous,00.00,"161,458.76","1,453,128.81"
07-Jan-2025,Tax,00.00,"484,376.27","968,752.54"
07-Jan-2025,Bill,"647,982.00",00.00,"1,616,734.54"
07-Jan-2025,RTGS,00.00,"161,673.45","1,455,061.09"
07-Jan-2025,Interest,00.94,00.00,"1,455,062.03"
07-Jan-2025,Debit Card,"17,611.20",00.00,"1,472,673.23"
07-Jan-2025,Purchase,00.00,"294,534.65","1,178,138.58"
07-Jan-2025,Debit Card,00.00,"589,069.29","589,069.29"
07-Jan-2025,Transfer,00.00,"117,813.86","471,255.43"
07-Jan-2025,Tax,"250,226.00",00.00,"721,481.43"
07-Jan-2025,Commission,00.00,"721,481.43",00.00
08-Jan-2025,Cash,"133,542.00",00.00,"133,542.00"
08-Jan-2025,Purchase,"23,334.60",00.00,"156,876.60"
08-Jan-2025,Bill,00.00,"31,375.32","125,501.28"
08-Jan-2025,Purchase,00.00,"31,375.32","94,125.96"
08-Jan-2025,Interest,144.40,00.00,"94,270.36"
08-Jan-2025,IMPS,00.00,"94,270.36",00.00
08-Jan-2025,Tax,"1,499,384.20",00.00,"1,499,384.20"
08-Jan-2025,Debit Card,00.00,"166,598.24","1,332,785.96"
08-Jan-2025,Purchase,"3,594.00",00.00,"1,336,379.96"
08-Jan-2025,Tax,"1,628,604.00",00.00,"2,964,983.96"
08-Jan-2025,RTGS,"11,222.43",00.00,"2,976,206.39"
08-Jan-2025,Reversal,00.00,"1,488,103.20","1,488,103.20"
08-Jan-2025,Reversal,00.00,"248,017.20","1,240,086.00"
08-Jan-2025,Miscellaneous,00.00,"1,240,086.00",00.00
08-Jan-2025,Reversal,"2,544.43",00.00,"2,544.43"
08-Jan-2025,Transfer,"573,840.00",00.00,"576,384.43"
08-Jan-2025,Reversal,00.00,"57,638.44","518,745.99"
08-Jan-2025,Tax,772.16,00.00,"519,518.15"
08-Jan-2025,Purchase,56.90,00.00,"519,575.05"
08-Jan-2025,Purchase,00.00,"259,787.53","259,787.52"
08-Jan-2025,ATM,00.00,"43,297.92","216,489.60"
08-Jan-2025,Reversal,644.50,00.00,"217,134.10"
08-Jan-2025,Tax,30.70,00.00,"217,164.80"
08-Jan-2025,Interest,"9,912.10",00.00,"227,076.90"
08-Jan-2025,Bill,"2,087.00",00.00,"229,163.90"
08-Jan-2025,IMPS,00.00,"114,581.95","114,581.95"
08-Jan-2025,Transfer,00.00,"57,290.98","57,290.98"
08-Jan-2025,Purchase,00.00,"5,729.10","51,561.88"
08-Jan-2025,Purchase,"20,054.59",00.00,"71,616.47"
08-Jan-2025,Purchase,10.00,00.00,"71,626.47"
09-Jan-2025,Commission,00.00,"10,232.35","61,394.12"
09-Jan-2025,Debit Card,"23,583.50",00.00,"84,977.62"
10-Jan-2025,IMPS,33.90,00.00,"85,011.52"
10-Jan-2025,Interest,"475,390.00",00.00,"560,401.52"
10-Jan-2025,Cheque,"10,690.21",00.00,"571,091.73"
10-Jan-2025,IMPS,00.00,"142,772.93","428,318.80"
10-Jan-2025,Cheque,00.00,"214,159.40","214,159.40"
10-Jan-2025,Interest,"6,113.00",00.00,"220,272.40"
10-Jan-2025,ATM,"696,208.25",00.00,"916,480.65"
10-Jan-2025,Debit Card,00.00,"916,480.65",00.00
10-Jan-2025,Interest,"198,990.00",00.00,"198,990.00"
11-Jan-2025,Debit Card,00.00,"198,990.00",00.00
11-Jan-2025,Cash,07.93,00.00,07.93
11-Jan-2025,Cash,00.00,01.98,05.95
11-Jan-2025,Debit Card,"404,672.80",00.00,"404,678.75"
11-Jan-2025,NEFT,"1,222,030.50",00.00,"1,626,709.25"
11-Jan-2025,Debit Card,"6,181.85",00.00,"1,632,891.10"
11-Jan-2025,Transfer,"226,125.00",00.00,"1,859,016.10"
11-Jan-2025,Miscellaneous,00.00,"232,377.01","1,626,639.09"
11-Jan-2025,Debit Card,"2,745.80",00.00,"1,629,384.89"
11-Jan-2025,Interest,"29,041.00",00.00,"1,658,425.89"
12-Jan-2025,Tax,"55,642.38",00.00,"1,714,068.27"
12-Jan-2025,Cash,00.00,"244,866.90","1,469,201.37"
12-Jan-2025,IMPS,00.00,"146,920.14","1,322,281.23"
12-Jan-2025,Miscellaneous,00.00,"188,897.32","1,133,383.91"
12-Jan-2025,NEFT,00.00,"226,676.78","906,707.13"
12-Jan-2025,Cheque,"1,184,473.80",00.00,"2,091,180.93"
12-Jan-2025,Cash,02.00,00.00,"2,091,182.93"
12-Jan-2025,NEFT,00.00,"2,091,182.93",00.00
12-Jan-2025,NEFT,"1,099,913.00",00.00,"1,099,913.00"
12-Jan-2025,Commission,"2,136.40",00.00,"1,102,049.40"
12-Jan-2025,Cash,10.59,00.00,"1,102,059.99"
12-Jan-2025,Cash,02.00,00.00,"1,102,061.99"
12-Jan-2025,Purchase,00.00,"110,206.20","991,855.79"
12-Jan-2025,Tax,00.00,"495,927.90","495,927.90"
12-Jan-2025,Debit Card,23.25,00.00,"495,951.15"
12-Jan-2025,ATM,339.13,00.00,"496,290.28"
12-Jan-2025,Purchase,286.37,00.00,"496,576.65"
12-Jan-2025,Cash,00.00,"62,072.08","434,504.57"
12-Jan-2025,Transfer,00.00,"108,626.14","325,878.43"
13-Jan-2025,RTGS,00.00,"325,878.43",00.00
14-Jan-2025,Reversal,402.10,00.00,402.10
14-Jan-2025,Bill,00.00,402.10,00.00
14-Jan-2025,RTGS,"1,385,579.50",00.00,"1,385,579.50"
14-Jan-2025,Debit Card,20.29,00.00,"1,385,599.79"
14-Jan-2025,Transfer,"1,869,685.00",00.00,"3,255,284.79"
15-Jan-2025,Bill,"171,995.00",00.00,"3,427,279.79"
15-Jan-2025,ATM,06.00,00.00,"3,427,285.79"
15-Jan-2025,NEFT,00.00,"3,427,285.79",00.00
15-Jan-2025,RTGS,"1,366,848.00",00.00,"1,366,848.00"
15-Jan-2025,Interest,00.00,"341,712.00","1,025,136.00"
15-Jan-2025,Cheque,00.00,"512,568.00","512,568.00"
15-Jan-2025,Miscellaneous,"196,158.20",00.00,"708,726.20"
15-Jan-2025,Bill,18.07,00.00,"708,744.27"
15-Jan-2025,Cheque,"28,422.50",00.00,"737,166.77"
15-Jan-2025,Debit Card,"25,655.56",00.00,"762,822.33"
15-Jan-2025,IMPS,00.00,"108,974.62","653,847.71"
15-Jan-2025,Reversal,"949,174.00",00.00,"1,603,021.71"
15-Jan-2025,RTGS,802.00,00.00,"1,603,823.71"
15-Jan-2025,Tax,"124,952.00",00.00,"1,728,775.71"
15-Jan-2025,Tax,00.00,"172,877.57","1,555,898.14"
15-Jan-2025,RTGS,00.00,"194,487.27","1,361,410.87"
15-Jan-2025,Bill,00.00,"680,705.44","680,705.44"
15-Jan-2025,ATM,"411,154.50",00.00,"1,091,859.94"
15-Jan-2025,IMPS,"2,176.68",00.00,"1,094,036.62"
15-Jan-2025,Interest,00.00,"273,509.16","820,527.47"
15-Jan-2025,ATM,99.23,00.00,"820,626.70"
15-Jan-2025,IMPS,00.00,"91,180.74","729,445.96"
15-Jan-2025,Bill,"62,327.70",00.00,"791,773.66"
15-Jan-2025,Reversal,00.00,"395,886.83","395,886.83"
15-Jan-2025,RTGS,44.74,00.00,"395,931.57"
15-Jan-2025,Cheque,636.50,00.00,"396,568.07"
15-Jan-2025,ATM,"18,515.00",00.00,"415,083.07"
15-Jan-2025,Debit Card,00.00,"51,885.38","363,197.69"
15-Jan-2025,Commission,00.00,"60,532.95","302,664.74"
15-Jan-2025,IMPS,00.00,"75,666.19","226,998.56"
15-Jan-2025,Cash,00.00,"226,998.56",00.00
15-Jan-2025,RTGS,"17,997.00",00.00,"17,997.00"
15-Jan-2025,Transfer,"188,190.00",00.00,"206,187.00"
15-Jan-2025,Bill,00.00,"51,546.75","154,640.25"
15-Jan-2025,Cheque,453.17,00.00,"155,093.42"
15-Jan-2025,Debit Card,03.10,00.00,"155,096.52"
15-Jan-2025,Debit Card,00.00,"19,387.07","135,709.45"
15-Jan-2025,ATM,00.00,"33,927.36","101,782.09"
15-Jan-2025,Reversal,14.40,00.00,"101,796.49"
15-Jan-2025,Cheque,74.91,00.00,"101,871.40"
15-Jan-2025,Commission,00.00,"11,319.04","90,552.36"
15-Jan-2025,Cheque,00.00,"22,638.09","67,914.27"
15-Jan-2025,Purchase,450.00,00.00,"68,364.27"
15-Jan-2025,Cash,"28,626.00",00.00,"96,990.27"
15-Jan-2025,Bill,00.00,"12,123.78","84,866.49"
15-Jan-2025,Commission,00.00,"28,288.83","56,577.66"
15-Jan-2025,Transfer,00.00,"7,072.21","49,505.45"
15-Jan-2025,Reversal,00.00,"8,250.91","41,254.54"
15-Jan-2025,Commission,00.00,"4,583.84","36,670.70"
15-Jan-2025,Commission,00.00,"36,670.70",00.00
15-Jan-2025,ATM,"5,943.80",00.00,"5,943.80"
15-Jan-2025,Purchase,"26,608.00",00.00,"32,551.80"
15-Jan-2025,Tax,"32,678.20",00.00,"65,230.00"
15-Jan-2025,Debit Card,257.44,00.00,"65,487.44"
15-Jan-2025,ATM,00.00,"7,276.38","58,211.06"
15-Jan-2025,Debit Card,31.07,00.00,"58,242.13"
15-Jan-2025,Debit Card,"216,792.30",00.00,"275,034.43"
15-Jan-2025,RTGS,"972,096.00",00.00,"1,247,130.43"
15-Jan-2025,Cheque,"1,428,312.20",00.00,"2,675,442.63"
15-Jan-2025,Bill,"25,755.90",00.00,"2,701,198.53"
15-Jan-2025,Cheque,02.20,00.00,"2,701,200.73"
15-Jan-2025,RTGS,50.00,00.00,"2,701,250.73"
15-Jan-2025,Transfer,"2,094,075.25",00.00,"4,795,325.98"
15-Jan-2025,Purchase,00.00,"4,795,325.98",00.00
15-Jan-2025,Debit Card,525.52,00.00,525.52
15-Jan-2025,Cheque,"1,986.40",00.00,"2,511.92"
15-Jan-2025,NEFT,00.00,418.65,"2,093.27"
15-Jan-2025,Interest,00.00,232.59,"1,860.68"
15-Jan-2025,Reversal,03.95,00.00,"1,864.63"
15-Jan-2025,Cash,00.00,"1,864.63",00.00
15-Jan-2025,ATM,00.52,00.00,00.52
15-Jan-2025,Commission,00.00,00.09,00.43
15-Jan-2025,RTGS,"10,183.20",00.00,"10,183.63"
15-Jan-2025,Interest,00.00,"2,036.73","8,146.90"
15-Jan-2025,IMPS,34.00,00.00,"8,180.90"
15-Jan-2025,Purchase,"321,894.00",00.00,"330,074.90"
15-Jan-2025,NEFT,"3,471.07",00.00,"333,545.97"
15-Jan-2025,Bill,00.00,"47,649.42","285,896.55"
15-Jan-2025,Transfer,00.00,"285,896.55",00.00
15-Jan-2025,ATM,"2,052.00",00.00,"2,052.00"
15-Jan-2025,Cheque,00.00,"1,026.00","1,026.00"
15-Jan-2025,Reversal,00.00,256.50,769.50
15-Jan-2025,Reversal,00.00,76.95,692.55
15-Jan-2025,Bill,"241,803.50",00.00,"242,496.05"
15-Jan-2025,Commission,"3,226.30",00.00,"245,722.35"
15-Jan-2025,NEFT,185.46,00.00,"245,907.81"
15-Jan-2025,Purchase,00.00,"122,953.91","122,953.90"
15-Jan-2025,Cheque,"182,600.90",00.00,"305,554.80"
15-Jan-2025,Transfer,00.00,"33,950.53","271,604.27"
15-Jan-2025,Debit Card,00.00,"27,160.43","244,443.84"
15-Jan-2025,Reversal,00.00,"122,221.92","122,221.92"
16-Jan-2025,Cheque,00.00,"20,370.32","101,851.60"
16-Jan-2025,NEFT,"3,510.00",00.00,"105,361.60"
16-Jan-2025,Tax,00.00,"11,706.84","93,654.76"
16-Jan-2025,Bill,"1,791,891.20",00.00,"1,885,545.96"
16-Jan-2025,Reversal,12.00,00.00,"1,885,557.96"
16-Jan-2025,Tax,00.00,"269,365.42","1,616,192.54"
16-Jan-2025,RTGS,00.00,"230,884.65","1,385,307.89"
16-Jan-2025,Bill,05.30,00.00,"1,385,313.19"
16-Jan-2025,Transfer,00.00,"173,164.15","1,212,149.04"
16-Jan-2025,Bill,"124,198.00",00.00,"1,336,347.04"
16-Jan-2025,NEFT,35.10,00.00,"1,336,382.14"
16-Jan-2025,Commission,00.00,"1,336,382.14",00.00
16-Jan-2025,Bill,"67,142.40",00.00,"67,142.40"
16-Jan-2025,Commission,00.00,"67,142.40",00.00
16-Jan-2025,Cheque,33.17,00.00,33.17
16-Jan-2025,Cash,00.00,03.32,29.85
16-Jan-2025,Transfer,00.00,07.46,22.39
16-Jan-2025,Debit Card,00.00,05.60,16.79
16-Jan-2025,Reversal,00.00,16.79,00.00
16-Jan-2025,IMPS,"20,129.00",00.00,"20,129.00"
16-Jan-2025,IMPS,"14,944.00",00.00,"35,073.00"
16-Jan-2025,Debit Card,02.40,00.00,"35,075.40"
16-Jan-2025,NEFT,00.00,"3,507.54","31,567.86"
16-Jan-2025,Transfer,00.00,"4,509.69","27,058.17"
16-Jan-2025,Commission,00.00,"4,509.70","22,548.48"
16-Jan-2025,IMPS,"305,088.00",00.00,"327,636.48"
16-Jan-2025,Bill,00.00,"163,818.24","163,818.24"
16-Jan-2025,Purchase,00.00,"18,202.03","145,616.21"
16-Jan-2025,IMPS,00.00,"24,269.37","121,346.84"
16-Jan-2025,Miscellaneous,"18,555.80",00.00,"139,902.64"
16-Jan-2025,Interest,00.00,"27,980.53","111,922.11"
16-Jan-2025,Cash,00.00,"15,988.87","95,933.24"
16-Jan-2025,NEFT,00.00,"10,659.25","85,273.99"
16-Jan-2025,Transfer,00.00,"14,212.33","71,061.66"
16-Jan-2025,Bill,"37,689.44",00.00,"108,751.10"
16-Jan-2025,Miscellaneous,"101,477.40",00.00,"210,228.50"
16-Jan-2025,IMPS,338.40,00.00,"210,566.90"
16-Jan-2025,RTGS,00.00,"21,056.69","189,510.21"
16-Jan-2025,RTGS,00.00,"18,951.02","170,559.19"
16-Jan-2025,Commission,00.00,"170,559.19",00.00
16-Jan-2025,Interest,06.48,00.00,06.48
16-Jan-2025,Debit Card,"103,945.47",00.00,"103,951.95"
16-Jan-2025,Bill,00.00,"103,951.95",00.00
16-Jan-2025,Cash,53.69,00.00,53.69
16-Jan-2025,Debit Card,64.00,00.00,117.69
16-Jan-2025,RTGS,"1,884,670.80",00.00,"1,884,788.49"
16-Jan-2025,Tax,"144,156.00",00.00,"2,028,944.49"
16-Jan-2025,Purchase,163.00,00.00,"2,029,107.49"
16-Jan-2025,Tax,"106,211.00",00.00,"2,135,318.49"
16-Jan-2025,Transfer,609.00,00.00,"2,135,927.49"
16-Jan-2025,NEFT,02.36,00.00,"2,135,929.85"
16-Jan-2025,Miscellaneous,00.00,"711,976.62","1,423,953.23"
16-Jan-2025,Reversal,73.00,00.00,"1,424,026.23"
16-Jan-2025,Commission,"3,325.07",00.00,"1,427,351.30"
16-Jan-2025,Bill,308.00,00.00,"1,427,659.30"
16-Jan-2025,RTGS,00.00,00.00,"1,427,659.30"
16-Jan-2025,Interest,"25,880.00",00.00,"1,453,539.30"
16-Jan-2025,Cheque,"26,891.40",00.00,"1,480,430.70"
16-Jan-2025,Tax,40.20,00.00,"1,480,470.90"
16-Jan-2025,Reversal,"1,954,333.00",00.00,"3,434,803.90"
16-Jan-2025,Commission,00.00,"381,644.88","3,053,159.02"
16-Jan-2025,Bill,00.00,"436,165.57","2,616,993.45"
16-Jan-2025,Cheque,"2,797.10",00.00,"2,619,790.55"
16-Jan-2025,Cash,00.00,"2,619,790.55",00.00
16-Jan-2025,Transfer,"801,666.00",00.00,"801,666.00"
16-Jan-2025,Debit Card,00.00,"133,611.00","668,055.00"
16-Jan-2025,Debit Card,00.00,"111,342.50","556,712.50"
16-Jan-2025,Reversal,02.77,00.00,"556,715.27"
16-Jan-2025,Tax,00.00,"185,571.76","371,143.51"
16-Jan-2025,ATM,00.00,"37,114.35","334,029.16"
16-Jan-2025,Miscellaneous,"175,219.81",00.00,"509,248.97"
16-Jan-2025,Bill,"137,376.80",00.00,"646,625.77"
16-Jan-2025,Bill,"222,959.00",00.00,"869,584.77"
16-Jan-2025,NEFT,00.00,"869,584.77",00.00
16-Jan-2025,ATM,383.98,00.00,383.98
16-Jan-2025,Tax,00.00,127.99,255.99
16-Jan-2025,NEFT,00.00,42.67,213.32
16-Jan-2025,IMPS,"130,242.84",00.00,"130,456.16"
16-Jan-2025,IMPS,670.00,00.00,"131,126.16"
16-Jan-2025,Purchase,00.00,"14,569.57","116,556.59"
16-Jan-2025,Debit Card,00.90,00.00,"116,557.49"
16-Jan-2025,Bill,"1,151,337.75",00.00,"1,267,895.24"
16-Jan-2025,Bill,00.00,"253,579.05","1,014,316.19"
16-Jan-2025,Cash,46.00,00.00,"1,014,362.19"
16-Jan-2025,Bill,02.00,00.00,"1,014,364.19"
16-Jan-2025,Commission,00.00,"507,182.10","507,182.10"
16-Jan-2025,Interest,00.00,"507,182.10",00.00
16-Jan-2025,Reversal,"3,016.20",00.00,"3,016.20"
16-Jan-2025,NEFT,"705,252.00",00.00,"708,268.20"
16-Jan-2025,Interest,00.00,"118,044.70","590,223.50"
16-Jan-2025,RTGS,00.00,"196,741.17","393,482.33"
16-Jan-2025,IMPS,"3,905.85",00.00,"397,388.18"
16-Jan-2025,ATM,00.00,"99,347.05","298,041.14"
16-Jan-2025,Commission,60.80,00.00,"298,101.94"
16-Jan-2025,Commission,00.00,"74,525.49","223,576.46"
16-Jan-2025,Purchase,"255,671.00",00.00,"479,247.46"
16-Jan-2025,Miscellaneous,08.00,00.00,"479,255.46"
16-Jan-2025,Cash,00.00,"59,906.93","419,348.53"
16-Jan-2025,Transfer,"3,042.24",00.00,"422,390.77"
16-Jan-2025,Cheque,00.00,"84,478.15","337,912.62"
16-Jan-2025,Bill,00.00,"48,273.23","289,639.39"
16-Jan-2025,Tax,00.00,"96,546.46","193,092.93"
16-Jan-2025,RTGS,261.62,00.00,"193,354.55"
16-Jan-2025,Commission,00.00,"24,169.32","169,185.23"
16-Jan-2025,RTGS,00.00,"28,197.54","140,987.69"
16-Jan-2025,Tax,00.00,"140,987.69",00.00
16-Jan-2025,Commission,07.70,00.00,07.70
16-Jan-2025,RTGS,04.00,00.00,11.70
16-Jan-2025,Bill,00.00,01.67,10.03
16-Jan-2025,Cheque,"2,585.10",00.00,"2,595.13"
16-Jan-2025,Reversal,00.00,"2,595.13",00.00
16-Jan-2025,Cheque,25.75,00.00,25.75
16-Jan-2025,NEFT,850.00,00.00,875.75
16-Jan-2025,Interest,"1,487,489.75",00.00,"1,488,365.50"
16-Jan-2025,Bill,544.08,00.00,"1,488,909.58"
17-Jan-2025,Purchase,00.00,"186,113.70","1,302,795.88"
17-Jan-2025,IMPS,00.00,"162,849.49","1,139,946.40"
17-Jan-2025,Reversal,460.20,00.00,"1,140,406.60"
17-Jan-2025,Cash,"2,042,914.50",00.00,"3,183,321.10"
17-Jan-2025,Transfer,314.30,00.00,"3,183,635.40"
17-Jan-2025,Cheque,"2,009,020.00",00.00,"5,192,655.40"
17-Jan-2025,Cheque,504.52,00.00,"5,193,159.92"
17-Jan-2025,Purchase,377.73,00.00,"5,193,537.65"
17-Jan-2025,Bill,06.00,00.00,"5,193,543.65"
17-Jan-2025,NEFT,00.00,"649,192.96","4,544,350.69"
17-Jan-2025,NEFT,00.00,"2,272,175.35","2,272,175.35"
17-Jan-2025,Commission,989.50,00.00,"2,273,164.85"
17-Jan-2025,Tax,00.00,"757,721.62","1,515,443.23"
17-Jan-2025,Miscellaneous,133.07,00.00,"1,515,576.30"
17-Jan-2025,Purchase,00.64,00.00,"1,515,576.94"
17-Jan-2025,Reversal,00.00,"252,596.16","1,262,980.78"
17-Jan-2025,IMPS,00.00,"210,496.80","1,052,483.98"
18-Jan-2025,Commission,"23,945.45",00.00,"1,076,429.43"
18-Jan-2025,Bill,42.00,00.00,"1,076,471.43"
18-Jan-2025,Reversal,00.00,"358,823.81","717,647.62"
18-Jan-2025,Debit Card,00.00,"143,529.52","574,118.10"
18-Jan-2025,Miscellaneous,50.01,00.00,"574,168.11"
18-Jan-2025,Debit Card,"1,306.80",00.00,"575,474.91"
18-Jan-2025,Cheque,00.00,"115,094.98","460,379.93"
18-Jan-2025,RTGS,00.00,"46,037.99","414,341.94"
18-Jan-2025,Transfer,102.30,00.00,"414,444.24"
18-Jan-2025,RTGS,00.00,"414,444.24",00.00
18-Jan-2025,Miscellaneous,"20,497.00",00.00,"20,497.00"
18-Jan-2025,Miscellaneous,"1,323,676.25",00.00,"1,344,173.25"
18-Jan-2025,Interest,"115,443.80",00.00,"1,459,617.05"
18-Jan-2025,Cheque,"1,021.80",00.00,"1,460,638.85"
18-Jan-2025,Transfer,00.00,"182,579.86","1,278,058.99"
18-Jan-2025,Cheque,00.00,"1,278,058.99",00.00
18-Jan-2025,Commission,06.00,00.00,06.00
18-Jan-2025,Commission,01.00,00.00,07.00
18-Jan-2025,IMPS,00.00,02.33,04.67
18-Jan-2025,Interest,"12,678.00",00.00,"12,682.67"
18-Jan-2025,Miscellaneous,207.00,00.00,"12,889.67"
18-Jan-2025,Reversal,128.00,00.00,"13,017.67"
18-Jan-2025,Interest,00.00,"1,446.41","11,571.26"
18-Jan-2025,Purchase,00.00,"1,157.13","10,414.13"
18-Jan-2025,Tax,00.00,"1,301.77","9,112.36"
18-Jan-2025,Interest,"32,061.29",00.00,"41,173.65"
18-Jan-2025,Tax,"3,101.30",00.00,"44,274.95"
18-Jan-2025,RTGS,05.00,00.00,"44,279.95"
18-Jan-2025,Bill,48.00,00.00,"44,327.95"
18-Jan-2025,NEFT,00.00,"44,327.95",00.00
18-Jan-2025,RTGS,"2,375.60",00.00,"2,375.60"
18-Jan-2025,IMPS,00.00,791.87,"1,583.73"
18-Jan-2025,Debit Card,00.00,791.87,791.86
18-Jan-2025,Tax,00.00,79.19,712.67
18-Jan-2025,Transfer,335.92,00.00,"1,048.59"
18-Jan-2025,IMPS,"122,841.78",00.00,"123,890.37"
18-Jan-2025,Miscellaneous,00.00,"61,945.19","61,945.18"
18-Jan-2025,Cash,"2,094.30",00.00,"64,039.48"
18-Jan-2025,Reversal,00.00,"7,115.50","56,923.98"
18-Jan-2025,Cash,00.00,"7,115.50","49,808.48"
18-Jan-2025,Debit Card,"890,731.00",00.00,"940,539.48"
18-Jan-2025,NEFT,00.00,"156,756.58","783,782.90"
18-Jan-2025,IMPS,"16,145.90",00.00,"799,928.80"
18-Jan-2025,Reversal,00.00,"199,982.20","599,946.60"
19-Jan-2025,IMPS,00.00,"99,991.10","499,955.50"
19-Jan-2025,Cash,471.00,00.00,"500,426.50"
19-Jan-2025,Bill,00.00,"50,042.65","450,383.85"
19-Jan-2025,Interest,00.00,"112,595.96","337,787.89"
19-Jan-2025,Interest,00.00,"112,595.96","225,191.93"
19-Jan-2025,IMPS,00.00,"37,531.99","187,659.94"
19-Jan-2025,ATM,03.68,00.00,"187,663.62"
19-Jan-2025,Tax,00.00,"20,851.51","166,812.11"
19-Jan-2025,Tax,00.00,"33,362.42","133,449.69"
19-Jan-2025,Commission,00.00,"19,064.24","114,385.45"
19-Jan-2025,Commission,"705,134.00",00.00,"819,519.45"
19-Jan-2025,Interest,"14,881.96",00.00,"834,401.41"
19-Jan-2025,NEFT,134.00,00.00,"834,535.41"
19-Jan-2025,Transfer,00.00,"278,178.47","556,356.94"
19-Jan-2025,NEFT,00.00,"79,479.56","476,877.38"
19-Jan-2025,Tax,"1,714,560.20",00.00,"2,191,437.58"
19-Jan-2025,Commission,"394,978.00",00.00,"2,586,415.58"
19-Jan-2025,Cash,00.00,"431,069.26","2,155,346.32"
19-Jan-2025,Tax,00.00,"269,418.29","1,885,928.03"
19-Jan-2025,Miscellaneous,00.00,"377,185.61","1,508,742.42"
19-Jan-2025,IMPS,00.00,"215,534.63","1,293,207.79"
20-Jan-2025,Commission,48.83,00.00,"1,293,256.62"
20-Jan-2025,RTGS,00.00,"258,651.32","1,034,605.30"
20-Jan-2025,ATM,00.00,"206,921.06","827,684.24"
20-Jan-2025,Cheque,"134,491.00",00.00,"962,175.24"
20-Jan-2025,ATM,00.00,"240,543.81","721,631.43"
20-Jan-2025,Reversal,05.00,00.00,"721,636.43"
21-Jan-2025,Cheque,75.80,00.00,"721,712.23"
21-Jan-2025,Reversal,00.00,"103,101.75","618,610.48"
21-Jan-2025,ATM,00.00,"77,326.31","541,284.17"
21-Jan-2025,Reversal,00.00,"108,256.83","433,027.34"
21-Jan-2025,Bill,00.00,"144,342.45","288,684.89"
21-Jan-2025,Commission,00.00,"72,171.22","216,513.67"
21-Jan-2025,RTGS,240.36,00.00,"216,754.03"
21-Jan-2025,Debit Card,00.00,"30,964.86","185,789.17"
21-Jan-2025,Cash,00.00,"30,964.86","154,824.31"
21-Jan-2025,Reversal,"1,670,905.00",00.00,"1,825,729.31"
21-Jan-2025,Debit Card,00.00,"1,825,729.31",00.00
21-Jan-2025,Miscellaneous,"2,030.00",00.00,"2,030.00"
21-Jan-2025,Bill,00.00,290.00,"1,740.00"
21-Jan-2025,Miscellaneous,00.00,217.50,"1,522.50"
21-Jan-2025,Tax,00.00,507.50,"1,015.00"
21-Jan-2025,RTGS,"247,352.69",00.00,"248,367.69"
21-Jan-2025,Cheque,00.00,"24,836.77","223,530.92"
21-Jan-2025,Interest,"3,708.00",00.00,"227,238.92"
21-Jan-2025,Commission,"1,365,891.00",00.00,"1,593,129.92"
21-Jan-2025,IMPS,05.59,00.00,"1,593,135.51"
21-Jan-2025,Debit Card,00.00,"265,522.59","1,327,612.92"
21-Jan-2025,NEFT,00.00,"442,537.64","885,075.28"
21-Jan-2025,Bill,00.00,"221,268.82","663,806.46"
21-Jan-2025,ATM,"171,835.44",00.00,"835,641.90"
21-Jan-2025,Interest,00.00,"104,455.24","731,186.66"
21-Jan-2025,Debit Card,"17,893.00",00.00,"749,079.66"
21-Jan-2025,Purchase,00.00,"74,907.97","674,171.69"
21-Jan-2025,Cheque,00.00,"134,834.34","539,337.35"
21-Jan-2025,Cash,18.20,00.00,"539,355.55"
21-Jan-2025,Debit Card,"145,270.00",00.00,"684,625.55"
21-Jan-2025,NEFT,"2,961.00",00.00,"687,586.55"
21-Jan-2025,Reversal,"3,184.20",00.00,"690,770.75"
21-Jan-2025,NEFT,00.00,"69,077.08","621,693.68"
21-Jan-2025,Commission,00.00,"155,423.42","466,270.26"
21-Jan-2025,Transfer,00.00,"77,711.71","388,558.55"
21-Jan-2025,Debit Card,00.00,"129,519.52","259,039.03"
21-Jan-2025,Reversal,"137,828.20",00.00,"396,867.23"
21-Jan-2025,Miscellaneous,00.00,"79,373.45","317,493.78"
21-Jan-2025,Transfer,00.00,"45,356.25","272,137.53"
21-Jan-2025,NEFT,34.54,00.00,"272,172.07"
21-Jan-2025,Tax,17.11,00.00,"272,189.18"
21-Jan-2025,Miscellaneous,"1,304,273.00",00.00,"1,576,462.18"
21-Jan-2025,Cheque,00.00,"788,231.09","788,231.09"
21-Jan-2025,Debit Card,"124,290.00",00.00,"912,521.09"
21-Jan-2025,NEFT,04.63,00.00,"912,525.72"
21-Jan-2025,RTGS,00.00,"456,262.86","456,262.86"
21-Jan-2025,ATM,04.30,00.00,"456,267.16"
21-Jan-2025,RTGS,03.40,00.00,"456,270.56"
21-Jan-2025,NEFT,618.00,00.00,"456,888.56"
21-Jan-2025,Reversal,00.00,"91,377.71","365,510.85"
21-Jan-2025,Reversal,"256,755.34",00.00,"622,266.19"
21-Jan-2025,Bill,00.00,"62,226.62","560,039.57"
21-Jan-2025,RTGS,00.00,"70,004.95","490,034.62"
21-Jan-2025,Interest,"43,922.20",00.00,"533,956.82"
21-Jan-2025,Tax,05.40,00.00,"533,962.22"
21-Jan-2025,Interest,00.00,"266,981.11","266,981.11"
21-Jan-2025,Tax,"136,275.25",00.00,"403,256.36"
21-Jan-2025,ATM,"2,056,637.00",00.00,"2,459,893.36"
21-Jan-2025,Commission,"8,535.51",00.00,"2,468,428.87"
21-Jan-2025,Purchase,"71,733.80",00.00,"2,540,162.67"
21-Jan-2025,Interest,"156,691.00",00.00,"2,696,853.67"
21-Jan-2025,Reversal,23.30,00.00,"2,696,876.97"
21-Jan-2025,RTGS,00.00,"898,958.99","1,797,917.98"
21-Jan-2025,Bill,00.00,"224,739.75","1,573,178.23"
21-Jan-2025,Tax,49.37,00.00,"1,573,227.60"
22-Jan-2025,Commission,00.00,"314,645.52","1,258,582.08"
22-Jan-2025,RTGS,00.00,"209,763.68","1,048,818.40"
22-Jan-2025,Cheque,327.34,00.00,"1,049,145.74"
22-Jan-2025,Purchase,00.00,"149,877.96","899,267.78"
22-Jan-2025,Cash,00.00,"112,408.47","786,859.31"
22-Jan-2025,Commission,00.00,"262,286.44","524,572.87"
22-Jan-2025,Reversal,181.00,00.00,"524,753.87"
22-Jan-2025,IMPS,00.00,"174,917.96","349,835.91"
22-Jan-2025,Interest,00.00,"69,967.18","279,868.73"
22-Jan-2025,Commission,06.00,00.00,"279,874.73"
22-Jan-2025,Bill,461.50,00.00,"280,336.23"
22-Jan-2025,RTGS,28.00,00.00,"280,364.23"
22-Jan-2025,Debit Card,"931,828.00",00.00,"1,212,192.23"
22-Jan-2025,ATM,00.00,"242,438.45","969,753.78"
22-Jan-2025,Bill,00.00,"161,625.63","808,128.15"
22-Jan-2025,Cheque,"224,937.00",00.00,"1,033,065.15"
22-Jan-2025,Cash,358.20,00.00,"1,033,423.35"
22-Jan-2025,Miscellaneous,00.00,"103,342.34","930,081.02"
22-Jan-2025,Commission,00.00,"465,040.51","465,040.51"
22-Jan-2025,Purchase,464.30,00.00,"465,504.81"
22-Jan-2025,Miscellaneous,00.00,"77,584.14","387,920.68"
22-Jan-2025,Cash,00.00,"55,417.24","332,503.44"
22-Jan-2025,Cheque,496.30,00.00,"332,999.74"
22-Jan-2025,IMPS,00.00,"332,999.74",00.00
22-Jan-2025,Cash,"1,266.79",00.00,"1,266.79"
22-Jan-2025,NEFT,"13,344.00",00.00,"14,610.79"
22-Jan-2025,Tax,"206,081.00",00.00,"220,691.79"
22-Jan-2025,Transfer,00.00,"110,345.90","110,345.90"
22-Jan-2025,Cheque,00.00,"13,793.24","96,552.66"
23-Jan-2025,Cash,00.00,"12,069.08","84,483.58"
23-Jan-2025,Commission,"21,884.52",00.00,"106,368.10"
23-Jan-2025,Transfer,00.00,"17,728.02","88,640.08"
23-Jan-2025,Bill,00.00,"14,773.35","73,866.73"
23-Jan-2025,IMPS,00.00,"10,552.39","63,314.34"
23-Jan-2025,NEFT,00.00,"15,828.59","47,485.76"
23-Jan-2025,ATM,"1,353,620.20",00.00,"1,401,105.96"
23-Jan-2025,Transfer,470.90,00.00,"1,401,576.86"
23-Jan-2025,Bill,"235,554.20",00.00,"1,637,131.06"
23-Jan-2025,Tax,"222,983.00",00.00,"1,860,114.06"
23-Jan-2025,ATM,22.00,00.00,"1,860,136.06"
23-Jan-2025,Cheque,00.00,"186,013.61","1,674,122.45"
23-Jan-2025,Debit Card,"21,568.10",00.00,"1,695,690.55"
23-Jan-2025,Cheque,"3,161.00",00.00,"1,698,851.55"
23-Jan-2025,Miscellaneous,"30,625.91",00.00,"1,729,477.46"
23-Jan-2025,Purchase,00.00,"576,492.49","1,152,984.97"
23-Jan-2025,IMPS,00.00,"164,712.14","988,272.83"
23-Jan-2025,Bill,00.00,"98,827.28","889,445.55"
23-Jan-2025,Debit Card,00.00,"98,827.28","790,618.27"
23-Jan-2025,Debit Card,00.00,"197,654.57","592,963.70"
23-Jan-2025,Commission,188.99,00.00,"593,152.69"
23-Jan-2025,Interest,00.00,"593,152.69",00.00
23-Jan-2025,Cheque,"1,962,976.00",00.00,"1,962,976.00"
23-Jan-2025,Bill,02.00,00.00,"1,962,978.00"
23-Jan-2025,RTGS,41.69,00.00,"1,963,019.69"
23-Jan-2025,Miscellaneous,00.00,"218,113.30","1,744,906.39"
23-Jan-2025,Purchase,00.00,"436,226.60","1,308,679.79"
23-Jan-2025,RTGS,381.10,00.00,"1,309,060.89"
23-Jan-2025,Tax,"5,000.30",00.00,"1,314,061.19"
23-Jan-2025,Debit Card,00.00,"164,257.65","1,149,803.54"
23-Jan-2025,Reversal,403.00,00.00,"1,150,206.54"
23-Jan-2025,Cash,00.00,"287,551.64","862,654.90"
23-Jan-2025,Miscellaneous,00.00,"95,850.54","766,804.36"
23-Jan-2025,NEFT,00.00,"191,701.09","575,103.27"
23-Jan-2025,Cheque,"1,786,537.20",00.00,"2,361,640.47"
24-Jan-2025,Reversal,00.00,"472,328.09","1,889,312.38"
24-Jan-2025,Cash,37.30,00.00,"1,889,349.68"
24-Jan-2025,Purchase,00.00,"944,674.84","944,674.84"
24-Jan-2025,Interest,00.00,"104,963.87","839,710.97"
24-Jan-2025,RTGS,46.60,00.00,"839,757.57"
24-Jan-2025,Cheque,00.00,"167,951.51","671,806.06"
24-Jan-2025,IMPS,"3,207.00",00.00,"675,013.06"
24-Jan-2025,Miscellaneous,110.80,00.00,"675,123.86"
24-Jan-2025,Purchase,"32,313.40",00.00,"707,437.26"
24-Jan-2025,Commission,00.00,"141,487.45","565,949.81"
24-Jan-2025,NEFT,00.00,"113,189.96","452,759.85"
24-Jan-2025,Cash,"217,762.30",00.00,"670,522.15"
24-Jan-2025,Purchase,"870,820.00",00.00,"1,541,342.15"
24-Jan-2025,Cash,00.00,"154,134.22","1,387,207.93"
24-Jan-2025,ATM,00.00,"231,201.32","1,156,006.61"
24-Jan-2025,Cash,"1,552,501.25",00.00,"2,708,507.86"
24-Jan-2025,Interest,00.00,"1,354,253.93","1,354,253.93"
24-Jan-2025,ATM,"243,964.00",00.00,"1,598,217.93"
24-Jan-2025,Cheque,"1,038,688.50",00.00,"2,636,906.43"
24-Jan-2025,Interest,35.10,00.00,"2,636,941.53"
24-Jan-2025,Purchase,"1,796,378.00",00.00,"4,433,319.53"
24-Jan-2025,Bill,"246,966.70",00.00,"4,680,286.23"
24-Jan-2025,Debit Card,33.00,00.00,"4,680,319.23"
25-Jan-2025,Transfer,00.00,"468,031.92","4,212,287.31"
25-Jan-2025,Cheque,00.00,"4,212,287.31",00.00
25-Jan-2025,Commission,"8,080.64",00.00,"8,080.64"
25-Jan-2025,Commission,00.00,"1,010.08","7,070.56"
25-Jan-2025,Cheque,"338,526.25",00.00,"345,596.81"
25-Jan-2025,Interest,00.00,"43,199.60","302,397.21"
25-Jan-2025,Interest,"14,909.00",00.00,"317,306.21"
25-Jan-2025,Tax,00.00,"52,884.37","264,421.84"
25-Jan-2025,Tax,"18,465.00",00.00,"282,886.84"
25-Jan-2025,RTGS,00.00,"31,431.87","251,454.97"
25-Jan-2025,NEFT,00.00,"251,454.97",00.00
25-Jan-2025,Tax,06.83,00.00,06.83
25-Jan-2025,Commission,00.00,06.83,00.00
25-Jan-2025,Bill,59.00,00.00,59.00
25-Jan-2025,Debit Card,"174,952.22",00.00,"175,011.22"
25-Jan-2025,Tax,00.00,"19,445.69","155,565.53"
25-Jan-2025,IMPS,00.00,"22,223.65","133,341.88"
25-Jan-2025,Transfer,00.00,"44,447.29","88,894.59"
25-Jan-2025,Bill,138.00,00.00,"89,032.59"
25-Jan-2025,Cheque,00.00,"14,838.77","74,193.82"
25-Jan-2025,Bill,"28,582.66",00.00,"102,776.48"
25-Jan-2025,Reversal,05.11,00.00,"102,781.59"
25-Jan-2025,Debit Card,14.61,00.00,"102,796.20"
25-Jan-2025,Debit Card,00.00,"102,796.20",00.00
25-Jan-2025,RTGS,26.60,00.00,26.60
25-Jan-2025,Transfer,07.30,00.00,33.90
25-Jan-2025,Commission,"105,727.34",00.00,"105,761.24"
25-Jan-2025,Tax,00.00,"52,880.62","52,880.62"
25-Jan-2025,Cash,32.00,00.00,"52,912.62"
25-Jan-2025,RTGS,00.00,"17,637.54","35,275.08"
25-Jan-2025,Tax,00.00,"11,758.36","23,516.72"
25-Jan-2025,IMPS,00.00,"2,939.59","20,577.13"
25-Jan-2025,Purchase,"864,947.00",00.00,"885,524.13"
25-Jan-2025,Cheque,00.00,"88,552.41","796,971.72"
25-Jan-2025,IMPS,00.00,"159,394.34","637,577.38"
25-Jan-2025,IMPS,00.00,"79,697.17","557,880.21"
25-Jan-2025,RTGS,"119,542.25",00.00,"677,422.46"
25-Jan-2025,Interest,"134,397.00",00.00,"811,819.46"
25-Jan-2025,Tax,00.00,"270,606.49","541,212.97"
25-Jan-2025,Commission,00.00,"54,121.30","487,091.67"
25-Jan-2025,RTGS,"1,595.00",00.00,"488,686.67"
25-Jan-2025,Cheque,00.00,"69,812.38","418,874.29"
25-Jan-2025,Reversal,00.00,"52,359.29","366,515.00"
25-Jan-2025,IMPS,"3,483.57",00.00,"369,998.57"
25-Jan-2025,ATM,"249,067.50",00.00,"619,066.07"
25-Jan-2025,Cheque,133.00,00.00,"619,199.07"
25-Jan-2025,IMPS,"8,081.00",00.00,"627,280.07"
25-Jan-2025,RTGS,487.00,00.00,"627,767.07"
25-Jan-2025,ATM,"750,463.00",00.00,"1,378,230.07"
25-Jan-2025,Debit Card,"1,923.00",00.00,"1,380,153.07"
25-Jan-2025,Debit Card,03.64,00.00,"1,380,156.71"
25-Jan-2025,Cheque,00.00,"1,380,156.71",00.00
25-Jan-2025,NEFT,"212,168.28",00.00,"212,168.28"
25-Jan-2025,ATM,00.00,"30,309.75","181,858.53"
25-Jan-2025,IMPS,00.00,"25,979.79","155,878.74"
25-Jan-2025,ATM,00.00,"77,939.37","77,939.37"
25-Jan-2025,Debit Card,00.00,"12,989.90","64,949.48"
25-Jan-2025,Tax,00.00,"16,237.37","48,712.11"
25-Jan-2025,RTGS,275.00,00.00,"48,987.11"
25-Jan-2025,Debit Card,00.00,"6,998.16","41,988.95"
25-Jan-2025,Interest,00.00,"6,998.16","34,990.79"
25-Jan-2025,Debit Card,108.92,00.00,"35,099.71"
25-Jan-2025,IMPS,00.00,"11,699.90","23,399.81"
25-Jan-2025,IMPS,20.00,00.00,"23,419.81"
25-Jan-2025,Reversal,00.00,"3,903.30","19,516.51"
25-Jan-2025,Debit Card,00.00,"9,758.26","9,758.25"
25-Jan-2025,Debit Card,00.00,"1,951.65","7,806.60"
25-Jan-2025,Purchase,"12,101.60",00.00,"19,908.20"
25-Jan-2025,Tax,00.00,"6,636.07","13,272.13"
25-Jan-2025,Debit Card,00.00,"2,212.02","11,060.11"
25-Jan-2025,IMPS,00.00,"1,106.01","9,954.10"
25-Jan-2025,RTGS,03.31,00.00,"9,957.41"
25-Jan-2025,ATM,00.00,"9,957.41",00.00
25-Jan-2025,RTGS,"12,440.70",00.00,"12,440.70"
25-Jan-2025,Commission,"1,890.00",00.00,"14,330.70"
25-Jan-2025,IMPS,358.50,00.00,"14,689.20"
25-Jan-2025,Tax,00.00,"3,672.30","11,016.90"
25-Jan-2025,Tax,00.00,"2,203.38","8,813.52"
25-Jan-2025,Bill,00.00,881.35,"7,932.17"
25-Jan-2025,Cash,00.00,"1,133.17","6,799.00"
25-Jan-2025,ATM,"34,402.90",00.00,"41,201.90"
25-Jan-2025,Commission,"14,200.00",00.00,"55,401.90"
25-Jan-2025,IMPS,00.00,"13,850.48","41,551.43"
25-Jan-2025,Cheque,274.70,00.00,"41,826.13"
25-Jan-2025,NEFT,00.00,"10,456.53","31,369.60"
25-Jan-2025,Cash,00.00,"7,842.40","23,527.20"
25-Jan-2025,Tax,"1,423,351.75",00.00,"1,446,878.95"
25-Jan-2025,Cheque,00.00,"206,696.99","1,240,181.96"
25-Jan-2025,ATM,00.00,"124,018.20","1,116,163.76"
25-Jan-2025,RTGS,00.00,"558,081.88","558,081.88"
25-Jan-2025,Reversal,00.70,00.00,"558,082.58"
25-Jan-2025,IMPS,00.00,"55,808.26","502,274.32"
25-Jan-2025,Purchase,"100,296.00",00.00,"602,570.32"
25-Jan-2025,IMPS,00.00,"120,514.06","482,056.26"
25-Jan-2025,IMPS,54.00,00.00,"482,110.26"
25-Jan-2025,Reversal,00.00,"48,211.03","433,899.23"
25-Jan-2025,Interest,00.00,"216,949.62","216,949.62"
25-Jan-2025,Transfer,00.00,"36,158.27","180,791.35"
25-Jan-2025,Reversal,00.00,"90,395.68","90,395.68"
25-Jan-2025,Cheque,"104,440.00",00.00,"194,835.68"
25-Jan-2025,Bill,"1,678.00",00.00,"196,513.68"
25-Jan-2025,Interest,"1,832.80",00.00,"198,346.48"
25-Jan-2025,Purchase,00.00,"49,586.62","148,759.86"
25-Jan-2025,IMPS,00.00,"24,793.31","123,966.55"
25-Jan-2025,Tax,"805,129.25",00.00,"929,095.80"
25-Jan-2025,Cash,"3,878.00",00.00,"932,973.80"
25-Jan-2025,Reversal,00.00,"93,297.38","839,676.42"
26-Jan-2025,RTGS,03.00,00.00,"839,679.42"
26-Jan-2025,Miscellaneous,440.00,00.00,"840,119.42"
26-Jan-2025,Cheque,00.00,"210,029.86","630,089.57"
26-Jan-2025,Bill,04.40,00.00,"630,093.97"
26-Jan-2025,ATM,00.00,"70,010.44","560,083.53"
27-Jan-2025,Cheque,"1,481,391.25",00.00,"2,041,474.78"
27-Jan-2025,Tax,00.00,"226,830.53","1,814,644.25"
27-Jan-2025,Commission,00.00,"302,440.71","1,512,203.54"
27-Jan-2025,Reversal,"1,674,730.50",00.00,"3,186,934.04"
27-Jan-2025,NEFT,189.50,00.00,"3,187,123.54"
27-Jan-2025,Debit Card,"544,004.00",00.00,"3,731,127.54"
27-Jan-2025,Miscellaneous,00.00,"466,390.94","3,264,736.60"
27-Jan-2025,Bill,12.60,00.00,"3,264,749.20"
27-Jan-2025,NEFT,00.00,"816,187.30","2,448,561.90"
27-Jan-2025,Debit Card,00.00,"1,224,280.95","1,224,280.95"
27-Jan-2025,Reversal,"206,600.34",00.00,"1,430,881.29"
27-Jan-2025,Transfer,47.71,00.00,"1,430,929.00"
27-Jan-2025,RTGS,"216,731.00",00.00,"1,647,660.00"
27-Jan-2025,Interest,40.00,00.00,"1,647,700.00"
28-Jan-2025,RTGS,"1,370,645.75",00.00,"3,018,345.75"
28-Jan-2025,Interest,"1,394.30",00.00,"3,019,740.05"
28-Jan-2025,Reversal,00.00,"301,974.01","2,717,766.04"
28-Jan-2025,Purchase,00.00,"339,720.76","2,378,045.28"
28-Jan-2025,IMPS,00.00,"1,189,022.64","1,189,022.64"
28-Jan-2025,Commission,00.00,"198,170.44","990,852.20"
28-Jan-2025,Reversal,00.00,"247,713.05","743,139.15"
28-Jan-2025,NEFT,00.00,"743,139.15",00.00
28-Jan-2025,Cheque,135.70,00.00,135.70
28-Jan-2025,ATM,00.00,45.23,90.47
28-Jan-2025,Bill,00.00,00.00,90.47
28-Jan-2025,Bill,"121,307.00",00.00,"121,397.47"
28-Jan-2025,Reversal,"1,997.23",00.00,"123,394.70"
28-Jan-2025,Cash,00.00,"12,339.47","111,055.23"
28-Jan-2025,Commission,24.12,00.00,"111,079.35"
28-Jan-2025,ATM,00.00,"18,513.23","92,566.12"
28-Jan-2025,Cheque,00.00,"11,570.77","80,995.36"
28-Jan-2025,Interest,"446,536.00",00.00,"527,531.36"
28-Jan-2025,Tax,00.00,"58,614.60","468,916.76"
28-Jan-2025,RTGS,284.30,00.00,"469,201.06"
28-Jan-2025,Cash,00.00,"93,840.21","375,360.85"
28-Jan-2025,ATM,"19,297.00",00.00,"394,657.85"
28-Jan-2025,Transfer,00.00,"78,931.57","315,726.28"
28-Jan-2025,Debit Card,00.00,"105,242.09","210,484.19"
28-Jan-2025,Miscellaneous,38.30,00.00,"210,522.49"
28-Jan-2025,RTGS,00.00,"30,074.64","180,447.85"
28-Jan-2025,NEFT,00.00,"30,074.64","150,373.21"
28-Jan-2025,Purchase,00.00,"150,373.21",00.00
28-Jan-2025,Cheque,03.24,00.00,03.24
28-Jan-2025,Reversal,"189,411.00",00.00,"189,414.24"
28-Jan-2025,Cash,"2,474.00",00.00,"191,888.24"
28-Jan-2025,ATM,00.00,"31,981.37","159,906.87"
28-Jan-2025,RTGS,29.99,00.00,"159,936.86"
28-Jan-2025,Bill,00.00,"39,984.22","119,952.64"
28-Jan-2025,Cheque,00.00,"19,992.11","99,960.53"
28-Jan-2025,IMPS,00.00,"16,660.09","83,300.44"
28-Jan-2025,ATM,"51,412.00",00.00,"134,712.44"
28-Jan-2025,Cash,00.00,"19,244.63","115,467.81"
28-Jan-2025,ATM,06.76,00.00,"115,474.57"
28-Jan-2025,Purchase,94.00,00.00,"115,568.57"
28-Jan-2025,Tax,"84,822.50",00.00,"200,391.07"
28-Jan-2025,Commission,00.00,"100,195.54","100,195.54"
28-Jan-2025,Commission,06.68,00.00,"100,202.22"
28-Jan-2025,Commission,"1,895.80",00.00,"102,098.02"
28-Jan-2025,Purchase,00.00,"20,419.60","81,678.42"
28-Jan-2025,Reversal,108.00,00.00,"81,786.42"
28-Jan-2025,Miscellaneous,"2,464.90",00.00,"84,251.32"
29-Jan-2025,Bill,00.00,"8,425.13","75,826.19"
29-Jan-2025,Interest,00.00,"18,956.55","56,869.64"
29-Jan-2025,Tax,00.00,"9,478.27","47,391.37"
29-Jan-2025,Bill,00.00,"15,797.12","31,594.25"
29-Jan-2025,Transfer,00.00,"10,531.42","21,062.83"
29-Jan-2025,Commission,"3,629.30",00.00,"24,692.13"
29-Jan-2025,Interest,336.66,00.00,"25,028.79"
29-Jan-2025,ATM,33.00,00.00,"25,061.79"
29-Jan-2025,NEFT,00.00,"12,530.90","12,530.90"
29-Jan-2025,IMPS,17.60,00.00,"12,548.50"
29-Jan-2025,RTGS,00.00,"1,568.56","10,979.94"
29-Jan-2025,Commission,66.10,00.00,"11,046.04"
29-Jan-2025,IMPS,00.00,"1,578.01","9,468.03"
29-Jan-2025,IMPS,"1,433,714.75",00.00,"1,443,182.78"
29-Jan-2025,Tax,00.00,"206,168.97","1,237,013.81"
29-Jan-2025,Transfer,"1,901.02",00.00,"1,238,914.83"
29-Jan-2025,IMPS,05.00,00.00,"1,238,919.83"
29-Jan-2025,Cheque,00.00,"1,238,919.83",00.00
29-Jan-2025,IMPS,04.86,00.00,04.86
29-Jan-2025,Transfer,"3,886.30",00.00,"3,891.16"
29-Jan-2025,NEFT,"201,866.62",00.00,"205,757.78"
29-Jan-2025,IMPS,"34,583.10",00.00,"240,340.88"
29-Jan-2025,Bill,00.00,"48,068.18","192,272.70"
29-Jan-2025,RTGS,00.00,"32,045.45","160,227.25"
29-Jan-2025,ATM,243.80,00.00,"160,471.05"
29-Jan-2025,Transfer,00.00,"40,117.76","120,353.29"
29-Jan-2025,Commission,00.00,"60,176.65","60,176.64"
29-Jan-2025,Miscellaneous,"1,012,177.25",00.00,"1,072,353.89"
29-Jan-2025,Commission,07.00,00.00,"1,072,360.89"
29-Jan-2025,Purchase,51.53,00.00,"1,072,412.42"
29-Jan-2025,Tax,00.00,"214,482.48","857,929.94"
29-Jan-2025,Debit Card,00.00,"285,976.65","571,953.29"
29-Jan-2025,ATM,"517,270.00",00.00,"1,089,223.29"
29-Jan-2025,RTGS,00.00,"1,089,223.29",00.00
29-Jan-2025,Commission,"1,953.50",00.00,"1,953.50"
29-Jan-2025,Interest,"24,325.86",00.00,"26,279.36"
29-Jan-2025,Transfer,00.00,"3,754.19","22,525.17"
29-Jan-2025,Commission,33.76,00.00,"22,558.93"
29-Jan-2025,IMPS,00.00,"2,819.87","19,739.06"
29-Jan-2025,Tax,00.00,"9,869.53","9,869.53"
29-Jan-2025,Debit Card,00.00,"1,644.92","8,224.61"
29-Jan-2025,Reversal,"25,809.00",00.00,"34,033.61"
29-Jan-2025,NEFT,11.60,00.00,"34,045.21"
29-Jan-2025,Interest,00.00,"3,404.52","30,640.69"
29-Jan-2025,ATM,"167,023.00",00.00,"197,663.69"
29-Jan-2025,IMPS,00.00,"49,415.92","148,247.77"
29-Jan-2025,ATM,00.00,"37,061.94","111,185.83"
29-Jan-2025,Cheque,644.00,00.00,"111,829.83"
29-Jan-2025,Transfer,423.00,00.00,"112,252.83"
29-Jan-2025,Transfer,00.00,"56,126.42","56,126.42"
29-Jan-2025,Purchase,"3,912.32",00.00,"60,038.74"
29-Jan-2025,RTGS,47.10,00.00,"60,085.84"
29-Jan-2025,Cheque,00.45,00.00,"60,086.29"
29-Jan-2025,Cash,"1,397,456.80",00.00,"1,457,543.09"
29-Jan-2025,ATM,00.00,"242,923.85","1,214,619.24"
29-Jan-2025,Cash,"1,479.30",00.00,"1,216,098.54"
29-Jan-2025,Transfer,00.00,"152,012.32","1,064,086.22"
29-Jan-2025,Miscellaneous,01.10,00.00,"1,064,087.32"
29-Jan-2025,Debit Card,"204,455.00",00.00,"1,268,542.32"
29-Jan-2025,Commission,00.00,"158,567.79","1,109,974.53"
29-Jan-2025,IMPS,633.70,00.00,"1,110,608.23"
29-Jan-2025,Interest,62.80,00.00,"1,110,671.03"
29-Jan-2025,Bill,"1,028.00",00.00,"1,111,699.03"
29-Jan-2025,ATM,00.00,"555,849.52","555,849.52"
29-Jan-2025,Tax,643.71,00.00,"556,493.23"
29-Jan-2025,Reversal,00.00,"79,499.03","476,994.20"
29-Jan-2025,Reversal,00.00,"52,999.36","423,994.84"
29-Jan-2025,Commission,00.20,00.00,"423,995.04"
29-Jan-2025,NEFT,30.35,00.00,"424,025.39"
29-Jan-2025,Debit Card,00.00,"212,012.70","212,012.70"
29-Jan-2025,Tax,00.00,"30,287.53","181,725.17"
29-Jan-2025,ATM,00.00,"60,575.06","121,150.11"
29-Jan-2025,Bill,00.00,"30,287.53","90,862.58"
29-Jan-2025,IMPS,"159,470.00",00.00,"250,332.58"
29-Jan-2025,Interest,00.00,"31,291.57","219,041.01"
29-Jan-2025,Interest,00.00,"24,337.89","194,703.12"
29-Jan-2025,Cheque,00.00,"21,633.68","173,069.44"
29-Jan-2025,Reversal,"58,644.34",00.00,"231,713.78"
29-Jan-2025,Debit Card,29.00,00.00,"231,742.78"
29-Jan-2025,NEFT,27.70,00.00,"231,770.48"
29-Jan-2025,Miscellaneous,"19,199.00",00.00,"250,969.48"
29-Jan-2025,Debit Card,00.00,"50,193.90","200,775.58"
29-Jan-2025,Cheque,00.00,"100,387.79","100,387.79"
29-Jan-2025,NEFT,44.84,00.00,"100,432.63"
29-Jan-2025,Cash,00.00,"50,216.32","50,216.32"
29-Jan-2025,ATM,"1,152,233.00",00.00,"1,202,449.32"
29-Jan-2025,Transfer,06.70,00.00,"1,202,456.02"
30-Jan-2025,Tax,"1,888,030.20",00.00,"3,090,486.22"
30-Jan-2025,Commission,00.00,"441,498.03","2,648,988.19"
30-Jan-2025,ATM,"321,531.80",00.00,"2,970,519.99"
30-Jan-2025,Cash,00.00,"297,052.00","2,673,467.99"
30-Jan-2025,ATM,"96,928.20",00.00,"2,770,396.19"
30-Jan-2025,ATM,482.10,00.00,"2,770,878.29"
30-Jan-2025,Commission,05.55,00.00,"2,770,883.84"
30-Jan-2025,NEFT,00.00,"554,176.77","2,216,707.07"
30-Jan-2025,Commission,806.07,00.00,"2,217,513.14"
30-Jan-2025,Interest,00.00,"443,502.63","1,774,010.51"
30-Jan-2025,Commission,60.00,00.00,"1,774,070.51"
30-Jan-2025,Purchase,"125,621.00",00.00,"1,899,691.51"
30-Jan-2025,Purchase,00.00,"211,076.83","1,688,614.68"
30-Jan-2025,Cash,"18,899.80",00.00,"1,707,514.48"
30-Jan-2025,Bill,00.00,"341,502.90","1,366,011.58"
30-Jan-2025,Purchase,00.00,"1,366,011.58",00.00
30-Jan-2025,RTGS,"1,815.00",00.00,"1,815.00"
30-Jan-2025,Cash,67.33,00.00,"1,882.33"
30-Jan-2025,Purchase,"64,593.00",00.00,"66,475.33"
30-Jan-2025,Purchase,12.63,00.00,"66,487.96"
30-Jan-2025,Bill,00.00,"13,297.59","53,190.37"
30-Jan-2025,Purchase,00.00,"5,910.04","47,280.33"
30-Jan-2025,Tax,00.00,"4,728.03","42,552.30"
30-Jan-2025,IMPS,"3,232.00",00.00,"45,784.30"
30-Jan-2025,RTGS,00.00,"45,784.30",00.00
30-Jan-2025,Reversal,07.00,00.00,07.00
31-Jan-2025,Cheque,00.00,00.88,06.12
31-Jan-2025,Bill,06.60,00.00,12.72
31-Jan-2025,Cheque,37.90,00.00,50.62
31-Jan-2025,Debit Card,"3,887.90",00.00,"3,938.52"
31-Jan-2025,Cash,00.00,656.42,"3,282.10"
01-Feb-2025,Bill,02.70,00.00,"3,284.80"
01-Feb-2025,Cheque,"2,013,110.25",00.00,"2,016,395.05"
01-Feb-2025,NEFT,28.90,00.00,"2,016,423.95"
02-Feb-2025,RTGS,03.85,00.00,"2,016,427.80"
02-Feb-2025,Cash,"93,309.19",00.00,"2,109,736.99"
02-Feb-2025,Interest,07.00,00.00,"2,109,743.99"
02-Feb-2025,Transfer,00.00,"2,109,743.99",00.00
02-Feb-2025,Purchase,"2,835.90",00.00,"2,835.90"
02-Feb-2025,Bill,"104,756.56",00.00,"107,592.46"
02-Feb-2025,Interest,00.00,"17,932.08","89,660.38"
02-Feb-2025,ATM,00.00,"9,962.26","79,698.12"
02-Feb-2025,Transfer,00.00,"13,283.02","66,415.10"
02-Feb-2025,Tax,00.00,"66,415.10",00.00
02-Feb-2025,Bill,"2,084,927.25",00.00,"2,084,927.25"
02-Feb-2025,IMPS,00.00,"297,846.75","1,787,080.50"
02-Feb-2025,Commission,00.00,"595,693.50","1,191,387.00"
02-Feb-2025,Bill,00.00,"148,923.38","1,042,463.62"
02-Feb-2025,ATM,00.00,"173,743.94","868,719.68"
02-Feb-2025,NEFT,06.25,00.00,"868,725.93"
03-Feb-2025,Debit Card,00.00,"173,745.19","694,980.74"
03-Feb-2025,Cash,"8,642.00",00.00,"703,622.74"
03-Feb-2025,Cheque,"132,877.00",00.00,"836,499.74"
03-Feb-2025,Cash,42.07,00.00,"836,541.81"
03-Feb-2025,RTGS,00.00,"167,308.36","669,233.45"
03-Feb-2025,Cash,06.10,00.00,"669,239.55"
03-Feb-2025,IMPS,00.00,"83,654.94","585,584.61"
03-Feb-2025,Purchase,595.00,00.00,"586,179.61"
03-Feb-2025,Bill,00.00,"65,131.07","521,048.54"
04-Feb-2025,Transfer,"1,795,243.50",00.00,"2,316,292.04"
04-Feb-2025,Interest,"334,603.00",00.00,"2,650,895.04"
04-Feb-2025,Miscellaneous,00.44,00.00,"2,650,895.48"
04-Feb-2025,Reversal,00.00,"662,723.87","1,988,171.61"
04-Feb-2025,Reversal,07.00,00.00,"1,988,178.61"
04-Feb-2025,Cash,19.00,00.00,"1,988,197.61"
04-Feb-2025,ATM,00.00,"284,028.23","1,704,169.38"
04-Feb-2025,Purchase,00.00,"213,021.17","1,491,148.21"
04-Feb-2025,Reversal,"200,424.20",00.00,"1,691,572.41"
04-Feb-2025,NEFT,366.00,00.00,"1,691,938.41"
04-Feb-2025,Bill,00.00,"845,969.21","845,969.20"
04-Feb-2025,Bill,00.00,"105,746.15","740,223.05"
04-Feb-2025,ATM,368.62,00.00,"740,591.67"
04-Feb-2025,Interest,"1,250,996.00",00.00,"1,991,587.67"
04-Feb-2025,Interest,14.00,00.00,"1,991,601.67"
05-Feb-2025,Debit Card,"638,513.75",00.00,"2,630,115.42"
05-Feb-2025,Miscellaneous,"460,887.50",00.00,"3,091,002.92"
05-Feb-2025,Miscellaneous,00.00,"1,545,501.46","1,545,501.46"
05-Feb-2025,Tax,00.00,"309,100.29","1,236,401.17"
05-Feb-2025,Tax,00.00,"309,100.29","927,300.88"
05-Feb-2025,Interest,"13,945.00",00.00,"941,245.88"
05-Feb-2025,ATM,"76,275.00",00.00,"1,017,520.88"
05-Feb-2025,Miscellaneous,00.00,"1,017,520.88",00.00
05-Feb-2025,Reversal,"2,044,088.00",00.00,"2,044,088.00"
05-Feb-2025,ATM,00.00,"255,511.00","1,788,577.00"
05-Feb-2025,Miscellaneous,52.80,00.00,"1,788,629.80"
05-Feb-2025,RTGS,427.68,00.00,"1,789,057.48"
05-Feb-2025,Cheque,00.00,"596,352.49","1,192,704.99"
06-Feb-2025,NEFT,00.00,"596,352.50","596,352.50"
06-Feb-2025,Tax,00.00,"198,784.17","397,568.33"
06-Feb-2025,Tax,00.00,"79,513.67","318,054.66"
06-Feb-2025,Purchase,00.00,"63,610.93","254,443.73"
06-Feb-2025,Reversal,00.00,"25,444.37","228,999.36"
06-Feb-2025,Reversal,09.86,00.00,"229,009.22"
06-Feb-2025,Purchase,00.00,"76,336.41","152,672.81"
06-Feb-2025,NEFT,00.00,"19,084.10","133,588.71"
06-Feb-2025,Purchase,617.20,00.00,"134,205.91"
06-Feb-2025,NEFT,00.00,"19,172.27","115,033.64"
06-Feb-2025,NEFT,100.00,00.00,"115,133.64"
06-Feb-2025,ATM,00.00,"14,391.71","100,741.94"
06-Feb-2025,Bill,00.00,"10,074.19","90,667.75"
06-Feb-2025,Purchase,07.00,00.00,"90,674.75"
06-Feb-2025,Commission,00.00,"90,674.75",00.00
06-Feb-2025,Reversal,"1,148,918.80",00.00,"1,148,918.80"
06-Feb-2025,Reversal,"34,378.56",00.00,"1,183,297.36"
06-Feb-2025,Bill,"26,853.20",00.00,"1,210,150.56"
06-Feb-2025,ATM,01.00,00.00,"1,210,151.56"
06-Feb-2025,Transfer,00.00,"121,015.16","1,089,136.40"
06-Feb-2025,Debit Card,00.00,"121,015.16","968,121.24"
06-Feb-2025,Debit Card,00.00,"484,060.62","484,060.62"
06-Feb-2025,NEFT,00.00,"60,507.58","423,553.04"
06-Feb-2025,Commission,21.68,00.00,"423,574.72"
06-Feb-2025,Tax,"3,744.30",00.00,"427,319.02"
06-Feb-2025,ATM,00.00,"85,463.80","341,855.22"
06-Feb-2025,Debit Card,00.00,"56,975.87","284,879.35"
06-Feb-2025,Bill,00.00,"47,479.89","237,399.46"
06-Feb-2025,Purchase,00.00,"79,133.15","158,266.31"
06-Feb-2025,Commission,00.00,"79,133.16","79,133.16"
07-Feb-2025,Cash,00.00,"39,566.58","39,566.58"
07-Feb-2025,ATM,01.90,00.00,"39,568.48"
07-Feb-2025,RTGS,"2,479.00",00.00,"42,047.48"
07-Feb-2025,Debit Card,00.00,"10,511.87","31,535.61"
07-Feb-2025,Cheque,"3,093.61",00.00,"34,629.22"
07-Feb-2025,Bill,19.90,00.00,"34,649.12"
07-Feb-2025,Cheque,53.62,00.00,"34,702.74"
07-Feb-2025,NEFT,"85,319.41",00.00,"120,022.15"
08-Feb-2025,Interest,00.00,"30,005.54","90,016.61"
08-Feb-2025,Cash,00.00,"15,002.77","75,013.84"
08-Feb-2025,IMPS,35.82,00.00,"75,049.66"
08-Feb-2025,Bill,00.00,"9,381.21","65,668.45"
08-Feb-2025,NEFT,00.00,"13,133.69","52,534.76"
08-Feb-2025,Debit Card,00.00,"26,267.38","26,267.38"
08-Feb-2025,IMPS,00.00,"4,377.90","21,889.48"
08-Feb-2025,NEFT,00.00,"3,648.25","18,241.23"
08-Feb-2025,ATM,"2,164.00",00.00,"20,405.23"
08-Feb-2025,Cheque,00.00,"2,040.52","18,364.71"
08-Feb-2025,Cash,00.00,"4,591.18","13,773.53"
08-Feb-2025,Miscellaneous,996.00,00.00,"14,769.53"
08-Feb-2025,ATM,04.20,00.00,"14,773.73"
08-Feb-2025,Cash,00.00,"7,386.87","7,386.86"
08-Feb-2025,Transfer,00.00,"1,055.27","6,331.59"
08-Feb-2025,Miscellaneous,05.70,00.00,"6,337.29"
08-Feb-2025,Commission,"78,986.10",00.00,"85,323.39"
08-Feb-2025,Cheque,04.60,00.00,"85,327.99"
08-Feb-2025,Cheque,"3,813.50",00.00,"89,141.49"
08-Feb-2025,Transfer,"23,619.00",00.00,"112,760.49"
08-Feb-2025,Bill,00.00,"56,380.25","56,380.24"
08-Feb-2025,Miscellaneous,"2,039,528.00",00.00,"2,095,908.24"
08-Feb-2025,NEFT,00.00,"299,415.46","1,796,492.78"
09-Feb-2025,Bill,"46,502.00",00.00,"1,842,994.78"
10-Feb-2025,Transfer,229.41,00.00,"1,843,224.19"
10-Feb-2025,Bill,"301,338.75",00.00,"2,144,562.94"
10-Feb-2025,Miscellaneous,00.00,"536,140.74","1,608,422.20"
10-Feb-2025,Bill,"212,230.03",00.00,"1,820,652.23"
10-Feb-2025,RTGS,00.00,"202,294.69","1,618,357.54"
11-Feb-2025,Purchase,00.00,"809,178.77","809,178.77"
11-Feb-2025,IMPS,00.00,"269,726.26","539,452.51"
11-Feb-2025,Interest,216.90,00.00,"539,669.41"
11-Feb-2025,IMPS,00.00,"539,669.41",00.00
11-Feb-2025,Miscellaneous,"14,558.00",00.00,"14,558.00"
11-Feb-2025,Cheque,"1,828,654.00",00.00,"1,843,212.00"
11-Feb-2025,Transfer,00.00,"368,642.40","1,474,569.60"
11-Feb-2025,Transfer,00.00,"737,284.80","737,284.80"
11-Feb-2025,Debit Card,00.00,"92,160.60","645,124.20"
11-Feb-2025,Interest,00.00,"129,024.84","516,099.36"
11-Feb-2025,NEFT,"6,948.00",00.00,"523,047.36"
11-Feb-2025,Tax,00.00,"174,349.12","348,698.24"
11-Feb-2025,Reversal,00.00,"58,116.37","290,581.87"
11-Feb-2025,RTGS,00.00,"96,860.62","193,721.25"
11-Feb-2025,Tax,"233,167.50",00.00,"426,888.75"
11-Feb-2025,Tax,00.00,"426,888.75",00.00
12-Feb-2025,Transfer,"27,141.90",00.00,"27,141.90"
12-Feb-2025,IMPS,"121,868.00",00.00,"149,009.90"
12-Feb-2025,ATM,"18,170.00",00.00,"167,179.90"
12-Feb-2025,Cheque,52.00,00.00,"167,231.90"
12-Feb-2025,Debit Card,00.00,"55,743.97","111,487.93"
12-Feb-2025,Interest,926.70,00.00,"112,414.63"
13-Feb-2025,NEFT,00.00,"11,241.46","101,173.17"
13-Feb-2025,ATM,00.00,"14,453.31","86,719.86"
13-Feb-2025,Interest,"248,384.00",00.00,"335,103.86"
13-Feb-2025,Cheque,00.00,"41,887.98","293,215.88"
13-Feb-2025,Miscellaneous,00.00,"36,651.99","256,563.90"
13-Feb-2025,Transfer,"12,545.50",00.00,"269,109.40"
13-Feb-2025,Transfer,364.10,00.00,"269,473.50"
13-Feb-2025,Cash,00.00,"26,947.35","242,526.15"
13-Feb-2025,Interest,00.00,"60,631.54","181,894.61"
13-Feb-2025,Bill,"872,682.00",00.00,"1,054,576.61"
13-Feb-2025,Cheque,"1,623,301.75",00.00,"2,677,878.36"
13-Feb-2025,IMPS,00.00,"2,677,878.36",00.00
13-Feb-2025,Transfer,"52,013.00",00.00,"52,013.00"
13-Feb-2025,Transfer,00.35,00.00,"52,013.35"
13-Feb-2025,Interest,"5,541.90",00.00,"57,555.25"
13-Feb-2025,Cash,00.00,"6,395.03","51,160.22"
13-Feb-2025,IMPS,00.00,"12,790.06","38,370.16"
13-Feb-2025,Debit Card,113.00,00.00,"38,483.16"
13-Feb-2025,Miscellaneous,"8,426.00",00.00,"46,909.16"
13-Feb-2025,Tax,00.00,"11,727.29","35,181.87"
13-Feb-2025,ATM,49.50,00.00,"35,231.37"
13-Feb-2025,Reversal,00.00,"35,231.37",00.00
13-Feb-2025,Cheque,14.53,00.00,14.53
13-Feb-2025,Miscellaneous,"1,677.70",00.00,"1,692.23"
13-Feb-2025,RTGS,00.00,564.08,"1,128.15"
13-Feb-2025,ATM,"12,653.34",00.00,"13,781.49"
13-Feb-2025,Tax,"1,249,938.00",00.00,"1,263,719.49"
13-Feb-2025,Commission,00.00,"126,371.95","1,137,347.54"
14-Feb-2025,Tax,"117,703.00",00.00,"1,255,050.54"
14-Feb-2025,Commission,"109,569.00",00.00,"1,364,619.54"
14-Feb-2025,Commission,45.00,00.00,"1,364,664.54"
14-Feb-2025,Cash,00.00,"227,444.09","1,137,220.45"
14-Feb-2025,Commission,00.00,"142,152.56","995,067.89"
14-Feb-2025,Bill,"2,701.15",00.00,"997,769.04"
14-Feb-2025,Interest,00.00,"332,589.68","665,179.36"
14-Feb-2025,Commission,00.00,"332,589.68","332,589.68"
14-Feb-2025,Tax,00.00,"66,517.94","266,071.74"
14-Feb-2025,Debit Card,"193,094.90",00.00,"459,166.64"
14-Feb-2025,Debit Card,00.00,"65,595.23","393,571.41"
14-Feb-2025,RTGS,"762,504.00",00.00,"1,156,075.41"
14-Feb-2025,IMPS,00.00,"165,153.63","990,921.78"
14-Feb-2025,NEFT,"8,703.00",00.00,"999,624.78"
14-Feb-2025,Miscellaneous,00.00,"111,069.42","888,555.36"
14-Feb-2025,Miscellaneous,"231,276.40",00.00,"1,119,831.76"
15-Feb-2025,Commission,"13,108.10",00.00,"1,132,939.86"
15-Feb-2025,RTGS,"47,581.60",00.00,"1,180,521.46"
15-Feb-2025,RTGS,"129,138.10",00.00,"1,309,659.56"
15-Feb-2025,Cheque,00.00,"436,553.19","873,106.37"
15-Feb-2025,NEFT,15.90,00.00,"873,122.27"
15-Feb-2025,RTGS,"28,590.90",00.00,"901,713.17"
15-Feb-2025,NEFT,31.33,00.00,"901,744.50"
15-Feb-2025,Commission,00.00,"901,744.50",00.00
15-Feb-2025,Reversal,61.00,00.00,61.00
15-Feb-2025,Tax,"178,244.38",00.00,"178,305.38"
16-Feb-2025,Cash,"181,514.84",00.00,"359,820.22"
16-Feb-2025,Cash,00.00,"51,402.89","308,417.33"
16-Feb-2025,Transfer,"25,934.69",00.00,"334,352.02"
16-Feb-2025,Tax,"104,389.75",00.00,"438,741.77"
16-Feb-2025,Transfer,01.90,00.00,"438,743.67"
16-Feb-2025,ATM,"1,680,143.50",00.00,"2,118,887.17"
16-Feb-2025,Transfer,74.40,00.00,"2,118,961.57"
16-Feb-2025,Interest,"203,131.00",00.00,"2,322,092.57"
16-Feb-2025,Commission,"237,468.80",00.00,"2,559,561.37"
16-Feb-2025,Reversal,00.00,"365,651.62","2,193,909.75"
16-Feb-2025,IMPS,00.00,"219,390.98","1,974,518.78"
16-Feb-2025,Purchase,00.00,"1,974,518.78",00.00
16-Feb-2025,Bill,"1,257,520.00",00.00,"1,257,520.00"
16-Feb-2025,Cheque,00.00,"157,190.00","1,100,330.00"
16-Feb-2025,RTGS,129.00,00.00,"1,100,459.00"
16-Feb-2025,ATM,"1,062.00",00.00,"1,101,521.00"
16-Feb-2025,Reversal,"3,397.00",00.00,"1,104,918.00"
17-Feb-2025,Cheque,00.00,"368,306.00","736,612.00"
17-Feb-2025,Debit Card,"1,324,024.20",00.00,"2,060,636.20"
17-Feb-2025,Debit Card,"4,186.00",00.00,"2,064,822.20"
18-Feb-2025,Miscellaneous,00.00,"688,274.07","1,376,548.13"
18-Feb-2025,Commission,00.00,"229,424.69","1,147,123.44"
18-Feb-2025,Reversal,"204,051.40",00.00,"1,351,174.84"
18-Feb-2025,Purchase,90.00,00.00,"1,351,264.84"
18-Feb-2025,Miscellaneous,"345,512.75",00.00,"1,696,777.59"
18-Feb-2025,Miscellaneous,00.00,"212,097.20","1,484,680.39"
18-Feb-2025,Bill,"31,183.00",00.00,"1,515,863.39"
18-Feb-2025,Interest,00.00,"303,172.68","1,212,690.71"
18-Feb-2025,Miscellaneous,"5,378.90",00.00,"1,218,069.61"
18-Feb-2025,Miscellaneous,00.00,"609,034.81","609,034.81"
18-Feb-2025,Transfer,250.10,00.00,"609,284.91"
18-Feb-2025,Tax,00.00,"67,698.32","541,586.59"
18-Feb-2025,Bill,44.41,00.00,"541,631.00"
18-Feb-2025,Interest,00.00,"67,703.88","473,927.12"
18-Feb-2025,ATM,00.00,"118,481.78","355,445.34"
18-Feb-2025,Tax,00.00,"44,430.67","311,014.67"
19-Feb-2025,Commission,04.00,00.00,"311,018.67"
19-Feb-2025,ATM,00.00,"34,557.63","276,461.04"
19-Feb-2025,Transfer,03.15,00.00,"276,464.19"
19-Feb-2025,Tax,00.00,"34,558.02","241,906.17"
19-Feb-2025,Reversal,00.00,"80,635.39","161,270.78"
19-Feb-2025,Commission,18.00,00.00,"161,288.78"
19-Feb-2025,Bill,"85,605.00",00.00,"246,893.78"
19-Feb-2025,Commission,00.00,"49,378.76","197,515.02"
19-Feb-2025,ATM,"203,625.00",00.00,"401,140.02"
19-Feb-2025,Interest,00.00,"200,570.01","200,570.01"
19-Feb-2025,Debit Card,00.00,"25,071.25","175,498.76"
19-Feb-2025,Miscellaneous,"22,967.60",00.00,"198,466.36"
19-Feb-2025,Commission,00.00,"22,051.82","176,414.54"
19-Feb-2025,Commission,"1,153.60",00.00,"177,568.14"
19-Feb-2025,Commission,"29,642.25",00.00,"207,210.39"
20-Feb-2025,Cheque,00.00,"25,901.30","181,309.09"
20-Feb-2025,Commission,00.00,"25,901.30","155,407.79"
20-Feb-2025,Interest,363.40,00.00,"155,771.19"
20-Feb-2025,Miscellaneous,"175,155.20",00.00,"330,926.39"
20-Feb-2025,Transfer,"1,629,853.00",00.00,"1,960,779.39"
20-Feb-2025,Commission,00.00,"196,077.94","1,764,701.45"
20-Feb-2025,Tax,79.00,00.00,"1,764,780.45"
20-Feb-2025,Transfer,00.00,"882,390.23","882,390.22"
20-Feb-2025,Tax,00.00,"176,478.04","705,912.18"
20-Feb-2025,Bill,00.00,"705,912.18",00.00
20-Feb-2025,Commission,"2,223.00",00.00,"2,223.00"
20-Feb-2025,IMPS,00.00,"1,111.50","1,111.50"
20-Feb-2025,Interest,128.00,00.00,"1,239.50"
20-Feb-2025,Purchase,00.00,123.95,"1,115.55"
20-Feb-2025,Bill,04.00,00.00,"1,119.55"
20-Feb-2025,Tax,00.00,186.59,932.96
20-Feb-2025,Cheque,00.00,233.24,699.72
20-Feb-2025,Miscellaneous,00.00,349.86,349.86
20-Feb-2025,Tax,00.00,38.87,310.99
20-Feb-2025,Cash,00.00,31.10,279.89
20-Feb-2025,IMPS,00.00,39.98,239.91
20-Feb-2025,Commission,00.00,26.66,213.25
20-Feb-2025,Transfer,00.00,106.63,106.62
20-Feb-2025,Cash,00.00,17.77,88.85
20-Feb-2025,Debit Card,"2,820.40",00.00,"2,909.25"
20-Feb-2025,ATM,04.17,00.00,"2,913.42"
20-Feb-2025,RTGS,12.09,00.00,"2,925.51"
20-Feb-2025,IMPS,"24,469.00",00.00,"27,394.51"
21-Feb-2025,Transfer,"1,701,823.00",00.00,"1,729,217.51"
21-Feb-2025,Commission,00.00,"288,202.92","1,441,014.59"
21-Feb-2025,Purchase,00.00,"360,253.65","1,080,760.94"
21-Feb-2025,NEFT,00.00,"360,253.65","720,507.29"
21-Feb-2025,Tax,"29,169.20",00.00,"749,676.49"
21-Feb-2025,NEFT,00.00,"93,709.56","655,966.93"
21-Feb-2025,RTGS,"55,789.44",00.00,"711,756.37"
21-Feb-2025,Reversal,"137,163.00",00.00,"848,919.37"
21-Feb-2025,RTGS,"1,540,725.00",00.00,"2,389,644.37"
21-Feb-2025,Miscellaneous,00.00,"398,274.06","1,991,370.31"
21-Feb-2025,Cheque,955.45,00.00,"1,992,325.76"
21-Feb-2025,IMPS,"175,522.00",00.00,"2,167,847.76"
21-Feb-2025,Transfer,00.00,"309,692.54","1,858,155.22"
21-Feb-2025,Debit Card,53.80,00.00,"1,858,209.02"
21-Feb-2025,Debit Card,00.00,"185,820.90","1,672,388.12"
21-Feb-2025,Tax,00.00,"238,912.59","1,433,475.53"
21-Feb-2025,Bill,00.00,"179,184.44","1,254,291.09"
21-Feb-2025,Commission,00.00,"313,572.77","940,718.32"
21-Feb-2025,Reversal,00.00,"156,786.39","783,931.93"
21-Feb-2025,ATM,00.00,"261,310.64","522,621.29"
21-Feb-2025,Tax,389.40,00.00,"523,010.69"
21-Feb-2025,Transfer,00.00,"52,301.07","470,709.62"
21-Feb-2025,IMPS,00.00,"78,451.60","392,258.02"
21-Feb-2025,Miscellaneous,"1,141,911.00",00.00,"1,534,169.02"
21-Feb-2025,Cash,21.20,00.00,"1,534,190.22"
21-Feb-2025,NEFT,00.00,"219,170.03","1,315,020.19"
21-Feb-2025,NEFT,"266,514.50",00.00,"1,581,534.69"
21-Feb-2025,RTGS,04.02,00.00,"1,581,538.71"
21-Feb-2025,NEFT,00.00,"263,589.79","1,317,948.92"
21-Feb-2025,Cash,"2,389.00",00.00,"1,320,337.92"
21-Feb-2025,Cheque,00.00,"188,619.70","1,131,718.22"
21-Feb-2025,Miscellaneous,00.00,"113,171.82","1,018,546.40"
21-Feb-2025,NEFT,00.00,"254,636.60","763,909.80"
22-Feb-2025,Purchase,45.80,00.00,"763,955.60"
22-Feb-2025,Miscellaneous,00.00,"763,955.60",00.00
22-Feb-2025,Cheque,03.60,00.00,03.60
22-Feb-2025,Commission,00.00,01.20,02.40
22-Feb-2025,Debit Card,00.00,00.60,01.80
22-Feb-2025,Interest,00.00,00.23,01.58
22-Feb-2025,NEFT,"1,942.00",00.00,"1,943.58"
22-Feb-2025,Reversal,00.00,242.95,"1,700.63"
22-Feb-2025,Transfer,00.00,212.58,"1,488.05"
22-Feb-2025,Reversal,00.00,186.01,"1,302.04"
22-Feb-2025,IMPS,"386,470.20",00.00,"387,772.24"
22-Feb-2025,Bill,48.00,00.00,"387,820.24"
22-Feb-2025,Debit Card,"11,224.06",00.00,"399,044.30"
22-Feb-2025,Interest,00.00,"399,044.30",00.00
22-Feb-2025,Interest,"207,953.20",00.00,"207,953.20"
22-Feb-2025,Miscellaneous,"2,091,395.00",00.00,"2,299,348.20"
22-Feb-2025,ATM,00.00,"459,869.64","1,839,478.56"
22-Feb-2025,Debit Card,00.00,"262,782.65","1,576,695.91"
22-Feb-2025,Purchase,00.00,"1,576,695.91",00.00
22-Feb-2025,Cheque,"1,726,862.00",00.00,"1,726,862.00"
22-Feb-2025,Commission,00.00,"246,694.57","1,480,167.43"
22-Feb-2025,Reversal,00.00,"211,452.49","1,268,714.94"
22-Feb-2025,RTGS,00.00,"126,871.49","1,141,843.45"
22-Feb-2025,Interest,246.00,00.00,"1,142,089.45"
22-Feb-2025,Debit Card,"122,112.00",00.00,"1,264,201.45"
22-Feb-2025,ATM,00.00,"140,466.83","1,123,734.62"
22-Feb-2025,Purchase,00.00,"124,859.40","998,875.22"
22-Feb-2025,Miscellaneous,42.70,00.00,"998,917.92"
22-Feb-2025,Purchase,05.70,00.00,"998,923.62"
22-Feb-2025,IMPS,00.00,"499,461.81","499,461.81"
22-Feb-2025,Tax,00.00,"249,730.91","249,730.90"
22-Feb-2025,RTGS,"1,294.00",00.00,"251,024.90"
22-Feb-2025,Reversal,00.00,"25,102.49","225,922.41"
22-Feb-2025,Commission,00.00,"75,307.47","150,614.94"
22-Feb-2025,Debit Card,00.00,"50,204.98","100,409.96"
22-Feb-2025,ATM,00.00,"12,551.25","87,858.72"
22-Feb-2025,Cheque,00.00,"29,286.24","58,572.48"
22-Feb-2025,NEFT,01.00,00.00,"58,573.48"
22-Feb-2025,Transfer,00.00,"58,573.48",00.00
22-Feb-2025,Commission,"23,560.58",00.00,"23,560.58"
22-Feb-2025,Interest,00.00,"5,890.15","17,670.44"
22-Feb-2025,Interest,00.00,"4,417.61","13,252.83"
22-Feb-2025,Tax,"123,080.00",00.00,"136,332.83"
22-Feb-2025,Cheque,00.00,"22,722.14","113,610.69"
22-Feb-2025,Purchase,00.00,"37,870.23","75,740.46"
22-Feb-2025,NEFT,"1,446,065.50",00.00,"1,521,805.96"
22-Feb-2025,NEFT,19.00,00.00,"1,521,824.96"
22-Feb-2025,Bill,00.00,"169,091.66","1,352,733.30"
22-Feb-2025,Purchase,00.49,00.00,"1,352,733.79"
22-Feb-2025,NEFT,00.00,"193,247.68","1,159,486.11"
22-Feb-2025,RTGS,480.00,00.00,"1,159,966.11"
22-Feb-2025,Cheque,00.00,"386,655.37","773,310.74"
22-Feb-2025,Cheque,00.00,"77,331.07","695,979.67"
22-Feb-2025,Debit Card,00.00,"69,597.97","626,381.70"
22-Feb-2025,Bill,462.20,00.00,"626,843.90"
22-Feb-2025,Transfer,00.00,"69,649.32","557,194.58"
22-Feb-2025,Transfer,"32,376.32",00.00,"589,570.90"
22-Feb-2025,Interest,43.90,00.00,"589,614.80"
22-Feb-2025,IMPS,00.00,"196,538.27","393,076.53"
22-Feb-2025,Miscellaneous,00.00,"43,675.17","349,401.36"
22-Feb-2025,NEFT,42.18,00.00,"349,443.54"
22-Feb-2025,Reversal,"18,021.46",00.00,"367,465.00"
22-Feb-2025,ATM,"41,790.00",00.00,"409,255.00"
22-Feb-2025,NEFT,"21,525.10",00.00,"430,780.10"
22-Feb-2025,Cash,00.00,"215,390.05","215,390.05"
22-Feb-2025,Reversal,"1,483,928.50",00.00,"1,699,318.55"
22-Feb-2025,Debit Card,"1,342.47",00.00,"1,700,661.02"
22-Feb-2025,Bill,"230,426.00",00.00,"1,931,087.02"
22-Feb-2025,Miscellaneous,00.00,"965,543.51","965,543.51"
22-Feb-2025,Reversal,00.00,"965,543.51",00.00
22-Feb-2025,Interest,"1,198,739.00",00.00,"1,198,739.00"
22-Feb-2025,Cheque,"64,447.60",00.00,"1,263,186.60"
22-Feb-2025,Transfer,"10,272.75",00.00,"1,273,459.35"
22-Feb-2025,Purchase,57.00,00.00,"1,273,516.35"
22-Feb-2025,Debit Card,00.00,"424,505.45","849,010.90"
22-Feb-2025,NEFT,"29,347.12",00.00,"878,358.02"
23-Feb-2025,Miscellaneous,03.39,00.00,"878,361.41"
23-Feb-2025,Purchase,00.00,"146,393.57","731,967.84"
23-Feb-2025,Cheque,00.00,"73,196.78","658,771.06"
23-Feb-2025,NEFT,00.00,"65,877.11","592,893.95"
23-Feb-2025,RTGS,00.00,"59,289.40","533,604.55"
23-Feb-2025,Miscellaneous,00.00,"177,868.18","355,736.37"
23-Feb-2025,Interest,00.00,"71,147.27","284,589.10"
23-Feb-2025,RTGS,00.00,"31,621.01","252,968.09"
23-Feb-2025,Bill,39.00,00.00,"253,007.09"
23-Feb-2025,Commission,02.00,00.00,"253,009.09"
23-Feb-2025,Debit Card,01.28,00.00,"253,010.37"
23-Feb-2025,Transfer,00.00,"84,336.79","168,673.58"
23-Feb-2025,Commission,00.00,"16,867.36","151,806.22"
23-Feb-2025,RTGS,"2,488.10",00.00,"154,294.32"
23-Feb-2025,Bill,"1,274,402.25",00.00,"1,428,696.57"
23-Feb-2025,Transfer,"31,024.81",00.00,"1,459,721.38"
24-Feb-2025,Purchase,"363,200.00",00.00,"1,822,921.38"
24-Feb-2025,Bill,00.00,"303,820.23","1,519,101.15"
24-Feb-2025,IMPS,00.00,"217,014.45","1,302,086.70"
24-Feb-2025,RTGS,00.00,"130,208.67","1,171,878.03"
24-Feb-2025,Miscellaneous,26.12,00.00,"1,171,904.15"
25-Feb-2025,Reversal,00.00,"585,952.08","585,952.07"
25-Feb-2025,Commission,264.00,00.00,"586,216.07"
25-Feb-2025,Tax,00.00,"97,702.68","488,513.39"
25-Feb-2025,IMPS,421.00,00.00,"488,934.39"
25-Feb-2025,ATM,00.00,"122,233.60","366,700.79"
25-Feb-2025,NEFT,00.00,"45,837.60","320,863.19"
25-Feb-2025,RTGS,529.00,00.00,"321,392.19"
25-Feb-2025,RTGS,04.20,00.00,"321,396.39"
25-Feb-2025,Miscellaneous,00.00,"321,396.39",00.00
25-Feb-2025,RTGS,"92,141.80",00.00,"92,141.80"
25-Feb-2025,Reversal,00.00,"23,035.45","69,106.35"
25-Feb-2025,Debit Card,00.00,"11,517.73","57,588.63"
25-Feb-2025,IMPS,04.00,00.00,"57,592.63"
26-Feb-2025,Interest,"789,329.00",00.00,"846,921.63"
26-Feb-2025,Interest,00.00,"846,921.63",00.00
27-Feb-2025,Reversal,"252,063.80",00.00,"252,063.80"
27-Feb-2025,Miscellaneous,00.00,"126,031.90","126,031.90"
27-Feb-2025,Transfer,"1,050,068.00",00.00,"1,176,099.90"
27-Feb-2025,Transfer,00.00,"294,024.98","882,074.92"
27-Feb-2025,Debit Card,00.00,"176,414.98","705,659.94"
27-Feb-2025,Bill,00.00,"352,829.97","352,829.97"
27-Feb-2025,Reversal,239.70,00.00,"353,069.67"
27-Feb-2025,Cash,20.00,00.00,"353,089.67"
27-Feb-2025,Cheque,00.00,"117,696.56","235,393.11"
27-Feb-2025,NEFT,80.65,00.00,"235,473.76"
27-Feb-2025,ATM,04.80,00.00,"235,478.56"
27-Feb-2025,Reversal,"18,820.19",00.00,"254,298.75"
27-Feb-2025,Reversal,"1,211.00",00.00,"255,509.75"
27-Feb-2025,Debit Card,504.00,00.00,"256,013.75"
27-Feb-2025,Reversal,00.00,"85,337.92","170,675.83"
28-Feb-2025,Reversal,00.00,"24,382.26","146,293.57"
28-Feb-2025,NEFT,"1,305.02",00.00,"147,598.59"
28-Feb-2025,Bill,"7,061.13",00.00,"154,659.72"
28-Feb-2025,Miscellaneous,00.00,"25,776.62","128,883.10"
28-Feb-2025,IMPS,00.00,"21,480.52","107,402.58"
28-Feb-2025,Debit Card,"2,044,637.80",00.00,"2,152,040.38"
28-Feb-2025,Debit Card,05.00,00.00,"2,152,045.38"
28-Feb-2025,Cash,00.00,"538,011.35","1,614,034.04"
28-Feb-2025,Tax,487.00,00.00,"1,614,521.04"
28-Feb-2025,Reversal,323.30,00.00,"1,614,844.34"
28-Feb-2025,Commission,00.00,"230,692.05","1,384,152.29"
28-Feb-2025,RTGS,"1,836.01",00.00,"1,385,988.30"
28-Feb-2025,Tax,06.70,00.00,"1,385,995.00"
28-Feb-2025,Reversal,"71,756.00",00.00,"1,457,751.00"
28-Feb-2025,IMPS,245.36,00.00,"1,457,996.36"
01-Mar-2025,ATM,00.00,"291,599.27","1,166,397.09"
01-Mar-2025,Interest,00.00,"1,166,397.09",00.00
01-Mar-2025,IMPS,"1,501,463.00",00.00,"1,501,463.00"
01-Mar-2025,Cheque,01.20,00.00,"1,501,464.20"
01-Mar-2025,Debit Card,368.50,00.00,"1,501,832.70"
01-Mar-2025,Cash,00.00,"300,366.54","1,201,466.16"
01-Mar-2025,Cash,51.28,00.00,"1,201,517.44"
01-Mar-2025,IMPS,33.86,00.00,"1,201,551.30"
01-Mar-2025,RTGS,37.00,00.00,"1,201,588.30"
01-Mar-2025,Cheque,"3,637.00",00.00,"1,205,225.30"
01-Mar-2025,Interest,"12,993.40",00.00,"1,218,218.70"
01-Mar-2025,Commission,"15,923.00",00.00,"1,234,141.70"
01-Mar-2025,Commission,07.90,00.00,"1,234,149.60"
01-Mar-2025,NEFT,00.00,"205,691.60","1,028,458.00"
01-Mar-2025,ATM,00.00,"102,845.80","925,612.20"
01-Mar-2025,NEFT,00.00,"154,268.70","771,343.50"
01-Mar-2025,RTGS,"3,995.35",00.00,"775,338.85"
01-Mar-2025,Debit Card,"2,141.00",00.00,"777,479.85"
01-Mar-2025,Debit Card,00.00,"97,184.98","680,294.87"
01-Mar-2025,Interest,"207,924.00",00.00,"888,218.87"
01-Mar-2025,NEFT,00.00,"444,109.44","444,109.44"
01-Mar-2025,ATM,"1,975.00",00.00,"446,084.44"
01-Mar-2025,Cheque,196.00,00.00,"446,280.44"
01-Mar-2025,Cash,00.00,"55,785.06","390,495.38"
01-Mar-2025,Interest,01.35,00.00,"390,496.73"
01-Mar-2025,Purchase,"3,952.76",00.00,"394,449.49"
01-Mar-2025,Miscellaneous,379.20,00.00,"394,828.69"
01-Mar-2025,Interest,00.00,"78,965.74","315,862.95"
01-Mar-2025,Commission,"82,707.80",00.00,"398,570.75"
01-Mar-2025,Cash,07.90,00.00,"398,578.65"
01-Mar-2025,Miscellaneous,04.00,00.00,"398,582.65"
01-Mar-2025,NEFT,00.00,"199,291.33","199,291.32"
01-Mar-2025,Debit Card,"3,767.00",00.00,"203,058.32"
01-Mar-2025,Transfer,00.00,"33,843.05","169,215.27"
01-Mar-2025,Commission,00.00,"169,215.27",00.00
01-Mar-2025,Transfer,"4,059.40",00.00,"4,059.40"
01-Mar-2025,Reversal,00.00,451.04,"3,608.36"
01-Mar-2025,RTGS,61.00,00.00,"3,669.36"
01-Mar-2025,Debit Card,"13,654.00",00.00,"17,323.36"
01-Mar-2025,Interest,00.00,"17,323.36",00.00
01-Mar-2025,Interest,01.90,00.00,01.90
01-Mar-2025,Interest,"181,838.00",00.00,"181,839.90"
01-Mar-2025,Purchase,00.00,"45,459.98","136,379.92"
01-Mar-2025,Reversal,02.74,00.00,"136,382.66"
01-Mar-2025,Cheque,00.00,"22,730.44","113,652.22"
01-Mar-2025,Transfer,04.00,00.00,"113,656.22"
01-Mar-2025,ATM,317.30,00.00,"113,973.52"
01-Mar-2025,Interest,"3,715.37",00.00,"117,688.89"
01-Mar-2025,Reversal,00.00,"29,422.22","88,266.67"
02-Mar-2025,Cheque,00.00,"22,066.67","66,200.00"
02-Mar-2025,NEFT,44.60,00.00,"66,244.60"
02-Mar-2025,Debit Card,00.00,"11,040.77","55,203.83"
02-Mar-2025,Purchase,00.00,"55,203.83",00.00
02-Mar-2025,Cheque,13.35,00.00,13.35
02-Mar-2025,Reversal,00.00,01.67,11.68
02-Mar-2025,Tax,00.00,02.34,09.34
02-Mar-2025,Debit Card,00.00,01.04,08.30
02-Mar-2025,Tax,214.00,00.00,222.30
02-Mar-2025,Purchase,00.00,31.76,190.54
02-Mar-2025,Bill,"2,573.23",00.00,"2,763.77"
02-Mar-2025,NEFT,00.00,345.47,"2,418.30"
02-Mar-2025,Reversal,"19,056.60",00.00,"21,474.90"
02-Mar-2025,Cheque,00.00,"2,386.10","19,088.80"
02-Mar-2025,Transfer,"2,220.71",00.00,"21,309.51"
02-Mar-2025,NEFT,00.00,"4,261.90","17,047.61"
02-Mar-2025,NEFT,00.00,"5,682.54","11,365.07"
02-Mar-2025,Commission,"2,388.64",00.00,"13,753.71"
02-Mar-2025,RTGS,27.10,00.00,"13,780.81"
02-Mar-2025,Reversal,00.00,"1,722.60","12,058.21"
02-Mar-2025,Reversal,05.00,00.00,"12,063.21"
02-Mar-2025,Debit Card,463.30,00.00,"12,526.51"
02-Mar-2025,Purchase,00.00,"2,087.75","10,438.76"
02-Mar-2025,RTGS,"428,479.25",00.00,"438,918.01"
02-Mar-2025,Cheque,"15,753.10",00.00,"454,671.11"
02-Mar-2025,Cheque,00.00,"56,833.89","397,837.22"
02-Mar-2025,ATM,00.00,"79,567.44","318,269.78"
03-Mar-2025,Miscellaneous,00.00,"31,826.98","286,442.80"
03-Mar-2025,Commission,"855,956.00",00.00,"1,142,398.80"
03-Mar-2025,Bill,462.00,00.00,"1,142,860.80"
03-Mar-2025,IMPS,"1,943,061.50",00.00,"3,085,922.30"
03-Mar-2025,Miscellaneous,00.00,"1,028,640.77","2,057,281.53"
03-Mar-2025,Cash,00.00,"257,160.19","1,800,121.34"
03-Mar-2025,RTGS,00.00,"1,800,121.34",00.00
03-Mar-2025,Cash,"725,584.50",00.00,"725,584.50"
03-Mar-2025,RTGS,00.00,"725,584.50",00.00
03-Mar-2025,Tax,"117,345.00",00.00,"117,345.00"
03-Mar-2025,ATM,07.71,00.00,"117,352.71"
03-Mar-2025,Interest,00.00,"29,338.18","88,014.53"
03-Mar-2025,IMPS,"1,162.30",00.00,"89,176.83"
03-Mar-2025,Reversal,"59,430.60",00.00,"148,607.43"
03-Mar-2025,NEFT,00.00,"148,607.43",00.00
03-Mar-2025,Cheque,03.10,00.00,03.10
03-Mar-2025,Tax,00.00,00.78,02.33
03-Mar-2025,Tax,00.00,00.58,01.75
03-Mar-2025,Transfer,00.00,00.58,01.17
03-Mar-2025,ATM,"29,619.00",00.00,"29,620.17"
03-Mar-2025,Cash,"1,929,649.00",00.00,"1,959,269.17"
04-Mar-2025,IMPS,08.00,00.00,"1,959,277.17"
04-Mar-2025,NEFT,100.34,00.00,"1,959,377.51"
04-Mar-2025,NEFT,00.00,"979,688.76","979,688.76"
04-Mar-2025,Miscellaneous,00.00,"489,844.38","489,844.38"
04-Mar-2025,IMPS,"3,893.84",00.00,"493,738.22"
04-Mar-2025,Debit Card,00.00,"49,373.82","444,364.40"
04-Mar-2025,Purchase,"2,958.92",00.00,"447,323.32"
04-Mar-2025,IMPS,00.00,"149,107.77","298,215.55"
04-Mar-2025,Miscellaneous,00.00,"29,821.56","268,394.00"
04-Mar-2025,NEFT,"1,301.00",00.00,"269,695.00"
05-Mar-2025,Purchase,00.00,"38,527.86","231,167.14"
05-Mar-2025,Transfer,"55,578.00",00.00,"286,745.14"
05-Mar-2025,Cash,06.70,00.00,"286,751.84"
05-Mar-2025,ATM,00.00,"47,791.97","238,959.87"
05-Mar-2025,Commission,00.00,"59,739.97","179,219.90"
05-Mar-2025,IMPS,"932,733.25",00.00,"1,111,953.15"
05-Mar-2025,Miscellaneous,00.00,"158,850.45","953,102.70"
05-Mar-2025,IMPS,04.00,00.00,"953,106.70"
05-Mar-2025,Cash,00.00,"105,900.74","847,205.96"
05-Mar-2025,Reversal,"3,902.25",00.00,"851,108.21"
05-Mar-2025,Commission,00.00,"85,110.82","765,997.39"
05-Mar-2025,Transfer,"166,631.72",00.00,"932,629.11"
05-Mar-2025,IMPS,"110,448.44",00.00,"1,043,077.55"
05-Mar-2025,Cheque,00.00,"521,538.78","521,538.78"
05-Mar-2025,Transfer,582.50,00.00,"522,121.28"
05-Mar-2025,Transfer,00.00,"522,121.28",00.00
05-Mar-2025,Miscellaneous,00.70,00.00,00.70
05-Mar-2025,Tax,00.00,00.70,00.00
05-Mar-2025,Interest,08.00,00.00,08.00
05-Mar-2025,RTGS,"1,159.38",00.00,"1,167.38"
05-Mar-2025,Bill,52.00,00.00,"1,219.38"
05-Mar-2025,NEFT,"2,027,337.20",00.00,"2,028,556.58"
05-Mar-2025,Miscellaneous,"194,312.00",00.00,"2,222,868.58"
05-Mar-2025,Reversal,38.00,00.00,"2,222,906.58"
05-Mar-2025,ATM,31.50,00.00,"2,222,938.08"
05-Mar-2025,Commission,00.00,"317,562.58","1,905,375.50"
05-Mar-2025,Interest,"74,250.00",00.00,"1,979,625.50"
05-Mar-2025,Reversal,00.00,"282,803.64","1,696,821.86"
05-Mar-2025,RTGS,"676,656.00",00.00,"2,373,477.86"
05-Mar-2025,Cheque,02.00,00.00,"2,373,479.86"
05-Mar-2025,Miscellaneous,"4,093.00",00.00,"2,377,572.86"
05-Mar-2025,Interest,00.00,"237,757.29","2,139,815.57"
05-Mar-2025,Bill,00.00,"356,635.93","1,783,179.64"
05-Mar-2025,Debit Card,"1,041,842.20",00.00,"2,825,021.84"
05-Mar-2025,Purchase,05.00,00.00,"2,825,026.84"
05-Mar-2025,Interest,00.00,"1,412,513.42","1,412,513.42"
05-Mar-2025,Reversal,06.70,00.00,"1,412,520.12"
05-Mar-2025,Commission,00.00,"235,420.02","1,177,100.10"
05-Mar-2025,IMPS,00.00,"147,137.51","1,029,962.59"
05-Mar-2025,Commission,00.00,"1,029,962.59",00.00
05-Mar-2025,Reversal,390.20,00.00,390.20
05-Mar-2025,RTGS,"815,896.00",00.00,"816,286.20"
05-Mar-2025,Debit Card,00.00,"163,257.24","653,028.96"
05-Mar-2025,Reversal,288.27,00.00,"653,317.23"
05-Mar-2025,ATM,00.00,"217,772.41","435,544.82"
05-Mar-2025,Cheque,06.78,00.00,"435,551.60"
05-Mar-2025,Tax,00.00,"43,555.16","391,996.44"
05-Mar-2025,RTGS,00.00,"78,399.29","313,597.15"
05-Mar-2025,Miscellaneous,61.11,00.00,"313,658.26"
05-Mar-2025,Transfer,00.00,"62,731.65","250,926.61"
05-Mar-2025,Interest,00.00,"41,821.10","209,105.51"
05-Mar-2025,ATM,00.00,"26,138.19","182,967.32"
05-Mar-2025,Transfer,"162,158.20",00.00,"345,125.52"
05-Mar-2025,Bill,00.00,"86,281.38","258,844.14"
05-Mar-2025,Commission,"237,763.38",00.00,"496,607.52"
05-Mar-2025,IMPS,04.20,00.00,"496,611.72"
05-Mar-2025,Miscellaneous,00.00,"62,076.47","434,535.26"
05-Mar-2025,NEFT,11.85,00.00,"434,547.11"
05-Mar-2025,Interest,00.00,"48,283.01","386,264.10"
05-Mar-2025,Cheque,"2,058,721.80",00.00,"2,444,985.90"
05-Mar-2025,Transfer,55.00,00.00,"2,445,040.90"
05-Mar-2025,Purchase,00.00,"489,008.18","1,956,032.72"
06-Mar-2025,Miscellaneous,"483,793.00",00.00,"2,439,825.72"
06-Mar-2025,IMPS,00.00,"813,275.24","1,626,550.48"
06-Mar-2025,ATM,03.38,00.00,"1,626,553.86"
06-Mar-2025,Miscellaneous,461.15,00.00,"1,627,015.01"
06-Mar-2025,Transfer,"13,720.44",00.00,"1,640,735.45"
06-Mar-2025,Miscellaneous,05.00,00.00,"1,640,740.45"
06-Mar-2025,IMPS,111.26,00.00,"1,640,851.71"
06-Mar-2025,Debit Card,00.00,"328,170.34","1,312,681.37"
06-Mar-2025,IMPS,00.00,"187,525.91","1,125,155.46"
06-Mar-2025,Purchase,00.00,"187,525.91","937,629.55"
06-Mar-2025,Purchase,07.00,00.00,"937,636.55"
06-Mar-2025,Transfer,"332,208.25",00.00,"1,269,844.80"
06-Mar-2025,RTGS,"1,554,322.00",00.00,"2,824,166.80"
06-Mar-2025,Bill,00.00,"564,833.36","2,259,333.44"
06-Mar-2025,ATM,"1,422,899.50",00.00,"3,682,232.94"
06-Mar-2025,Cheque,02.10,00.00,"3,682,235.04"
06-Mar-2025,Tax,"76,695.62",00.00,"3,758,930.66"
06-Mar-2025,IMPS,"230,172.10",00.00,"3,989,102.76"
06-Mar-2025,Commission,"2,950.00",00.00,"3,992,052.76"
06-Mar-2025,Purchase,03.68,00.00,"3,992,056.44"
06-Mar-2025,IMPS,"123,377.00",00.00,"4,115,433.44"
06-Mar-2025,Cheque,"1,810.50",00.00,"4,117,243.94"
06-Mar-2025,Debit Card,"1,931.00",00.00,"4,119,174.94"
06-Mar-2025,Debit Card,00.00,"411,917.49","3,707,257.45"
06-Mar-2025,Interest,02.90,00.00,"3,707,260.35"
06-Mar-2025,RTGS,384.60,00.00,"3,707,644.95"
06-Mar-2025,ATM,04.00,00.00,"3,707,648.95"
06-Mar-2025,Cheque,"843,772.00",00.00,"4,551,420.95"
06-Mar-2025,Debit Card,00.00,"758,570.16","3,792,850.79"
06-Mar-2025,Purchase,00.00,"541,835.83","3,251,014.96"
06-Mar-2025,Transfer,00.00,"361,223.88","2,889,791.08"
06-Mar-2025,IMPS,01.00,00.00,"2,889,792.08"
06-Mar-2025,Tax,04.00,00.00,"2,889,796.08"
06-Mar-2025,Interest,00.81,00.00,"2,889,796.89"
06-Mar-2025,Cheque,00.00,"321,088.54","2,568,708.35"
06-Mar-2025,IMPS,00.00,"366,958.34","2,201,750.01"
06-Mar-2025,Purchase,"2,379.81",00.00,"2,204,129.82"
06-Mar-2025,Bill,00.00,"275,516.23","1,928,613.59"
06-Mar-2025,Reversal,"58,991.00",00.00,"1,987,604.59"
06-Mar-2025,Cheque,419.00,00.00,"1,988,023.59"
06-Mar-2025,Commission,00.00,"497,005.90","1,491,017.69"
06-Mar-2025,NEFT,05.63,00.00,"1,491,023.32"
06-Mar-2025,ATM,00.30,00.00,"1,491,023.62"
06-Mar-2025,ATM,00.00,"1,491,023.62",00.00
06-Mar-2025,Bill,272.00,00.00,272.00
06-Mar-2025,Miscellaneous,93.41,00.00,365.41
06-Mar-2025,Miscellaneous,00.00,91.35,274.06
06-Mar-2025,Miscellaneous,"1,331,947.00",00.00,"1,332,221.06"
06-Mar-2025,Commission,"57,493.00",00.00,"1,389,714.06"
06-Mar-2025,RTGS,"379,640.75",00.00,"1,769,354.81"
06-Mar-2025,IMPS,00.00,"884,677.41","884,677.40"
06-Mar-2025,Miscellaneous,"22,928.72",00.00,"907,606.12"
06-Mar-2025,RTGS,00.00,"151,267.69","756,338.43"
06-Mar-2025,Tax,"1,968.18",00.00,"758,306.61"
06-Mar-2025,Interest,03.00,00.00,"758,309.61"
06-Mar-2025,Tax,149.50,00.00,"758,459.11"
06-Mar-2025,Cash,00.00,"84,273.23","674,185.88"
06-Mar-2025,Transfer,"17,855.00",00.00,"692,040.88"
06-Mar-2025,Commission,"22,915.40",00.00,"714,956.28"
06-Mar-2025,Miscellaneous,"20,306.53",00.00,"735,262.81"
06-Mar-2025,Tax,00.00,"367,631.41","367,631.40"
06-Mar-2025,Miscellaneous,00.00,"61,271.90","306,359.50"
06-Mar-2025,ATM,"484,151.50",00.00,"790,511.00"
06-Mar-2025,IMPS,"26,206.90",00.00,"816,717.90"
06-Mar-2025,Reversal,00.00,"204,179.48","612,538.43"
06-Mar-2025,Interest,00.00,"612,538.43",00.00
06-Mar-2025,Transfer,"151,462.00",00.00,"151,462.00"
06-Mar-2025,Miscellaneous,00.00,"18,932.75","132,529.25"
06-Mar-2025,Miscellaneous,00.00,"33,132.31","99,396.94"
06-Mar-2025,Cash,00.00,"99,396.94",00.00
06-Mar-2025,NEFT,05.00,00.00,05.00
06-Mar-2025,Cash,00.00,01.00,04.00
06-Mar-2025,Cash,02.98,00.00,06.98
06-Mar-2025,Interest,00.00,02.33,04.65
06-Mar-2025,RTGS,00.00,00.52,04.13
06-Mar-2025,Reversal,"22,811.50",00.00,"22,815.63"
06-Mar-2025,ATM,37.40,00.00,"22,853.03"
07-Mar-2025,Tax,00.00,"5,713.26","17,139.77"
07-Mar-2025,ATM,712.40,00.00,"17,852.17"
07-Mar-2025,NEFT,00.00,"2,550.31","15,301.86"
07-Mar-2025,Interest,00.00,"1,700.21","13,601.65"
07-Mar-2025,Purchase,42.32,00.00,"13,643.97"
07-Mar-2025,NEFT,00.00,"1,364.40","12,279.57"
07-Mar-2025,Miscellaneous,61.50,00.00,"12,341.07"
07-Mar-2025,Interest,"2,524.61",00.00,"14,865.68"
07-Mar-2025,Commission,00.00,"3,716.42","11,149.26"
08-Mar-2025,Bill,00.00,"1,114.93","10,034.33"
08-Mar-2025,Reversal,"9,686.60",00.00,"19,720.93"
08-Mar-2025,Tax,00.00,"9,860.47","9,860.46"
08-Mar-2025,Tax,00.00,"9,860.46",00.00
08-Mar-2025,Purchase,"895,284.50",00.00,"895,284.50"
08-Mar-2025,Bill,00.00,"89,528.45","805,756.05"
08-Mar-2025,Transfer,00.00,"201,439.01","604,317.04"
08-Mar-2025,Debit Card,02.15,00.00,"604,319.19"
08-Mar-2025,NEFT,00.00,"604,319.19",00.00
08-Mar-2025,NEFT,"10,621.00",00.00,"10,621.00"
08-Mar-2025,NEFT,00.00,"1,180.11","9,440.89"
08-Mar-2025,Transfer,00.00,944.09,"8,496.80"
08-Mar-2025,Bill,00.00,"4,248.40","4,248.40"
08-Mar-2025,Purchase,"10,912.30",00.00,"15,160.70"
08-Mar-2025,Commission,00.00,"1,684.52","13,476.18"
08-Mar-2025,Debit Card,"1,089,967.80",00.00,"1,103,443.98"
08-Mar-2025,ATM,"223,781.50",00.00,"1,327,225.48"
08-Mar-2025,Interest,00.00,"1,327,225.48",00.00
08-Mar-2025,Miscellaneous,"2,452.78",00.00,"2,452.78"
08-Mar-2025,Commission,00.00,245.28,"2,207.50"
08-Mar-2025,NEFT,00.00,"1,103.75","1,103.75"
08-Mar-2025,Interest,00.00,110.38,993.38
08-Mar-2025,Transfer,"2,658.05",00.00,"3,651.43"
08-Mar-2025,RTGS,07.00,00.00,"3,658.43"
08-Mar-2025,Commission,00.00,457.30,"3,201.13"
08-Mar-2025,Miscellaneous,"228,419.41",00.00,"231,620.54"
08-Mar-2025,NEFT,00.00,"38,603.42","193,017.12"
08-Mar-2025,NEFT,"1,363.60",00.00,"194,380.72"
08-Mar-2025,IMPS,07.50,00.00,"194,388.22"
08-Mar-2025,IMPS,"32,501.47",00.00,"226,889.69"
08-Mar-2025,Miscellaneous,00.00,"56,722.42","170,167.27"
08-Mar-2025,IMPS,00.99,00.00,"170,168.26"
08-Mar-2025,RTGS,00.00,"170,168.26",00.00
08-Mar-2025,Bill,339.70,00.00,339.70
08-Mar-2025,Debit Card,"2,479.38",00.00,"2,819.08"
08-Mar-2025,ATM,40.00,00.00,"2,859.08"
08-Mar-2025,Cheque,00.00,285.91,"2,573.17"
08-Mar-2025,Commission,06.41,00.00,"2,579.58"
08-Mar-2025,Transfer,58.93,00.00,"2,638.51"
08-Mar-2025,Commission,"163,784.22",00.00,"166,422.73"
08-Mar-2025,Transfer,00.00,"166,422.73",00.00
08-Mar-2025,Reversal,"13,115.60",00.00,"13,115.60"
08-Mar-2025,Bill,"987,441.00",00.00,"1,000,556.60"
08-Mar-2025,RTGS,"2,859.60",00.00,"1,003,416.20"
08-Mar-2025,Commission,00.00,"334,472.07","668,944.13"
08-Mar-2025,Reversal,00.00,"668,944.13",00.00
08-Mar-2025,Transfer,"1,989.00",00.00,"1,989.00"
08-Mar-2025,Purchase,"3,174.39",00.00,"5,163.39"
08-Mar-2025,Bill,00.00,"1,032.68","4,130.71"
08-Mar-2025,Transfer,21.98,00.00,"4,152.69"
08-Mar-2025,Cheque,00.00,519.09,"3,633.60"
08-Mar-2025,Cheque,"159,071.34",00.00,"162,704.94"
08-Mar-2025,ATM,00.00,"20,338.12","142,366.82"
08-Mar-2025,Purchase,"2,318.03",00.00,"144,684.85"
08-Mar-2025,Reversal,00.00,"28,936.97","115,747.88"
08-Mar-2025,ATM,00.00,"38,582.63","77,165.25"
09-Mar-2025,Cash,58.10,00.00,"77,223.35"
09-Mar-2025,Bill,00.00,"77,223.35",00.00
09-Mar-2025,Debit Card,07.00,00.00,07.00
09-Mar-2025,Purchase,00.00,01.00,06.00
09-Mar-2025,NEFT,"1,709,582.00",00.00,"1,709,588.00"
09-Mar-2025,Reversal,00.00,"284,931.33","1,424,656.67"
09-Mar-2025,Reversal,288.20,00.00,"1,424,944.87"
09-Mar-2025,Reversal,"17,962.00",00.00,"1,442,906.87"
09-Mar-2025,Transfer,00.00,"360,726.72","1,082,180.15"
09-Mar-2025,Purchase,00.00,"541,090.08","541,090.07"
09-Mar-2025,Tax,594.00,00.00,"541,684.07"
09-Mar-2025,Cash,254.63,00.00,"541,938.70"
09-Mar-2025,Debit Card,"5,063.60",00.00,"547,002.30"
09-Mar-2025,IMPS,00.00,"136,750.58","410,251.72"
09-Mar-2025,Cash,"173,356.00",00.00,"583,607.72"
09-Mar-2025,Interest,00.00,"145,901.93","437,705.79"
09-Mar-2025,ATM,"1,644.99",00.00,"439,350.78"
09-Mar-2025,Commission,00.00,"54,918.85","384,431.93"
09-Mar-2025,Tax,07.01,00.00,"384,438.94"
09-Mar-2025,Tax,"28,757.00",00.00,"413,195.94"
09-Mar-2025,ATM,00.00,"68,865.99","344,329.95"
09-Mar-2025,Interest,00.00,"49,189.99","295,139.96"
09-Mar-2025,NEFT,00.00,"29,514.00","265,625.96"
09-Mar-2025,IMPS,306.00,00.00,"265,931.96"
09-Mar-2025,Cheque,00.00,"53,186.39","212,745.57"
09-Mar-2025,Commission,00.00,"106,372.79","106,372.78"
09-Mar-2025,Tax,285.33,00.00,"106,658.11"
09-Mar-2025,Cash,"3,673.54",00.00,"110,331.65"
09-Mar-2025,Debit Card,"49,826.00",00.00,"160,157.65"
09-Mar-2025,Transfer,00.00,"53,385.88","106,771.77"
09-Mar-2025,RTGS,00.00,"11,863.53","94,908.24"
09-Mar-2025,RTGS,245.70,00.00,"95,153.94"
09-Mar-2025,Commission,00.00,"23,788.49","71,365.46"
09-Mar-2025,Cheque,00.00,"7,929.50","63,435.96"
09-Mar-2025,Debit Card,"139,262.60",00.00,"202,698.56"
09-Mar-2025,Miscellaneous,00.00,"22,522.06","180,176.50"
09-Mar-2025,Reversal,"11,377.60",00.00,"191,554.10"
09-Mar-2025,NEFT,00.00,"47,888.53","143,665.58"
09-Mar-2025,ATM,61.53,00.00,"143,727.11"
09-Mar-2025,Debit Card,"250,637.47",00.00,"394,364.58"
09-Mar-2025,Cheque,00.00,"56,337.80","338,026.78"
09-Mar-2025,RTGS,00.00,"67,605.36","270,421.42"
09-Mar-2025,Miscellaneous,20.80,00.00,"270,442.22"
09-Mar-2025,Cheque,"104,644.00",00.00,"375,086.22"
09-Mar-2025,Purchase,335.00,00.00,"375,421.22"
09-Mar-2025,Transfer,02.90,00.00,"375,424.12"
09-Mar-2025,Reversal,02.30,00.00,"375,426.42"
09-Mar-2025,Bill,115.50,00.00,"375,541.92"
09-Mar-2025,Purchase,00.00,"53,648.85","321,893.07"
09-Mar-2025,Transfer,106.40,00.00,"321,999.47"
09-Mar-2025,NEFT,"1,005,793.00",00.00,"1,327,792.47"
09-Mar-2025,RTGS,00.00,"442,597.49","885,194.98"
09-Mar-2025,Bill,00.00,"88,519.50","796,675.48"
09-Mar-2025,Reversal,00.00,"88,519.50","708,155.98"
09-Mar-2025,IMPS,"254,309.50",00.00,"962,465.48"
09-Mar-2025,IMPS,00.00,"120,308.19","842,157.30"
09-Mar-2025,IMPS,"1,771,566.00",00.00,"2,613,723.30"
09-Mar-2025,Transfer,00.00,"871,241.10","1,742,482.20"
09-Mar-2025,IMPS,50.56,00.00,"1,742,532.76"
09-Mar-2025,RTGS,00.00,"290,422.13","1,452,110.63"
09-Mar-2025,Interest,"821,608.50",00.00,"2,273,719.13"
09-Mar-2025,Miscellaneous,00.00,"284,214.89","1,989,504.24"
09-Mar-2025,Purchase,"882,850.00",00.00,"2,872,354.24"
09-Mar-2025,ATM,00.00,"1,436,177.12","1,436,177.12"
09-Mar-2025,Commission,56.30,00.00,"1,436,233.42"
09-Mar-2025,Cheque,210.40,00.00,"1,436,443.82"
09-Mar-2025,Miscellaneous,"625,613.00",00.00,"2,062,056.82"
09-Mar-2025,IMPS,00.00,"294,579.55","1,767,477.27"
09-Mar-2025,Reversal,"74,071.81",00.00,"1,841,549.08"
09-Mar-2025,NEFT,856.00,00.00,"1,842,405.08"
09-Mar-2025,Tax,00.00,"460,601.27","1,381,803.81"
09-Mar-2025,Cheque,00.00,"230,300.64","1,151,503.18"
09-Mar-2025,IMPS,"3,185.42",00.00,"1,154,688.60"
09-Mar-2025,Cheque,"118,657.20",00.00,"1,273,345.80"
09-Mar-2025,Interest,"9,756.00",00.00,"1,283,101.80"
09-Mar-2025,Commission,06.00,00.00,"1,283,107.80"
09-Mar-2025,Cheque,00.00,"427,702.60","855,405.20"
09-Mar-2025,Cash,04.60,00.00,"855,409.80"
09-Mar-2025,NEFT,00.00,"142,568.30","712,841.50"
09-Mar-2025,NEFT,"2,036,105.80",00.00,"2,748,947.30"
09-Mar-2025,Commission,00.00,"343,618.41","2,405,328.89"
09-Mar-2025,Cheque,00.00,"481,065.78","1,924,263.11"
09-Mar-2025,Transfer,"86,807.12",00.00,"2,011,070.23"
10-Mar-2025,Tax,00.00,"287,295.75","1,723,774.48"
10-Mar-2025,Commission,00.00,"861,887.24","861,887.24"
10-Mar-2025,Transfer,32.00,00.00,"861,919.24"
10-Mar-2025,Transfer,00.00,"215,479.81","646,439.43"
10-Mar-2025,IMPS,"30,968.25",00.00,"677,407.68"
10-Mar-2025,NEFT,00.00,"169,351.92","508,055.76"
10-Mar-2025,NEFT,00.00,"169,351.92","338,703.84"
10-Mar-2025,Transfer,"50,206.00",00.00,"388,909.84"
10-Mar-2025,Cheque,"1,885.63",00.00,"390,795.47"
10-Mar-2025,Commission,"15,544.06",00.00,"406,339.53"
10-Mar-2025,Cheque,"3,555.92",00.00,"409,895.45"
10-Mar-2025,Reversal,"77,690.00",00.00,"487,585.45"
10-Mar-2025,Miscellaneous,81.00,00.00,"487,666.45"
10-Mar-2025,Transfer,00.00,"162,555.48","325,110.97"
10-Mar-2025,Cash,00.00,"65,022.19","260,088.78"
10-Mar-2025,IMPS,00.00,"26,008.88","234,079.90"
10-Mar-2025,RTGS,00.00,"26,008.88","208,071.02"
10-Mar-2025,Miscellaneous,00.00,"52,017.76","156,053.26"
10-Mar-2025,Interest,421.00,00.00,"156,474.26"
10-Mar-2025,Debit Card,"753,008.00",00.00,"909,482.26"
10-Mar-2025,ATM,00.00,"151,580.38","757,901.88"
10-Mar-2025,Bill,"94,406.20",00.00,"852,308.08"
10-Mar-2025,ATM,00.00,"106,538.51","745,769.57"
10-Mar-2025,Reversal,00.00,"82,863.29","662,906.28"
10-Mar-2025,RTGS,00.00,"165,726.57","497,179.71"
10-Mar-2025,Cash,00.00,"71,025.67","426,154.04"
10-Mar-2025,Cash,00.00,"53,269.26","372,884.78"
10-Mar-2025,NEFT,00.00,"124,294.93","248,589.85"
10-Mar-2025,Cash,22.15,00.00,"248,612.00"
10-Mar-2025,Interest,15.70,00.00,"248,627.70"
10-Mar-2025,Interest,00.00,"82,875.90","165,751.80"
10-Mar-2025,Interest,00.00,"33,150.36","132,601.44"
10-Mar-2025,Reversal,00.00,"16,575.18","116,026.26"
10-Mar-2025,Purchase,00.00,"12,891.81","103,134.45"
10-Mar-2025,Miscellaneous,"72,673.28",00.00,"175,807.73"
10-Mar-2025,Miscellaneous,"24,755.00",00.00,"200,562.73"
10-Mar-2025,Miscellaneous,00.00,"20,056.27","180,506.46"
10-Mar-2025,Purchase,00.00,"25,786.64","154,719.82"
10-Mar-2025,Cash,00.00,"154,719.82",00.00
10-Mar-2025,NEFT,"2,097.00",00.00,"2,097.00"
10-Mar-2025,Miscellaneous,01.90,00.00,"2,098.90"
10-Mar-2025,Cheque,60.33,00.00,"2,159.23"
10-Mar-2025,Debit Card,00.00,539.81,"1,619.42"
10-Mar-2025,ATM,03.33,00.00,"1,622.75"
10-Mar-2025,Bill,00.00,811.38,811.38
10-Mar-2025,IMPS,00.00,811.38,00.00
10-Mar-2025,Interest,"1,688,595.20",00.00,"1,688,595.20"
10-Mar-2025,Cheque,00.00,"844,297.60","844,297.60"
10-Mar-2025,Transfer,04.00,00.00,"844,301.60"
11-Mar-2025,Miscellaneous,00.00,"211,075.40","633,226.20"
11-Mar-2025,NEFT,00.00,"63,322.62","569,903.58"
11-Mar-2025,NEFT,06.87,00.00,"569,910.45"
11-Mar-2025,RTGS,"3,166.85",00.00,"573,077.30"
11-Mar-2025,Purchase,00.00,"286,538.65","286,538.65"
11-Mar-2025,Purchase,"7,100.89",00.00,"293,639.54"
11-Mar-2025,Transfer,"164,182.38",00.00,"457,821.92"
11-Mar-2025,Interest,"3,365.20",00.00,"461,187.12"
11-Mar-2025,NEFT,"2,865.63",00.00,"464,052.75"
11-Mar-2025,Interest,"164,503.50",00.00,"628,556.25"
11-Mar-2025,Bill,02.40,00.00,"628,558.65"
11-Mar-2025,Interest,01.00,00.00,"628,559.65"
12-Mar-2025,Cheque,"475,295.50",00.00,"1,103,855.15"
12-Mar-2025,Reversal,"10,067.50",00.00,"1,113,922.65"
12-Mar-2025,ATM,00.00,"222,784.53","891,138.12"
12-Mar-2025,Miscellaneous,02.70,00.00,"891,140.82"
12-Mar-2025,Purchase,"1,693,082.50",00.00,"2,584,223.32"
12-Mar-2025,IMPS,"249,716.28",00.00,"2,833,939.60"
12-Mar-2025,Miscellaneous,"2,870.50",00.00,"2,836,810.10"
12-Mar-2025,Miscellaneous,00.00,"472,801.68","2,364,008.42"
12-Mar-2025,Miscellaneous,"2,791.10",00.00,"2,366,799.52"
12-Mar-2025,Debit Card,00.00,"591,699.88","1,775,099.64"
12-Mar-2025,Miscellaneous,"2,054.31",00.00,"1,777,153.95"
12-Mar-2025,Reversal,00.00,"253,879.14","1,523,274.81"
12-Mar-2025,NEFT,06.30,00.00,"1,523,281.11"
12-Mar-2025,Reversal,"26,804.10",00.00,"1,550,085.21"
12-Mar-2025,NEFT,00.00,"387,521.30","1,162,563.91"
12-Mar-2025,Reversal,00.00,"129,173.77","1,033,390.14"
12-Mar-2025,Cash,00.00,"344,463.38","688,926.76"
12-Mar-2025,Reversal,"215,541.00",00.00,"904,467.76"
12-Mar-2025,Reversal,00.00,"113,058.47","791,409.29"
12-Mar-2025,Commission,637.90,00.00,"792,047.19"
12-Mar-2025,Bill,01.00,00.00,"792,048.19"
12-Mar-2025,Tax,00.00,"198,012.05","594,036.14"
12-Mar-2025,Reversal,00.00,"99,006.02","495,030.12"
12-Mar-2025,RTGS,00.00,"49,503.01","445,527.11"
12-Mar-2025,Cheque,00.00,"445,527.11",00.00
12-Mar-2025,Commission,33.30,00.00,33.30
12-Mar-2025,Miscellaneous,"1,009,803.00",00.00,"1,009,836.30"
12-Mar-2025,Cash,00.00,"252,459.08","757,377.23"
12-Mar-2025,RTGS,00.00,"757,377.23",00.00
12-Mar-2025,Debit Card,62.00,00.00,62.00
12-Mar-2025,Cheque,05.44,00.00,67.44
12-Mar-2025,Cheque,63.10,00.00,130.54
12-Mar-2025,Bill,"224,759.50",00.00,"224,890.04"
12-Mar-2025,ATM,227.30,00.00,"225,117.34"
12-Mar-2025,Cheque,00.00,"75,039.11","150,078.23"
12-Mar-2025,Bill,"271,300.75",00.00,"421,378.98"
12-Mar-2025,RTGS,415.00,00.00,"421,793.98"
12-Mar-2025,Miscellaneous,"71,687.00",00.00,"493,480.98"
13-Mar-2025,Commission,"1,765,004.00",00.00,"2,258,484.98"
13-Mar-2025,ATM,00.00,"451,697.00","1,806,787.98"
13-Mar-2025,ATM,00.00,"1,806,787.98",00.00
13-Mar-2025,ATM,"28,026.50",00.00,"28,026.50"
13-Mar-2025,Commission,00.00,"2,802.65","25,223.85"
13-Mar-2025,Purchase,00.00,"4,203.98","21,019.88"
13-Mar-2025,ATM,00.00,"5,254.97","15,764.91"
13-Mar-2025,Cheque,85.70,00.00,"15,850.61"
13-Mar-2025,Reversal,00.00,"3,170.12","12,680.49"
13-Mar-2025,Purchase,00.00,"12,680.49",00.00
14-Mar-2025,Cheque,"1,129,380.00",00.00,"1,129,380.00"
14-Mar-2025,RTGS,00.00,"376,460.00","752,920.00"
14-Mar-2025,Bill,28.00,00.00,"752,948.00"
14-Mar-2025,Purchase,"1,775,056.80",00.00,"2,528,004.80"
14-Mar-2025,Bill,00.50,00.00,"2,528,005.30"
14-Mar-2025,Interest,"25,734.00",00.00,"2,553,739.30"
14-Mar-2025,Bill,01.70,00.00,"2,553,741.00"
14-Mar-2025,Cheque,00.00,"319,217.63","2,234,523.38"
14-Mar-2025,Interest,00.00,"372,420.56","1,862,102.82"
14-Mar-2025,Reversal,00.00,"372,420.56","1,489,682.26"
14-Mar-2025,IMPS,00.00,"744,841.13","744,841.13"
14-Mar-2025,NEFT,00.00,"93,105.14","651,735.99"
14-Mar-2025,Commission,00.00,"108,622.67","543,113.32"
14-Mar-2025,IMPS,00.00,"90,518.89","452,594.43"
14-Mar-2025,RTGS,63.77,00.00,"452,658.20"
14-Mar-2025,ATM,384.40,00.00,"453,042.60"
14-Mar-2025,Cheque,00.00,"90,608.52","362,434.08"
14-Mar-2025,Cash,00.00,"90,608.52","271,825.56"
14-Mar-2025,ATM,04.00,00.00,"271,829.56"
15-Mar-2025,Bill,"236,092.00",00.00,"507,921.56"
15-Mar-2025,ATM,04.70,00.00,"507,926.26"
15-Mar-2025,Bill,00.00,"50,792.63","457,133.63"
15-Mar-2025,Debit Card,00.00,"45,713.36","411,420.27"
15-Mar-2025,IMPS,00.00,"82,284.05","329,136.22"
15-Mar-2025,Transfer,"135,324.70",00.00,"464,460.92"
15-Mar-2025,Cash,185.01,00.00,"464,645.93"
15-Mar-2025,Purchase,00.00,"92,929.19","371,716.74"
15-Mar-2025,Interest,"17,071.00",00.00,"388,787.74"
15-Mar-2025,Bill,"101,604.10",00.00,"490,391.84"
15-Mar-2025,RTGS,01.00,00.00,"490,392.84"
15-Mar-2025,Tax,"20,587.40",00.00,"510,980.24"
15-Mar-2025,NEFT,00.00,"85,163.37","425,816.87"
15-Mar-2025,Transfer,308.30,00.00,"426,125.17"
16-Mar-2025,RTGS,07.09,00.00,"426,132.26"
16-Mar-2025,Reversal,00.00,"42,613.23","383,519.03"
16-Mar-2025,Miscellaneous,56.69,00.00,"383,575.72"
16-Mar-2025,Interest,17.00,00.00,"383,592.72"
16-Mar-2025,Debit Card,"2,056,734.25",00.00,"2,440,326.97"
16-Mar-2025,NEFT,285.00,00.00,"2,440,611.97"
16-Mar-2025,Transfer,293.50,00.00,"2,440,905.47"
16-Mar-2025,Cash,338.00,00.00,"2,441,243.47"
16-Mar-2025,Cash,00.00,"305,155.43","2,136,088.04"
16-Mar-2025,Cheque,21.00,00.00,"2,136,109.04"
16-Mar-2025,Transfer,04.60,00.00,"2,136,113.64"
16-Mar-2025,Miscellaneous,"26,609.20",00.00,"2,162,722.84"
16-Mar-2025,Debit Card,00.00,"2,162,722.84",00.00
16-Mar-2025,Cash,358.80,00.00,358.80
16-Mar-2025,Commission,00.00,179.40,179.40
16-Mar-2025,Debit Card,00.00,17.94,161.46
16-Mar-2025,NEFT,"228,724.90",00.00,"228,886.36"
16-Mar-2025,IMPS,00.00,00.00,"228,886.36"
16-Mar-2025,Tax,00.00,"57,221.59","171,664.77"
16-Mar-2025,RTGS,07.00,00.00,"171,671.77"
16-Mar-2025,Transfer,54.51,00.00,"171,726.28"
16-Mar-2025,Reversal,"479,292.00",00.00,"651,018.28"
16-Mar-2025,Debit Card,00.00,"217,006.09","434,012.19"
16-Mar-2025,NEFT,06.93,00.00,"434,019.12"
16-Mar-2025,Cash,00.00,"62,002.73","372,016.39"
16-Mar-2025,Reversal,00.00,"37,201.64","334,814.75"
16-Mar-2025,ATM,00.00,"66,962.95","267,851.80"
16-Mar-2025,Debit Card,40.60,00.00,"267,892.40"
16-Mar-2025,Commission,00.00,"66,973.10","200,919.30"
16-Mar-2025,Purchase,00.00,"33,486.55","167,432.75"
16-Mar-2025,Reversal,00.00,"167,432.75",00.00
16-Mar-2025,Miscellaneous,"7,385.00",00.00,"7,385.00"
16-Mar-2025,Cash,00.00,"1,477.00","5,908.00"
16-Mar-2025,RTGS,00.00,"2,954.00","2,954.00"
16-Mar-2025,Reversal,00.00,"2,954.00",00.00
16-Mar-2025,Commission,186.55,00.00,186.55
16-Mar-2025,Interest,00.00,26.65,159.90
16-Mar-2025,Tax,22.83,00.00,182.73
16-Mar-2025,Miscellaneous,04.40,00.00,187.13
16-Mar-2025,Commission,"4,007.00",00.00,"4,194.13"
16-Mar-2025,Cheque,"30,387.00",00.00,"34,581.13"
16-Mar-2025,Commission,00.00,"3,842.35","30,738.78"
16-Mar-2025,IMPS,00.00,"3,842.35","26,896.43"
16-Mar-2025,Bill,"1,463,460.50",00.00,"1,490,356.93"
16-Mar-2025,ATM,00.00,"496,785.64","993,571.29"
16-Mar-2025,Commission,"17,792.50",00.00,"1,011,363.79"
16-Mar-2025,Bill,"1,929,241.80",00.00,"2,940,605.59"
16-Mar-2025,Tax,00.00,"735,151.40","2,205,454.19"
16-Mar-2025,Purchase,05.30,00.00,"2,205,459.49"
16-Mar-2025,Debit Card,00.00,"367,576.58","1,837,882.91"
16-Mar-2025,Bill,00.00,"459,470.73","1,378,412.18"
16-Mar-2025,Transfer,00.00,"275,682.44","1,102,729.74"
16-Mar-2025,Miscellaneous,00.00,"157,532.82","945,196.92"
16-Mar-2025,Bill,00.00,"315,065.64","630,131.28"
16-Mar-2025,Cash,"158,483.97",00.00,"788,615.25"
16-Mar-2025,Purchase,"3,438.00",00.00,"792,053.25"
16-Mar-2025,Transfer,00.00,"198,013.31","594,039.94"
16-Mar-2025,Tax,00.00,"297,019.97","297,019.97"
16-Mar-2025,Tax,"37,842.80",00.00,"334,862.77"
16-Mar-2025,Tax,"1,775,568.50",00.00,"2,110,431.27"
16-Mar-2025,Reversal,00.00,"263,803.91","1,846,627.36"
16-Mar-2025,Cheque,00.00,"1,846,627.36",00.00
17-Mar-2025,Cheque,20.00,00.00,20.00
17-Mar-2025,Interest,00.00,10.00,10.00
17-Mar-2025,ATM,337.00,00.00,347.00
17-Mar-2025,Debit Card,"169,942.60",00.00,"170,289.60"
17-Mar-2025,Miscellaneous,00.00,"170,289.60",00.00
17-Mar-2025,RTGS,08.00,00.00,08.00
18-Mar-2025,ATM,"22,381.22",00.00,"22,389.22"
18-Mar-2025,RTGS,22.80,00.00,"22,412.02"
18-Mar-2025,Tax,00.00,"2,241.20","20,170.82"
18-Mar-2025,Interest,"9,609.02",00.00,"29,779.84"
18-Mar-2025,Commission,"98,662.20",00.00,"128,442.04"
18-Mar-2025,IMPS,00.00,"32,110.51","96,331.53"
18-Mar-2025,Debit Card,00.00,"9,633.15","86,698.38"
18-Mar-2025,Tax,"3,786.49",00.00,"90,484.87"
18-Mar-2025,IMPS,00.00,"9,048.49","81,436.38"
18-Mar-2025,NEFT,"1,117.50",00.00,"82,553.88"
18-Mar-2025,Cash,00.00,"9,172.65","73,381.23"
18-Mar-2025,Cash,00.00,"14,676.25","58,704.98"
18-Mar-2025,Miscellaneous,00.00,"9,784.16","48,920.82"
18-Mar-2025,Cash,00.00,"6,115.10","42,805.72"
18-Mar-2025,Cheque,00.00,"7,134.29","35,671.43"
18-Mar-2025,Purchase,55.00,00.00,"35,726.43"
18-Mar-2025,Cheque,00.77,00.00,"35,727.20"
18-Mar-2025,Debit Card,00.00,"3,572.72","32,154.48"
19-Mar-2025,Commission,"74,359.00",00.00,"106,513.48"
19-Mar-2025,Interest,00.00,"53,256.74","53,256.74"
19-Mar-2025,Transfer,"660,733.25",00.00,"713,989.99"
19-Mar-2025,Bill,06.00,00.00,"713,995.99"
19-Mar-2025,Miscellaneous,00.00,"713,995.99",00.00
19-Mar-2025,Reversal,"25,392.60",00.00,"25,392.60"
19-Mar-2025,IMPS,00.00,"2,821.40","22,571.20"
19-Mar-2025,Debit Card,"184,812.00",00.00,"207,383.20"
19-Mar-2025,Tax,00.00,"207,383.20",00.00
19-Mar-2025,Transfer,"4,932.05",00.00,"4,932.05"
19-Mar-2025,RTGS,00.00,"1,233.01","3,699.04"
19-Mar-2025,Tax,00.00,"1,233.01","2,466.03"
19-Mar-2025,Transfer,00.00,411.01,"2,055.02"
19-Mar-2025,Purchase,"74,672.00",00.00,"76,727.02"
19-Mar-2025,NEFT,"22,608.00",00.00,"99,335.02"
19-Mar-2025,RTGS,19.65,00.00,"99,354.67"
19-Mar-2025,Miscellaneous,00.00,"49,677.34","49,677.34"
19-Mar-2025,Reversal,"1,454.80",00.00,"51,132.14"
19-Mar-2025,ATM,16.00,00.00,"51,148.14"
19-Mar-2025,Cash,"21,847.00",00.00,"72,995.14"
19-Mar-2025,Cheque,00.00,"8,110.57","64,884.57"
19-Mar-2025,Interest,01.90,00.00,"64,886.47"
19-Mar-2025,IMPS,"25,649.00",00.00,"90,535.47"
19-Mar-2025,Bill,"167,865.80",00.00,"258,401.27"
19-Mar-2025,Miscellaneous,"2,493.00",00.00,"260,894.27"
19-Mar-2025,Transfer,"59,567.50",00.00,"320,461.77"
19-Mar-2025,IMPS,00.00,"160,230.89","160,230.88"
19-Mar-2025,Reversal,30.40,00.00,"160,261.28"
19-Mar-2025,Reversal,"2,957.10",00.00,"163,218.38"
19-Mar-2025,Reversal,00.00,"27,203.06","136,015.32"
19-Mar-2025,NEFT,06.48,00.00,"136,021.80"
19-Mar-2025,NEFT,00.00,"15,113.53","120,908.27"
19-Mar-2025,ATM,00.00,"120,908.27",00.00
19-Mar-2025,RTGS,"21,321.10",00.00,"21,321.10"
19-Mar-2025,Cheque,"1,139.00",00.00,"22,460.10"
19-Mar-2025,RTGS,00.00,"4,492.02","17,968.08"
19-Mar-2025,Tax,01.30,00.00,"17,969.38"
19-Mar-2025,Purchase,00.00,"8,984.69","8,984.69"
19-Mar-2025,Transfer,00.00,"1,283.53","7,701.16"
19-Mar-2025,RTGS,"13,848.91",00.00,"21,550.07"
19-Mar-2025,IMPS,"136,662.00",00.00,"158,212.07"
19-Mar-2025,Bill,"249,675.00",00.00,"407,887.07"
19-Mar-2025,Cheque,"35,751.41",00.00,"443,638.48"
19-Mar-2025,Commission,00.00,"55,454.81","388,183.67"
19-Mar-2025,Commission,00.00,"64,697.28","323,486.39"
19-Mar-2025,Interest,00.00,"46,212.34","277,274.05"
19-Mar-2025,Tax,00.00,"55,454.81","221,819.24"
19-Mar-2025,Cash,00.00,"22,181.92","199,637.32"
19-Mar-2025,Purchase,"173,803.00",00.00,"373,440.32"
19-Mar-2025,Miscellaneous,"1,917,169.50",00.00,"2,290,609.82"
19-Mar-2025,Debit Card,00.00,"458,121.96","1,832,487.86"
19-Mar-2025,Interest,"2,193.80",00.00,"1,834,681.66"
19-Mar-2025,Reversal,00.00,"366,936.33","1,467,745.33"
19-Mar-2025,Tax,25.60,00.00,"1,467,770.93"
19-Mar-2025,Reversal,00.00,"209,681.56","1,258,089.37"
19-Mar-2025,Purchase,00.00,"314,522.34","943,567.03"
19-Mar-2025,Transfer,01.46,00.00,"943,568.49"
19-Mar-2025,NEFT,392.40,00.00,"943,960.89"
19-Mar-2025,IMPS,00.00,"235,990.22","707,970.67"
19-Mar-2025,IMPS,209.96,00.00,"708,180.63"
19-Mar-2025,Commission,"20,033.32",00.00,"728,213.95"
19-Mar-2025,Tax,00.00,"145,642.79","582,571.16"
19-Mar-2025,ATM,00.00,"72,821.40","509,749.76"
19-Mar-2025,Tax,"29,646.40",00.00,"539,396.16"
19-Mar-2025,ATM,00.00,"89,899.36","449,496.80"
19-Mar-2025,Bill,00.00,"44,949.68","404,547.12"
19-Mar-2025,Transfer,00.00,"40,454.71","364,092.41"
19-Mar-2025,Transfer,00.00,"182,046.21","182,046.20"
19-Mar-2025,Interest,14.22,00.00,"182,060.42"
19-Mar-2025,Cash,00.00,"22,757.55","159,302.87"
19-Mar-2025,Bill,00.00,"19,912.86","139,390.01"
19-Mar-2025,Interest,462.30,00.00,"139,852.31"
19-Mar-2025,Miscellaneous,"19,805.70",00.00,"159,658.01"
19-Mar-2025,NEFT,"658,356.00",00.00,"818,014.01"
19-Mar-2025,Tax,00.00,"90,890.45","727,123.56"
19-Mar-2025,NEFT,07.00,00.00,"727,130.56"
19-Mar-2025,Transfer,36.00,00.00,"727,166.56"
19-Mar-2025,Reversal,419.00,00.00,"727,585.56"
19-Mar-2025,NEFT,"25,076.30",00.00,"752,661.86"
19-Mar-2025,Transfer,00.00,"752,661.86",00.00
19-Mar-2025,ATM,26.68,00.00,26.68
19-Mar-2025,Commission,"2,950.14",00.00,"2,976.82"
19-Mar-2025,NEFT,00.00,330.76,"2,646.06"
19-Mar-2025,Cheque,00.00,378.01,"2,268.05"
20-Mar-2025,IMPS,00.00,756.02,"1,512.03"
20-Mar-2025,Debit Card,00.00,756.02,756.02
20-Mar-2025,Interest,00.00,378.01,378.01
20-Mar-2025,Reversal,"605,054.00",00.00,"605,432.01"
20-Mar-2025,NEFT,00.00,"67,270.22","538,161.79"
20-Mar-2025,Transfer,00.00,"107,632.36","430,529.43"
20-Mar-2025,Interest,"222,771.90",00.00,"653,301.33"
20-Mar-2025,RTGS,00.00,"163,325.33","489,976.00"
20-Mar-2025,Purchase,00.00,"48,997.60","440,978.40"
20-Mar-2025,Interest,00.00,"62,996.91","377,981.49"
20-Mar-2025,Bill,"2,432.00",00.00,"380,413.49"
20-Mar-2025,Debit Card,"1,597,556.00",00.00,"1,977,969.49"
20-Mar-2025,Tax,00.00,"247,246.19","1,730,723.30"
20-Mar-2025,Reversal,486.56,00.00,"1,731,209.86"
20-Mar-2025,RTGS,"5,639.08",00.00,"1,736,848.94"
20-Mar-2025,Reversal,"1,047,391.00",00.00,"2,784,239.94"
20-Mar-2025,Commission,"1,983,538.80",00.00,"4,767,778.74"
20-Mar-2025,ATM,00.00,"1,191,944.69","3,575,834.06"
20-Mar-2025,Reversal,00.00,"357,583.41","3,218,250.65"
21-Mar-2025,Commission,07.17,00.00,"3,218,257.82"
21-Mar-2025,Debit Card,54.00,00.00,"3,218,311.82"
21-Mar-2025,Interest,"4,035.00",00.00,"3,222,346.82"
21-Mar-2025,Cheque,164.80,00.00,"3,222,511.62"
21-Mar-2025,Commission,00.00,"1,074,170.54","2,148,341.08"
21-Mar-2025,RTGS,"1,814.24",00.00,"2,150,155.32"
21-Mar-2025,Bill,00.00,"307,165.05","1,842,990.27"
21-Mar-2025,Interest,00.00,"460,747.57","1,382,242.70"
21-Mar-2025,Cheque,00.00,"345,560.68","1,036,682.02"
21-Mar-2025,Tax,"236,939.80",00.00,"1,273,621.82"
21-Mar-2025,Debit Card,00.00,"212,270.30","1,061,351.52"
21-Mar-2025,IMPS,"15,922.20",00.00,"1,077,273.72"
21-Mar-2025,ATM,"3,708.00",00.00,"1,080,981.72"
21-Mar-2025,ATM,00.00,"1,080,981.72",00.00
21-Mar-2025,Transfer,"501,340.50",00.00,"501,340.50"
21-Mar-2025,Tax,01.00,00.00,"501,341.50"
21-Mar-2025,IMPS,00.55,00.00,"501,342.05"
21-Mar-2025,Purchase,"194,226.22",00.00,"695,568.27"
21-Mar-2025,Reversal,00.00,"86,946.03","608,622.24"
21-Mar-2025,IMPS,00.00,"121,724.45","486,897.79"
22-Mar-2025,Debit Card,00.00,"48,689.78","438,208.01"
22-Mar-2025,Reversal,00.00,"73,034.67","365,173.34"
22-Mar-2025,Commission,00.00,"40,574.82","324,598.52"
22-Mar-2025,NEFT,00.00,"324,598.52",00.00
22-Mar-2025,RTGS,12.00,00.00,12.00
22-Mar-2025,NEFT,"364,568.00",00.00,"364,580.00"
22-Mar-2025,Miscellaneous,00.00,"121,526.67","243,053.33"
22-Mar-2025,IMPS,00.00,"34,721.90","208,331.43"
22-Mar-2025,Miscellaneous,"1,062.60",00.00,"209,394.03"
22-Mar-2025,Bill,00.00,"209,394.03",00.00
22-Mar-2025,Interest,"169,393.00",00.00,"169,393.00"
22-Mar-2025,Bill,"249,356.03",00.00,"418,749.03"
22-Mar-2025,IMPS,09.71,00.00,"418,758.74"
23-Mar-2025,Tax,"3,636.00",00.00,"422,394.74"
23-Mar-2025,Interest,366.40,00.00,"422,761.14"
23-Mar-2025,Transfer,00.00,"211,380.57","211,380.57"
23-Mar-2025,ATM,52.00,00.00,"211,432.57"
23-Mar-2025,Reversal,"1,934,992.80",00.00,"2,146,425.37"
23-Mar-2025,Interest,"2,025,182.50",00.00,"4,171,607.87"
23-Mar-2025,Reversal,00.00,"417,160.79","3,754,447.08"
23-Mar-2025,NEFT,"19,994.90",00.00,"3,774,441.98"
24-Mar-2025,Tax,"131,476.00",00.00,"3,905,917.98"
24-Mar-2025,Tax,301.49,00.00,"3,906,219.47"
24-Mar-2025,Debit Card,"3,655.58",00.00,"3,909,875.05"
24-Mar-2025,Reversal,00.00,"390,987.51","3,518,887.54"
24-Mar-2025,ATM,"173,418.80",00.00,"3,692,306.34"
24-Mar-2025,Reversal,00.00,"738,461.27","2,953,845.07"
24-Mar-2025,Cash,"99,541.53",00.00,"3,053,386.60"
24-Mar-2025,Tax,00.00,"610,677.32","2,442,709.28"
24-Mar-2025,Purchase,279.00,00.00,"2,442,988.28"
24-Mar-2025,Bill,"19,256.20",00.00,"2,462,244.48"
24-Mar-2025,Commission,00.00,"307,780.56","2,154,463.92"
24-Mar-2025,Transfer,00.00,"1,077,231.96","1,077,231.96"
24-Mar-2025,Purchase,07.80,00.00,"1,077,239.76"
24-Mar-2025,Tax,00.00,"119,693.31","957,546.45"
24-Mar-2025,Transfer,491.10,00.00,"958,037.55"
24-Mar-2025,IMPS,"31,177.00",00.00,"989,214.55"
24-Mar-2025,Reversal,44.00,00.00,"989,258.55"
25-Mar-2025,Tax,00.00,"123,657.32","865,601.23"
25-Mar-2025,IMPS,00.18,00.00,"865,601.41"
25-Mar-2025,Reversal,00.00,"432,800.71","432,800.70"
25-Mar-2025,Miscellaneous,00.00,"108,200.18","324,600.53"
25-Mar-2025,Interest,206.62,00.00,"324,807.15"
25-Mar-2025,Purchase,"143,583.00",00.00,"468,390.15"
25-Mar-2025,Debit Card,00.00,"93,678.03","374,712.12"
25-Mar-2025,IMPS,00.00,"53,530.30","321,181.82"
25-Mar-2025,Transfer,00.00,"107,060.61","214,121.21"
25-Mar-2025,NEFT,"449,435.25",00.00,"663,556.46"
25-Mar-2025,ATM,00.00,"221,185.49","442,370.97"
25-Mar-2025,Miscellaneous,384.54,00.00,"442,755.51"
25-Mar-2025,Transfer,202.00,00.00,"442,957.51"
25-Mar-2025,IMPS,"73,947.80",00.00,"516,905.31"
25-Mar-2025,RTGS,00.00,"86,150.89","430,754.42"
25-Mar-2025,Miscellaneous,"10,894.90",00.00,"441,649.32"
25-Mar-2025,ATM,62.00,00.00,"441,711.32"
25-Mar-2025,RTGS,362.00,00.00,"442,073.32"
25-Mar-2025,Commission,00.00,"88,414.66","353,658.66"
25-Mar-2025,Cheque,"3,355.70",00.00,"357,014.36"
25-Mar-2025,Bill,00.00,"71,402.87","285,611.49"
25-Mar-2025,Interest,00.00,"47,601.92","238,009.58"
25-Mar-2025,Bill,"9,616.00",00.00,"247,625.58"
25-Mar-2025,Cheque,00.00,"24,762.56","222,863.02"
25-Mar-2025,Cheque,288.71,00.00,"223,151.73"
25-Mar-2025,Miscellaneous,"21,537.60",00.00,"244,689.33"
26-Mar-2025,Commission,00.00,"48,937.87","195,751.46"
26-Mar-2025,NEFT,"850,100.80",00.00,"1,045,852.26"
26-Mar-2025,Transfer,00.00,"209,170.45","836,681.81"
26-Mar-2025,Cash,"2,065,962.00",00.00,"2,902,643.81"
26-Mar-2025,RTGS,"3,211.00",00.00,"2,905,854.81"
26-Mar-2025,Cheque,00.00,"2,905,854.81",00.00
26-Mar-2025,Tax,"17,119.69",00.00,"17,119.69"
26-Mar-2025,Debit Card,00.00,"8,559.85","8,559.84"
26-Mar-2025,Purchase,00.00,"8,559.84",00.00
26-Mar-2025,Bill,04.70,00.00,04.70
26-Mar-2025,Reversal,"1,543.00",00.00,"1,547.70"
26-Mar-2025,Cash,00.00,309.54,"1,238.16"
26-Mar-2025,Miscellaneous,231.03,00.00,"1,469.19"
26-Mar-2025,Commission,00.00,734.60,734.60
26-Mar-2025,IMPS,00.00,183.65,550.95
26-Mar-2025,Purchase,"368,435.20",00.00,"368,986.15"
26-Mar-2025,Purchase,110.00,00.00,"369,096.15"
26-Mar-2025,RTGS,00.00,"52,728.02","316,368.13"
26-Mar-2025,Debit Card,"190,321.81",00.00,"506,689.94"
26-Mar-2025,Miscellaneous,00.00,"253,344.97","253,344.97"
26-Mar-2025,NEFT,07.70,00.00,"253,352.67"
27-Mar-2025,IMPS,"746,195.80",00.00,"999,548.47"
27-Mar-2025,RTGS,00.00,"199,909.69","799,638.78"
27-Mar-2025,Miscellaneous,204.10,00.00,"799,842.88"
27-Mar-2025,Commission,00.00,"266,614.29","533,228.59"
27-Mar-2025,Bill,00.00,"177,742.86","355,485.73"
27-Mar-2025,Miscellaneous,00.00,"355,485.73",00.00
27-Mar-2025,IMPS,"893,916.20",00.00,"893,916.20"
27-Mar-2025,Miscellaneous,121.00,00.00,"894,037.20"
27-Mar-2025,Commission,00.00,"111,754.65","782,282.55"
27-Mar-2025,Transfer,"15,555.00",00.00,"797,837.55"
28-Mar-2025,Purchase,00.00,"88,648.62","709,188.93"
28-Mar-2025,IMPS,00.00,"78,798.77","630,390.16"
28-Mar-2025,Commission,10.00,00.00,"630,400.16"
28-Mar-2025,Tax,13.76,00.00,"630,413.92"
28-Mar-2025,Cash,"237,656.00",00.00,"868,069.92"
28-Mar-2025,Tax,"115,834.50",00.00,"983,904.42"
28-Mar-2025,Interest,"1,937,759.80",00.00,"2,921,664.22"
28-Mar-2025,Reversal,00.00,"2,921,664.22",00.00
28-Mar-2025,Purchase,"1,742,885.20",00.00,"1,742,885.20"
28-Mar-2025,Purchase,35.40,00.00,"1,742,920.60"
28-Mar-2025,ATM,00.00,"348,584.12","1,394,336.48"
28-Mar-2025,Transfer,"662,160.50",00.00,"2,056,496.98"
28-Mar-2025,Transfer,00.00,"411,299.40","1,645,197.58"
28-Mar-2025,RTGS,"260,841.20",00.00,"1,906,038.78"
28-Mar-2025,Transfer,"118,156.72",00.00,"2,024,195.50"
28-Mar-2025,Cash,00.00,"253,024.44","1,771,171.06"
28-Mar-2025,Bill,"26,667.00",00.00,"1,797,838.06"
28-Mar-2025,Transfer,"1,211,765.00",00.00,"3,009,603.06"
28-Mar-2025,NEFT,00.00,"601,920.61","2,407,682.45"
28-Mar-2025,Miscellaneous,00.00,"300,960.31","2,106,722.14"
28-Mar-2025,Cash,"1,280.00",00.00,"2,108,002.14"
28-Mar-2025,Bill,00.00,"351,333.69","1,756,668.45"
28-Mar-2025,RTGS,00.00,"439,167.11","1,317,501.34"
28-Mar-2025,ATM,"23,156.00",00.00,"1,340,657.34"
28-Mar-2025,RTGS,00.00,"223,442.89","1,117,214.45"
28-Mar-2025,Purchase,703.33,00.00,"1,117,917.78"
28-Mar-2025,Purchase,00.00,"139,739.72","978,178.06"
28-Mar-2025,Purchase,"1,783.56",00.00,"979,961.62"
28-Mar-2025,Transfer,"1,597,044.25",00.00,"2,577,005.87"
28-Mar-2025,Cash,"143,798.00",00.00,"2,720,803.87"
28-Mar-2025,Purchase,00.00,"340,100.48","2,380,703.39"
28-Mar-2025,Transfer,00.00,"2,380,703.39",00.00
28-Mar-2025,NEFT,00.97,00.00,00.97
28-Mar-2025,IMPS,00.00,00.11,00.86
28-Mar-2025,Miscellaneous,"4,723.57",00.00,"4,724.43"
28-Mar-2025,NEFT,00.00,"4,724.43",00.00
28-Mar-2025,Bill,"15,517.40",00.00,"15,517.40"
28-Mar-2025,Interest,00.00,"2,216.77","13,300.63"
28-Mar-2025,Bill,"4,657.87",00.00,"17,958.50"
28-Mar-2025,Reversal,00.00,"4,489.63","13,468.88"
28-Mar-2025,NEFT,00.00,"1,683.61","11,785.27"
28-Mar-2025,Tax,00.00,"2,357.05","9,428.22"
28-Mar-2025,Tax,00.00,"1,178.53","8,249.69"
28-Mar-2025,Commission,00.00,824.97,"7,424.72"
28-Mar-2025,Transfer,171.70,00.00,"7,596.42"
28-Mar-2025,Purchase,"1,680,930.00",00.00,"1,688,526.42"
28-Mar-2025,RTGS,123.10,00.00,"1,688,649.52"
28-Mar-2025,Cheque,00.00,"562,883.17","1,125,766.35"
28-Mar-2025,Debit Card,"1,842,787.25",00.00,"2,968,553.60"
28-Mar-2025,NEFT,"12,585.60",00.00,"2,981,139.20"
28-Mar-2025,Transfer,52.99,00.00,"2,981,192.19"
28-Mar-2025,Cheque,"26,119.81",00.00,"3,007,312.00"
28-Mar-2025,Purchase,00.00,"601,462.40","2,405,849.60"
28-Mar-2025,Cheque,59.63,00.00,"2,405,909.23"
28-Mar-2025,ATM,"4,012.50",00.00,"2,409,921.73"
28-Mar-2025,ATM,00.00,"301,240.22","2,108,681.51"
28-Mar-2025,Tax,00.00,"527,170.38","1,581,511.13"
28-Mar-2025,Commission,00.00,"175,723.46","1,405,787.67"
28-Mar-2025,Bill,00.00,"1,405,787.67",00.00
28-Mar-2025,ATM,00.41,00.00,00.41
28-Mar-2025,Purchase,"79,905.50",00.00,"79,905.91"
28-Mar-2025,Interest,00.00,"13,317.65","66,588.26"
28-Mar-2025,Miscellaneous,"18,316.15",00.00,"84,904.41"
28-Mar-2025,Transfer,00.00,"42,452.21","42,452.20"
28-Mar-2025,Reversal,00.00,"21,226.10","21,226.10"
28-Mar-2025,Purchase,"14,168.90",00.00,"35,395.00"
28-Mar-2025,RTGS,00.00,"35,395.00",00.00
28-Mar-2025,Tax,05.40,00.00,05.40
28-Mar-2025,Commission,"1,786.00",00.00,"1,791.40"
28-Mar-2025,IMPS,"7,638.06",00.00,"9,429.46"
28-Mar-2025,IMPS,219.00,00.00,"9,648.46"
28-Mar-2025,RTGS,00.00,"1,206.06","8,442.40"
28-Mar-2025,Debit Card,00.00,"1,407.07","7,035.33"
28-Mar-2025,Commission,00.00,"1,172.56","5,862.78"
28-Mar-2025,Bill,00.00,"2,931.39","2,931.39"
28-Mar-2025,Cheque,"191,296.00",00.00,"194,227.39"
28-Mar-2025,ATM,00.00,"24,278.42","169,948.97"
28-Mar-2025,Commission,40.00,00.00,"169,988.97"
28-Mar-2025,Cheque,"597,654.00",00.00,"767,642.97"
28-Mar-2025,Cheque,"1,074,460.00",00.00,"1,842,102.97"
28-Mar-2025,Cheque,00.00,"921,051.49","921,051.48"
28-Mar-2025,Cheque,00.00,"230,262.87","690,788.61"
28-Mar-2025,Cash,"18,052.00",00.00,"708,840.61"
28-Mar-2025,Cash,"168,146.81",00.00,"876,987.42"
28-Mar-2025,Transfer,00.00,"175,397.48","701,589.94"
28-Mar-2025,RTGS,188.68,00.00,"701,778.62"
28-Mar-2025,ATM,00.60,00.00,"701,779.22"
28-Mar-2025,Debit Card,"588,721.50",00.00,"1,290,500.72"
28-Mar-2025,IMPS,"2,109.60",00.00,"1,292,610.32"
28-Mar-2025,Cash,00.00,"1,292,610.32",00.00
28-Mar-2025,Bill,415.00,00.00,415.00
28-Mar-2025,Interest,"1,962,092.00",00.00,"1,962,507.00"
28-Mar-2025,Bill,413.00,00.00,"1,962,920.00"
28-Mar-2025,Tax,03.00,00.00,"1,962,923.00"
28-Mar-2025,Miscellaneous,00.00,"1,962,923.00",00.00
28-Mar-2025,Bill,161.00,00.00,161.00
28-Mar-2025,ATM,00.00,20.13,140.88
28-Mar-2025,Interest,00.00,46.96,93.92
28-Mar-2025,Transfer,00.00,11.74,82.18
28-Mar-2025,Bill,424.55,00.00,506.73
28-Mar-2025,Interest,00.00,84.46,422.28
28-Mar-2025,ATM,"28,393.40",00.00,"28,815.68"
28-Mar-2025,Commission,"1,112,743.75",00.00,"1,141,559.43"
28-Mar-2025,RTGS,00.00,"1,141,559.43",00.00
29-Mar-2025,Reversal,108.81,00.00,108.81
29-Mar-2025,RTGS,00.00,15.54,93.27
29-Mar-2025,Commission,"1,096,922.75",00.00,"1,097,016.02"
29-Mar-2025,Purchase,"896,920.00",00.00,"1,993,936.02"
29-Mar-2025,IMPS,"2,151.97",00.00,"1,996,087.99"
29-Mar-2025,Debit Card,"6,639.30",00.00,"2,002,727.29"
29-Mar-2025,Purchase,21.40,00.00,"2,002,748.69"
29-Mar-2025,Cheque,"1,435.00",00.00,"2,004,183.69"
29-Mar-2025,Miscellaneous,00.00,"668,061.23","1,336,122.46"
29-Mar-2025,NEFT,00.00,"334,030.62","1,002,091.84"
29-Mar-2025,IMPS,00.00,"250,522.96","751,568.88"
29-Mar-2025,Bill,"22,685.81",00.00,"774,254.69"
29-Mar-2025,Bill,00.00,"86,028.30","688,226.39"
29-Mar-2025,Purchase,"148,424.00",00.00,"836,650.39"
29-Mar-2025,NEFT,00.00,"209,162.60","627,487.79"
29-Mar-2025,Reversal,"2,076.00",00.00,"629,563.79"
29-Mar-2025,NEFT,"205,079.20",00.00,"834,642.99"
29-Mar-2025,Transfer,00.00,"139,107.17","695,535.82"
29-Mar-2025,ATM,460.70,00.00,"695,996.52"
29-Mar-2025,Reversal,"1,684.38",00.00,"697,680.90"
29-Mar-2025,Transfer,07.89,00.00,"697,688.79"
29-Mar-2025,Transfer,00.00,"174,422.20","523,266.59"
29-Mar-2025,Debit Card,54.10,00.00,"523,320.69"
29-Mar-2025,Tax,"972,319.50",00.00,"1,495,640.19"
29-Mar-2025,Reversal,"2,887.20",00.00,"1,498,527.39"
29-Mar-2025,Bill,00.00,"149,852.74","1,348,674.65"
29-Mar-2025,Cash,07.00,00.00,"1,348,681.65"
29-Mar-2025,Interest,"8,428.41",00.00,"1,357,110.06"
29-Mar-2025,ATM,00.00,"226,185.01","1,130,925.05"
29-Mar-2025,ATM,02.60,00.00,"1,130,927.65"
29-Mar-2025,Tax,00.00,"376,975.88","753,951.77"
29-Mar-2025,Bill,02.00,00.00,"753,953.77"
29-Mar-2025,Debit Card,00.00,"188,488.44","565,465.33"
29-Mar-2025,Bill,00.00,"141,366.33","424,099.00"
29-Mar-2025,Transfer,34.29,00.00,"424,133.29"
29-Mar-2025,Transfer,00.00,"53,016.66","371,116.63"
29-Mar-2025,ATM,03.00,00.00,"371,119.63"
29-Mar-2025,Debit Card,00.00,"123,706.54","247,413.09"
29-Mar-2025,Tax,00.00,"123,706.55","123,706.54"
29-Mar-2025,Reversal,"2,040.00",00.00,"125,746.54"
29-Mar-2025,Tax,69.00,00.00,"125,815.54"
29-Mar-2025,Bill,"19,571.33",00.00,"145,386.87"
29-Mar-2025,Cash,00.00,"145,386.87",00.00
29-Mar-2025,Cash,"6,061.10",00.00,"6,061.10"
29-Mar-2025,Debit Card,"20,298.00",00.00,"26,359.10"
29-Mar-2025,Cheque,00.00,"2,635.91","23,723.19"
29-Mar-2025,Debit Card,"1,275,468.00",00.00,"1,299,191.19"
29-Mar-2025,Transfer,54.00,00.00,"1,299,245.19"
29-Mar-2025,Debit Card,"239,562.00",00.00,"1,538,807.19"
29-Mar-2025,IMPS,00.00,"769,403.60","769,403.60"
29-Mar-2025,NEFT,00.00,"769,403.60",00.00
29-Mar-2025,NEFT,01.80,00.00,01.80
29-Mar-2025,RTGS,"2,796.00",00.00,"2,797.80"
29-Mar-2025,Cash,00.00,932.60,"1,865.20"
29-Mar-2025,NEFT,00.00,207.24,"1,657.96"
29-Mar-2025,Reversal,"623,479.50",00.00,"625,137.46"
29-Mar-2025,Commission,00.00,"89,305.35","535,832.11"
29-Mar-2025,Transfer,00.00,"107,166.42","428,665.69"
29-Mar-2025,Cash,19.50,00.00,"428,685.19"
29-Mar-2025,Miscellaneous,00.00,"53,585.65","375,099.54"
29-Mar-2025,Miscellaneous,"51,511.00",00.00,"426,610.54"
29-Mar-2025,Miscellaneous,"11,760.19",00.00,"438,370.73"
29-Mar-2025,Interest,01.50,00.00,"438,372.23"
29-Mar-2025,Purchase,"1,398.00",00.00,"439,770.23"
30-Mar-2025,Commission,339.51,00.00,"440,109.74"
30-Mar-2025,Miscellaneous,"883,703.00",00.00,"1,323,812.74"
30-Mar-2025,Transfer,"31,444.17",00.00,"1,355,256.91"
30-Mar-2025,Cheque,00.00,"169,407.11","1,185,849.80"
30-Mar-2025,RTGS,"12,452.03",00.00,"1,198,301.83"
30-Mar-2025,Tax,"171,568.20",00.00,"1,369,870.03"
30-Mar-2025,Debit Card,00.00,"273,974.01","1,095,896.02"
30-Mar-2025,ATM,"1,478,948.00",00.00,"2,574,844.02"
30-Mar-2025,Reversal,00.00,"514,968.80","2,059,875.22"
30-Mar-2025,Interest,00.00,"205,987.52","1,853,887.70"
30-Mar-2025,RTGS,00.00,"463,471.93","1,390,415.78"
30-Mar-2025,Tax,00.00,"198,630.83","1,191,784.95"
30-Mar-2025,NEFT,03.00,00.00,"1,191,787.95"
30-Mar-2025,Interest,00.00,"132,420.88","1,059,367.07"
30-Mar-2025,Purchase,00.00,"176,561.18","882,805.89"
30-Mar-2025,Cash,00.00,"220,701.47","662,104.42"
30-Mar-2025,Interest,42.20,00.00,"662,146.62"
30-Mar-2025,ATM,00.00,"132,429.32","529,717.30"
30-Mar-2025,Cash,00.00,"52,971.73","476,745.57"
30-Mar-2025,Commission,"35,374.60",00.00,"512,120.17"
30-Mar-2025,Commission,00.00,"85,353.36","426,766.81"
30-Mar-2025,Interest,405.00,00.00,"427,171.81"
30-Mar-2025,ATM,"170,733.20",00.00,"597,905.01"
30-Mar-2025,Transfer,36.00,00.00,"597,941.01"
30-Mar-2025,Purchase,27.92,00.00,"597,968.93"
30-Mar-2025,Bill,"976,281.00",00.00,"1,574,249.93"
30-Mar-2025,Interest,00.00,"224,892.85","1,349,357.08"
30-Mar-2025,Reversal,"248,569.30",00.00,"1,597,926.38"
30-Mar-2025,Tax,00.00,"532,642.13","1,065,284.25"
30-Mar-2025,NEFT,00.00,"133,160.53","932,123.72"
30-Mar-2025,Tax,00.00,"310,707.91","621,415.81"
30-Mar-2025,Cheque,00.00,"77,676.98","543,738.83"
30-Mar-2025,Bill,510.60,00.00,"544,249.43"
30-Mar-2025,Debit Card,00.00,"68,031.18","476,218.25"
30-Mar-2025,Purchase,00.00,"79,369.71","396,848.54"
30-Mar-2025,Tax,00.00,"132,282.85","264,565.69"
30-Mar-2025,Miscellaneous,00.00,"66,141.42","198,424.27"
30-Mar-2025,RTGS,00.00,"198,424.27",00.00
30-Mar-2025,Tax,49.00,00.00,49.00
31-Mar-2025,Commission,00.00,06.13,42.88
31-Mar-2025,Cash,00.00,04.76,38.12
31-Mar-2025,Cash,00.00,12.71,25.41
31-Mar-2025,ATM,00.00,02.54,22.87
31-Mar-2025,Transfer,"11,199.90",00.00,"11,222.77"
31-Mar-2025,Commission,00.00,"1,246.97","9,975.80"
31-Mar-2025,Cash,00.00,"2,493.95","7,481.85"
31-Mar-2025,NEFT,00.00,748.19,"6,733.66"
01-Apr-2025,Commission,00.00,"1,683.42","5,050.24"
01-Apr-2025,Reversal,00.00,631.28,"4,418.96"
01-Apr-2025,Cash,00.00,"1,104.74","3,314.22"
01-Apr-2025,RTGS,"1,564.10",00.00,"4,878.32"
01-Apr-2025,Debit Card,00.00,542.04,"4,336.28"
01-Apr-2025,Bill,00.00,"1,084.07","3,252.21"
02-Apr-2025,Tax,00.00,464.60,"2,787.61"
03-Apr-2025,Bill,63.50,00.00,"2,851.11"
03-Apr-2025,Reversal,00.00,"2,851.11",00.00
03-Apr-2025,Transfer,"1,582,375.00",00.00,"1,582,375.00"
03-Apr-2025,Debit Card,"177,582.00",00.00,"1,759,957.00"
03-Apr-2025,Debit Card,"1,526,132.75",00.00,"3,286,089.75"
03-Apr-2025,IMPS,45.52,00.00,"3,286,135.27"
03-Apr-2025,Debit Card,00.00,"657,227.05","2,628,908.22"
03-Apr-2025,Miscellaneous,00.00,"1,314,454.11","1,314,454.11"
03-Apr-2025,IMPS,00.90,00.00,"1,314,455.01"
03-Apr-2025,Transfer,00.00,"1,314,455.01",00.00
03-Apr-2025,ATM,"2,317.21",00.00,"2,317.21"
03-Apr-2025,Miscellaneous,"29,534.60",00.00,"31,851.81"
03-Apr-2025,IMPS,00.00,"31,851.81",00.00
03-Apr-2025,RTGS,"1,954,040.50",00.00,"1,954,040.50"
03-Apr-2025,IMPS,461.64,00.00,"1,954,502.14"
03-Apr-2025,ATM,10.00,00.00,"1,954,512.14"
03-Apr-2025,Debit Card,"1,218,573.80",00.00,"3,173,085.94"
03-Apr-2025,RTGS,00.00,"1,057,695.31","2,115,390.63"
03-Apr-2025,Miscellaneous,941.98,00.00,"2,116,332.61"
03-Apr-2025,RTGS,06.70,00.00,"2,116,339.31"
03-Apr-2025,RTGS,41.30,00.00,"2,116,380.61"
03-Apr-2025,NEFT,460.89,00.00,"2,116,841.50"
03-Apr-2025,Cash,00.00,"211,684.15","1,905,157.35"
03-Apr-2025,Interest,00.00,"476,289.34","1,428,868.01"
03-Apr-2025,Transfer,240.00,00.00,"1,429,108.01"
03-Apr-2025,Miscellaneous,00.00,"204,158.29","1,224,949.72"
03-Apr-2025,Debit Card,00.00,"122,494.97","1,102,454.75"
03-Apr-2025,Bill,297.00,00.00,"1,102,751.75"
03-Apr-2025,Debit Card,07.35,00.00,"1,102,759.10"
03-Apr-2025,Transfer,00.00,"367,586.37","735,172.73"
03-Apr-2025,Commission,"30,562.00",00.00,"765,734.73"
03-Apr-2025,Miscellaneous,380.85,00.00,"766,115.58"
03-Apr-2025,NEFT,"4,000.80",00.00,"770,116.38"
03-Apr-2025,Cheque,00.00,"154,023.28","616,093.10"
03-Apr-2025,Reversal,"1,534.00",00.00,"617,627.10"
03-Apr-2025,Cash,00.00,"68,625.23","549,001.87"
03-Apr-2025,IMPS,00.00,"183,000.62","366,001.25"
03-Apr-2025,Cheque,"24,657.90",00.00,"390,659.15"
03-Apr-2025,Debit Card,"135,408.30",00.00,"526,067.45"
03-Apr-2025,Bill,"13,482.31",00.00,"539,549.76"
03-Apr-2025,Cash,"2,277.06",00.00,"541,826.82"
03-Apr-2025,Transfer,00.00,"541,826.82",00.00
03-Apr-2025,IMPS,"20,756.00",00.00,"20,756.00"
03-Apr-2025,ATM,00.00,"2,594.50","18,161.50"
03-Apr-2025,Debit Card,810.70,00.00,"18,972.20"
03-Apr-2025,Debit Card,05.00,00.00,"18,977.20"
03-Apr-2025,RTGS,00.00,"3,162.87","15,814.33"
03-Apr-2025,Interest,00.00,"1,757.15","14,057.18"
03-Apr-2025,ATM,00.00,"1,405.72","12,651.46"
03-Apr-2025,Miscellaneous,00.00,"6,325.73","6,325.73"
03-Apr-2025,NEFT,00.00,"2,108.58","4,217.15"
03-Apr-2025,Bill,02.56,00.00,"4,219.71"
03-Apr-2025,Reversal,"6,870.39",00.00,"11,090.10"
03-Apr-2025,Debit Card,00.00,"5,545.05","5,545.05"
03-Apr-2025,Miscellaneous,"66,713.78",00.00,"72,258.83"
03-Apr-2025,RTGS,00.00,"12,043.14","60,215.69"
03-Apr-2025,Bill,"2,040,492.00",00.00,"2,100,707.69"
03-Apr-2025,Purchase,"1,955,777.50",00.00,"4,056,485.19"
03-Apr-2025,Cash,"173,233.25",00.00,"4,229,718.44"
03-Apr-2025,Bill,00.00,"469,968.72","3,759,749.72"
03-Apr-2025,NEFT,00.00,"417,749.97","3,341,999.75"
03-Apr-2025,ATM,07.21,00.00,"3,342,006.96"
03-Apr-2025,Transfer,07.00,00.00,"3,342,013.96"
03-Apr-2025,Cash,"2,772.20",00.00,"3,344,786.16"
03-Apr-2025,Miscellaneous,00.00,"334,478.62","3,010,307.54"
03-Apr-2025,RTGS,00.00,"602,061.51","2,408,246.03"
03-Apr-2025,Reversal,"1,521.40",00.00,"2,409,767.43"
03-Apr-2025,Cheque,06.40,00.00,"2,409,773.83"
03-Apr-2025,Debit Card,00.00,"2,409,773.83",00.00
03-Apr-2025,Commission,"26,939.30",00.00,"26,939.30"
03-Apr-2025,Cash,"64,899.30",00.00,"91,838.60"
03-Apr-2025,Debit Card,15.75,00.00,"91,854.35"
03-Apr-2025,Tax,00.00,"22,963.59","68,890.76"
03-Apr-2025,Reversal,"1,228.00",00.00,"70,118.76"
03-Apr-2025,Miscellaneous,00.00,"14,023.75","56,095.01"
03-Apr-2025,Bill,"14,954.90",00.00,"71,049.91"
03-Apr-2025,Tax,49.04,00.00,"71,098.95"
04-Apr-2025,Bill,00.00,"7,109.90","63,989.06"
04-Apr-2025,Transfer,00.70,00.00,"63,989.76"
04-Apr-2025,Interest,"1,490,146.00",00.00,"1,554,135.76"
04-Apr-2025,Bill,"192,327.72",00.00,"1,746,463.48"
04-Apr-2025,Miscellaneous,00.00,"873,231.74","873,231.74"
04-Apr-2025,Debit Card,00.00,"109,153.97","764,077.77"
04-Apr-2025,Bill,00.00,"109,153.97","654,923.80"
04-Apr-2025,NEFT,23.90,00.00,"654,947.70"
04-Apr-2025,Cash,00.00,"81,868.46","573,079.24"
04-Apr-2025,Cheque,00.00,"95,513.21","477,566.03"
04-Apr-2025,Cash,"24,195.00",00.00,"501,761.03"
04-Apr-2025,Interest,00.00,"250,880.52","250,880.52"
04-Apr-2025,IMPS,"248,419.19",00.00,"499,299.71"
04-Apr-2025,Cash,"25,737.14",00.00,"525,036.85"
04-Apr-2025,Cheque,"220,776.00",00.00,"745,812.85"
04-Apr-2025,Purchase,"14,385.86",00.00,"760,198.71"
04-Apr-2025,Purchase,05.40,00.00,"760,204.11"
04-Apr-2025,Cheque,570.90,00.00,"760,775.01"
04-Apr-2025,Tax,00.00,"253,591.67","507,183.34"
04-Apr-2025,NEFT,00.00,"56,353.70","450,829.64"
04-Apr-2025,Commission,00.00,"45,082.96","405,746.68"
04-Apr-2025,Commission,266.00,00.00,"406,012.68"
04-Apr-2025,Cheque,00.00,"135,337.56","270,675.12"
04-Apr-2025,IMPS,403.73,00.00,"271,078.85"
04-Apr-2025,IMPS,"1,405,226.00",00.00,"1,676,304.85"
04-Apr-2025,Tax,"1,532.00",00.00,"1,677,836.85"
04-Apr-2025,ATM,00.00,"335,567.37","1,342,269.48"
04-Apr-2025,Reversal,00.00,"671,134.74","671,134.74"
04-Apr-2025,IMPS,00.00,"83,891.84","587,242.90"
04-Apr-2025,Purchase,00.00,"195,747.63","391,495.27"
04-Apr-2025,Reversal,"134,565.88",00.00,"526,061.15"
04-Apr-2025,Commission,"1,039,746.80",00.00,"1,565,807.95"
04-Apr-2025,RTGS,00.00,"173,978.66","1,391,829.29"
05-Apr-2025,Interest,00.00,"695,914.65","695,914.64"
05-Apr-2025,Transfer,"1,323,962.00",00.00,"2,019,876.64"
05-Apr-2025,Debit Card,"26,781.34",00.00,"2,046,657.98"
05-Apr-2025,NEFT,00.00,"227,406.44","1,819,251.54"
05-Apr-2025,IMPS,00.00,"363,850.31","1,455,401.23"
05-Apr-2025,ATM,"26,864.00",00.00,"1,482,265.23"
05-Apr-2025,IMPS,"231,993.09",00.00,"1,714,258.32"
05-Apr-2025,Reversal,03.96,00.00,"1,714,262.28"
05-Apr-2025,Bill,356.00,00.00,"1,714,618.28"
05-Apr-2025,IMPS,00.00,"285,769.71","1,428,848.57"
05-Apr-2025,Debit Card,"1,698,011.80",00.00,"3,126,860.37"
05-Apr-2025,Debit Card,29.40,00.00,"3,126,889.77"
05-Apr-2025,Miscellaneous,"27,935.52",00.00,"3,154,825.29"
05-Apr-2025,Reversal,212.07,00.00,"3,155,037.36"
05-Apr-2025,Tax,00.00,"525,839.56","2,629,197.80"
06-Apr-2025,Tax,"74,342.00",00.00,"2,703,539.80"
06-Apr-2025,Tax,00.00,"675,884.95","2,027,654.85"
06-Apr-2025,Bill,"431,654.00",00.00,"2,459,308.85"
06-Apr-2025,Debit Card,"82,332.00",00.00,"2,541,640.85"
06-Apr-2025,Commission,"2,765.76",00.00,"2,544,406.61"
06-Apr-2025,Cash,00.00,"424,067.77","2,120,338.84"
06-Apr-2025,Miscellaneous,00.00,"235,593.20","1,884,745.64"
06-Apr-2025,Purchase,"8,391.30",00.00,"1,893,136.94"
06-Apr-2025,IMPS,189.80,00.00,"1,893,326.74"
06-Apr-2025,Tax,00.00,"270,475.25","1,622,851.49"
06-Apr-2025,Bill,"167,971.50",00.00,"1,790,822.99"
06-Apr-2025,Tax,00.00,"223,852.87","1,566,970.12"
06-Apr-2025,Debit Card,00.00,"1,566,970.12",00.00
06-Apr-2025,Cheque,48.45,00.00,48.45
06-Apr-2025,Reversal,00.00,05.38,43.07
06-Apr-2025,Debit Card,08.73,00.00,51.80
06-Apr-2025,Purchase,00.00,05.76,46.04
06-Apr-2025,RTGS,04.85,00.00,50.89
06-Apr-2025,NEFT,03.00,00.00,53.89
06-Apr-2025,Purchase,00.00,05.39,48.50
06-Apr-2025,Bill,02.00,00.00,50.50
06-Apr-2025,Purchase,00.00,05.05,45.45
06-Apr-2025,Debit Card,"19,806.95",00.00,"19,852.40"
06-Apr-2025,Miscellaneous,00.00,"3,970.48","15,881.92"
06-Apr-2025,Debit Card,00.00,"7,940.96","7,940.96"
06-Apr-2025,NEFT,"1,315.30",00.00,"9,256.26"
06-Apr-2025,Reversal,00.00,"1,028.47","8,227.79"
06-Apr-2025,Bill,00.00,"1,175.40","7,052.39"
06-Apr-2025,Tax,"57,401.19",00.00,"64,453.58"
06-Apr-2025,Bill,00.00,"64,453.58",00.00
06-Apr-2025,Tax,02.20,00.00,02.20
06-Apr-2025,Cash,00.00,00.22,01.98
06-Apr-2025,IMPS,"1,018,756.50",00.00,"1,018,758.48"
06-Apr-2025,Bill,"373,500.25",00.00,"1,392,258.73"
06-Apr-2025,Reversal,00.00,"348,064.68","1,044,194.05"
06-Apr-2025,NEFT,00.00,"522,097.03","522,097.02"
06-Apr-2025,ATM,00.00,"130,524.26","391,572.76"
06-Apr-2025,Cash,00.00,"43,508.08","348,064.68"
06-Apr-2025,Bill,00.00,"69,612.94","278,451.74"
06-Apr-2025,Bill,00.00,"139,225.87","139,225.87"
06-Apr-2025,Bill,00.00,"17,403.23","121,822.64"
06-Apr-2025,Debit Card,00.00,"13,535.85","108,286.79"
06-Apr-2025,Transfer,358.87,00.00,"108,645.66"
06-Apr-2025,Transfer,"259,279.97",00.00,"367,925.63"
06-Apr-2025,Cheque,59.00,00.00,"367,984.63"
06-Apr-2025,Debit Card,00.00,"45,998.08","321,986.55"
06-Apr-2025,ATM,00.00,"32,198.66","289,787.90"
06-Apr-2025,Purchase,00.00,"57,957.58","231,830.32"
06-Apr-2025,Purchase,"3,759.30",00.00,"235,589.62"
06-Apr-2025,Commission,07.30,00.00,"235,596.92"
06-Apr-2025,NEFT,"1,071,466.00",00.00,"1,307,062.92"
06-Apr-2025,Purchase,47.95,00.00,"1,307,110.87"
06-Apr-2025,Interest,00.00,"145,234.54","1,161,876.33"
06-Apr-2025,Purchase,02.00,00.00,"1,161,878.33"
06-Apr-2025,Debit Card,00.00,"145,234.79","1,016,643.54"
06-Apr-2025,Tax,00.00,"101,664.35","914,979.19"
06-Apr-2025,Cheque,00.00,"182,995.84","731,983.35"
06-Apr-2025,Reversal,00.00,"243,994.45","487,988.90"
06-Apr-2025,Reversal,25.60,00.00,"488,014.50"
06-Apr-2025,Reversal,00.00,"97,602.90","390,411.60"
06-Apr-2025,Interest,00.00,"39,041.16","351,370.44"
06-Apr-2025,NEFT,00.00,"351,370.44",00.00
06-Apr-2025,NEFT,"398,539.00",00.00,"398,539.00"
06-Apr-2025,Bill,00.00,"99,634.75","298,904.25"
06-Apr-2025,Cash,00.00,"298,904.25",00.00
06-Apr-2025,Bill,"16,694.32",00.00,"16,694.32"
06-Apr-2025,NEFT,18.30,00.00,"16,712.62"
07-Apr-2025,IMPS,00.00,"8,356.31","8,356.31"
07-Apr-2025,Interest,00.00,"1,193.76","7,162.55"
07-Apr-2025,Purchase,02.01,00.00,"7,164.56"
07-Apr-2025,Tax,00.00,796.06,"6,368.50"
07-Apr-2025,NEFT,00.00,"1,592.13","4,776.38"
07-Apr-2025,Reversal,25.00,00.00,"4,801.38"
07-Apr-2025,Miscellaneous,00.00,685.91,"4,115.47"
07-Apr-2025,NEFT,02.70,00.00,"4,118.17"
07-Apr-2025,RTGS,"135,219.00",00.00,"139,337.17"
07-Apr-2025,Reversal,00.00,"46,445.72","92,891.45"
07-Apr-2025,Bill,146.00,00.00,"93,037.45"
07-Apr-2025,Interest,00.00,"23,259.36","69,778.09"
07-Apr-2025,Interest,01.20,00.00,"69,779.29"
07-Apr-2025,NEFT,00.00,"9,968.47","59,810.82"
07-Apr-2025,Tax,29.20,00.00,"59,840.02"
07-Apr-2025,Commission,00.00,"5,984.00","53,856.02"
07-Apr-2025,Reversal,00.00,"53,856.02",00.00
07-Apr-2025,RTGS,"16,623.60",00.00,"16,623.60"
07-Apr-2025,Transfer,00.00,"1,662.36","14,961.24"
07-Apr-2025,Transfer,00.00,"1,496.12","13,465.12"
07-Apr-2025,Cash,00.00,"13,465.12",00.00
07-Apr-2025,Cash,01.80,00.00,01.80
07-Apr-2025,Transfer,09.00,00.00,10.80
07-Apr-2025,Cheque,00.00,01.20,09.60
07-Apr-2025,Interest,07.06,00.00,16.66
07-Apr-2025,Transfer,"1,003,641.50",00.00,"1,003,658.16"
07-Apr-2025,Tax,"3,028.00",00.00,"1,006,686.16"
07-Apr-2025,Cash,458.00,00.00,"1,007,144.16"
07-Apr-2025,Miscellaneous,33.40,00.00,"1,007,177.56"
07-Apr-2025,RTGS,00.00,"143,882.51","863,295.05"
07-Apr-2025,RTGS,03.10,00.00,"863,298.15"
07-Apr-2025,Bill,00.00,"86,329.82","776,968.34"
07-Apr-2025,ATM,"18,437.22",00.00,"795,405.56"
08-Apr-2025,NEFT,"746,383.50",00.00,"1,541,789.06"
08-Apr-2025,Bill,00.00,"308,357.81","1,233,431.25"
08-Apr-2025,Transfer,00.00,"176,204.46","1,057,226.79"
08-Apr-2025,ATM,"131,203.59",00.00,"1,188,430.38"
08-Apr-2025,Miscellaneous,"221,521.31",00.00,"1,409,951.69"
08-Apr-2025,Tax,427.69,00.00,"1,410,379.38"
08-Apr-2025,Cheque,"9,727.00",00.00,"1,420,106.38"
08-Apr-2025,Commission,"28,821.97",00.00,"1,448,928.35"
08-Apr-2025,NEFT,317.32,00.00,"1,449,245.67"
08-Apr-2025,Debit Card,00.00,"483,081.89","966,163.78"
08-Apr-2025,Debit Card,00.00,"966,163.78",00.00
09-Apr-2025,Cash,"52,706.80",00.00,"52,706.80"
09-Apr-2025,Cash,00.00,"5,856.31","46,850.49"
09-Apr-2025,Tax,24.38,00.00,"46,874.87"
09-Apr-2025,Purchase,28.00,00.00,"46,902.87"
09-Apr-2025,Cash,00.00,"5,862.86","41,040.01"
09-Apr-2025,RTGS,20.90,00.00,"41,060.91"
09-Apr-2025,Reversal,00.00,"4,562.32","36,498.59"
09-Apr-2025,RTGS,00.00,"36,498.59",00.00
09-Apr-2025,Commission,"1,717.08",00.00,"1,717.08"
09-Apr-2025,Reversal,"213,686.50",00.00,"215,403.58"
09-Apr-2025,Purchase,00.00,"23,933.73","191,469.85"
09-Apr-2025,ATM,"2,210.00",00.00,"193,679.85"
10-Apr-2025,Reversal,00.00,"24,209.98","169,469.87"
10-Apr-2025,ATM,00.00,"33,893.97","135,575.90"
10-Apr-2025,Purchase,"1,601,089.25",00.00,"1,736,665.15"
10-Apr-2025,Commission,00.00,"868,332.58","868,332.58"
10-Apr-2025,Debit Card,"538,863.00",00.00,"1,407,195.58"
10-Apr-2025,Cash,00.00,"703,597.79","703,597.79"
10-Apr-2025,Reversal,279.67,00.00,"703,877.46"
10-Apr-2025,RTGS,58.64,00.00,"703,936.10"
10-Apr-2025,Purchase,00.00,"117,322.68","586,613.42"
10-Apr-2025,Cash,"1,168.50",00.00,"587,781.92"
10-Apr-2025,IMPS,00.00,"293,890.96","293,890.96"
10-Apr-2025,NEFT,00.00,"36,736.37","257,154.59"
11-Apr-2025,NEFT,"11,880.82",00.00,"269,035.41"
11-Apr-2025,Purchase,00.00,"29,892.82","239,142.59"
11-Apr-2025,ATM,"49,653.00",00.00,"288,795.59"
11-Apr-2025,ATM,00.00,"72,198.90","216,596.69"
11-Apr-2025,Reversal,00.00,"36,099.45","180,497.24"
11-Apr-2025,Cheque,00.00,"20,055.25","160,441.99"
11-Apr-2025,Purchase,17.00,00.00,"160,458.99"
11-Apr-2025,ATM,00.00,"26,743.17","133,715.82"
12-Apr-2025,IMPS,00.00,"14,857.31","118,858.51"
12-Apr-2025,Commission,153.00,00.00,"119,011.51"
12-Apr-2025,Bill,"167,394.00",00.00,"286,405.51"
12-Apr-2025,NEFT,00.00,"40,915.07","245,490.44"
12-Apr-2025,Interest,02.00,00.00,"245,492.44"
12-Apr-2025,RTGS,27.41,00.00,"245,519.85"
12-Apr-2025,Tax,00.00,"40,919.98","204,599.88"
12-Apr-2025,ATM,00.00,"22,733.32","181,866.56"
12-Apr-2025,Interest,00.00,"18,186.66","163,679.90"
12-Apr-2025,ATM,00.00,"18,186.66","145,493.24"
13-Apr-2025,NEFT,00.00,"145,493.24",00.00
13-Apr-2025,Transfer,"1,285,608.00",00.00,"1,285,608.00"
13-Apr-2025,Cheque,457.27,00.00,"1,286,065.27"
13-Apr-2025,ATM,"1,523,498.00",00.00,"2,809,563.27"
13-Apr-2025,Tax,00.00,"280,956.33","2,528,606.94"
13-Apr-2025,ATM,"22,393.30",00.00,"2,551,000.24"
13-Apr-2025,Transfer,00.00,"850,333.41","1,700,666.83"
14-Apr-2025,Miscellaneous,00.00,"566,888.94","1,133,777.89"
14-Apr-2025,Purchase,00.00,"141,722.24","992,055.65"
14-Apr-2025,Interest,00.00,"992,055.65",00.00
14-Apr-2025,Cheque,30.00,00.00,30.00
14-Apr-2025,Transfer,"312,895.50",00.00,"312,925.50"
14-Apr-2025,RTGS,813.00,00.00,"313,738.50"
14-Apr-2025,ATM,00.00,"39,217.31","274,521.19"
14-Apr-2025,ATM,"1,464,396.80",00.00,"1,738,917.99"
14-Apr-2025,IMPS,00.00,"869,459.00","869,459.00"
14-Apr-2025,NEFT,00.00,"173,891.80","695,567.20"
14-Apr-2025,IMPS,00.00,"347,783.60","347,783.60"
14-Apr-2025,Cash,"16,395.00",00.00,"364,178.60"
14-Apr-2025,Miscellaneous,51.30,00.00,"364,229.90"
14-Apr-2025,Purchase,"1,569,189.25",00.00,"1,933,419.15"
14-Apr-2025,Tax,409.00,00.00,"1,933,828.15"
15-Apr-2025,IMPS,00.00,"644,609.38","1,289,218.77"
15-Apr-2025,Debit Card,00.00,"184,174.11","1,105,044.66"
15-Apr-2025,NEFT,"4,010.80",00.00,"1,109,055.46"
15-Apr-2025,Commission,"885,962.00",00.00,"1,995,017.46"
15-Apr-2025,Tax,344.00,00.00,"1,995,361.46"
15-Apr-2025,NEFT,00.00,"399,072.29","1,596,289.17"
15-Apr-2025,IMPS,"132,171.25",00.00,"1,728,460.42"
15-Apr-2025,Cheque,00.00,"192,051.16","1,536,409.26"
15-Apr-2025,Commission,00.00,"512,136.42","1,024,272.84"
15-Apr-2025,ATM,00.00,"256,068.21","768,204.63"
15-Apr-2025,Commission,"16,678.22",00.00,"784,882.85"
15-Apr-2025,ATM,213.92,00.00,"785,096.77"
15-Apr-2025,Transfer,"245,613.50",00.00,"1,030,710.27"
15-Apr-2025,Bill,07.77,00.00,"1,030,718.04"
15-Apr-2025,Interest,57.89,00.00,"1,030,775.93"
15-Apr-2025,Cash,"564,267.00",00.00,"1,595,042.93"
15-Apr-2025,NEFT,00.00,"398,760.73","1,196,282.20"
15-Apr-2025,Interest,311.80,00.00,"1,196,594.00"
15-Apr-2025,IMPS,00.00,"239,318.80","957,275.20"
15-Apr-2025,Debit Card,00.00,"957,275.20",00.00
15-Apr-2025,Tax,"1,039,217.80",00.00,"1,039,217.80"
15-Apr-2025,Interest,00.00,"148,459.69","890,758.11"
15-Apr-2025,Commission,"596,247.20",00.00,"1,487,005.31"
15-Apr-2025,Tax,00.00,"247,834.22","1,239,171.09"
15-Apr-2025,Tax,"8,442.00",00.00,"1,247,613.09"
15-Apr-2025,ATM,00.00,"311,903.27","935,709.82"
15-Apr-2025,Purchase,171.05,00.00,"935,880.87"
15-Apr-2025,IMPS,40.30,00.00,"935,921.17"
15-Apr-2025,Cheque,00.00,"116,990.15","818,931.02"
15-Apr-2025,Tax,313.60,00.00,"819,244.62"
15-Apr-2025,Reversal,29.71,00.00,"819,274.33"
15-Apr-2025,NEFT,00.00,"163,854.87","655,419.46"
15-Apr-2025,Cheque,"239,146.80",00.00,"894,566.26"
15-Apr-2025,Debit Card,409.28,00.00,"894,975.54"
15-Apr-2025,IMPS,00.00,"447,487.77","447,487.77"
15-Apr-2025,Interest,27.65,00.00,"447,515.42"
15-Apr-2025,Transfer,00.00,"74,585.90","372,929.52"
15-Apr-2025,Tax,00.00,"41,436.61","331,492.91"
15-Apr-2025,RTGS,"3,915.90",00.00,"335,408.81"
15-Apr-2025,Commission,00.00,"335,408.81",00.00
15-Apr-2025,Reversal,"60,430.10",00.00,"60,430.10"
15-Apr-2025,Bill,"43,704.00",00.00,"104,134.10"
15-Apr-2025,Transfer,00.00,"104,134.10",00.00
15-Apr-2025,Bill,"362,392.00",00.00,"362,392.00"
15-Apr-2025,Purchase,43.08,00.00,"362,435.08"
15-Apr-2025,IMPS,00.00,"36,243.51","326,191.57"
15-Apr-2025,RTGS,"136,673.16",00.00,"462,864.73"
15-Apr-2025,Debit Card,00.00,"66,123.53","396,741.20"
15-Apr-2025,Interest,00.00,"198,370.60","198,370.60"
15-Apr-2025,Tax,00.80,00.00,"198,371.40"
15-Apr-2025,Miscellaneous,"75,089.53",00.00,"273,460.93"
15-Apr-2025,Cash,394.13,00.00,"273,855.06"
15-Apr-2025,Miscellaneous,00.00,"68,463.77","205,391.30"
15-Apr-2025,Cash,"22,307.70",00.00,"227,699.00"
15-Apr-2025,Transfer,"45,077.90",00.00,"272,776.90"
15-Apr-2025,IMPS,00.00,"34,097.11","238,679.79"
16-Apr-2025,RTGS,00.00,"29,834.97","208,844.82"
16-Apr-2025,Commission,"992,234.00",00.00,"1,201,078.82"
16-Apr-2025,Commission,05.00,00.00,"1,201,083.82"
16-Apr-2025,Reversal,"102,496.50",00.00,"1,303,580.32"
16-Apr-2025,Tax,656.53,00.00,"1,304,236.85"
16-Apr-2025,Transfer,00.00,"260,847.37","1,043,389.48"
16-Apr-2025,NEFT,"44,442.70",00.00,"1,087,832.18"
16-Apr-2025,Commission,"8,048.00",00.00,"1,095,880.18"
17-Apr-2025,IMPS,00.00,"547,940.09","547,940.09"
17-Apr-2025,Bill,191.05,00.00,"548,131.14"
17-Apr-2025,Bill,00.00,"54,813.11","493,318.03"
17-Apr-2025,Transfer,"119,119.25",00.00,"612,437.28"
17-Apr-2025,RTGS,"173,570.70",00.00,"786,007.98"
17-Apr-2025,IMPS,04.00,00.00,"786,011.98"
17-Apr-2025,Miscellaneous,105.74,00.00,"786,117.72"
17-Apr-2025,Debit Card,00.00,"786,117.72",00.00
17-Apr-2025,Bill,272.16,00.00,272.16
17-Apr-2025,Cheque,00.00,136.08,136.08
17-Apr-2025,Purchase,02.22,00.00,138.30
17-Apr-2025,Transfer,05.02,00.00,143.32
17-Apr-2025,Cash,00.00,15.92,127.40
17-Apr-2025,Transfer,231.07,00.00,358.47
17-Apr-2025,Interest,"2,058.00",00.00,"2,416.47"
18-Apr-2025,Debit Card,293.00,00.00,"2,709.47"
18-Apr-2025,Transfer,00.00,451.58,"2,257.89"
18-Apr-2025,Cash,"14,551.70",00.00,"16,809.59"
18-Apr-2025,Cheque,07.00,00.00,"16,816.59"
18-Apr-2025,IMPS,"217,500.75",00.00,"234,317.34"
18-Apr-2025,Interest,00.00,"23,431.73","210,885.61"
18-Apr-2025,Interest,00.00,"23,431.73","187,453.88"
18-Apr-2025,Reversal,00.00,"26,779.13","160,674.75"
18-Apr-2025,Transfer,00.00,"53,558.25","107,116.50"
18-Apr-2025,Cash,00.00,"107,116.50",00.00
18-Apr-2025,Reversal,"19,912.30",00.00,"19,912.30"
18-Apr-2025,Reversal,00.00,"19,912.30",00.00
18-Apr-2025,Interest,01.82,00.00,01.82
18-Apr-2025,Miscellaneous,"11,184.62",00.00,"11,186.44"
18-Apr-2025,Tax,00.00,"1,398.31","9,788.14"
18-Apr-2025,Purchase,00.00,"1,398.31","8,389.83"
18-Apr-2025,Transfer,07.80,00.00,"8,397.63"
18-Apr-2025,Reversal,00.50,00.00,"8,398.13"
18-Apr-2025,NEFT,00.00,"4,199.07","4,199.06"
18-Apr-2025,Reversal,00.00,419.91,"3,779.15"
18-Apr-2025,NEFT,980.66,00.00,"4,759.81"
18-Apr-2025,Commission,00.00,594.98,"4,164.83"
18-Apr-2025,Transfer,"225,662.40",00.00,"229,827.23"
18-Apr-2025,Cash,91.50,00.00,"229,918.73"
18-Apr-2025,Commission,05.70,00.00,"229,924.43"
18-Apr-2025,Reversal,"3,814.00",00.00,"233,738.43"
18-Apr-2025,RTGS,"125,550.50",00.00,"359,288.93"
18-Apr-2025,NEFT,04.34,00.00,"359,293.27"
18-Apr-2025,Transfer,"139,817.00",00.00,"499,110.27"
18-Apr-2025,NEFT,00.00,"166,370.09","332,740.18"
18-Apr-2025,IMPS,00.00,"166,370.09","166,370.09"
18-Apr-2025,NEFT,00.00,"27,728.35","138,641.74"
18-Apr-2025,ATM,06.00,00.00,"138,647.74"
18-Apr-2025,Miscellaneous,"7,478.00",00.00,"146,125.74"
18-Apr-2025,Tax,"12,217.00",00.00,"158,342.74"
18-Apr-2025,Purchase,05.20,00.00,"158,347.94"
18-Apr-2025,Bill,00.00,"158,347.94",00.00
18-Apr-2025,Interest,"3,439.36",00.00,"3,439.36"
18-Apr-2025,RTGS,61.00,00.00,"3,500.36"
18-Apr-2025,Debit Card,00.00,875.09,"2,625.27"
18-Apr-2025,IMPS,00.00,328.16,"2,297.11"
18-Apr-2025,Cheque,"3,184.30",00.00,"5,481.41"
18-Apr-2025,NEFT,"3,920.00",00.00,"9,401.41"
18-Apr-2025,Cash,00.00,"2,350.35","7,051.06"
18-Apr-2025,Tax,"233,110.50",00.00,"240,161.56"
18-Apr-2025,Bill,05.74,00.00,"240,167.30"
18-Apr-2025,RTGS,40.00,00.00,"240,207.30"
18-Apr-2025,RTGS,04.40,00.00,"240,211.70"
18-Apr-2025,Bill,00.00,"60,052.93","180,158.78"
18-Apr-2025,Cash,"2,675.20",00.00,"182,833.98"
18-Apr-2025,Miscellaneous,00.00,"18,283.40","164,550.58"
18-Apr-2025,Interest,00.00,"82,275.29","82,275.29"
18-Apr-2025,ATM,04.30,00.00,"82,279.59"
18-Apr-2025,Tax,00.00,"11,754.23","70,525.36"
18-Apr-2025,Purchase,00.00,"7,052.54","63,472.82"
18-Apr-2025,Tax,44.50,00.00,"63,517.32"
18-Apr-2025,Purchase,06.00,00.00,"63,523.32"
18-Apr-2025,NEFT,01.40,00.00,"63,524.72"
18-Apr-2025,Purchase,00.00,"9,074.96","54,449.76"
19-Apr-2025,Reversal,526.00,00.00,"54,975.76"
19-Apr-2025,Purchase,00.00,"7,853.68","47,122.08"
19-Apr-2025,Transfer,00.00,"7,853.68","39,268.40"
19-Apr-2025,NEFT,"241,148.00",00.00,"280,416.40"
19-Apr-2025,Interest,00.00,"46,736.07","233,680.33"
19-Apr-2025,Transfer,"1,678.00",00.00,"235,358.33"
19-Apr-2025,NEFT,00.00,"23,535.83","211,822.50"
19-Apr-2025,IMPS,00.00,"30,260.36","181,562.14"
19-Apr-2025,Cheque,00.00,"25,937.45","155,624.69"
19-Apr-2025,Transfer,00.00,"77,812.35","77,812.34"
19-Apr-2025,Interest,00.00,"8,645.82","69,166.52"
19-Apr-2025,Cash,377.60,00.00,"69,544.12"
19-Apr-2025,Bill,01.16,00.00,"69,545.28"
19-Apr-2025,Debit Card,"3,874.00",00.00,"73,419.28"
19-Apr-2025,Cash,"23,963.10",00.00,"97,382.38"
19-Apr-2025,Tax,"1,817,330.50",00.00,"1,914,712.88"
19-Apr-2025,ATM,00.00,"478,678.22","1,436,034.66"
19-Apr-2025,Cash,00.00,"718,017.33","718,017.33"
19-Apr-2025,RTGS,01.20,00.00,"718,018.53"
19-Apr-2025,Cheque,"3,664.30",00.00,"721,682.83"
20-Apr-2025,Tax,00.00,"90,210.35","631,472.48"
20-Apr-2025,IMPS,00.00,"315,736.24","315,736.24"
20-Apr-2025,Interest,05.00,00.00,"315,741.24"
20-Apr-2025,ATM,"12,759.10",00.00,"328,500.34"
20-Apr-2025,Debit Card,00.00,"164,250.17","164,250.17"
20-Apr-2025,Interest,00.00,"164,250.17",00.00
20-Apr-2025,Transfer,243.70,00.00,243.70
20-Apr-2025,Purchase,00.00,121.85,121.85
20-Apr-2025,RTGS,"3,259.13",00.00,"3,380.98"
20-Apr-2025,Cheque,412.40,00.00,"3,793.38"
20-Apr-2025,Tax,"6,938.00",00.00,"10,731.38"
20-Apr-2025,Miscellaneous,36.20,00.00,"10,767.58"
20-Apr-2025,Cheque,00.00,"3,589.19","7,178.39"
20-Apr-2025,Debit Card,"1,456,888.00",00.00,"1,464,066.39"
20-Apr-2025,ATM,00.00,"244,011.07","1,220,055.32"
20-Apr-2025,IMPS,25.60,00.00,"1,220,080.92"
20-Apr-2025,Miscellaneous,67.34,00.00,"1,220,148.26"
20-Apr-2025,IMPS,00.00,"610,074.13","610,074.13"
20-Apr-2025,Commission,00.00,"122,014.83","488,059.30"
20-Apr-2025,Transfer,"5,876.50",00.00,"493,935.80"
20-Apr-2025,RTGS,00.00,"54,881.76","439,054.04"
20-Apr-2025,NEFT,"219,053.75",00.00,"658,107.79"
20-Apr-2025,RTGS,00.00,"73,123.09","584,984.70"
20-Apr-2025,NEFT,"31,417.00",00.00,"616,401.70"
20-Apr-2025,Miscellaneous,05.90,00.00,"616,407.60"
20-Apr-2025,ATM,00.00,"88,058.23","528,349.37"
20-Apr-2025,Cheque,"172,699.59",00.00,"701,048.96"
20-Apr-2025,Commission,"145,321.30",00.00,"846,370.26"
20-Apr-2025,Transfer,00.00,"105,796.28","740,573.98"
20-Apr-2025,Tax,44.00,00.00,"740,617.98"
20-Apr-2025,NEFT,"75,694.00",00.00,"816,311.98"
21-Apr-2025,IMPS,"1,144.00",00.00,"817,455.98"
21-Apr-2025,Transfer,00.00,"90,828.44","726,627.54"
21-Apr-2025,Miscellaneous,00.00,"363,313.77","363,313.77"
21-Apr-2025,Bill,00.00,"40,368.20","322,945.57"
21-Apr-2025,Transfer,"1,337.00",00.00,"324,282.57"
21-Apr-2025,Tax,00.00,"40,535.32","283,747.25"
21-Apr-2025,RTGS,"21,975.00",00.00,"305,722.25"
21-Apr-2025,Cash,00.00,"38,215.28","267,506.97"
21-Apr-2025,Reversal,"24,063.40",00.00,"291,570.37"
21-Apr-2025,Bill,"152,027.00",00.00,"443,597.37"
21-Apr-2025,NEFT,"199,489.00",00.00,"643,086.37"
21-Apr-2025,Interest,113.70,00.00,"643,200.07"
21-Apr-2025,Purchase,00.00,"91,885.72","551,314.35"
21-Apr-2025,Tax,"16,035.78",00.00,"567,350.13"
21-Apr-2025,Interest,"14,767.00",00.00,"582,117.13"
21-Apr-2025,Commission,63.00,00.00,"582,180.13"
21-Apr-2025,Cash,00.00,"145,545.03","436,635.10"
21-Apr-2025,Purchase,00.00,"436,635.10",00.00
21-Apr-2025,Transfer,"1,480,507.00",00.00,"1,480,507.00"
21-Apr-2025,ATM,03.56,00.00,"1,480,510.56"
21-Apr-2025,Purchase,00.00,"493,503.52","987,007.04"
21-Apr-2025,Cash,"28,548.00",00.00,"1,015,555.04"
21-Apr-2025,Debit Card,"31,009.10",00.00,"1,046,564.14"
21-Apr-2025,Interest,"11,560.00",00.00,"1,058,124.14"
21-Apr-2025,Commission,"95,604.94",00.00,"1,153,729.08"
21-Apr-2025,Transfer,07.00,00.00,"1,153,736.08"
21-Apr-2025,ATM,00.00,"192,289.35","961,446.73"
21-Apr-2025,Commission,00.00,"240,361.68","721,085.05"
21-Apr-2025,RTGS,"25,246.54",00.00,"746,331.59"
21-Apr-2025,Bill,00.00,"248,777.20","497,554.39"
21-Apr-2025,NEFT,"1,334.00",00.00,"498,888.39"
21-Apr-2025,Interest,123.00,00.00,"499,011.39"
21-Apr-2025,Miscellaneous,00.00,"83,168.57","415,842.82"
21-Apr-2025,ATM,00.00,"51,980.35","363,862.47"
21-Apr-2025,NEFT,01.00,00.00,"363,863.47"
21-Apr-2025,Tax,00.00,"40,429.27","323,434.20"
21-Apr-2025,Transfer,"125,647.06",00.00,"449,081.26"
21-Apr-2025,ATM,"22,543.00",00.00,"471,624.26"
21-Apr-2025,Debit Card,00.10,00.00,"471,624.36"
21-Apr-2025,Tax,00.00,"117,906.09","353,718.27"
21-Apr-2025,NEFT,04.97,00.00,"353,723.24"
21-Apr-2025,Interest,"1,130.70",00.00,"354,853.94"
21-Apr-2025,Commission,"677,341.00",00.00,"1,032,194.94"
21-Apr-2025,NEFT,00.00,"172,032.49","860,162.45"
21-Apr-2025,Transfer,00.00,"122,880.35","737,282.10"
21-Apr-2025,Cash,221.86,00.00,"737,503.96"
21-Apr-2025,Cheque,00.00,"105,357.71","632,146.25"
21-Apr-2025,Cash,"1,322,260.00",00.00,"1,954,406.25"
21-Apr-2025,NEFT,00.00,"279,200.89","1,675,205.36"
21-Apr-2025,RTGS,00.00,"837,602.68","837,602.68"
21-Apr-2025,Bill,00.00,"139,600.45","698,002.23"
22-Apr-2025,ATM,06.00,00.00,"698,008.23"
22-Apr-2025,Tax,00.00,"69,800.82","628,207.41"
22-Apr-2025,Bill,07.10,00.00,"628,214.51"
22-Apr-2025,Cash,00.00,"314,107.26","314,107.26"
23-Apr-2025,ATM,00.00,"104,702.42","209,404.84"
23-Apr-2025,Interest,"23,108.00",00.00,"232,512.84"
23-Apr-2025,Cash,00.00,"58,128.21","174,384.63"
23-Apr-2025,Reversal,00.00,"34,876.93","139,507.70"
23-Apr-2025,IMPS,00.00,"27,901.54","111,606.16"
23-Apr-2025,Cash,00.00,"37,202.05","74,404.11"
23-Apr-2025,Tax,"176,672.28",00.00,"251,076.39"
23-Apr-2025,Miscellaneous,00.00,"31,384.55","219,691.84"
23-Apr-2025,Tax,00.00,"27,461.48","192,230.36"
23-Apr-2025,Tax,27.00,00.00,"192,257.36"
23-Apr-2025,Miscellaneous,"46,028.70",00.00,"238,286.06"
23-Apr-2025,Miscellaneous,"2,623.00",00.00,"240,909.06"
23-Apr-2025,Commission,321.43,00.00,"241,230.49"
23-Apr-2025,Reversal,00.00,"40,205.08","201,025.41"
23-Apr-2025,IMPS,"1,452,648.25",00.00,"1,653,673.66"
23-Apr-2025,Bill,00.00,"183,741.52","1,469,932.14"
23-Apr-2025,Purchase,00.00,"183,741.52","1,286,190.62"
23-Apr-2025,RTGS,00.00,"257,238.12","1,028,952.50"
24-Apr-2025,Tax,"327,947.00",00.00,"1,356,899.50"
24-Apr-2025,Cash,00.00,"452,299.83","904,599.67"
24-Apr-2025,Cheque,00.00,"129,228.52","775,371.15"
24-Apr-2025,Cheque,"1,437.00",00.00,"776,808.15"
24-Apr-2025,Transfer,04.86,00.00,"776,813.01"
24-Apr-2025,Interest,00.00,"776,813.01",00.00
24-Apr-2025,Commission,01.70,00.00,01.70
24-Apr-2025,Purchase,420.83,00.00,422.53
24-Apr-2025,IMPS,00.00,422.53,00.00
24-Apr-2025,Cheque,34.00,00.00,34.00
24-Apr-2025,Tax,00.00,17.00,17.00
24-Apr-2025,Cheque,"33,791.60",00.00,"33,808.60"
24-Apr-2025,Miscellaneous,107.80,00.00,"33,916.40"
24-Apr-2025,Interest,00.00,"8,479.10","25,437.30"
24-Apr-2025,Tax,"1,410.00",00.00,"26,847.30"
25-Apr-2025,Commission,00.00,"3,355.91","23,491.39"
25-Apr-2025,Transfer,"218,810.91",00.00,"242,302.30"
25-Apr-2025,Cheque,281.00,00.00,"242,583.30"
25-Apr-2025,RTGS,"1,642,277.00",00.00,"1,884,860.30"
25-Apr-2025,IMPS,06.00,00.00,"1,884,866.30"
25-Apr-2025,Miscellaneous,00.00,"235,608.29","1,649,258.01"
25-Apr-2025,Cash,52.85,00.00,"1,649,310.86"
25-Apr-2025,Interest,00.00,"274,885.14","1,374,425.72"
25-Apr-2025,NEFT,00.00,"196,346.53","1,178,079.19"
25-Apr-2025,Cheque,"211,199.70",00.00,"1,389,278.89"
25-Apr-2025,Commission,"20,675.40",00.00,"1,409,954.29"
25-Apr-2025,Interest,00.00,"176,244.29","1,233,710.00"
25-Apr-2025,Purchase,221.00,00.00,"1,233,931.00"
25-Apr-2025,Transfer,33.90,00.00,"1,233,964.90"
25-Apr-2025,Bill,495.00,00.00,"1,234,459.90"
25-Apr-2025,Interest,00.00,"176,351.41","1,058,108.49"
25-Apr-2025,Debit Card,00.00,"264,527.12","793,581.37"
25-Apr-2025,Cheque,"15,186.60",00.00,"808,767.97"
25-Apr-2025,Commission,00.00,"269,589.32","539,178.65"
25-Apr-2025,Interest,00.00,"107,835.73","431,342.92"
25-Apr-2025,Purchase,00.00,"86,268.58","345,074.34"
25-Apr-2025,ATM,00.00,"43,134.29","301,940.05"
25-Apr-2025,Tax,27.00,00.00,"301,967.05"
25-Apr-2025,Interest,00.00,"60,393.41","241,573.64"
25-Apr-2025,Cheque,00.00,"30,196.71","211,376.94"
25-Apr-2025,Reversal,00.00,"35,229.49","176,147.45"
25-Apr-2025,Transfer,00.00,"58,715.82","117,431.63"
25-Apr-2025,ATM,"7,735.86",00.00,"125,167.49"
25-Apr-2025,Bill,00.00,"31,291.87","93,875.62"
25-Apr-2025,Cheque,"24,445.20",00.00,"118,320.82"
25-Apr-2025,Transfer,00.00,"59,160.41","59,160.41"
25-Apr-2025,Reversal,"9,333.00",00.00,"68,493.41"
25-Apr-2025,Commission,778.00,00.00,"69,271.41"
25-Apr-2025,Purchase,"35,757.91",00.00,"105,029.32"
25-Apr-2025,RTGS,11.39,00.00,"105,040.71"
25-Apr-2025,Miscellaneous,"3,444.95",00.00,"108,485.66"
25-Apr-2025,Cheque,00.00,"108,485.66",00.00
25-Apr-2025,NEFT,12.02,00.00,12.02
25-Apr-2025,Cash,00.00,06.01,06.01
25-Apr-2025,Interest,"1,038,800.00",00.00,"1,038,806.01"
25-Apr-2025,Cash,00.00,"1,038,806.01",00.00
25-Apr-2025,IMPS,03.00,00.00,03.00
25-Apr-2025,Purchase,"3,237.34",00.00,"3,240.34"
25-Apr-2025,Debit Card,00.66,00.00,"3,241.00"
25-Apr-2025,Bill,00.00,405.13,"2,835.88"
25-Apr-2025,Commission,00.00,283.59,"2,552.29"
25-Apr-2025,Commission,00.00,"2,552.29",00.00
25-Apr-2025,Debit Card,"26,851.34",00.00,"26,851.34"
25-Apr-2025,Debit Card,00.00,"26,851.34",00.00
25-Apr-2025,Reversal,"248,327.40",00.00,"248,327.40"
25-Apr-2025,Reversal,"4,837.58",00.00,"253,164.98"
25-Apr-2025,ATM,00.00,"50,633.00","202,531.98"
25-Apr-2025,Debit Card,00.00,"28,933.14","173,598.84"
25-Apr-2025,Commission,00.00,"86,799.42","86,799.42"
25-Apr-2025,RTGS,00.00,"17,359.88","69,439.54"
25-Apr-2025,Transfer,845.18,00.00,"70,284.72"
25-Apr-2025,Bill,00.00,"23,428.24","46,856.48"
25-Apr-2025,Miscellaneous,"121,900.00",00.00,"168,756.48"
25-Apr-2025,NEFT,00.00,"28,126.08","140,630.40"
25-Apr-2025,Tax,00.00,"14,063.04","126,567.36"
25-Apr-2025,Miscellaneous,"1,708.30",00.00,"128,275.66"
25-Apr-2025,Commission,00.00,"42,758.55","85,517.11"
25-Apr-2025,Reversal,"8,718.59",00.00,"94,235.70"
25-Apr-2025,Bill,"3,503.19",00.00,"97,738.89"
25-Apr-2025,Purchase,00.00,"10,859.88","86,879.01"
25-Apr-2025,Tax,00.00,"8,687.90","78,191.11"
25-Apr-2025,Commission,00.00,"13,031.85","65,159.26"
25-Apr-2025,Purchase,01.00,00.00,"65,160.26"
25-Apr-2025,NEFT,07.34,00.00,"65,167.60"
25-Apr-2025,Cash,00.00,"8,145.95","57,021.65"
25-Apr-2025,Interest,320.91,00.00,"57,342.56"
25-Apr-2025,RTGS,00.00,"19,114.19","38,228.37"
25-Apr-2025,Miscellaneous,"74,388.00",00.00,"112,616.37"
25-Apr-2025,Cash,00.00,"14,077.05","98,539.32"
25-Apr-2025,Miscellaneous,"227,729.00",00.00,"326,268.32"
25-Apr-2025,Reversal,"1,231.55",00.00,"327,499.87"
25-Apr-2025,Reversal,00.00,"109,166.62","218,333.25"
25-Apr-2025,Purchase,05.64,00.00,"218,338.89"
25-Apr-2025,Transfer,00.00,"21,833.89","196,505.00"
25-Apr-2025,IMPS,"258,493.72",00.00,"454,998.72"
25-Apr-2025,ATM,00.00,"113,749.68","341,249.04"
25-Apr-2025,Bill,"750,547.25",00.00,"1,091,796.29"
25-Apr-2025,ATM,00.00,"155,970.90","935,825.39"
25-Apr-2025,Cheque,00.00,"133,689.34","802,136.05"
25-Apr-2025,Tax,"25,076.70",00.00,"827,212.75"
25-Apr-2025,Purchase,00.00,"413,606.38","413,606.38"
25-Apr-2025,Transfer,"4,028.00",00.00,"417,634.38"
25-Apr-2025,NEFT,07.00,00.00,"417,641.38"
25-Apr-2025,Reversal,495.00,00.00,"418,136.38"
25-Apr-2025,ATM,30.40,00.00,"418,166.78"
25-Apr-2025,Purchase,00.00,"209,083.39","209,083.39"
25-Apr-2025,Commission,00.00,"23,231.49","185,851.90"
25-Apr-2025,Commission,05.00,00.00,"185,856.90"
25-Apr-2025,Commission,00.00,"37,171.38","148,685.52"
25-Apr-2025,Debit Card,00.00,"24,780.92","123,904.60"
25-Apr-2025,Purchase,"1,689,466.00",00.00,"1,813,370.60"
25-Apr-2025,Bill,03.00,00.00,"1,813,373.60"
25-Apr-2025,NEFT,01.16,00.00,"1,813,374.76"
25-Apr-2025,Miscellaneous,00.00,"201,486.08","1,611,888.68"
26-Apr-2025,Miscellaneous,05.00,00.00,"1,611,893.68"
26-Apr-2025,Interest,00.20,00.00,"1,611,893.88"
26-Apr-2025,Miscellaneous,18.15,00.00,"1,611,912.03"
26-Apr-2025,Debit Card,00.00,"179,101.34","1,432,810.69"
26-Apr-2025,Purchase,00.00,"238,801.78","1,194,008.91"
26-Apr-2025,Bill,09.70,00.00,"1,194,018.61"
26-Apr-2025,Cheque,"165,528.70",00.00,"1,359,547.31"
26-Apr-2025,Interest,00.00,"194,221.04","1,165,326.27"
26-Apr-2025,Bill,740.00,00.00,"1,166,066.27"
26-Apr-2025,Cheque,"1,532,976.50",00.00,"2,699,042.77"
26-Apr-2025,Transfer,00.00,"449,840.46","2,249,202.31"
26-Apr-2025,Transfer,00.00,"562,300.58","1,686,901.73"
26-Apr-2025,ATM,"3,717.50",00.00,"1,690,619.23"
26-Apr-2025,Cheque,00.00,"169,061.92","1,521,557.31"
26-Apr-2025,ATM,"933,739.00",00.00,"2,455,296.31"
26-Apr-2025,Tax,00.00,"491,059.26","1,964,237.05"
26-Apr-2025,Debit Card,00.00,"245,529.63","1,718,707.42"
26-Apr-2025,Commission,34.78,00.00,"1,718,742.20"
26-Apr-2025,ATM,"92,181.78",00.00,"1,810,923.98"
26-Apr-2025,Miscellaneous,"22,628.00",00.00,"1,833,551.98"
26-Apr-2025,Cash,00.00,"183,355.20","1,650,196.78"
26-Apr-2025,Bill,00.00,"235,742.40","1,414,454.38"
26-Apr-2025,RTGS,22.30,00.00,"1,414,476.68"
26-Apr-2025,Purchase,"2,969.00",00.00,"1,417,445.68"
26-Apr-2025,IMPS,00.00,"157,493.96","1,259,951.72"
26-Apr-2025,Cheque,00.00,"1,259,951.72",00.00
26-Apr-2025,Reversal,51.44,00.00,51.44
26-Apr-2025,RTGS,"3,080.67",00.00,"3,132.11"
26-Apr-2025,RTGS,00.00,348.01,"2,784.10"
26-Apr-2025,Reversal,"22,158.87",00.00,"24,942.97"
26-Apr-2025,Transfer,00.00,"6,235.74","18,707.23"
26-Apr-2025,RTGS,57.27,00.00,"18,764.50"
26-Apr-2025,Reversal,00.00,"3,752.90","15,011.60"
26-Apr-2025,ATM,00.00,"7,505.80","7,505.80"
26-Apr-2025,Commission,00.00,"1,501.16","6,004.64"
27-Apr-2025,IMPS,00.00,750.58,"5,254.06"
27-Apr-2025,Reversal,"226,072.00",00.00,"231,326.06"
27-Apr-2025,Cheque,00.00,"57,831.52","173,494.54"
27-Apr-2025,Cheque,"23,545.50",00.00,"197,040.04"
27-Apr-2025,Interest,401.00,00.00,"197,441.04"
27-Apr-2025,Cheque,00.00,"39,488.21","157,952.83"
27-Apr-2025,Transfer,"30,434.10",00.00,"188,386.93"
27-Apr-2025,Miscellaneous,00.00,"62,795.64","125,591.29"
27-Apr-2025,RTGS,"79,298.00",00.00,"204,889.29"
27-Apr-2025,Cash,21.40,00.00,"204,910.69"
27-Apr-2025,RTGS,00.00,"34,151.78","170,758.91"
27-Apr-2025,NEFT,491.20,00.00,"171,250.11"
28-Apr-2025,Transfer,"14,099.70",00.00,"185,349.81"
28-Apr-2025,ATM,00.00,"46,337.45","139,012.36"
28-Apr-2025,IMPS,00.00,"17,376.55","121,635.81"
28-Apr-2025,Cash,"1,251,654.25",00.00,"1,373,290.06"
28-Apr-2025,Cheque,"91,191.00",00.00,"1,464,481.06"
28-Apr-2025,Cheque,00.00,"244,080.18","1,220,400.88"
28-Apr-2025,Purchase,547.00,00.00,"1,220,947.88"
28-Apr-2025,RTGS,00.00,"135,660.88","1,085,287.00"
29-Apr-2025,Debit Card,"34,564.38",00.00,"1,119,851.38"
29-Apr-2025,Miscellaneous,"165,322.80",00.00,"1,285,174.18"
29-Apr-2025,IMPS,00.00,"642,587.09","642,587.09"
30-Apr-2025,Interest,00.00,"64,258.71","578,328.38"
30-Apr-2025,Interest,00.00,"96,388.06","481,940.32"
30-Apr-2025,Cheque,00.00,"53,548.92","428,391.40"
30-Apr-2025,Cheque,191.60,00.00,"428,583.00"
30-Apr-2025,Tax,00.00,"107,145.75","321,437.25"
30-Apr-2025,ATM,00.00,"64,287.45","257,149.80"
30-Apr-2025,ATM,00.00,"128,574.90","128,574.90"
30-Apr-2025,RTGS,"19,969.30",00.00,"148,544.20"
30-Apr-2025,Tax,00.00,"14,854.42","133,689.78"
30-Apr-2025,Cheque,"1,871,140.00",00.00,"2,004,829.78"
30-Apr-2025,Cheque,00.00,"250,603.72","1,754,226.06"
30-Apr-2025,ATM,"3,077.32",00.00,"1,757,303.38"
30-Apr-2025,ATM,00.00,"219,662.92","1,537,640.46"
30-Apr-2025,Bill,00.00,"768,820.23","768,820.23"
30-Apr-2025,Cheque,00.00,"76,882.02","691,938.21"
30-Apr-2025,Cash,00.00,"115,323.04","576,615.17"
30-Apr-2025,Transfer,"121,663.03",00.00,"698,278.20"
30-Apr-2025,Debit Card,"1,494,170.00",00.00,"2,192,448.20"
01-May-2025,Tax,"32,053.80",00.00,"2,224,502.00"
01-May-2025,Debit Card,00.00,"222,450.20","2,002,051.80"
01-May-2025,Tax,00.00,"286,007.40","1,716,044.40"
01-May-2025,Reversal,00.00,"572,014.80","1,144,029.60"
01-May-2025,Miscellaneous,00.00,"286,007.40","858,022.20"
01-May-2025,Transfer,"15,623.00",00.00,"873,645.20"
01-May-2025,Cheque,00.00,"124,806.46","748,838.74"
01-May-2025,Debit Card,"23,114.20",00.00,"771,952.94"
01-May-2025,Transfer,00.00,"128,658.82","643,294.12"
02-May-2025,RTGS,00.00,"643,294.12",00.00
02-May-2025,Reversal,"2,819.88",00.00,"2,819.88"
02-May-2025,Transfer,00.00,"2,819.88",00.00
02-May-2025,Purchase,"247,630.00",00.00,"247,630.00"
02-May-2025,RTGS,"21,825.60",00.00,"269,455.60"
02-May-2025,ATM,00.00,"33,681.95","235,773.65"
02-May-2025,Bill,00.00,"29,471.71","206,301.94"
02-May-2025,NEFT,00.00,"41,260.39","165,041.55"
02-May-2025,Miscellaneous,02.00,00.00,"165,043.55"
02-May-2025,Miscellaneous,00.00,"16,504.36","148,539.19"
02-May-2025,Miscellaneous,00.00,"74,269.60","74,269.60"
02-May-2025,Bill,"2,333.90",00.00,"76,603.50"
03-May-2025,NEFT,04.20,00.00,"76,607.70"
03-May-2025,NEFT,"1,349,930.00",00.00,"1,426,537.70"
03-May-2025,Debit Card,00.00,"713,268.85","713,268.85"
04-May-2025,Miscellaneous,00.00,"237,756.28","475,512.57"
04-May-2025,Tax,00.00,"47,551.26","427,961.31"
04-May-2025,Debit Card,04.88,00.00,"427,966.19"
05-May-2025,Debit Card,190.24,00.00,"428,156.43"
05-May-2025,IMPS,00.00,"142,718.81","285,437.62"
05-May-2025,Miscellaneous,241.60,00.00,"285,679.22"
05-May-2025,Cheque,03.20,00.00,"285,682.42"
05-May-2025,Reversal,00.00,"142,841.21","142,841.21"
05-May-2025,Reversal,359.10,00.00,"143,200.31"
05-May-2025,Reversal,00.00,"143,200.31",00.00
05-May-2025,Cheque,"70,214.00",00.00,"70,214.00"
05-May-2025,Debit Card,00.00,"10,030.57","60,183.43"
05-May-2025,ATM,03.00,00.00,"60,186.43"
05-May-2025,Purchase,00.00,"20,062.14","40,124.29"
05-May-2025,Commission,609.20,00.00,"40,733.49"
05-May-2025,Miscellaneous,00.00,"6,788.92","33,944.57"
05-May-2025,Transfer,05.40,00.00,"33,949.97"
05-May-2025,Debit Card,"1,178.33",00.00,"35,128.30"
05-May-2025,Purchase,41.92,00.00,"35,170.22"
05-May-2025,Reversal,00.00,"8,792.56","26,377.66"
05-May-2025,Interest,34.86,00.00,"26,412.52"
05-May-2025,ATM,"1,262,180.50",00.00,"1,288,593.02"
05-May-2025,Transfer,"1,339.40",00.00,"1,289,932.42"
05-May-2025,Commission,71.10,00.00,"1,290,003.52"
05-May-2025,Tax,00.00,"258,000.70","1,032,002.82"
05-May-2025,NEFT,37.73,00.00,"1,032,040.55"
05-May-2025,Tax,00.00,"129,005.07","903,035.48"
05-May-2025,Cash,"247,601.10",00.00,"1,150,636.58"
05-May-2025,Commission,04.00,00.00,"1,150,640.58"
05-May-2025,NEFT,00.00,"383,546.86","767,093.72"
05-May-2025,IMPS,00.00,"255,697.91","511,395.81"
05-May-2025,NEFT,00.00,"255,697.91","255,697.90"
05-May-2025,NEFT,00.00,"63,924.48","191,773.42"
05-May-2025,ATM,430.00,00.00,"192,203.42"
05-May-2025,Interest,00.00,"19,220.34","172,983.08"
05-May-2025,Cheque,00.00,"57,661.03","115,322.05"
05-May-2025,Tax,00.00,"28,830.51","86,491.54"
05-May-2025,RTGS,"664,976.50",00.00,"751,468.04"
05-May-2025,Interest,00.00,"93,933.51","657,534.54"
05-May-2025,IMPS,00.80,00.00,"657,535.34"
05-May-2025,Tax,01.14,00.00,"657,536.48"
05-May-2025,Cash,162.00,00.00,"657,698.48"
05-May-2025,NEFT,00.00,"109,616.41","548,082.07"
05-May-2025,RTGS,"882,805.00",00.00,"1,430,887.07"
05-May-2025,Bill,"92,411.10",00.00,"1,523,298.17"
05-May-2025,Interest,00.00,"761,649.09","761,649.08"
05-May-2025,RTGS,61.15,00.00,"761,710.23"
05-May-2025,Debit Card,"136,584.00",00.00,"898,294.23"
05-May-2025,Commission,00.00,"99,810.47","798,483.76"
05-May-2025,NEFT,"127,232.20",00.00,"925,715.96"
05-May-2025,ATM,00.00,"185,143.19","740,572.77"
05-May-2025,Purchase,00.00,"105,796.11","634,776.66"
05-May-2025,NEFT,00.00,"317,388.33","317,388.33"
05-May-2025,ATM,29.50,00.00,"317,417.83"
05-May-2025,Reversal,163.00,00.00,"317,580.83"
05-May-2025,ATM,00.00,"79,395.21","238,185.62"
05-May-2025,Transfer,00.00,"39,697.60","198,488.02"
05-May-2025,Tax,36.82,00.00,"198,524.84"
05-May-2025,Purchase,00.00,"28,360.69","170,164.15"
06-May-2025,NEFT,"111,148.12",00.00,"281,312.27"
06-May-2025,Bill,00.00,"40,187.47","241,124.80"
06-May-2025,IMPS,00.00,"24,112.48","217,012.32"
06-May-2025,Interest,227.60,00.00,"217,239.92"
07-May-2025,ATM,00.00,"24,137.77","193,102.15"
07-May-2025,Commission,00.00,"24,137.77","168,964.38"
07-May-2025,Tax,00.00,"168,964.38",00.00
07-May-2025,Tax,"120,471.66",00.00,"120,471.66"
07-May-2025,Debit Card,00.00,"17,210.24","103,261.42"
07-May-2025,Interest,00.00,"12,907.68","90,353.74"
07-May-2025,Interest,"3,596.95",00.00,"93,950.69"
07-May-2025,Miscellaneous,"7,223.00",00.00,"101,173.69"
07-May-2025,NEFT,"10,244.53",00.00,"111,418.22"
07-May-2025,Commission,00.00,"111,418.22",00.00
07-May-2025,RTGS,"1,451,715.50",00.00,"1,451,715.50"
07-May-2025,Cheque,00.00,"483,905.17","967,810.33"
07-May-2025,Tax,152.27,00.00,"967,962.60"
07-May-2025,Transfer,"3,617.00",00.00,"971,579.60"
07-May-2025,IMPS,00.00,"194,315.92","777,263.68"
07-May-2025,Interest,00.00,"97,157.96","680,105.72"
07-May-2025,RTGS,"15,700.40",00.00,"695,806.12"
07-May-2025,ATM,00.00,"99,400.87","596,405.25"
07-May-2025,Tax,"14,093.40",00.00,"610,498.65"
07-May-2025,Bill,"30,498.10",00.00,"640,996.75"
07-May-2025,Tax,00.00,"91,570.96","549,425.79"
07-May-2025,Transfer,04.83,00.00,"549,430.62"
07-May-2025,IMPS,"1,685.50",00.00,"551,116.12"
07-May-2025,Purchase,00.00,"91,852.69","459,263.43"
07-May-2025,Cash,"528,270.00",00.00,"987,533.43"
07-May-2025,Debit Card,04.00,00.00,"987,537.43"
07-May-2025,Cheque,00.00,"164,589.57","822,947.86"
07-May-2025,IMPS,00.00,"164,589.57","658,358.29"
07-May-2025,Cash,"807,225.00",00.00,"1,465,583.29"
07-May-2025,Interest,"2,999.00",00.00,"1,468,582.29"
07-May-2025,Debit Card,00.00,"244,763.72","1,223,818.58"
07-May-2025,Cheque,00.00,"1,223,818.58",00.00
07-May-2025,Interest,06.00,00.00,06.00
07-May-2025,ATM,00.00,03.00,03.00
07-May-2025,Tax,"13,664.00",00.00,"13,667.00"
07-May-2025,Tax,"2,082,389.25",00.00,"2,096,056.25"
07-May-2025,Cheque,604.70,00.00,"2,096,660.95"
08-May-2025,IMPS,00.00,"524,165.24","1,572,495.71"
09-May-2025,Cash,00.00,"157,249.57","1,415,246.14"
09-May-2025,NEFT,00.00,"353,811.54","1,061,434.60"
09-May-2025,RTGS,00.00,"176,905.77","884,528.83"
09-May-2025,Cheque,"606,613.75",00.00,"1,491,142.58"
09-May-2025,Commission,"229,891.44",00.00,"1,721,034.02"
09-May-2025,Cheque,"47,519.00",00.00,"1,768,553.02"
09-May-2025,Cash,"7,940.62",00.00,"1,776,493.64"
09-May-2025,Cheque,48.80,00.00,"1,776,542.44"
09-May-2025,Cheque,59.60,00.00,"1,776,602.04"
09-May-2025,Cash,00.00,"444,150.51","1,332,451.53"
09-May-2025,Commission,00.00,"666,225.77","666,225.76"
09-May-2025,Reversal,00.00,"74,025.08","592,200.68"
09-May-2025,Cheque,00.00,"65,800.08","526,400.60"
09-May-2025,Cash,00.00,"65,800.08","460,600.52"
09-May-2025,Debit Card,"1,335.00",00.00,"461,935.52"
09-May-2025,Tax,00.00,"76,989.25","384,946.27"
09-May-2025,NEFT,829.70,00.00,"385,775.97"
09-May-2025,Commission,345.90,00.00,"386,121.87"
09-May-2025,NEFT,"16,873.59",00.00,"402,995.46"
09-May-2025,Interest,00.00,"402,995.46",00.00
09-May-2025,Debit Card,40.50,00.00,40.50
09-May-2025,Commission,"22,311.00",00.00,"22,351.50"
09-May-2025,RTGS,00.00,"3,725.25","18,626.25"
09-May-2025,Transfer,04.54,00.00,"18,630.79"
09-May-2025,RTGS,"2,345.90",00.00,"20,976.69"
09-May-2025,ATM,00.00,"2,330.74","18,645.95"
09-May-2025,Purchase,00.00,"2,071.77","16,574.18"
09-May-2025,NEFT,"1,647.00",00.00,"18,221.18"
09-May-2025,Cheque,"1,339,230.00",00.00,"1,357,451.18"
09-May-2025,Purchase,"557,037.00",00.00,"1,914,488.18"
09-May-2025,Interest,00.00,"319,081.36","1,595,406.82"
09-May-2025,ATM,"3,488.00",00.00,"1,598,894.82"
09-May-2025,NEFT,00.00,"799,447.41","799,447.41"
09-May-2025,Bill,00.00,"99,930.93","699,516.48"
09-May-2025,Bill,00.00,"116,586.08","582,930.40"
10-May-2025,ATM,00.00,"116,586.08","466,344.32"
10-May-2025,NEFT,318.10,00.00,"466,662.42"
10-May-2025,Debit Card,00.05,00.00,"466,662.47"
10-May-2025,RTGS,00.00,"116,665.62","349,996.85"
10-May-2025,Bill,"3,031.06",00.00,"353,027.91"
10-May-2025,Tax,145.00,00.00,"353,172.91"
10-May-2025,Debit Card,00.00,"70,634.58","282,538.33"
10-May-2025,Commission,00.00,"94,179.44","188,358.89"
10-May-2025,Bill,"10,569.00",00.00,"198,927.89"
10-May-2025,Debit Card,00.00,"33,154.65","165,773.24"
10-May-2025,RTGS,"173,943.00",00.00,"339,716.24"
10-May-2025,Tax,"516,915.00",00.00,"856,631.24"
10-May-2025,Miscellaneous,06.45,00.00,"856,637.69"
10-May-2025,Interest,00.00,"142,772.95","713,864.74"
10-May-2025,IMPS,00.00,"118,977.46","594,887.28"
10-May-2025,RTGS,00.00,"59,488.73","535,398.55"
10-May-2025,Bill,00.70,00.00,"535,399.25"
10-May-2025,Purchase,00.00,"76,485.61","458,913.64"
10-May-2025,Tax,"524,639.00",00.00,"983,552.64"
11-May-2025,NEFT,"196,893.00",00.00,"1,180,445.64"
11-May-2025,Cheque,00.00,"131,160.63","1,049,285.01"
11-May-2025,Transfer,00.00,"104,928.50","944,356.51"
11-May-2025,Commission,"127,748.00",00.00,"1,072,104.51"
11-May-2025,Cash,00.00,"134,013.06","938,091.45"
11-May-2025,Commission,00.00,"312,697.15","625,394.30"
11-May-2025,Purchase,00.00,"125,078.86","500,315.44"
11-May-2025,Transfer,00.00,"500,315.44",00.00
11-May-2025,Interest,"1,418,527.00",00.00,"1,418,527.00"
11-May-2025,Cheque,00.00,"1,418,527.00",00.00
11-May-2025,Cheque,182.40,00.00,182.40
11-May-2025,Bill,00.00,60.80,121.60
11-May-2025,Bill,00.00,121.60,00.00
11-May-2025,Transfer,233.00,00.00,233.00
11-May-2025,RTGS,00.00,33.29,199.71
11-May-2025,Transfer,32.47,00.00,232.18
11-May-2025,Tax,00.00,232.18,00.00
11-May-2025,Cash,36.00,00.00,36.00
11-May-2025,Reversal,00.00,12.00,24.00
11-May-2025,Commission,00.00,02.67,21.33
11-May-2025,ATM,00.00,03.56,17.77
11-May-2025,Cheque,00.00,02.22,15.55
11-May-2025,Interest,00.00,05.18,10.37
11-May-2025,Purchase,00.00,02.07,08.30
11-May-2025,Miscellaneous,865.00,00.00,873.30
11-May-2025,Bill,00.00,873.30,00.00
12-May-2025,Bill,"80,515.56",00.00,"80,515.56"
12-May-2025,Miscellaneous,07.00,00.00,"80,522.56"
12-May-2025,Commission,"53,506.75",00.00,"134,029.31"
12-May-2025,RTGS,00.00,"44,676.44","89,352.87"
12-May-2025,ATM,00.00,"17,870.57","71,482.30"
12-May-2025,Tax,"1,827,063.20",00.00,"1,898,545.50"
12-May-2025,Purchase,00.00,"271,220.79","1,627,324.71"
12-May-2025,Tax,00.00,"325,464.94","1,301,859.77"
12-May-2025,Bill,"8,833.80",00.00,"1,310,693.57"
12-May-2025,Interest,"3,246.36",00.00,"1,313,939.93"
13-May-2025,Cheque,"4,700.20",00.00,"1,318,640.13"
13-May-2025,Purchase,23.80,00.00,"1,318,663.93"
13-May-2025,Miscellaneous,00.00,"188,380.56","1,130,283.37"
13-May-2025,Commission,00.00,"1,130,283.37",00.00
13-May-2025,Miscellaneous,"407,287.00",00.00,"407,287.00"
13-May-2025,Interest,00.00,"58,183.86","349,103.14"
13-May-2025,Bill,00.00,"116,367.71","232,735.43"
13-May-2025,Transfer,35.70,00.00,"232,771.13"
13-May-2025,Transfer,00.00,"29,096.39","203,674.74"
13-May-2025,Cheque,"3,772.40",00.00,"207,447.14"
13-May-2025,ATM,00.00,"25,930.89","181,516.25"
13-May-2025,Cash,00.00,"36,303.25","145,213.00"
13-May-2025,Interest,00.00,"16,134.78","129,078.22"
13-May-2025,Cheque,08.00,00.00,"129,086.22"
13-May-2025,Purchase,"22,802.50",00.00,"151,888.72"
13-May-2025,Cheque,00.00,"50,629.57","101,259.15"
13-May-2025,Commission,00.00,"11,251.02","90,008.13"
13-May-2025,ATM,"3,268.00",00.00,"93,276.13"
13-May-2025,Purchase,00.00,"13,325.16","79,950.97"
13-May-2025,NEFT,"223,709.00",00.00,"303,659.97"
13-May-2025,Interest,00.00,"30,366.00","273,293.97"
13-May-2025,Cash,00.00,"136,646.99","136,646.98"
13-May-2025,Purchase,00.00,"68,323.49","68,323.49"
13-May-2025,Cash,03.00,00.00,"68,326.49"
13-May-2025,Transfer,00.00,"34,163.25","34,163.25"
13-May-2025,Transfer,13.00,00.00,"34,176.25"
13-May-2025,Interest,00.00,"4,882.32","29,293.93"
13-May-2025,Bill,18.80,00.00,"29,312.73"
13-May-2025,Cheque,22.00,00.00,"29,334.73"
13-May-2025,Tax,"239,308.00",00.00,"268,642.73"
13-May-2025,Transfer,"860,874.50",00.00,"1,129,517.23"
13-May-2025,Bill,32.00,00.00,"1,129,549.23"
13-May-2025,IMPS,"29,775.56",00.00,"1,159,324.79"
13-May-2025,Debit Card,00.00,"193,220.80","966,103.99"
13-May-2025,Reversal,00.00,"966,103.99",00.00
13-May-2025,Tax,10.00,00.00,10.00
13-May-2025,Cheque,"28,867.23",00.00,"28,877.23"
13-May-2025,Reversal,175.00,00.00,"29,052.23"
13-May-2025,Bill,42.90,00.00,"29,095.13"
13-May-2025,Tax,"1,943.00",00.00,"31,038.13"
13-May-2025,Tax,290.00,00.00,"31,328.13"
13-May-2025,IMPS,"2,626.98",00.00,"33,955.11"
13-May-2025,ATM,00.00,"4,244.39","29,710.72"
13-May-2025,Cheque,"141,675.00",00.00,"171,385.72"
13-May-2025,IMPS,"1,103,749.00",00.00,"1,275,134.72"
13-May-2025,RTGS,"200,589.00",00.00,"1,475,723.72"
13-May-2025,NEFT,00.00,"491,907.91","983,815.81"
13-May-2025,Commission,00.00,"196,763.16","787,052.65"
13-May-2025,Cash,"202,538.00",00.00,"989,590.65"
13-May-2025,Purchase,166.00,00.00,"989,756.65"
13-May-2025,IMPS,00.00,"141,393.81","848,362.84"
13-May-2025,Purchase,40.00,00.00,"848,402.84"
13-May-2025,Commission,17.40,00.00,"848,420.24"
13-May-2025,Debit Card,"1,588,014.80",00.00,"2,436,435.04"
13-May-2025,ATM,00.00,"304,554.38","2,131,880.66"
13-May-2025,Cash,00.00,"236,875.63","1,895,005.03"
13-May-2025,Reversal,00.00,"379,001.01","1,516,004.02"
13-May-2025,Cheque,06.70,00.00,"1,516,010.72"
13-May-2025,Miscellaneous,00.00,"151,601.07","1,364,409.65"
13-May-2025,ATM,00.00,"454,803.22","909,606.43"
13-May-2025,RTGS,00.00,"129,943.78","779,662.65"
13-May-2025,Interest,"37,263.00",00.00,"816,925.65"
13-May-2025,Reversal,40.82,00.00,"816,966.47"
13-May-2025,ATM,00.00,"204,241.62","612,724.85"
13-May-2025,Reversal,48.00,00.00,"612,772.85"
13-May-2025,RTGS,"1,284,615.80",00.00,"1,897,388.65"
13-May-2025,ATM,00.00,"632,462.88","1,264,925.77"
13-May-2025,RTGS,383.39,00.00,"1,265,309.16"
13-May-2025,Commission,"15,947.00",00.00,"1,281,256.16"
13-May-2025,IMPS,00.00,"128,125.62","1,153,130.54"
13-May-2025,Commission,02.20,00.00,"1,153,132.74"
13-May-2025,ATM,370.80,00.00,"1,153,503.54"
13-May-2025,IMPS,07.00,00.00,"1,153,510.54"
13-May-2025,Cash,00.00,"288,377.64","865,132.90"
13-May-2025,NEFT,00.00,"432,566.45","432,566.45"
13-May-2025,Interest,"149,982.41",00.00,"582,548.86"
13-May-2025,IMPS,"1,659,741.00",00.00,"2,242,289.86"
13-May-2025,Cash,00.00,"320,327.12","1,921,962.74"
13-May-2025,Miscellaneous,00.00,"240,245.34","1,681,717.40"
13-May-2025,Bill,00.00,"840,858.70","840,858.70"
13-May-2025,Bill,00.00,"420,429.35","420,429.35"
13-May-2025,Transfer,00.00,"420,429.35",00.00
13-May-2025,Reversal,"1,650,537.50",00.00,"1,650,537.50"
13-May-2025,Transfer,"16,392.00",00.00,"1,666,929.50"
13-May-2025,Reversal,55.58,00.00,"1,666,985.08"
13-May-2025,Purchase,00.00,"238,140.73","1,428,844.35"
13-May-2025,Purchase,00.00,"1,428,844.35",00.00
13-May-2025,Interest,"2,734.00",00.00,"2,734.00"
13-May-2025,Cheque,"3,668.31",00.00,"6,402.31"
13-May-2025,Cash,"3,442.30",00.00,"9,844.61"
13-May-2025,Bill,16.30,00.00,"9,860.91"
13-May-2025,NEFT,00.00,"1,643.49","8,217.42"
13-May-2025,Tax,"8,545.00",00.00,"16,762.42"
13-May-2025,Bill,432.70,00.00,"17,195.12"
13-May-2025,Miscellaneous,00.00,"17,195.12",00.00
13-May-2025,Cash,"170,626.20",00.00,"170,626.20"
13-May-2025,RTGS,27.00,00.00,"170,653.20"
13-May-2025,ATM,854.60,00.00,"171,507.80"
13-May-2025,Bill,318.00,00.00,"171,825.80"
13-May-2025,Commission,07.74,00.00,"171,833.54"
13-May-2025,Miscellaneous,"1,596,543.00",00.00,"1,768,376.54"
13-May-2025,Commission,00.00,"442,094.14","1,326,282.40"
13-May-2025,Reversal,00.00,"147,364.71","1,178,917.69"
13-May-2025,RTGS,233.95,00.00,"1,179,151.64"
13-May-2025,Commission,00.00,"589,575.82","589,575.82"
13-May-2025,Debit Card,434.00,00.00,"590,009.82"
14-May-2025,ATM,"32,320.68",00.00,"622,330.50"
14-May-2025,NEFT,"1,149.30",00.00,"623,479.80"
14-May-2025,Cash,211.00,00.00,"623,690.80"
14-May-2025,RTGS,00.00,"155,922.70","467,768.10"
14-May-2025,NEFT,00.00,"51,974.23","415,793.87"
14-May-2025,NEFT,00.00,"207,896.94","207,896.94"
14-May-2025,NEFT,00.00,"25,987.12","181,909.82"
14-May-2025,ATM,00.00,"22,738.73","159,171.09"
14-May-2025,Reversal,00.00,"15,917.11","143,253.98"
14-May-2025,Cash,00.00,"47,751.33","95,502.65"
14-May-2025,Commission,00.00,"15,917.11","79,585.54"
14-May-2025,NEFT,"2,341.70",00.00,"81,927.24"
14-May-2025,ATM,00.00,"11,703.89","70,223.35"
14-May-2025,Debit Card,"193,734.53",00.00,"263,957.88"
14-May-2025,Cash,00.00,"87,985.96","175,971.92"
14-May-2025,Tax,00.00,"17,597.19","158,374.73"
14-May-2025,Cash,00.00,"52,791.58","105,583.15"
14-May-2025,Cash,07.00,00.00,"105,590.15"
14-May-2025,NEFT,04.73,00.00,"105,594.88"
14-May-2025,Cheque,49.00,00.00,"105,643.88"
14-May-2025,Debit Card,00.00,"105,643.88",00.00
14-May-2025,Commission,"15,356.40",00.00,"15,356.40"
15-May-2025,Reversal,336.00,00.00,"15,692.40"
15-May-2025,Cheque,00.00,"7,846.20","7,846.20"
15-May-2025,Reversal,"73,837.70",00.00,"81,683.90"
15-May-2025,RTGS,"1,745.00",00.00,"83,428.90"
15-May-2025,NEFT,"953,943.00",00.00,"1,037,371.90"
15-May-2025,Transfer,00.00,"1,037,371.90",00.00
15-May-2025,Interest,"4,466.63",00.00,"4,466.63"
15-May-2025,ATM,00.00,"1,488.88","2,977.75"
15-May-2025,Interest,00.00,595.55,"2,382.20"
15-May-2025,ATM,00.00,264.69,"2,117.51"
15-May-2025,Bill,"219,696.44",00.00,"221,813.95"
15-May-2025,NEFT,00.00,"44,362.79","177,451.16"
15-May-2025,NEFT,01.10,00.00,"177,452.26"
15-May-2025,Purchase,00.00,"25,350.32","152,101.94"
15-May-2025,Miscellaneous,"1,479.00",00.00,"153,580.94"
15-May-2025,Purchase,00.00,"76,790.47","76,790.47"
15-May-2025,Debit Card,03.00,00.00,"76,793.47"
15-May-2025,Transfer,234.00,00.00,"77,027.47"
15-May-2025,Cheque,00.00,"8,558.61","68,468.86"
15-May-2025,Bill,00.00,"9,781.27","58,687.59"
15-May-2025,ATM,"30,905.05",00.00,"89,592.64"
15-May-2025,Debit Card,00.00,"29,864.21","59,728.43"
15-May-2025,Reversal,00.00,"19,909.48","39,818.95"
15-May-2025,IMPS,00.00,"5,688.42","34,130.53"
15-May-2025,Bill,108.00,00.00,"34,238.53"
15-May-2025,Interest,00.00,"3,423.85","30,814.68"
15-May-2025,Debit Card,05.20,00.00,"30,819.88"
15-May-2025,RTGS,00.00,"30,819.88",00.00
15-May-2025,Debit Card,"13,247.90",00.00,"13,247.90"
15-May-2025,Reversal,00.00,"1,892.56","11,355.34"
15-May-2025,Transfer,48.00,00.00,"11,403.34"
15-May-2025,ATM,00.00,"3,801.11","7,602.23"
15-May-2025,Reversal,113.00,00.00,"7,715.23"
15-May-2025,Miscellaneous,00.00,"3,857.62","3,857.62"
15-May-2025,Interest,00.00,551.09,"3,306.53"
15-May-2025,IMPS,56.00,00.00,"3,362.53"
15-May-2025,RTGS,00.00,840.63,"2,521.90"
15-May-2025,Commission,00.00,252.19,"2,269.71"
15-May-2025,Transfer,"1,865,984.50",00.00,"1,868,254.21"
15-May-2025,Cheque,"31,844.40",00.00,"1,900,098.61"
15-May-2025,Reversal,"3,271.40",00.00,"1,903,370.01"
15-May-2025,Cash,00.00,"1,903,370.01",00.00
15-May-2025,IMPS,04.00,00.00,04.00
15-May-2025,Bill,47.00,00.00,51.00
15-May-2025,Interest,"1,521,381.00",00.00,"1,521,432.00"
15-May-2025,NEFT,00.00,"380,358.00","1,141,074.00"
15-May-2025,Interest,00.00,"1,141,074.00",00.00
15-May-2025,NEFT,"1,888,510.20",00.00,"1,888,510.20"
15-May-2025,Miscellaneous,"20,018.75",00.00,"1,908,528.95"
15-May-2025,Cheque,54.60,00.00,"1,908,583.55"
15-May-2025,NEFT,"1,232.70",00.00,"1,909,816.25"
15-May-2025,ATM,00.00,"477,454.06","1,432,362.19"
15-May-2025,Reversal,00.00,"143,236.22","1,289,125.97"
15-May-2025,Miscellaneous,00.00,"214,854.33","1,074,271.64"
15-May-2025,Cash,"3,279.09",00.00,"1,077,550.73"
15-May-2025,Cheque,00.00,"215,510.15","862,040.58"
15-May-2025,Cash,"151,076.80",00.00,"1,013,117.38"
15-May-2025,NEFT,"2,647.90",00.00,"1,015,765.28"
15-May-2025,Purchase,00.00,"338,588.43","677,176.85"
15-May-2025,ATM,05.50,00.00,"677,182.35"
15-May-2025,Miscellaneous,29.00,00.00,"677,211.35"
15-May-2025,Interest,00.00,"225,737.12","451,474.23"
15-May-2025,RTGS,"83,586.00",00.00,"535,060.23"
15-May-2025,IMPS,00.00,"267,530.12","267,530.12"
15-May-2025,Debit Card,00.00,"29,725.57","237,804.55"
15-May-2025,RTGS,00.00,"23,780.46","214,024.10"
15-May-2025,Transfer,00.00,"23,780.46","190,243.64"
15-May-2025,Miscellaneous,00.48,00.00,"190,244.12"
15-May-2025,IMPS,00.00,"190,244.12",00.00
15-May-2025,Commission,06.00,00.00,06.00
15-May-2025,RTGS,"28,149.38",00.00,"28,155.38"
15-May-2025,Miscellaneous,03.00,00.00,"28,158.38"
15-May-2025,Cheque,00.00,"3,128.71","25,029.67"
15-May-2025,Cash,"10,365.70",00.00,"35,395.37"
15-May-2025,Cheque,46.10,00.00,"35,441.47"
15-May-2025,Miscellaneous,00.00,"3,544.15","31,897.32"
15-May-2025,Bill,"3,753.40",00.00,"35,650.72"
15-May-2025,RTGS,00.00,"17,825.36","17,825.36"
16-May-2025,RTGS,39.00,00.00,"17,864.36"
16-May-2025,Cheque,"47,923.00",00.00,"65,787.36"
16-May-2025,Cash,00.00,"16,446.84","49,340.52"
16-May-2025,ATM,00.00,"5,482.28","43,858.24"
16-May-2025,NEFT,00.00,"4,385.82","39,472.42"
16-May-2025,Cheque,00.00,"19,736.21","19,736.21"
16-May-2025,Bill,01.55,00.00,"19,737.76"
16-May-2025,Cash,04.10,00.00,"19,741.86"
16-May-2025,Purchase,00.00,"1,974.19","17,767.67"
16-May-2025,ATM,00.00,"1,776.77","15,990.90"
17-May-2025,Bill,01.00,00.00,"15,991.90"
17-May-2025,Transfer,"22,115.90",00.00,"38,107.80"
17-May-2025,IMPS,00.00,"4,763.48","33,344.33"
17-May-2025,Cash,00.00,"4,763.48","28,580.85"
17-May-2025,RTGS,00.00,"5,716.17","22,864.68"
17-May-2025,RTGS,00.00,"5,716.17","17,148.51"
17-May-2025,Debit Card,00.00,"2,449.79","14,698.72"
17-May-2025,Transfer,00.00,"14,698.72",00.00
17-May-2025,RTGS,02.63,00.00,02.63
17-May-2025,Cash,"559,488.00",00.00,"559,490.63"
17-May-2025,IMPS,00.00,"79,927.23","479,563.40"
18-May-2025,ATM,00.00,"59,945.43","419,617.98"
18-May-2025,Bill,"17,999.00",00.00,"437,616.98"
18-May-2025,Reversal,01.40,00.00,"437,618.38"
19-May-2025,Miscellaneous,00.00,"54,702.30","382,916.08"
19-May-2025,RTGS,00.00,"127,638.69","255,277.39"
19-May-2025,Miscellaneous,00.00,"51,055.48","204,221.91"
19-May-2025,Cheque,00.00,"51,055.48","153,166.43"
19-May-2025,Bill,00.00,"51,055.48","102,110.95"
19-May-2025,Debit Card,00.00,"11,345.66","90,765.29"
19-May-2025,RTGS,00.00,"18,153.06","72,612.23"
19-May-2025,Reversal,00.00,"9,076.53","63,535.70"
19-May-2025,Commission,54.10,00.00,"63,589.80"
19-May-2025,Interest,"1,542,702.00",00.00,"1,606,291.80"
19-May-2025,NEFT,14.80,00.00,"1,606,306.60"
19-May-2025,Debit Card,00.00,"200,788.33","1,405,518.28"
19-May-2025,Tax,"1,318,945.50",00.00,"2,724,463.78"
19-May-2025,Miscellaneous,444.00,00.00,"2,724,907.78"
19-May-2025,Cheque,00.00,"454,151.30","2,270,756.48"
19-May-2025,NEFT,324.73,00.00,"2,271,081.21"
19-May-2025,Miscellaneous,00.00,"567,770.30","1,703,310.91"
19-May-2025,IMPS,00.00,"170,331.09","1,532,979.82"
19-May-2025,Miscellaneous,00.00,"306,595.96","1,226,383.86"
19-May-2025,Interest,00.00,"136,264.87","1,090,118.99"
20-May-2025,NEFT,00.00,"109,011.90","981,107.09"
20-May-2025,Interest,00.00,"122,638.39","858,468.70"
20-May-2025,RTGS,00.00,"286,156.23","572,312.47"
20-May-2025,Commission,05.70,00.00,"572,318.17"
20-May-2025,Commission,00.00,"286,159.09","286,159.09"
20-May-2025,Miscellaneous,"15,494.00",00.00,"301,653.09"
20-May-2025,Bill,00.00,"75,413.27","226,239.82"
20-May-2025,Purchase,60.79,00.00,"226,300.61"
20-May-2025,Purchase,00.00,"25,144.51","201,156.10"
20-May-2025,Commission,"1,365,981.25",00.00,"1,567,137.35"
20-May-2025,Transfer,"13,718.90",00.00,"1,580,856.25"
20-May-2025,Tax,00.00,"1,580,856.25",00.00
20-May-2025,Transfer,03.60,00.00,03.60
20-May-2025,RTGS,"453,856.25",00.00,"453,859.85"
20-May-2025,Cash,"11,661.00",00.00,"465,520.85"
20-May-2025,Debit Card,420.00,00.00,"465,940.85"
20-May-2025,Interest,00.00,"51,771.21","414,169.64"
20-May-2025,Commission,"470,147.25",00.00,"884,316.89"
20-May-2025,NEFT,07.52,00.00,"884,324.41"
20-May-2025,NEFT,00.00,"88,432.44","795,891.97"
20-May-2025,Purchase,00.00,"159,178.39","636,713.58"
20-May-2025,Cheque,00.00,"159,178.40","477,535.18"
20-May-2025,Cash,"3,005.00",00.00,"480,540.18"
20-May-2025,Bill,25.30,00.00,"480,565.48"
20-May-2025,IMPS,19.70,00.00,"480,585.18"
20-May-2025,RTGS,94.00,00.00,"480,679.18"
20-May-2025,Debit Card,"2,538.82",00.00,"483,218.00"
20-May-2025,ATM,00.00,"48,321.80","434,896.20"
20-May-2025,RTGS,"29,436.80",00.00,"464,333.00"
20-May-2025,IMPS,"35,941.53",00.00,"500,274.53"
20-May-2025,Debit Card,"2,032.80",00.00,"502,307.33"
20-May-2025,NEFT,00.00,"55,811.93","446,495.40"
20-May-2025,ATM,00.00,"63,785.06","382,710.34"
20-May-2025,Miscellaneous,04.30,00.00,"382,714.64"
21-May-2025,Tax,00.00,"76,542.93","306,171.71"
21-May-2025,Cash,35.60,00.00,"306,207.31"
21-May-2025,NEFT,00.00,"51,034.55","255,172.76"
21-May-2025,Reversal,21.61,00.00,"255,194.37"
21-May-2025,IMPS,378.00,00.00,"255,572.37"
21-May-2025,Purchase,00.00,"31,946.55","223,625.82"
21-May-2025,IMPS,"278,566.00",00.00,"502,191.82"
21-May-2025,RTGS,"2,277.00",00.00,"504,468.82"
21-May-2025,IMPS,29.00,00.00,"504,497.82"
21-May-2025,Transfer,00.00,"504,497.82",00.00
21-May-2025,Bill,04.50,00.00,04.50
21-May-2025,Bill,00.00,00.56,03.94
21-May-2025,Transfer,"490,010.00",00.00,"490,013.94"
21-May-2025,NEFT,00.00,"81,668.99","408,344.95"
21-May-2025,Debit Card,00.00,"136,114.98","272,229.97"
21-May-2025,Interest,00.00,"34,028.75","238,201.22"
21-May-2025,Bill,00.00,"34,028.75","204,172.47"
21-May-2025,IMPS,00.00,"34,028.75","170,143.72"
21-May-2025,Cash,00.00,"56,714.57","113,429.15"
22-May-2025,Commission,"1,368,926.20",00.00,"1,482,355.35"
22-May-2025,Cash,"171,010.00",00.00,"1,653,365.35"
22-May-2025,Cash,00.00,"330,673.07","1,322,692.28"
22-May-2025,Transfer,00.00,"132,269.23","1,190,423.05"
22-May-2025,RTGS,00.00,"132,269.23","1,058,153.82"
22-May-2025,Cash,02.00,00.00,"1,058,155.82"
22-May-2025,Debit Card,00.00,"117,572.87","940,582.95"
22-May-2025,Commission,"585,612.00",00.00,"1,526,194.95"
22-May-2025,Reversal,00.00,"508,731.65","1,017,463.30"
22-May-2025,Miscellaneous,58.30,00.00,"1,017,521.60"
22-May-2025,ATM,00.00,"169,586.93","847,934.67"
22-May-2025,Interest,"125,308.90",00.00,"973,243.57"
22-May-2025,Commission,"243,356.91",00.00,"1,216,600.48"
22-May-2025,Reversal,480.45,00.00,"1,217,080.93"
22-May-2025,Debit Card,00.00,"1,217,080.93",00.00
22-May-2025,NEFT,"118,780.30",00.00,"118,780.30"
22-May-2025,Purchase,00.00,"29,695.08","89,085.22"
22-May-2025,Cash,00.00,"44,542.61","44,542.61"
22-May-2025,NEFT,00.00,"14,847.54","29,695.07"
22-May-2025,Purchase,00.00,"7,423.77","22,271.30"
22-May-2025,Cheque,00.00,"11,135.65","11,135.65"
22-May-2025,NEFT,00.00,"2,227.13","8,908.52"
22-May-2025,Bill,56.00,00.00,"8,964.52"
22-May-2025,Cash,00.00,996.06,"7,968.46"
22-May-2025,Interest,"1,491,472.00",00.00,"1,499,440.46"
22-May-2025,Tax,448.00,00.00,"1,499,888.46"
22-May-2025,NEFT,"90,233.72",00.00,"1,590,122.18"
22-May-2025,Purchase,"6,534.00",00.00,"1,596,656.18"
22-May-2025,Interest,12.00,00.00,"1,596,668.18"
22-May-2025,IMPS,00.00,"199,583.52","1,397,084.66"
22-May-2025,Reversal,"43,752.10",00.00,"1,440,836.76"
22-May-2025,Debit Card,"251,265.80",00.00,"1,692,102.56"
22-May-2025,Tax,264.70,00.00,"1,692,367.26"
22-May-2025,Debit Card,"2,716.50",00.00,"1,695,083.76"
22-May-2025,NEFT,00.00,"211,885.47","1,483,198.29"
22-May-2025,IMPS,405.10,00.00,"1,483,603.39"
22-May-2025,Interest,00.00,"211,943.34","1,271,660.05"
23-May-2025,Interest,00.00,"423,886.68","847,773.37"
23-May-2025,Bill,00.00,"847,773.37",00.00
23-May-2025,Interest,"1,028.00",00.00,"1,028.00"
23-May-2025,Interest,00.00,514.00,514.00
23-May-2025,Debit Card,"121,836.00",00.00,"122,350.00"
23-May-2025,RTGS,"2,406.70",00.00,"124,756.70"
23-May-2025,Interest,16.00,00.00,"124,772.70"
23-May-2025,Debit Card,00.00,"17,824.67","106,948.03"
23-May-2025,Interest,00.00,"26,737.01","80,211.02"
23-May-2025,Tax,00.00,"13,368.50","66,842.52"
23-May-2025,RTGS,00.00,"9,548.93","57,293.59"
23-May-2025,Interest,00.00,"19,097.86","38,195.73"
23-May-2025,RTGS,00.00,"7,639.15","30,556.58"
23-May-2025,Cash,00.00,"6,111.32","24,445.26"
23-May-2025,Commission,"4,187.34",00.00,"28,632.60"
23-May-2025,ATM,00.00,"7,158.15","21,474.45"
23-May-2025,Tax,00.00,"21,474.45",00.00
23-May-2025,NEFT,"1,292,562.75",00.00,"1,292,562.75"
23-May-2025,Debit Card,"50,530.10",00.00,"1,343,092.85"
23-May-2025,Purchase,00.00,"167,886.61","1,175,206.24"
23-May-2025,Cheque,00.00,"1,175,206.24",00.00
23-May-2025,Reversal,55.30,00.00,55.30
23-May-2025,Interest,00.00,11.06,44.24
23-May-2025,Purchase,02.50,00.00,46.74
23-May-2025,Cheque,"57,022.60",00.00,"57,069.34"
23-May-2025,Tax,"22,181.39",00.00,"79,250.73"
23-May-2025,Purchase,"1,241.00",00.00,"80,491.73"
23-May-2025,IMPS,00.00,"11,498.82","68,992.91"
23-May-2025,NEFT,00.00,"7,665.88","61,327.03"
23-May-2025,Reversal,00.00,"6,132.70","55,194.33"
23-May-2025,ATM,"8,182.02",00.00,"63,376.35"
23-May-2025,Miscellaneous,00.00,"15,844.09","47,532.26"
23-May-2025,Reversal,876.00,00.00,"48,408.26"
23-May-2025,Purchase,140.80,00.00,"48,549.06"
23-May-2025,Miscellaneous,00.00,"8,091.51","40,457.55"
23-May-2025,Tax,"989,940.00",00.00,"1,030,397.55"
23-May-2025,Cash,07.24,00.00,"1,030,404.79"
23-May-2025,Tax,00.00,"128,800.60","901,604.19"
23-May-2025,Miscellaneous,05.62,00.00,"901,609.81"
23-May-2025,Bill,"1,478.00",00.00,"903,087.81"
23-May-2025,Debit Card,00.00,"150,514.64","752,573.18"
23-May-2025,Commission,15.00,00.00,"752,588.18"
23-May-2025,Interest,"217,490.00",00.00,"970,078.18"
23-May-2025,Debit Card,00.00,"107,786.46","862,291.72"
23-May-2025,IMPS,00.00,"287,430.57","574,861.15"
23-May-2025,Interest,"28,035.87",00.00,"602,897.02"
23-May-2025,Miscellaneous,00.00,"150,724.26","452,172.76"
23-May-2025,Tax,"184,776.00",00.00,"636,948.76"
23-May-2025,ATM,00.68,00.00,"636,949.44"
23-May-2025,Tax,322.60,00.00,"637,272.04"
23-May-2025,Purchase,"434,024.00",00.00,"1,071,296.04"
23-May-2025,Interest,00.00,"178,549.34","892,746.70"
23-May-2025,Transfer,00.00,"178,549.34","714,197.36"
23-May-2025,Reversal,00.00,"79,355.26","634,842.10"
23-May-2025,Purchase,00.00,"79,355.26","555,486.84"
23-May-2025,Reversal,00.00,"61,720.76","493,766.08"
23-May-2025,Interest,00.00,"61,720.76","432,045.32"
24-May-2025,IMPS,"3,217.70",00.00,"435,263.02"
24-May-2025,IMPS,00.00,"435,263.02",00.00
24-May-2025,Interest,"3,306.60",00.00,"3,306.60"
24-May-2025,Bill,00.00,"3,306.60",00.00
24-May-2025,Cheque,415.00,00.00,415.00
24-May-2025,NEFT,604.42,00.00,"1,019.42"
24-May-2025,Miscellaneous,00.00,169.90,849.52
24-May-2025,Purchase,00.00,84.95,764.57
24-May-2025,Bill,00.00,254.86,509.71
24-May-2025,NEFT,00.00,50.97,458.74
24-May-2025,Cash,"4,094.77",00.00,"4,553.51"
24-May-2025,Bill,"2,063,630.00",00.00,"2,068,183.51"
24-May-2025,Bill,"3,372.00",00.00,"2,071,555.51"
24-May-2025,Transfer,00.00,"345,259.25","1,726,296.26"
24-May-2025,Miscellaneous,00.00,"172,629.63","1,553,666.63"
24-May-2025,Tax,00.00,"517,888.88","1,035,777.75"
25-May-2025,NEFT,00.00,"103,577.78","932,199.98"
25-May-2025,Interest,00.00,"103,577.78","828,622.20"
25-May-2025,Bill,06.02,00.00,"828,628.22"
25-May-2025,Commission,"119,744.50",00.00,"948,372.72"
25-May-2025,Transfer,00.00,"237,093.18","711,279.54"
25-May-2025,Tax,"1,281,413.50",00.00,"1,992,693.04"
25-May-2025,NEFT,00.00,"1,992,693.04",00.00
25-May-2025,Bill,"9,820.00",00.00,"9,820.00"
25-May-2025,Purchase,"1,687,874.80",00.00,"1,697,694.80"
25-May-2025,Cash,"180,088.10",00.00,"1,877,782.90"
25-May-2025,ATM,"31,159.38",00.00,"1,908,942.28"
25-May-2025,Debit Card,"28,565.90",00.00,"1,937,508.18"
25-May-2025,Transfer,00.00,"968,754.09","968,754.09"
25-May-2025,Bill,00.00,"96,875.41","871,878.68"
25-May-2025,RTGS,37.60,00.00,"871,916.28"
25-May-2025,Miscellaneous,00.00,"290,638.76","581,277.52"
25-May-2025,Commission,00.00,"193,759.17","387,518.35"
26-May-2025,NEFT,00.00,"38,751.84","348,766.51"
26-May-2025,Cash,00.00,"43,595.81","305,170.70"
26-May-2025,Reversal,459.00,00.00,"305,629.70"
26-May-2025,Bill,00.00,"152,814.85","152,814.85"
26-May-2025,IMPS,04.00,00.00,"152,818.85"
26-May-2025,IMPS,14.56,00.00,"152,833.41"
26-May-2025,Cash,00.00,"38,208.35","114,625.06"
26-May-2025,Bill,415.80,00.00,"115,040.86"
26-May-2025,Cash,00.00,"38,346.95","76,693.91"
26-May-2025,Interest,00.00,"15,338.78","61,355.13"
26-May-2025,Cash,"118,013.00",00.00,"179,368.13"
26-May-2025,Cheque,00.00,"29,894.69","149,473.44"
26-May-2025,Interest,"1,397,064.00",00.00,"1,546,537.44"
26-May-2025,Transfer,00.00,"1,546,537.44",00.00
26-May-2025,ATM,67.40,00.00,67.40
26-May-2025,Reversal,00.00,16.85,50.55
26-May-2025,NEFT,163.60,00.00,214.15
26-May-2025,Commission,54.00,00.00,268.15
27-May-2025,Purchase,"2,865.43",00.00,"3,133.58"
27-May-2025,Miscellaneous,"186,853.00",00.00,"189,986.58"
27-May-2025,Interest,00.00,"23,748.32","166,238.26"
28-May-2025,Interest,00.00,"83,119.13","83,119.13"
28-May-2025,Interest,"1,772.39",00.00,"84,891.52"
28-May-2025,Interest,00.00,"9,432.39","75,459.13"
28-May-2025,RTGS,00.00,"18,864.78","56,594.35"
28-May-2025,Bill,00.00,"8,084.91","48,509.44"
28-May-2025,NEFT,00.00,"48,509.44",00.00
28-May-2025,Miscellaneous,"1,844.10",00.00,"1,844.10"
28-May-2025,Interest,00.00,263.44,"1,580.66"
28-May-2025,Debit Card,00.00,526.89,"1,053.77"
28-May-2025,RTGS,17.60,00.00,"1,071.37"
28-May-2025,Tax,"209,396.00",00.00,"210,467.37"
28-May-2025,Cheque,00.00,"26,308.42","184,158.95"
28-May-2025,NEFT,"47,050.78",00.00,"231,209.73"
28-May-2025,Commission,"6,833.12",00.00,"238,042.85"
28-May-2025,Debit Card,00.00,"34,006.12","204,036.73"
28-May-2025,Debit Card,"6,046.15",00.00,"210,082.88"
28-May-2025,Transfer,00.00,"21,008.29","189,074.59"
28-May-2025,IMPS,00.00,"18,907.46","170,167.13"
28-May-2025,ATM,00.00,"24,309.59","145,857.54"
28-May-2025,Cheque,00.00,"145,857.54",00.00
28-May-2025,IMPS,347.70,00.00,347.70
28-May-2025,Bill,"14,167.75",00.00,"14,515.45"
28-May-2025,Interest,"151,607.20",00.00,"166,122.65"
28-May-2025,Reversal,"22,106.50",00.00,"188,229.15"
28-May-2025,Cash,"1,629.44",00.00,"189,858.59"
28-May-2025,RTGS,"18,025.00",00.00,"207,883.59"
28-May-2025,NEFT,"467,884.80",00.00,"675,768.39"
28-May-2025,Transfer,00.86,00.00,"675,769.25"
28-May-2025,RTGS,00.00,"75,085.47","600,683.78"
28-May-2025,Cash,00.00,"75,085.47","525,598.31"
28-May-2025,NEFT,00.00,"75,085.47","450,512.84"
28-May-2025,Miscellaneous,"152,711.00",00.00,"603,223.84"
28-May-2025,Interest,00.00,"75,402.98","527,820.86"
28-May-2025,ATM,961.31,00.00,"528,782.17"
28-May-2025,Miscellaneous,"167,214.00",00.00,"695,996.17"
28-May-2025,Purchase,03.00,00.00,"695,999.17"
28-May-2025,Tax,00.00,"115,999.86","579,999.31"
28-May-2025,Debit Card,00.00,"72,499.91","507,499.40"
28-May-2025,Purchase,00.00,"101,499.88","405,999.52"
29-May-2025,Bill,00.00,"57,999.93","347,999.59"
29-May-2025,Purchase,00.00,"57,999.93","289,999.66"
29-May-2025,Debit Card,00.00,"41,428.52","248,571.14"
29-May-2025,Interest,"6,663.00",00.00,"255,234.14"
29-May-2025,RTGS,109.74,00.00,"255,343.88"
29-May-2025,Transfer,"1,879,790.25",00.00,"2,135,134.13"
29-May-2025,Debit Card,05.76,00.00,"2,135,139.89"
29-May-2025,RTGS,00.00,"1,067,569.95","1,067,569.94"
29-May-2025,RTGS,421.68,00.00,"1,067,991.62"
29-May-2025,Bill,00.00,"177,998.60","889,993.02"
29-May-2025,Cheque,"2,543.27",00.00,"892,536.29"
29-May-2025,ATM,"2,022.25",00.00,"894,558.54"
29-May-2025,Debit Card,"465,308.50",00.00,"1,359,867.04"
29-May-2025,Cheque,21.17,00.00,"1,359,888.21"
29-May-2025,Reversal,00.00,"226,648.04","1,133,240.18"
29-May-2025,Cash,"3,177.41",00.00,"1,136,417.59"
29-May-2025,ATM,"96,382.90",00.00,"1,232,800.49"
29-May-2025,Transfer,00.00,"136,977.83","1,095,822.66"
29-May-2025,ATM,"161,736.10",00.00,"1,257,558.76"
29-May-2025,ATM,170.60,00.00,"1,257,729.36"
29-May-2025,Commission,"3,779.00",00.00,"1,261,508.36"
29-May-2025,RTGS,238.40,00.00,"1,261,746.76"
29-May-2025,Transfer,03.29,00.00,"1,261,750.05"
29-May-2025,Commission,00.00,"140,194.45","1,121,555.60"
29-May-2025,Transfer,00.00,"140,194.45","981,361.15"
29-May-2025,Debit Card,00.00,"163,560.19","817,800.96"
29-May-2025,Reversal,233.00,00.00,"818,033.96"
29-May-2025,Miscellaneous,"26,086.17",00.00,"844,120.13"
29-May-2025,NEFT,27.00,00.00,"844,147.13"
29-May-2025,ATM,00.00,"422,073.57","422,073.56"
29-May-2025,Purchase,00.00,"52,759.20","369,314.36"
29-May-2025,RTGS,"8,523.70",00.00,"377,838.06"
29-May-2025,Cheque,00.00,"47,229.76","330,608.30"
29-May-2025,RTGS,"1,332.63",00.00,"331,940.93"
29-May-2025,Bill,00.00,"165,970.47","165,970.46"
29-May-2025,Interest,"6,767.00",00.00,"172,737.46"
29-May-2025,IMPS,00.00,"172,737.46",00.00
29-May-2025,Cash,"1,329,030.25",00.00,"1,329,030.25"
29-May-2025,Interest,00.00,"664,515.13","664,515.12"
29-May-2025,IMPS,00.00,"166,128.78","498,386.34"
29-May-2025,Miscellaneous,00.00,"166,128.78","332,257.56"
30-May-2025,Miscellaneous,"3,380.21",00.00,"335,637.77"
30-May-2025,IMPS,42.30,00.00,"335,680.07"
30-May-2025,IMPS,71.00,00.00,"335,751.07"
30-May-2025,NEFT,03.90,00.00,"335,754.97"
30-May-2025,Bill,00.00,"167,877.49","167,877.48"
30-May-2025,Cheque,"2,764.20",00.00,"170,641.68"
30-May-2025,Commission,436.70,00.00,"171,078.38"
30-May-2025,RTGS,03.96,00.00,"171,082.34"
30-May-2025,Purchase,00.00,"171,082.34",00.00
30-May-2025,Debit Card,06.00,00.00,06.00
30-May-2025,Purchase,"874,460.75",00.00,"874,466.75"
30-May-2025,Cash,00.00,"145,744.46","728,722.29"
30-May-2025,Cash,"129,626.30",00.00,"858,348.59"
30-May-2025,ATM,24.26,00.00,"858,372.85"
30-May-2025,NEFT,00.00,"429,186.43","429,186.42"
30-May-2025,Tax,00.00,"429,186.42",00.00
30-May-2025,Bill,25.90,00.00,25.90
30-May-2025,Cash,00.00,02.88,23.02
30-May-2025,RTGS,00.00,11.51,11.51
30-May-2025,Cash,00.00,03.84,07.67
30-May-2025,Reversal,00.00,01.53,06.14
30-May-2025,ATM,00.00,00.77,05.37
31-May-2025,Purchase,00.00,00.60,04.77
31-May-2025,Commission,00.00,00.80,03.97
31-May-2025,Interest,"541,915.00",00.00,"541,918.97"
31-May-2025,Tax,"2,218.51",00.00,"544,137.48"
31-May-2025,Purchase,"2,287.00",00.00,"546,424.48"
31-May-2025,IMPS,00.00,"546,424.48",00.00
31-May-2025,Debit Card,"37,124.00",00.00,"37,124.00"
31-May-2025,ATM,03.00,00.00,"37,127.00"
31-May-2025,Purchase,"238,111.00",00.00,"275,238.00"
31-May-2025,RTGS,00.00,"275,238.00",00.00
31-May-2025,Interest,26.86,00.00,26.86
31-May-2025,Reversal,00.00,26.86,00.00
31-May-2025,Cash,03.00,00.00,03.00
31-May-2025,ATM,"1,249,868.50",00.00,"1,249,871.50"
31-May-2025,Tax,33.30,00.00,"1,249,904.80"
31-May-2025,Commission,"50,280.80",00.00,"1,300,185.60"
31-May-2025,Tax,00.00,"216,697.60","1,083,488.00"
31-May-2025,Cash,00.00,"120,387.56","963,100.44"
31-May-2025,Interest,461.10,00.00,"963,561.54"
31-May-2025,Cheque,00.00,"963,561.54",00.00
31-May-2025,Reversal,01.80,00.00,01.80
31-May-2025,RTGS,00.00,00.26,01.54
31-May-2025,Debit Card,"1,402,730.20",00.00,"1,402,731.74"
31-May-2025,Tax,27.00,00.00,"1,402,758.74"
31-May-2025,Cash,00.00,"467,586.25","935,172.49"
31-May-2025,Tax,00.00,"311,724.16","623,448.33"
31-May-2025,Miscellaneous,00.00,"62,344.83","561,103.50"
31-May-2025,Bill,00.00,"280,551.75","280,551.75"
01-Jun-2025,ATM,"725,435.00",00.00,"1,005,986.75"
01-Jun-2025,Commission,00.00,"251,496.69","754,490.06"
01-Jun-2025,Purchase,01.00,00.00,"754,491.06"
01-Jun-2025,Commission,"14,911.00",00.00,"769,402.06"
01-Jun-2025,Cash,00.00,"109,914.58","659,487.48"
01-Jun-2025,Bill,00.00,"659,487.48",00.00
01-Jun-2025,Cheque,08.00,00.00,08.00
01-Jun-2025,Debit Card,04.10,00.00,12.10
01-Jun-2025,Interest,00.00,12.10,00.00
01-Jun-2025,Debit Card,251.20,00.00,251.20
01-Jun-2025,Transfer,01.40,00.00,252.60
01-Jun-2025,Cash,00.00,25.26,227.34
01-Jun-2025,Commission,"1,478,676.00",00.00,"1,478,903.34"
02-Jun-2025,Tax,00.00,"492,967.78","985,935.56"
02-Jun-2025,Commission,01.00,00.00,"985,936.56"
02-Jun-2025,Cash,00.00,"246,484.14","739,452.42"
03-Jun-2025,Cheque,403.00,00.00,"739,855.42"
03-Jun-2025,Tax,00.00,"246,618.47","493,236.95"
03-Jun-2025,Cheque,"2,187.00",00.00,"495,423.95"
03-Jun-2025,Transfer,06.77,00.00,"495,430.72"
03-Jun-2025,Commission,"1,357,338.00",00.00,"1,852,768.72"
03-Jun-2025,Interest,00.00,"1,852,768.72",00.00
03-Jun-2025,IMPS,00.32,00.00,00.32
03-Jun-2025,Tax,00.00,00.08,00.24
03-Jun-2025,Debit Card,00.00,00.04,00.20
03-Jun-2025,Commission,02.50,00.00,02.70
03-Jun-2025,IMPS,378.00,00.00,380.70
03-Jun-2025,NEFT,149.00,00.00,529.70
03-Jun-2025,Miscellaneous,"1,908,383.80",00.00,"1,908,913.50"
03-Jun-2025,Commission,"2,077,077.50",00.00,"3,985,991.00"
03-Jun-2025,Reversal,"2,604.70",00.00,"3,988,595.70"
03-Jun-2025,ATM,00.00,"1,994,297.85","1,994,297.85"
03-Jun-2025,Transfer,"62,266.00",00.00,"2,056,563.85"
03-Jun-2025,Debit Card,178.90,00.00,"2,056,742.75"
03-Jun-2025,Reversal,43.00,00.00,"2,056,785.75"
03-Jun-2025,ATM,"2,907.30",00.00,"2,059,693.05"
03-Jun-2025,Miscellaneous,00.00,"1,029,846.53","1,029,846.52"
03-Jun-2025,Debit Card,"3,122.83",00.00,"1,032,969.35"
03-Jun-2025,Debit Card,00.00,"147,567.05","885,402.30"
03-Jun-2025,Bill,427.00,00.00,"885,829.30"
03-Jun-2025,Debit Card,00.00,"221,457.33","664,371.98"
04-Jun-2025,Tax,"18,965.00",00.00,"683,336.98"
04-Jun-2025,Commission,"15,365.22",00.00,"698,702.20"
04-Jun-2025,Cheque,"1,613,952.00",00.00,"2,312,654.20"
04-Jun-2025,Reversal,227.00,00.00,"2,312,881.20"
04-Jun-2025,Cash,00.00,"578,220.30","1,734,660.90"
04-Jun-2025,Commission,00.00,"216,832.61","1,517,828.29"
04-Jun-2025,Interest,06.00,00.00,"1,517,834.29"
04-Jun-2025,Debit Card,00.00,"505,944.76","1,011,889.53"
04-Jun-2025,Purchase,"699,132.00",00.00,"1,711,021.53"
04-Jun-2025,Purchase,"2,119.90",00.00,"1,713,141.43"
04-Jun-2025,NEFT,00.00,"428,285.36","1,284,856.07"
04-Jun-2025,Miscellaneous,55.30,00.00,"1,284,911.37"
04-Jun-2025,NEFT,00.00,"128,491.14","1,156,420.23"
04-Jun-2025,Cheque,"5,283.00",00.00,"1,161,703.23"
04-Jun-2025,Interest,00.00,"290,425.81","871,277.42"
04-Jun-2025,Miscellaneous,"2,628.60",00.00,"873,906.02"
04-Jun-2025,Debit Card,"122,858.31",00.00,"996,764.33"
04-Jun-2025,Reversal,"952,474.00",00.00,"1,949,238.33"
04-Jun-2025,Bill,00.00,"243,654.79","1,705,583.54"
04-Jun-2025,Tax,"3,692.86",00.00,"1,709,276.40"
04-Jun-2025,Commission,76.00,00.00,"1,709,352.40"
04-Jun-2025,ATM,"1,213.49",00.00,"1,710,565.89"
04-Jun-2025,Miscellaneous,00.00,"285,094.32","1,425,471.58"
04-Jun-2025,Purchase,"1,133,035.00",00.00,"2,558,506.58"
04-Jun-2025,ATM,00.00,"2,558,506.58",00.00
04-Jun-2025,Tax,85.00,00.00,85.00
04-Jun-2025,Cheque,"476,514.00",00.00,"476,599.00"
04-Jun-2025,Reversal,00.00,"158,866.33","317,732.67"
04-Jun-2025,NEFT,00.00,"52,955.45","264,777.22"
04-Jun-2025,Interest,00.00,"37,825.32","226,951.90"
04-Jun-2025,Miscellaneous,00.00,"75,650.63","151,301.27"
04-Jun-2025,Purchase,"431,152.80",00.00,"582,454.07"
04-Jun-2025,Purchase,35.40,00.00,"582,489.47"
04-Jun-2025,Debit Card,50.45,00.00,"582,539.92"
04-Jun-2025,Reversal,00.00,"97,089.99","485,449.93"
04-Jun-2025,RTGS,"1,836,611.80",00.00,"2,322,061.73"
04-Jun-2025,IMPS,00.00,"774,020.58","1,548,041.15"
04-Jun-2025,Purchase,"29,115.10",00.00,"1,577,156.25"
04-Jun-2025,Bill,"3,557.88",00.00,"1,580,714.13"
04-Jun-2025,Cash,"2,376.00",00.00,"1,583,090.13"
04-Jun-2025,Cash,00.00,"316,618.03","1,266,472.10"
04-Jun-2025,Commission,00.00,"158,309.01","1,108,163.09"
04-Jun-2025,Cash,00.00,"184,693.85","923,469.24"
04-Jun-2025,Commission,00.00,"92,346.92","831,122.32"
04-Jun-2025,Tax,02.80,00.00,"831,125.12"
04-Jun-2025,Interest,61.00,00.00,"831,186.12"
04-Jun-2025,Cheque,00.00,"92,354.01","738,832.11"
04-Jun-2025,Cheque,00.00,"147,766.42","591,065.69"
04-Jun-2025,NEFT,"177,205.00",00.00,"768,270.69"
04-Jun-2025,IMPS,00.00,"128,045.12","640,225.57"
04-Jun-2025,Purchase,00.00,"106,704.26","533,521.31"
04-Jun-2025,IMPS,00.00,"53,352.13","480,169.18"
04-Jun-2025,IMPS,218.52,00.00,"480,387.70"
04-Jun-2025,Purchase,"18,738.00",00.00,"499,125.70"
04-Jun-2025,Bill,"24,758.00",00.00,"523,883.70"
04-Jun-2025,Tax,00.03,00.00,"523,883.73"
04-Jun-2025,Tax,"622,208.50",00.00,"1,146,092.23"
04-Jun-2025,Bill,00.00,"382,030.74","764,061.49"
04-Jun-2025,ATM,00.00,"95,507.69","668,553.80"
04-Jun-2025,Reversal,294.00,00.00,"668,847.80"
04-Jun-2025,Interest,00.00,"334,423.90","334,423.90"
04-Jun-2025,Bill,"1,590,075.00",00.00,"1,924,498.90"
04-Jun-2025,Miscellaneous,"2,266.00",00.00,"1,926,764.90"
05-Jun-2025,Bill,"118,473.10",00.00,"2,045,238.00"
05-Jun-2025,Purchase,00.00,"292,176.86","1,753,061.14"
05-Jun-2025,Miscellaneous,00.00,"194,784.57","1,558,276.57"
05-Jun-2025,Bill,00.00,"155,827.66","1,402,448.91"
05-Jun-2025,Cash,384.00,00.00,"1,402,832.91"
05-Jun-2025,NEFT,"2,443.47",00.00,"1,405,276.38"
05-Jun-2025,Interest,"115,340.00",00.00,"1,520,616.38"
05-Jun-2025,Commission,00.00,"253,436.06","1,267,180.32"
06-Jun-2025,RTGS,00.00,"253,436.06","1,013,744.26"
06-Jun-2025,Debit Card,00.00,"202,748.85","810,995.41"
06-Jun-2025,Tax,54.98,00.00,"811,050.39"
06-Jun-2025,ATM,00.00,"405,525.20","405,525.20"
06-Jun-2025,Debit Card,00.00,"57,932.17","347,593.03"
06-Jun-2025,Interest,00.00,"34,759.30","312,833.73"
06-Jun-2025,Cheque,322.00,00.00,"313,155.73"
06-Jun-2025,IMPS,00.00,"44,736.53","268,419.20"
06-Jun-2025,NEFT,00.00,"38,345.60","230,073.60"
06-Jun-2025,Reversal,00.00,"46,014.72","184,058.88"
06-Jun-2025,Purchase,"3,364.90",00.00,"187,423.78"
06-Jun-2025,Commission,00.00,"46,855.95","140,567.84"
06-Jun-2025,Tax,54.00,00.00,"140,621.84"
06-Jun-2025,NEFT,00.00,"23,436.97","117,184.87"
06-Jun-2025,Commission,"1,230,381.00",00.00,"1,347,565.87"
06-Jun-2025,Miscellaneous,"2,371.80",00.00,"1,349,937.67"
06-Jun-2025,Transfer,"99,395.34",00.00,"1,449,333.01"
06-Jun-2025,IMPS,00.00,"181,166.63","1,268,166.38"
06-Jun-2025,Purchase,00.00,"181,166.63","1,086,999.75"
06-Jun-2025,IMPS,"1,644.00",00.00,"1,088,643.75"
06-Jun-2025,Interest,"235,037.70",00.00,"1,323,681.45"
06-Jun-2025,Debit Card,00.00,"330,920.36","992,761.09"
06-Jun-2025,Purchase,00.00,"110,306.79","882,454.30"
07-Jun-2025,ATM,"117,255.62",00.00,"999,709.92"
07-Jun-2025,Debit Card,00.00,"124,963.74","874,746.18"
07-Jun-2025,RTGS,"1,493,038.50",00.00,"2,367,784.68"
07-Jun-2025,Commission,250.00,00.00,"2,368,034.68"
07-Jun-2025,Transfer,00.00,"236,803.47","2,131,231.21"
07-Jun-2025,IMPS,52.20,00.00,"2,131,283.41"
07-Jun-2025,Reversal,00.00,"710,427.80","1,420,855.61"
07-Jun-2025,ATM,00.00,"710,427.81","710,427.80"
07-Jun-2025,Miscellaneous,00.00,"118,404.63","592,023.17"
07-Jun-2025,NEFT,00.00,"98,670.53","493,352.64"
07-Jun-2025,RTGS,00.00,"49,335.26","444,017.38"
07-Jun-2025,Reversal,367.00,00.00,"444,384.38"
07-Jun-2025,IMPS,00.00,"49,376.04","395,008.34"
07-Jun-2025,Interest,"26,026.00",00.00,"421,034.34"
07-Jun-2025,NEFT,00.00,"105,258.59","315,775.76"
07-Jun-2025,Commission,00.00,"63,155.15","252,620.61"
07-Jun-2025,IMPS,00.00,"63,155.15","189,465.46"
07-Jun-2025,NEFT,"95,885.60",00.00,"285,351.06"
07-Jun-2025,Interest,"892,506.00",00.00,"1,177,857.06"
07-Jun-2025,IMPS,00.00,"117,785.71","1,060,071.35"
07-Jun-2025,Cheque,09.00,00.00,"1,060,080.35"
07-Jun-2025,RTGS,"588,543.75",00.00,"1,648,624.10"
07-Jun-2025,IMPS,02.81,00.00,"1,648,626.91"
07-Jun-2025,Bill,00.00,"1,648,626.91",00.00
07-Jun-2025,Tax,375.10,00.00,375.10
07-Jun-2025,Cash,"870,963.00",00.00,"871,338.10"
07-Jun-2025,Miscellaneous,"28,134.06",00.00,"899,472.16"
07-Jun-2025,Debit Card,00.00,"449,736.08","449,736.08"
07-Jun-2025,ATM,00.00,"49,970.68","399,765.40"
07-Jun-2025,NEFT,00.00,"39,976.54","359,788.86"
07-Jun-2025,Cash,00.00,"39,976.54","319,812.32"
07-Jun-2025,NEFT,"2,329.21",00.00,"322,141.53"
07-Jun-2025,Purchase,"182,915.00",00.00,"505,056.53"
07-Jun-2025,Reversal,00.00,"50,505.65","454,550.88"
07-Jun-2025,Transfer,"1,623.30",00.00,"456,174.18"
07-Jun-2025,Bill,189.20,00.00,"456,363.38"
07-Jun-2025,Reversal,00.18,00.00,"456,363.56"
07-Jun-2025,Debit Card,00.00,"50,707.06","405,656.50"
07-Jun-2025,Transfer,00.00,"45,072.94","360,583.56"
07-Jun-2025,Bill,"166,642.20",00.00,"527,225.76"
07-Jun-2025,Reversal,00.00,"87,870.96","439,354.80"
07-Jun-2025,Cash,00.00,"62,764.97","376,589.83"
07-Jun-2025,Debit Card,00.00,"41,843.31","334,746.52"
07-Jun-2025,Cheque,00.00,"334,746.52",00.00
07-Jun-2025,Bill,"912,470.00",00.00,"912,470.00"
07-Jun-2025,IMPS,"1,006.30",00.00,"913,476.30"
07-Jun-2025,Miscellaneous,36.00,00.00,"913,512.30"
07-Jun-2025,Tax,"9,948.86",00.00,"923,461.16"
07-Jun-2025,Interest,"1,711,361.00",00.00,"2,634,822.16"
07-Jun-2025,Miscellaneous,17.00,00.00,"2,634,839.16"
07-Jun-2025,Tax,"15,330.80",00.00,"2,650,169.96"
07-Jun-2025,IMPS,"3,157.50",00.00,"2,653,327.46"
07-Jun-2025,ATM,00.00,"884,442.49","1,768,884.97"
07-Jun-2025,Cash,00.00,"1,768,884.97",00.00
07-Jun-2025,NEFT,"2,035.20",00.00,"2,035.20"
07-Jun-2025,Commission,"3,416.70",00.00,"5,451.90"
07-Jun-2025,Purchase,02.00,00.00,"5,453.90"
07-Jun-2025,Purchase,00.00,605.99,"4,847.91"
07-Jun-2025,NEFT,00.00,"1,615.97","3,231.94"
07-Jun-2025,ATM,30.20,00.00,"3,262.14"
07-Jun-2025,Purchase,"3,784.38",00.00,"7,046.52"
07-Jun-2025,Debit Card,00.00,"1,174.42","5,872.10"
07-Jun-2025,ATM,00.00,"1,468.03","4,404.08"
07-Jun-2025,Purchase,00.00,550.51,"3,853.57"
07-Jun-2025,Commission,"114,669.00",00.00,"118,522.57"
07-Jun-2025,Bill,00.00,"14,815.32","103,707.25"
07-Jun-2025,Miscellaneous,"126,876.00",00.00,"230,583.25"
07-Jun-2025,Transfer,00.00,"76,861.08","153,722.17"
07-Jun-2025,Miscellaneous,"22,423.00",00.00,"176,145.17"
07-Jun-2025,Cash,00.00,"29,357.53","146,787.64"
07-Jun-2025,Cash,00.00,"73,393.82","73,393.82"
07-Jun-2025,Interest,00.00,"9,174.23","64,219.59"
07-Jun-2025,Cash,183.20,00.00,"64,402.79"
07-Jun-2025,Interest,"157,227.00",00.00,"221,629.79"
07-Jun-2025,Commission,00.00,"24,625.53","197,004.26"
07-Jun-2025,Debit Card,00.00,"32,834.04","164,170.22"
07-Jun-2025,Commission,"21,821.00",00.00,"185,991.22"
07-Jun-2025,Tax,00.00,"92,995.61","92,995.61"
07-Jun-2025,Purchase,01.30,00.00,"92,996.91"
07-Jun-2025,RTGS,00.00,"9,299.69","83,697.22"
07-Jun-2025,Cash,387.80,00.00,"84,085.02"
07-Jun-2025,Reversal,"36,115.60",00.00,"120,200.62"
07-Jun-2025,IMPS,"9,452.16",00.00,"129,652.78"
07-Jun-2025,IMPS,00.00,"12,965.28","116,687.50"
07-Jun-2025,Reversal,53.31,00.00,"116,740.81"
07-Jun-2025,NEFT,00.00,"12,971.20","103,769.61"
07-Jun-2025,Interest,00.00,"12,971.20","90,798.41"
07-Jun-2025,Cheque,00.00,"15,133.07","75,665.34"
07-Jun-2025,NEFT,190.50,00.00,"75,855.84"
08-Jun-2025,ATM,00.00,"15,171.17","60,684.67"
08-Jun-2025,Cheque,00.00,"7,585.58","53,099.09"
08-Jun-2025,RTGS,"99,743.03",00.00,"152,842.12"
08-Jun-2025,Debit Card,00.00,00.00,"152,842.12"
08-Jun-2025,Cheque,"103,430.72",00.00,"256,272.84"
09-Jun-2025,IMPS,00.00,"32,034.11","224,238.74"
09-Jun-2025,Cheque,00.00,"224,238.74",00.00
09-Jun-2025,Bill,17.20,00.00,17.20
09-Jun-2025,Transfer,00.00,01.72,15.48
09-Jun-2025,Transfer,00.00,01.94,13.54
09-Jun-2025,Commission,00.00,01.35,12.19
09-Jun-2025,Reversal,54.36,00.00,66.55
09-Jun-2025,Cheque,00.00,09.51,57.04
09-Jun-2025,Interest,27.00,00.00,84.04
09-Jun-2025,IMPS,"9,451.00",00.00,"9,535.04"
09-Jun-2025,Debit Card,00.00,"1,191.88","8,343.16"
09-Jun-2025,Miscellaneous,"146,798.75",00.00,"155,141.91"
09-Jun-2025,IMPS,46.00,00.00,"155,187.91"
09-Jun-2025,Interest,"9,960.53",00.00,"165,148.44"
09-Jun-2025,Purchase,"1,165.01",00.00,"166,313.45"
09-Jun-2025,RTGS,"3,659.00",00.00,"169,972.45"
09-Jun-2025,Commission,00.00,"16,997.25","152,975.21"
09-Jun-2025,Miscellaneous,"6,073.61",00.00,"159,048.82"
09-Jun-2025,Cheque,00.00,"15,904.88","143,143.94"
09-Jun-2025,Miscellaneous,00.00,"17,892.99","125,250.95"
09-Jun-2025,RTGS,"1,336,674.50",00.00,"1,461,925.45"
09-Jun-2025,Cheque,02.40,00.00,"1,461,927.85"
09-Jun-2025,Commission,00.00,"292,385.57","1,169,542.28"
09-Jun-2025,Commission,264.00,00.00,"1,169,806.28"
09-Jun-2025,Bill,"236,959.69",00.00,"1,406,765.97"
09-Jun-2025,ATM,00.00,"1,406,765.97",00.00
09-Jun-2025,Interest,45.00,00.00,45.00
09-Jun-2025,Debit Card,00.00,04.50,40.50
09-Jun-2025,Cheque,00.00,06.75,33.75
09-Jun-2025,Tax,00.00,04.82,28.93
09-Jun-2025,Interest,"222,414.20",00.00,"222,443.13"
09-Jun-2025,Miscellaneous,970.70,00.00,"223,413.83"
09-Jun-2025,RTGS,"21,212.00",00.00,"244,625.83"
09-Jun-2025,Tax,00.00,"61,156.46","183,469.37"
09-Jun-2025,Interest,45.00,00.00,"183,514.37"
09-Jun-2025,Reversal,00.00,"91,757.19","91,757.18"
09-Jun-2025,Transfer,00.00,"10,195.24","81,561.94"
09-Jun-2025,Interest,00.00,"40,780.97","40,780.97"
09-Jun-2025,Purchase,04.00,00.00,"40,784.97"
09-Jun-2025,Interest,00.00,"40,784.97",00.00
09-Jun-2025,Commission,655.80,00.00,655.80
09-Jun-2025,ATM,00.00,65.58,590.22
09-Jun-2025,Miscellaneous,00.00,147.56,442.66
09-Jun-2025,Commission,"216,624.80",00.00,"217,067.46"
09-Jun-2025,RTGS,00.00,"108,533.73","108,533.73"
09-Jun-2025,Interest,00.00,"36,177.91","72,355.82"
09-Jun-2025,Tax,20.80,00.00,"72,376.62"
09-Jun-2025,Purchase,"40,665.75",00.00,"113,042.37"
09-Jun-2025,Purchase,00.00,"16,148.91","96,893.46"
09-Jun-2025,Commission,00.00,"12,111.68","84,781.78"
09-Jun-2025,Cash,"177,289.00",00.00,"262,070.78"
09-Jun-2025,Commission,00.00,"29,118.98","232,951.80"
09-Jun-2025,Miscellaneous,02.10,00.00,"232,953.90"
09-Jun-2025,IMPS,275.00,00.00,"233,228.90"
09-Jun-2025,Reversal,"31,079.30",00.00,"264,308.20"
09-Jun-2025,Commission,00.00,"33,038.53","231,269.68"
09-Jun-2025,Bill,341.00,00.00,"231,610.68"
10-Jun-2025,Reversal,00.00,"23,161.07","208,449.61"
10-Jun-2025,Purchase,00.00,"208,449.61",00.00
10-Jun-2025,Cheque,88.00,00.00,88.00
11-Jun-2025,Transfer,"667,792.00",00.00,"667,880.00"
11-Jun-2025,Purchase,00.00,"66,788.00","601,092.00"
11-Jun-2025,Debit Card,104.80,00.00,"601,196.80"
11-Jun-2025,IMPS,00.00,"66,799.64","534,397.16"
11-Jun-2025,Cash,00.00,"59,377.46","475,019.70"
12-Jun-2025,Transfer,00.00,"118,754.93","356,264.78"
12-Jun-2025,Miscellaneous,"553,845.00",00.00,"910,109.78"
12-Jun-2025,Miscellaneous,00.00,"303,369.93","606,739.85"
12-Jun-2025,Bill,00.00,"86,677.12","520,062.73"
12-Jun-2025,Purchase,00.00,"86,677.12","433,385.61"
12-Jun-2025,Tax,"1,955.60",00.00,"435,341.21"
12-Jun-2025,ATM,"1,160.00",00.00,"436,501.21"
12-Jun-2025,IMPS,"69,216.00",00.00,"505,717.21"
12-Jun-2025,Transfer,00.00,"126,429.30","379,287.91"
12-Jun-2025,RTGS,"16,021.40",00.00,"395,309.31"
12-Jun-2025,Cheque,00.00,"56,472.76","338,836.55"
13-Jun-2025,Miscellaneous,00.00,"33,883.66","304,952.90"
13-Jun-2025,Interest,"229,518.50",00.00,"534,471.40"
13-Jun-2025,Miscellaneous,00.00,"76,353.06","458,118.34"
13-Jun-2025,Purchase,"9,024.00",00.00,"467,142.34"
13-Jun-2025,Cash,00.00,"467,142.34",00.00
13-Jun-2025,Reversal,17.50,00.00,17.50
13-Jun-2025,ATM,"3,974.19",00.00,"3,991.69"
13-Jun-2025,NEFT,"205,540.80",00.00,"209,532.49"
13-Jun-2025,IMPS,"1,929,746.50",00.00,"2,139,278.99"
13-Jun-2025,Reversal,"871,770.20",00.00,"3,011,049.19"
13-Jun-2025,Interest,08.00,00.00,"3,011,057.19"
13-Jun-2025,Miscellaneous,00.00,"1,003,685.73","2,007,371.46"
13-Jun-2025,RTGS,00.00,"250,921.43","1,756,450.03"
13-Jun-2025,Transfer,00.00,"585,483.34","1,170,966.69"
13-Jun-2025,Purchase,"25,706.36",00.00,"1,196,673.05"
13-Jun-2025,Commission,00.00,"149,584.13","1,047,088.92"
13-Jun-2025,Bill,00.00,"130,886.12","916,202.80"
13-Jun-2025,Reversal,00.00,"458,101.40","458,101.40"
13-Jun-2025,Miscellaneous,00.00,"50,900.16","407,201.24"
13-Jun-2025,ATM,00.00,"40,720.12","366,481.12"
13-Jun-2025,Reversal,"39,480.44",00.00,"405,961.56"
13-Jun-2025,Miscellaneous,00.00,"57,994.51","347,967.05"
13-Jun-2025,Transfer,"1,146,701.00",00.00,"1,494,668.05"
13-Jun-2025,Transfer,00.00,"149,466.81","1,345,201.24"
13-Jun-2025,Bill,"227,527.81",00.00,"1,572,729.05"
13-Jun-2025,Miscellaneous,335.00,00.00,"1,573,064.05"
13-Jun-2025,Miscellaneous,"220,675.00",00.00,"1,793,739.05"
13-Jun-2025,ATM,"532,227.80",00.00,"2,325,966.85"
13-Jun-2025,Debit Card,"30,155.20",00.00,"2,356,122.05"
13-Jun-2025,RTGS,04.00,00.00,"2,356,126.05"
13-Jun-2025,Purchase,04.00,00.00,"2,356,130.05"
13-Jun-2025,RTGS,02.00,00.00,"2,356,132.05"
13-Jun-2025,Cash,06.18,00.00,"2,356,138.23"
13-Jun-2025,Purchase,00.00,"294,517.28","2,061,620.95"
13-Jun-2025,Cheque,00.00,"206,162.10","1,855,458.86"
14-Jun-2025,IMPS,210.60,00.00,"1,855,669.46"
14-Jun-2025,Debit Card,07.38,00.00,"1,855,676.84"
14-Jun-2025,Commission,00.00,"265,096.69","1,590,580.15"
14-Jun-2025,NEFT,00.00,"397,645.04","1,192,935.11"
14-Jun-2025,Cheque,"766,205.00",00.00,"1,959,140.11"
14-Jun-2025,Bill,00.00,"489,785.03","1,469,355.08"
14-Jun-2025,IMPS,353.62,00.00,"1,469,708.70"
14-Jun-2025,Debit Card,00.00,"367,427.18","1,102,281.52"
14-Jun-2025,Transfer,00.00,"122,475.72","979,805.80"
14-Jun-2025,Reversal,"1,804.10",00.00,"981,609.90"
14-Jun-2025,Debit Card,"12,773.33",00.00,"994,383.23"
14-Jun-2025,Cash,00.00,"124,297.90","870,085.33"
14-Jun-2025,Cheque,"16,907.04",00.00,"886,992.37"
14-Jun-2025,Tax,"1,507,648.00",00.00,"2,394,640.37"
14-Jun-2025,IMPS,433.00,00.00,"2,395,073.37"
14-Jun-2025,Cheque,"955,130.00",00.00,"3,350,203.37"
14-Jun-2025,Cheque,00.00,"1,116,734.46","2,233,468.91"
14-Jun-2025,Bill,"7,916.43",00.00,"2,241,385.34"
14-Jun-2025,Cheque,00.00,"747,128.45","1,494,256.89"
14-Jun-2025,Tax,00.00,"213,465.27","1,280,791.62"
14-Jun-2025,Interest,00.00,"128,079.16","1,152,712.46"
15-Jun-2025,Tax,00.00,"384,237.49","768,474.97"
15-Jun-2025,Interest,"11,005.00",00.00,"779,479.97"
15-Jun-2025,Debit Card,00.00,"77,948.00","701,531.97"
15-Jun-2025,Purchase,00.00,"100,218.85","601,313.12"
15-Jun-2025,Miscellaneous,30.00,00.00,"601,343.12"
15-Jun-2025,RTGS,00.00,"60,134.31","541,208.81"
15-Jun-2025,Miscellaneous,"152,843.38",00.00,"694,052.19"
15-Jun-2025,Interest,00.00,"173,513.05","520,539.14"
15-Jun-2025,Interest,03.76,00.00,"520,542.90"
15-Jun-2025,Miscellaneous,279.10,00.00,"520,822.00"
15-Jun-2025,Commission,00.00,"74,403.14","446,418.86"
15-Jun-2025,Bill,"371,233.75",00.00,"817,652.61"
15-Jun-2025,Bill,07.60,00.00,"817,660.21"
15-Jun-2025,Cash,00.00,"136,276.70","681,383.51"
15-Jun-2025,ATM,00.00,"68,138.35","613,245.16"
15-Jun-2025,Miscellaneous,00.00,"153,311.29","459,933.87"
15-Jun-2025,NEFT,00.00,"114,983.47","344,950.40"
15-Jun-2025,Tax,00.00,"172,475.20","172,475.20"
15-Jun-2025,Commission,"26,561.00",00.00,"199,036.20"
15-Jun-2025,Commission,00.00,"66,345.40","132,690.80"
15-Jun-2025,Tax,00.00,"66,345.40","66,345.40"
15-Jun-2025,Debit Card,"10,443.71",00.00,"76,789.11"
15-Jun-2025,Miscellaneous,"17,625.11",00.00,"94,414.22"
15-Jun-2025,Purchase,00.00,"47,207.11","47,207.11"
15-Jun-2025,Transfer,00.00,"5,245.23","41,961.88"
15-Jun-2025,Commission,58.90,00.00,"42,020.78"
15-Jun-2025,Debit Card,00.00,"4,668.98","37,351.80"
15-Jun-2025,Reversal,"21,479.00",00.00,"58,830.80"
15-Jun-2025,Cash,57.00,00.00,"58,887.80"
15-Jun-2025,IMPS,46.30,00.00,"58,934.10"
15-Jun-2025,Interest,"14,140.00",00.00,"73,074.10"
15-Jun-2025,Miscellaneous,00.00,"36,537.05","36,537.05"
15-Jun-2025,Interest,00.00,"7,307.41","29,229.64"
15-Jun-2025,Tax,452.00,00.00,"29,681.64"
15-Jun-2025,Cheque,216.00,00.00,"29,897.64"
15-Jun-2025,Miscellaneous,00.00,"9,965.88","19,931.76"
15-Jun-2025,Cash,"122,122.00",00.00,"142,053.76"
15-Jun-2025,Interest,00.00,"23,675.63","118,378.13"
15-Jun-2025,IMPS,00.00,"11,837.81","106,540.32"
15-Jun-2025,Tax,00.00,"13,317.54","93,222.78"
15-Jun-2025,Tax,"24,827.07",00.00,"118,049.85"
15-Jun-2025,Tax,"140,348.25",00.00,"258,398.10"
15-Jun-2025,Miscellaneous,00.00,"51,679.62","206,718.48"
15-Jun-2025,Cheque,"676,665.75",00.00,"883,384.23"
15-Jun-2025,RTGS,"238,979.90",00.00,"1,122,364.13"
15-Jun-2025,Cash,00.00,"140,295.52","982,068.61"
15-Jun-2025,Miscellaneous,00.00,"163,678.10","818,390.51"
15-Jun-2025,Tax,07.00,00.00,"818,397.51"
15-Jun-2025,NEFT,"145,955.31",00.00,"964,352.82"
15-Jun-2025,Cash,"111,972.30",00.00,"1,076,325.12"
15-Jun-2025,Bill,00.00,"1,076,325.12",00.00
15-Jun-2025,Transfer,"67,191.97",00.00,"67,191.97"
16-Jun-2025,Purchase,"3,820.85",00.00,"71,012.82"
16-Jun-2025,Commission,00.00,"8,876.60","62,136.22"
16-Jun-2025,Reversal,00.00,"62,136.22",00.00
17-Jun-2025,Debit Card,"132,446.00",00.00,"132,446.00"
17-Jun-2025,ATM,00.00,"13,244.60","119,201.40"
17-Jun-2025,Transfer,00.00,"119,201.40",00.00
17-Jun-2025,Transfer,"198,421.00",00.00,"198,421.00"
18-Jun-2025,NEFT,"1,619,653.75",00.00,"1,818,074.75"
18-Jun-2025,Cheque,436.40,00.00,"1,818,511.15"
18-Jun-2025,IMPS,00.00,"202,056.79","1,616,454.36"
18-Jun-2025,Commission,00.00,"269,409.06","1,347,045.30"
18-Jun-2025,IMPS,00.00,"1,347,045.30",00.00
18-Jun-2025,IMPS,"102,440.80",00.00,"102,440.80"
18-Jun-2025,RTGS,79.53,00.00,"102,520.33"
18-Jun-2025,Cash,01.10,00.00,"102,521.43"
18-Jun-2025,Cheque,07.00,00.00,"102,528.43"
18-Jun-2025,Cash,00.00,"14,646.92","87,881.51"
18-Jun-2025,Miscellaneous,00.00,"8,788.15","79,093.36"
18-Jun-2025,Purchase,00.00,"26,364.45","52,728.91"
18-Jun-2025,Transfer,"4,919.98",00.00,"57,648.89"
18-Jun-2025,Miscellaneous,00.00,"14,412.22","43,236.67"
18-Jun-2025,Cash,"1,531.00",00.00,"44,767.67"
18-Jun-2025,ATM,70.19,00.00,"44,837.86"
18-Jun-2025,Bill,00.00,"7,472.98","37,364.88"
18-Jun-2025,RTGS,00.00,"6,227.48","31,137.40"
18-Jun-2025,Bill,00.00,"31,137.40",00.00
18-Jun-2025,Debit Card,"1,735,617.00",00.00,"1,735,617.00"
18-Jun-2025,Transfer,"16,685.10",00.00,"1,752,302.10"
18-Jun-2025,NEFT,"27,054.00",00.00,"1,779,356.10"
18-Jun-2025,RTGS,00.00,"444,839.03","1,334,517.08"
18-Jun-2025,ATM,"30,408.00",00.00,"1,364,925.08"
18-Jun-2025,IMPS,"2,279.40",00.00,"1,367,204.48"
18-Jun-2025,IMPS,00.00,"1,367,204.48",00.00
18-Jun-2025,Interest,"12,920.46",00.00,"12,920.46"
18-Jun-2025,Transfer,00.00,"1,292.05","11,628.41"
18-Jun-2025,Cash,"63,329.34",00.00,"74,957.75"
18-Jun-2025,Debit Card,00.00,"8,328.64","66,629.11"
18-Jun-2025,Purchase,00.00,"66,629.11",00.00
18-Jun-2025,IMPS,"30,366.00",00.00,"30,366.00"
18-Jun-2025,Cheque,00.00,"7,591.50","22,774.50"
18-Jun-2025,ATM,"228,580.44",00.00,"251,354.94"
19-Jun-2025,Reversal,00.00,"50,270.99","201,083.95"
19-Jun-2025,Interest,"3,039.00",00.00,"204,122.95"
19-Jun-2025,Tax,00.00,"29,160.42","174,962.53"
19-Jun-2025,Cash,45.00,00.00,"175,007.53"
20-Jun-2025,Miscellaneous,00.00,"58,335.84","116,671.69"
20-Jun-2025,Reversal,00.00,"12,963.52","103,708.17"
20-Jun-2025,Commission,00.00,"103,708.17",00.00
20-Jun-2025,Bill,07.92,00.00,07.92
20-Jun-2025,Reversal,00.00,07.92,00.00
20-Jun-2025,ATM,228.00,00.00,228.00
20-Jun-2025,RTGS,"12,232.00",00.00,"12,460.00"
20-Jun-2025,ATM,00.00,"6,230.00","6,230.00"
20-Jun-2025,Transfer,00.00,"2,076.67","4,153.33"
20-Jun-2025,IMPS,"123,069.75",00.00,"127,223.08"
20-Jun-2025,Commission,"24,693.70",00.00,"151,916.78"
20-Jun-2025,RTGS,00.00,"21,702.40","130,214.38"
20-Jun-2025,Interest,00.00,"65,107.19","65,107.19"
20-Jun-2025,Purchase,"162,675.00",00.00,"227,782.19"
20-Jun-2025,Bill,00.00,"113,891.10","113,891.10"
20-Jun-2025,Cheque,00.00,"12,654.57","101,236.53"
20-Jun-2025,Purchase,00.00,"12,654.57","88,581.96"
21-Jun-2025,IMPS,00.00,"88,581.96",00.00
21-Jun-2025,Bill,59.14,00.00,59.14
21-Jun-2025,Tax,00.00,19.71,39.43
21-Jun-2025,Commission,21.00,00.00,60.43
21-Jun-2025,Transfer,00.00,60.43,00.00
21-Jun-2025,NEFT,"4,556.50",00.00,"4,556.50"
21-Jun-2025,Purchase,00.00,"2,278.25","2,278.25"
22-Jun-2025,IMPS,"167,991.00",00.00,"170,269.25"
22-Jun-2025,Miscellaneous,00.00,"85,134.63","85,134.62"
22-Jun-2025,Miscellaneous,00.00,"28,378.21","56,756.41"
22-Jun-2025,Bill,00.00,"7,094.55","49,661.86"
22-Jun-2025,Interest,14.49,00.00,"49,676.35"
22-Jun-2025,NEFT,51.64,00.00,"49,727.99"
22-Jun-2025,Commission,00.00,"7,104.00","42,623.99"
22-Jun-2025,Bill,"361,974.50",00.00,"404,598.49"
22-Jun-2025,Interest,00.50,00.00,"404,598.99"
22-Jun-2025,IMPS,00.00,"202,299.50","202,299.50"
22-Jun-2025,Reversal,00.00,"25,287.44","177,012.06"
22-Jun-2025,Commission,07.00,00.00,"177,019.06"
22-Jun-2025,ATM,"1,924.00",00.00,"178,943.06"
22-Jun-2025,ATM,"5,054.92",00.00,"183,997.98"
22-Jun-2025,Reversal,00.00,"91,998.99","91,998.99"
22-Jun-2025,IMPS,00.00,"13,142.71","78,856.28"
22-Jun-2025,ATM,00.00,"19,714.07","59,142.21"
22-Jun-2025,Cheque,97.00,00.00,"59,239.21"
22-Jun-2025,Purchase,"141,264.00",00.00,"200,503.21"
22-Jun-2025,Cheque,00.00,"20,050.32","180,452.89"
22-Jun-2025,RTGS,"3,205.58",00.00,"183,658.47"
22-Jun-2025,Reversal,00.00,"26,236.92","157,421.55"
22-Jun-2025,IMPS,00.00,"26,236.93","131,184.62"
23-Jun-2025,IMPS,00.00,"26,236.92","104,947.70"
23-Jun-2025,NEFT,"8,131.66",00.00,"113,079.36"
23-Jun-2025,Commission,00.00,"28,269.84","84,809.52"
23-Jun-2025,Bill,"3,572.00",00.00,"88,381.52"
23-Jun-2025,Cash,26.56,00.00,"88,408.08"
23-Jun-2025,Interest,00.00,"17,681.62","70,726.46"
23-Jun-2025,Tax,"18,868.90",00.00,"89,595.36"
23-Jun-2025,IMPS,485.00,00.00,"90,080.36"
23-Jun-2025,Cheque,00.00,"12,868.62","77,211.74"
23-Jun-2025,Cheque,00.00,"12,868.62","64,343.12"
23-Jun-2025,Purchase,03.50,00.00,"64,346.62"
23-Jun-2025,Tax,"4,984.00",00.00,"69,330.62"
23-Jun-2025,Debit Card,00.00,"69,330.62",00.00
23-Jun-2025,Bill,"1,917,427.25",00.00,"1,917,427.25"
23-Jun-2025,Debit Card,00.00,"383,485.45","1,533,941.80"
23-Jun-2025,IMPS,05.04,00.00,"1,533,946.84"
24-Jun-2025,Bill,"17,809.20",00.00,"1,551,756.04"
24-Jun-2025,Interest,00.00,"310,351.21","1,241,404.83"
24-Jun-2025,RTGS,"32,180.60",00.00,"1,273,585.43"
24-Jun-2025,Miscellaneous,39.51,00.00,"1,273,624.94"
24-Jun-2025,Interest,58.21,00.00,"1,273,683.15"
24-Jun-2025,Reversal,"1,699.20",00.00,"1,275,382.35"
24-Jun-2025,ATM,00.00,"637,691.18","637,691.18"
24-Jun-2025,Reversal,"46,664.80",00.00,"684,355.98"
24-Jun-2025,Cheque,419.00,00.00,"684,774.98"
24-Jun-2025,Tax,00.00,"228,258.33","456,516.65"
24-Jun-2025,Debit Card,"12,403.80",00.00,"468,920.45"
24-Jun-2025,Purchase,"2,884.00",00.00,"471,804.45"
24-Jun-2025,Debit Card,06.60,00.00,"471,811.05"
24-Jun-2025,Bill,00.00,"58,976.38","412,834.67"
24-Jun-2025,Miscellaneous,00.00,"58,976.38","353,858.29"
24-Jun-2025,Reversal,00.00,"70,771.66","283,086.63"
24-Jun-2025,Reversal,00.00,"70,771.66","212,314.97"
24-Jun-2025,Bill,00.00,"30,330.71","181,984.26"
24-Jun-2025,NEFT,00.00,"36,396.85","145,587.41"
24-Jun-2025,Miscellaneous,"28,224.50",00.00,"173,811.91"
24-Jun-2025,ATM,00.00,"86,905.96","86,905.96"
24-Jun-2025,ATM,"9,899.60",00.00,"96,805.56"
24-Jun-2025,Interest,"3,083.70",00.00,"99,889.26"
24-Jun-2025,RTGS,00.00,"19,977.85","79,911.41"
24-Jun-2025,Bill,00.00,"39,955.71","39,955.70"
25-Jun-2025,RTGS,00.00,"6,659.28","33,296.42"
25-Jun-2025,Reversal,00.00,"5,549.40","27,747.02"
25-Jun-2025,Cheque,00.00,"3,468.38","24,278.64"
25-Jun-2025,Cash,00.00,"3,034.83","21,243.81"
25-Jun-2025,ATM,00.00,"7,081.27","14,162.54"
25-Jun-2025,Debit Card,00.00,"2,360.42","11,802.12"
26-Jun-2025,Cheque,04.06,00.00,"11,806.18"
26-Jun-2025,IMPS,00.00,"1,967.70","9,838.48"
26-Jun-2025,Purchase,"10,585.78",00.00,"20,424.26"
26-Jun-2025,Cheque,00.00,"2,042.43","18,381.83"
26-Jun-2025,Commission,222.50,00.00,"18,604.33"
26-Jun-2025,Debit Card,"4,055.00",00.00,"22,659.33"
26-Jun-2025,RTGS,"13,354.80",00.00,"36,014.13"
26-Jun-2025,Transfer,834.00,00.00,"36,848.13"
26-Jun-2025,NEFT,"1,063.00",00.00,"37,911.13"
26-Jun-2025,Debit Card,"1,272.20",00.00,"39,183.33"
26-Jun-2025,ATM,"2,237.00",00.00,"41,420.33"
26-Jun-2025,Cash,06.30,00.00,"41,426.63"
26-Jun-2025,RTGS,00.00,"4,142.66","37,283.97"
26-Jun-2025,IMPS,"32,379.00",00.00,"69,662.97"
26-Jun-2025,Miscellaneous,00.00,"9,951.85","59,711.12"
26-Jun-2025,RTGS,03.00,00.00,"59,714.12"
26-Jun-2025,Transfer,"16,335.00",00.00,"76,049.12"
26-Jun-2025,Cash,01.00,00.00,"76,050.12"
26-Jun-2025,Debit Card,00.00,"10,864.30","65,185.82"
26-Jun-2025,Bill,00.00,"65,185.82",00.00
27-Jun-2025,Purchase,"244,071.00",00.00,"244,071.00"
27-Jun-2025,Miscellaneous,00.00,"81,357.00","162,714.00"
27-Jun-2025,Cheque,00.00,"32,542.80","130,171.20"
27-Jun-2025,Miscellaneous,00.00,"14,463.47","115,707.73"
27-Jun-2025,IMPS,"9,774.00",00.00,"125,481.73"
27-Jun-2025,Reversal,00.00,"41,827.24","83,654.49"
27-Jun-2025,IMPS,00.00,"20,913.62","62,740.87"
27-Jun-2025,Tax,01.90,00.00,"62,742.77"
27-Jun-2025,Commission,"3,808.00",00.00,"66,550.77"
27-Jun-2025,ATM,00.00,"11,091.80","55,458.98"
27-Jun-2025,Cash,00.00,"55,458.98",00.00
27-Jun-2025,Miscellaneous,"1,342,989.00",00.00,"1,342,989.00"
27-Jun-2025,Interest,00.00,"134,298.90","1,208,690.10"
27-Jun-2025,Cash,64.00,00.00,"1,208,754.10"
27-Jun-2025,Transfer,00.00,"172,679.16","1,036,074.94"
27-Jun-2025,Commission,00.00,"103,607.49","932,467.45"
27-Jun-2025,NEFT,00.00,"93,246.75","839,220.70"
27-Jun-2025,Commission,00.00,"93,246.74","745,973.96"
27-Jun-2025,Interest,00.00,"149,194.79","596,779.17"
27-Jun-2025,IMPS,"1,445.05",00.00,"598,224.22"
27-Jun-2025,Commission,65.00,00.00,"598,289.22"
27-Jun-2025,ATM,"3,660.00",00.00,"601,949.22"
27-Jun-2025,Purchase,33.70,00.00,"601,982.92"
27-Jun-2025,Purchase,"5,765.00",00.00,"607,747.92"
27-Jun-2025,Debit Card,00.00,"303,873.96","303,873.96"
27-Jun-2025,RTGS,19.70,00.00,"303,893.66"
27-Jun-2025,ATM,00.00,"60,778.73","243,114.93"
28-Jun-2025,ATM,00.00,"34,730.70","208,384.23"
28-Jun-2025,RTGS,"145,463.59",00.00,"353,847.82"
28-Jun-2025,Interest,00.00,"39,316.42","314,531.40"
28-Jun-2025,Interest,00.00,"157,265.70","157,265.70"
28-Jun-2025,RTGS,00.00,"157,265.70",00.00
28-Jun-2025,Transfer,"142,928.00",00.00,"142,928.00"
28-Jun-2025,ATM,00.00,"28,585.60","114,342.40"
28-Jun-2025,Cheque,266.40,00.00,"114,608.80"
28-Jun-2025,Transfer,00.00,"57,304.40","57,304.40"
28-Jun-2025,Interest,"713,602.75",00.00,"770,907.15"
28-Jun-2025,Purchase,07.60,00.00,"770,914.75"
28-Jun-2025,Cash,06.00,00.00,"770,920.75"
28-Jun-2025,Interest,00.00,"77,092.08","693,828.68"
28-Jun-2025,Bill,02.61,00.00,"693,831.29"
28-Jun-2025,IMPS,07.00,00.00,"693,838.29"
28-Jun-2025,Reversal,00.00,"693,838.29",00.00
28-Jun-2025,NEFT,40.40,00.00,40.40
28-Jun-2025,Debit Card,00.00,04.49,35.91
28-Jun-2025,Tax,"18,877.40",00.00,"18,913.31"
28-Jun-2025,Reversal,434.00,00.00,"19,347.31"
28-Jun-2025,Purchase,00.00,"2,763.90","16,583.41"
28-Jun-2025,Transfer,00.00,"1,842.60","14,740.81"
28-Jun-2025,Cash,"298,097.50",00.00,"312,838.31"
28-Jun-2025,Purchase,"26,296.00",00.00,"339,134.31"
28-Jun-2025,Miscellaneous,27.43,00.00,"339,161.74"
28-Jun-2025,NEFT,"1,113,743.00",00.00,"1,452,904.74"
28-Jun-2025,Debit Card,162.60,00.00,"1,453,067.34"
28-Jun-2025,RTGS,00.00,"242,177.89","1,210,889.45"
28-Jun-2025,NEFT,"31,024.60",00.00,"1,241,914.05"
28-Jun-2025,IMPS,501.00,00.00,"1,242,415.05"
28-Jun-2025,NEFT,00.00,"138,046.12","1,104,368.93"
28-Jun-2025,Cheque,"1,726,855.25",00.00,"2,831,224.18"
28-Jun-2025,Miscellaneous,00.00,"2,831,224.18",00.00
29-Jun-2025,Transfer,"10,975.00",00.00,"10,975.00"
29-Jun-2025,Purchase,02.14,00.00,"10,977.14"
29-Jun-2025,Transfer,"186,985.28",00.00,"197,962.42"
29-Jun-2025,Tax,00.00,"197,962.42",00.00
30-Jun-2025,ATM,"5,933.00",00.00,"5,933.00"
30-Jun-2025,Reversal,00.00,847.57,"5,085.43"
30-Jun-2025,Reversal,00.00,"1,271.36","3,814.07"
30-Jun-2025,Commission,00.00,953.52,"2,860.55"
30-Jun-2025,RTGS,00.00,953.52,"1,907.03"
30-Jun-2025,Cash,00.00,211.89,"1,695.14"
30-Jun-2025,Cash,257.00,00.00,"1,952.14"
30-Jun-2025,Commission,00.00,390.43,"1,561.71"
30-Jun-2025,IMPS,00.00,195.21,"1,366.50"
30-Jun-2025,Purchase,123.50,00.00,"1,490.00"
30-Jun-2025,Cash,00.00,149.00,"1,341.00"
30-Jun-2025,Cheque,116.90,00.00,"1,457.90"
30-Jun-2025,Transfer,05.85,00.00,"1,463.75"
30-Jun-2025,Interest,00.00,"1,463.75",00.00
30-Jun-2025,Commission,00.36,00.00,00.36
30-Jun-2025,Reversal,00.00,00.05,00.32
30-Jun-2025,Interest,03.00,00.00,03.32
30-Jun-2025,Commission,00.00,00.42,02.90
30-Jun-2025,Purchase,00.00,00.97,01.93
30-Jun-2025,Purchase,00.00,00.97,00.96
30-Jun-2025,Cash,00.00,00.32,00.64
30-Jun-2025,Tax,00.00,00.16,00.48
30-Jun-2025,Interest,00.00,00.06,00.42
30-Jun-2025,IMPS,437.90,00.00,438.32
30-Jun-2025,Interest,"42,879.00",00.00,"43,317.32"
30-Jun-2025,RTGS,00.00,"14,439.11","28,878.21"
30-Jun-2025,Cash,29.63,00.00,"28,907.84"
30-Jun-2025,Cash,"1,024,681.00",00.00,"1,053,588.84"
30-Jun-2025,Cash,"1,234,412.75",00.00,"2,288,001.59"
30-Jun-2025,Bill,00.00,"381,333.60","1,906,667.99"
01-Jul-2025,Reversal,12.37,00.00,"1,906,680.36"
01-Jul-2025,Miscellaneous,"2,008,052.00",00.00,"3,914,732.36"
01-Jul-2025,Commission,34.80,00.00,"3,914,767.16"
01-Jul-2025,Bill,"685,174.00",00.00,"4,599,941.16"
01-Jul-2025,NEFT,00.00,"657,134.45","3,942,806.71"
01-Jul-2025,Miscellaneous,84.90,00.00,"3,942,891.61"
02-Jul-2025,Debit Card,00.00,"394,289.16","3,548,602.45"
02-Jul-2025,NEFT,00.00,"506,943.21","3,041,659.24"
02-Jul-2025,Cheque,"676,168.20",00.00,"3,717,827.44"
02-Jul-2025,Tax,00.00,"743,565.49","2,974,261.95"
02-Jul-2025,Tax,"231,408.70",00.00,"3,205,670.65"
02-Jul-2025,RTGS,"1,421,452.00",00.00,"4,627,122.65"
02-Jul-2025,Tax,32.30,00.00,"4,627,154.95"
02-Jul-2025,Reversal,01.45,00.00,"4,627,156.40"
02-Jul-2025,Debit Card,04.02,00.00,"4,627,160.42"
02-Jul-2025,Purchase,01.58,00.00,"4,627,162.00"
02-Jul-2025,Tax,02.00,00.00,"4,627,164.00"
02-Jul-2025,Tax,04.00,00.00,"4,627,168.00"
02-Jul-2025,IMPS,08.00,00.00,"4,627,176.00"
02-Jul-2025,Bill,00.00,"1,542,392.00","3,084,784.00"
02-Jul-2025,Purchase,00.00,"440,683.43","2,644,100.57"
02-Jul-2025,Miscellaneous,"1,739,467.00",00.00,"4,383,567.57"
02-Jul-2025,Reversal,00.00,"438,356.76","3,945,210.81"
02-Jul-2025,Purchase,06.00,00.00,"3,945,216.81"
03-Jul-2025,Cheque,00.00,"986,304.20","2,958,912.61"
03-Jul-2025,Bill,00.00,"422,701.80","2,536,210.81"
03-Jul-2025,Debit Card,"1,958.53",00.00,"2,538,169.34"
03-Jul-2025,Reversal,"1,522.11",00.00,"2,539,691.45"
03-Jul-2025,Reversal,00.00,"1,269,845.73","1,269,845.73"
03-Jul-2025,NEFT,00.00,"181,406.53","1,088,439.20"
03-Jul-2025,IMPS,"2,160.07",00.00,"1,090,599.27"
03-Jul-2025,Interest,"2,088,498.00",00.00,"3,179,097.27"
03-Jul-2025,Miscellaneous,00.00,"794,774.32","2,384,322.95"
03-Jul-2025,Transfer,00.00,"476,864.59","1,907,458.36"
03-Jul-2025,Purchase,00.00,"476,864.59","1,430,593.77"
03-Jul-2025,ATM,217.74,00.00,"1,430,811.51"
03-Jul-2025,Transfer,00.00,"476,937.17","953,874.34"
03-Jul-2025,NEFT,00.00,"190,774.87","763,099.47"
03-Jul-2025,Bill,"30,575.00",00.00,"793,674.47"
03-Jul-2025,Commission,00.00,"264,558.16","529,116.31"
03-Jul-2025,ATM,"31,999.50",00.00,"561,115.81"
03-Jul-2025,Miscellaneous,00.00,"70,139.48","490,976.33"
03-Jul-2025,IMPS,"2,226.31",00.00,"493,202.64"
03-Jul-2025,Transfer,"365,027.50",00.00,"858,230.14"
03-Jul-2025,Purchase,"132,080.00",00.00,"990,310.14"
03-Jul-2025,Purchase,00.00,"330,103.38","660,206.76"
03-Jul-2025,Debit Card,55.86,00.00,"660,262.62"
03-Jul-2025,Tax,00.00,"82,532.83","577,729.79"
03-Jul-2025,ATM,00.00,"115,545.96","462,183.83"
04-Jul-2025,Tax,21.10,00.00,"462,204.93"
04-Jul-2025,RTGS,00.00,"46,220.49","415,984.44"
04-Jul-2025,Tax,00.00,"69,330.74","346,653.70"
04-Jul-2025,NEFT,05.01,00.00,"346,658.71"
04-Jul-2025,Reversal,"1,416.00",00.00,"348,074.71"
04-Jul-2025,Purchase,03.67,00.00,"348,078.38"
04-Jul-2025,RTGS,00.00,"174,039.19","174,039.19"
04-Jul-2025,ATM,00.00,"58,013.06","116,026.13"
04-Jul-2025,Tax,"179,374.00",00.00,"295,400.13"
04-Jul-2025,IMPS,00.00,"42,200.02","253,200.11"
04-Jul-2025,Debit Card,00.00,"25,320.01","227,880.10"
04-Jul-2025,NEFT,00.00,"32,554.30","195,325.80"
04-Jul-2025,Cash,152.00,00.00,"195,477.80"
04-Jul-2025,Bill,265.00,00.00,"195,742.80"
04-Jul-2025,Bill,"1,104.00",00.00,"196,846.80"
04-Jul-2025,Transfer,"1,761,554.00",00.00,"1,958,400.80"
04-Jul-2025,Bill,00.00,"979,200.40","979,200.40"
04-Jul-2025,NEFT,00.00,"326,400.13","652,800.27"
04-Jul-2025,Cash,00.00,"93,257.18","559,543.09"
05-Jul-2025,Reversal,00.00,"62,171.45","497,371.64"
05-Jul-2025,Purchase,07.10,00.00,"497,378.74"
05-Jul-2025,Bill,00.00,"248,689.37","248,689.37"
05-Jul-2025,Commission,"1,026.69",00.00,"249,716.06"
05-Jul-2025,Purchase,13.70,00.00,"249,729.76"
05-Jul-2025,Purchase,852.40,00.00,"250,582.16"
05-Jul-2025,Debit Card,04.00,00.00,"250,586.16"
06-Jul-2025,Interest,00.00,"50,117.23","200,468.93"
06-Jul-2025,Tax,"22,252.43",00.00,"222,721.36"
06-Jul-2025,Commission,01.30,00.00,"222,722.66"
06-Jul-2025,Reversal,00.00,"37,120.44","185,602.22"
06-Jul-2025,Miscellaneous,00.00,"37,120.44","148,481.78"
06-Jul-2025,Cheque,"15,833.50",00.00,"164,315.28"
06-Jul-2025,Bill,00.00,"54,771.76","109,543.52"
06-Jul-2025,Miscellaneous,08.21,00.00,"109,551.73"
06-Jul-2025,Interest,"107,834.00",00.00,"217,385.73"
06-Jul-2025,RTGS,07.70,00.00,"217,393.43"
06-Jul-2025,Cheque,"13,305.90",00.00,"230,699.33"
06-Jul-2025,Cheque,"2,079.47",00.00,"232,778.80"
06-Jul-2025,ATM,"110,417.60",00.00,"343,196.40"
06-Jul-2025,Reversal,02.26,00.00,"343,198.66"
06-Jul-2025,Cash,07.30,00.00,"343,205.96"
06-Jul-2025,Miscellaneous,"16,285.00",00.00,"359,490.96"
06-Jul-2025,Debit Card,00.00,"51,355.85","308,135.11"
06-Jul-2025,IMPS,"181,500.91",00.00,"489,636.02"
06-Jul-2025,RTGS,00.00,"244,818.01","244,818.01"
06-Jul-2025,Transfer,00.00,"34,974.00","209,844.01"
06-Jul-2025,Transfer,04.59,00.00,"209,848.60"
06-Jul-2025,Reversal,"1,062,314.00",00.00,"1,272,162.60"
06-Jul-2025,Purchase,109.00,00.00,"1,272,271.60"
06-Jul-2025,Tax,59.00,00.00,"1,272,330.60"
06-Jul-2025,Transfer,00.00,"159,041.33","1,113,289.28"
06-Jul-2025,Purchase,00.00,"556,644.64","556,644.64"
07-Jul-2025,Cash,00.00,"185,548.21","371,096.43"
07-Jul-2025,Reversal,00.00,"123,698.81","247,397.62"
07-Jul-2025,Miscellaneous,31.00,00.00,"247,428.62"
07-Jul-2025,Commission,50.00,00.00,"247,478.62"
07-Jul-2025,Cheque,"2,383.80",00.00,"249,862.42"
07-Jul-2025,Commission,00.00,"62,465.61","187,396.82"
07-Jul-2025,Bill,00.00,"46,849.21","140,547.62"
07-Jul-2025,Commission,"25,594.80",00.00,"166,142.42"
07-Jul-2025,Cash,"1,428,765.00",00.00,"1,594,907.42"
07-Jul-2025,Cheque,03.00,00.00,"1,594,910.42"
07-Jul-2025,Cheque,"7,905.81",00.00,"1,602,816.23"
07-Jul-2025,Transfer,990.78,00.00,"1,603,807.01"
07-Jul-2025,NEFT,00.00,"200,475.88","1,403,331.13"
07-Jul-2025,RTGS,00.00,"233,888.52","1,169,442.61"
07-Jul-2025,Purchase,"988,457.50",00.00,"2,157,900.11"
07-Jul-2025,Reversal,00.00,"431,580.02","1,726,320.09"
07-Jul-2025,IMPS,"1,594,451.00",00.00,"3,320,771.09"
07-Jul-2025,ATM,431.00,00.00,"3,321,202.09"
07-Jul-2025,RTGS,00.00,"1,107,067.36","2,214,134.73"
07-Jul-2025,Miscellaneous,283.00,00.00,"2,214,417.73"
07-Jul-2025,RTGS,55.00,00.00,"2,214,472.73"
07-Jul-2025,Commission,00.00,"276,809.09","1,937,663.64"
08-Jul-2025,Purchase,"1,422.00",00.00,"1,939,085.64"
08-Jul-2025,Interest,00.00,"1,939,085.64",00.00
08-Jul-2025,NEFT,121.00,00.00,121.00
08-Jul-2025,ATM,00.00,30.25,90.75
08-Jul-2025,Bill,00.00,45.38,45.38
08-Jul-2025,ATM,00.00,45.38,00.00
08-Jul-2025,Purchase,44.80,00.00,44.80
08-Jul-2025,RTGS,157.00,00.00,201.80
08-Jul-2025,Tax,00.00,40.36,161.44
08-Jul-2025,Reversal,00.00,16.14,145.30
08-Jul-2025,Tax,02.00,00.00,147.30
08-Jul-2025,Debit Card,00.00,14.73,132.57
08-Jul-2025,Cheque,00.00,18.94,113.63
08-Jul-2025,Commission,"14,318.63",00.00,"14,432.26"
08-Jul-2025,Cash,324.00,00.00,"14,756.26"
08-Jul-2025,Cheque,00.00,"14,756.26",00.00
08-Jul-2025,NEFT,266.00,00.00,266.00
08-Jul-2025,Interest,00.00,44.33,221.67
08-Jul-2025,Cheque,00.00,36.95,184.72
08-Jul-2025,RTGS,01.00,00.00,185.72
08-Jul-2025,Reversal,"1,151.00",00.00,"1,336.72"
08-Jul-2025,Miscellaneous,00.00,167.09,"1,169.63"
08-Jul-2025,NEFT,00.00,292.41,877.22
08-Jul-2025,Interest,00.00,97.47,779.75
09-Jul-2025,Commission,00.00,129.96,649.79
09-Jul-2025,ATM,"2,988.00",00.00,"3,637.79"
09-Jul-2025,IMPS,10.00,00.00,"3,647.79"
09-Jul-2025,Commission,00.00,"1,215.93","2,431.86"
09-Jul-2025,Debit Card,00.00,405.31,"2,026.55"
09-Jul-2025,Transfer,"138,686.53",00.00,"140,713.08"
09-Jul-2025,Tax,05.71,00.00,"140,718.79"
09-Jul-2025,Tax,00.30,00.00,"140,719.09"
09-Jul-2025,Cheque,363.00,00.00,"141,082.09"
09-Jul-2025,Cash,03.00,00.00,"141,085.09"
09-Jul-2025,Purchase,00.00,"20,155.01","120,930.08"
09-Jul-2025,Transfer,"55,436.59",00.00,"176,366.67"
09-Jul-2025,NEFT,16.68,00.00,"176,383.35"
09-Jul-2025,Commission,"9,051.41",00.00,"185,434.76"
09-Jul-2025,IMPS,"1,989,676.00",00.00,"2,175,110.76"
09-Jul-2025,Cash,468.20,00.00,"2,175,578.96"
09-Jul-2025,ATM,"2,212.59",00.00,"2,177,791.55"
09-Jul-2025,Purchase,484.10,00.00,"2,178,275.65"
09-Jul-2025,Debit Card,"3,004.04",00.00,"2,181,279.69"
09-Jul-2025,ATM,00.00,"1,090,639.85","1,090,639.84"
09-Jul-2025,Miscellaneous,00.00,"155,805.69","934,834.15"
09-Jul-2025,ATM,00.00,"93,483.42","841,350.74"
09-Jul-2025,ATM,00.00,"168,270.15","673,080.59"
09-Jul-2025,Interest,"493,822.00",00.00,"1,166,902.59"
09-Jul-2025,Cash,06.04,00.00,"1,166,908.63"
09-Jul-2025,ATM,00.00,"145,863.58","1,021,045.05"
09-Jul-2025,Bill,04.00,00.00,"1,021,049.05"
09-Jul-2025,Reversal,174.40,00.00,"1,021,223.45"
09-Jul-2025,Cheque,00.00,"102,122.35","919,101.10"
09-Jul-2025,Cash,"19,872.60",00.00,"938,973.70"
09-Jul-2025,Purchase,57.50,00.00,"939,031.20"
09-Jul-2025,Bill,"31,042.06",00.00,"970,073.26"
09-Jul-2025,NEFT,00.00,"242,518.32","727,554.94"
09-Jul-2025,IMPS,00.00,"103,936.42","623,618.52"
09-Jul-2025,Reversal,22.44,00.00,"623,640.96"
09-Jul-2025,Purchase,02.96,00.00,"623,643.92"
09-Jul-2025,Reversal,00.00,"69,293.77","554,350.15"
10-Jul-2025,Miscellaneous,46.00,00.00,"554,396.15"
10-Jul-2025,Commission,101.50,00.00,"554,497.65"
11-Jul-2025,NEFT,127.66,00.00,"554,625.31"
11-Jul-2025,Bill,257.90,00.00,"554,883.21"
11-Jul-2025,Reversal,"2,611.00",00.00,"557,494.21"
11-Jul-2025,Cheque,44.10,00.00,"557,538.31"
11-Jul-2025,Debit Card,00.00,"557,538.31",00.00
11-Jul-2025,Tax,"309,738.50",00.00,"309,738.50"
11-Jul-2025,Cash,"1,844,082.25",00.00,"2,153,820.75"
11-Jul-2025,Tax,00.00,"358,970.13","1,794,850.62"
12-Jul-2025,IMPS,37.80,00.00,"1,794,888.42"
12-Jul-2025,IMPS,00.00,"224,361.05","1,570,527.37"
12-Jul-2025,NEFT,"3,945.42",00.00,"1,574,472.79"
12-Jul-2025,RTGS,"1,449.00",00.00,"1,575,921.79"
12-Jul-2025,Commission,"15,633.00",00.00,"1,591,554.79"
12-Jul-2025,ATM,00.40,00.00,"1,591,555.19"
12-Jul-2025,Commission,00.00,"159,155.52","1,432,399.67"
12-Jul-2025,NEFT,148.00,00.00,"1,432,547.67"
12-Jul-2025,RTGS,00.00,"204,649.67","1,227,898.00"
12-Jul-2025,Reversal,"1,675,420.00",00.00,"2,903,318.00"
12-Jul-2025,Transfer,01.18,00.00,"2,903,319.18"
12-Jul-2025,Interest,00.00,"725,829.80","2,177,489.39"
12-Jul-2025,Miscellaneous,"3,908.27",00.00,"2,181,397.66"
12-Jul-2025,Cash,"3,041.00",00.00,"2,184,438.66"
12-Jul-2025,NEFT,00.00,"1,092,219.33","1,092,219.33"
12-Jul-2025,Tax,00.00,"546,109.67","546,109.66"
12-Jul-2025,Interest,"1,795.80",00.00,"547,905.46"
12-Jul-2025,Interest,00.00,"78,272.21","469,633.25"
12-Jul-2025,Miscellaneous,00.00,"46,963.33","422,669.92"
12-Jul-2025,Tax,"22,715.38",00.00,"445,385.30"
12-Jul-2025,Debit Card,00.00,"445,385.30",00.00
12-Jul-2025,Cash,"32,048.00",00.00,"32,048.00"
13-Jul-2025,Cash,00.00,"3,560.89","28,487.11"
13-Jul-2025,RTGS,"148,198.00",00.00,"176,685.11"
13-Jul-2025,Cash,381.82,00.00,"177,066.93"
13-Jul-2025,Interest,00.00,"35,413.39","141,653.54"
13-Jul-2025,Cheque,00.00,"35,413.39","106,240.16"
13-Jul-2025,RTGS,00.00,"10,624.02","95,616.14"
13-Jul-2025,IMPS,00.00,"13,659.45","81,956.69"
13-Jul-2025,Bill,00.00,"13,659.45","68,297.24"
13-Jul-2025,Interest,00.00,"9,756.75","58,540.49"
13-Jul-2025,IMPS,"359,900.00",00.00,"418,440.49"
13-Jul-2025,Miscellaneous,00.00,"418,440.49",00.00
13-Jul-2025,Reversal,"1,740,765.50",00.00,"1,740,765.50"
13-Jul-2025,Reversal,00.00,"217,595.69","1,523,169.81"
13-Jul-2025,RTGS,"1,872,839.00",00.00,"3,396,008.81"
13-Jul-2025,Tax,00.00,"424,501.10","2,971,507.71"
13-Jul-2025,Tax,"1,264,408.50",00.00,"4,235,916.21"
13-Jul-2025,IMPS,03.20,00.00,"4,235,919.41"
13-Jul-2025,NEFT,00.00,"470,657.71","3,765,261.70"
14-Jul-2025,Cheque,00.00,"1,882,630.85","1,882,630.85"
14-Jul-2025,Cash,00.00,"376,526.17","1,506,104.68"
14-Jul-2025,Commission,"1,870.50",00.00,"1,507,975.18"
14-Jul-2025,ATM,00.00,"167,552.80","1,340,422.38"
14-Jul-2025,RTGS,43.00,00.00,"1,340,465.38"
14-Jul-2025,Bill,00.00,"268,093.08","1,072,372.30"
15-Jul-2025,IMPS,00.00,"357,457.43","714,914.87"
15-Jul-2025,Purchase,00.00,"79,434.99","635,479.88"
15-Jul-2025,Miscellaneous,00.00,"317,739.94","317,739.94"
15-Jul-2025,Miscellaneous,93.20,00.00,"317,833.14"
15-Jul-2025,Interest,00.00,"79,458.29","238,374.86"
15-Jul-2025,Purchase,00.00,"119,187.43","119,187.43"
15-Jul-2025,Cash,00.00,"119,187.43",00.00
15-Jul-2025,Purchase,"188,553.00",00.00,"188,553.00"
15-Jul-2025,ATM,00.00,"23,569.13","164,983.88"
15-Jul-2025,Purchase,00.00,"164,983.88",00.00
15-Jul-2025,Interest,20.00,00.00,20.00
15-Jul-2025,NEFT,00.00,05.00,15.00
15-Jul-2025,Tax,00.00,03.00,12.00
16-Jul-2025,Tax,"71,725.00",00.00,"71,737.00"
16-Jul-2025,Cash,"2,739.30",00.00,"74,476.30"
16-Jul-2025,Commission,"8,410.40",00.00,"82,886.70"
16-Jul-2025,Bill,00.00,"27,628.90","55,257.80"
16-Jul-2025,Cheque,00.00,"7,893.97","47,363.83"
16-Jul-2025,Miscellaneous,01.00,00.00,"47,364.83"
16-Jul-2025,RTGS,"2,183.60",00.00,"49,548.43"
16-Jul-2025,Cheque,"2,027,013.20",00.00,"2,076,561.63"
16-Jul-2025,Reversal,00.00,"1,038,280.82","1,038,280.82"
16-Jul-2025,Purchase,00.00,"148,325.83","889,954.99"
16-Jul-2025,Debit Card,00.00,"444,977.50","444,977.50"
16-Jul-2025,Purchase,07.04,00.00,"444,984.54"
16-Jul-2025,Cheque,"261,317.25",00.00,"706,301.79"
16-Jul-2025,IMPS,00.00,"176,575.45","529,726.34"
16-Jul-2025,Interest,"10,349.20",00.00,"540,075.54"
16-Jul-2025,Cash,00.00,"108,015.11","432,060.43"
16-Jul-2025,Interest,329.02,00.00,"432,389.45"
16-Jul-2025,ATM,116.00,00.00,"432,505.45"
16-Jul-2025,RTGS,00.00,"48,056.16","384,449.29"
16-Jul-2025,ATM,43.00,00.00,"384,492.29"
16-Jul-2025,Commission,00.00,"42,721.37","341,770.92"
16-Jul-2025,Miscellaneous,00.00,"42,721.37","299,049.56"
16-Jul-2025,Tax,00.00,"37,381.20","261,668.36"
16-Jul-2025,RTGS,05.10,00.00,"261,673.46"
16-Jul-2025,ATM,00.00,"130,836.73","130,836.73"
16-Jul-2025,Cheque,"118,654.80",00.00,"249,491.53"
16-Jul-2025,Miscellaneous,"1,680,540.50",00.00,"1,930,032.03"
16-Jul-2025,Transfer,00.00,"1,930,032.03",00.00
16-Jul-2025,Interest,"4,008.29",00.00,"4,008.29"
16-Jul-2025,Cheque,00.00,572.61,"3,435.68"
16-Jul-2025,Transfer,63.90,00.00,"3,499.58"
16-Jul-2025,RTGS,00.00,583.26,"2,916.32"
16-Jul-2025,NEFT,18.45,00.00,"2,934.77"
16-Jul-2025,Transfer,59.80,00.00,"2,994.57"
16-Jul-2025,Transfer,07.80,00.00,"3,002.37"
16-Jul-2025,Interest,00.00,500.40,"2,501.98"
16-Jul-2025,Bill,00.00,357.43,"2,144.55"
16-Jul-2025,Debit Card,00.00,357.43,"1,787.13"
16-Jul-2025,Reversal,00.00,255.30,"1,531.83"
16-Jul-2025,Bill,00.00,306.37,"1,225.46"
16-Jul-2025,Cash,"1,527,671.00",00.00,"1,528,896.46"
16-Jul-2025,Debit Card,60.00,00.00,"1,528,956.46"
16-Jul-2025,NEFT,00.00,"305,791.29","1,223,165.17"
16-Jul-2025,ATM,12.66,00.00,"1,223,177.83"
17-Jul-2025,Cash,"775,426.00",00.00,"1,998,603.83"
17-Jul-2025,Miscellaneous,00.00,00.00,"1,998,603.83"
17-Jul-2025,Purchase,00.00,"666,201.28","1,332,402.55"
17-Jul-2025,RTGS,00.00,"148,044.73","1,184,357.82"
17-Jul-2025,Debit Card,00.00,"197,392.97","986,964.85"
17-Jul-2025,Reversal,"1,583.41",00.00,"988,548.26"
17-Jul-2025,Interest,00.00,"164,758.04","823,790.22"
17-Jul-2025,Interest,00.00,"823,790.22",00.00
17-Jul-2025,NEFT,"2,744.00",00.00,"2,744.00"
17-Jul-2025,Purchase,00.00,"2,744.00",00.00
17-Jul-2025,Purchase,81.00,00.00,81.00
17-Jul-2025,Transfer,00.00,13.50,67.50
17-Jul-2025,IMPS,00.00,67.50,00.00
17-Jul-2025,Reversal,06.90,00.00,06.90
17-Jul-2025,RTGS,00.00,00.69,06.21
17-Jul-2025,Tax,00.00,01.04,05.18
17-Jul-2025,Commission,32.90,00.00,38.08
17-Jul-2025,Cheque,00.00,03.81,34.27
17-Jul-2025,Tax,00.00,34.27,00.00
17-Jul-2025,Debit Card,03.60,00.00,03.60
17-Jul-2025,Debit Card,00.00,00.45,03.15
17-Jul-2025,Miscellaneous,"367,324.80",00.00,"367,327.95"
17-Jul-2025,Miscellaneous,03.80,00.00,"367,331.75"
17-Jul-2025,Commission,"64,698.00",00.00,"432,029.75"
17-Jul-2025,Interest,36.00,00.00,"432,065.75"
17-Jul-2025,ATM,"2,032,496.00",00.00,"2,464,561.75"
17-Jul-2025,Miscellaneous,"211,133.00",00.00,"2,675,694.75"
17-Jul-2025,NEFT,00.00,"267,569.48","2,408,125.28"
17-Jul-2025,Reversal,00.00,"401,354.21","2,006,771.07"
17-Jul-2025,NEFT,00.00,"401,354.21","1,605,416.86"
17-Jul-2025,Reversal,00.00,"535,138.95","1,070,277.91"
17-Jul-2025,Cheque,06.34,00.00,"1,070,284.25"
17-Jul-2025,Miscellaneous,00.00,"133,785.53","936,498.72"
17-Jul-2025,Tax,00.00,"93,649.87","842,848.85"
17-Jul-2025,Interest,"18,623.40",00.00,"861,472.25"
17-Jul-2025,Miscellaneous,"116,475.40",00.00,"977,947.65"
17-Jul-2025,Debit Card,03.00,00.00,"977,950.65"
17-Jul-2025,NEFT,"29,315.64",00.00,"1,007,266.29"
17-Jul-2025,Cheque,00.00,"167,877.72","839,388.58"
17-Jul-2025,Bill,00.00,"279,796.19","559,592.39"
17-Jul-2025,Interest,122.00,00.00,"559,714.39"
17-Jul-2025,IMPS,"3,386.00",00.00,"563,100.39"
17-Jul-2025,RTGS,"3,314.28",00.00,"566,414.67"
17-Jul-2025,Miscellaneous,06.20,00.00,"566,420.87"
17-Jul-2025,Commission,"15,412.92",00.00,"581,833.79"
17-Jul-2025,Purchase,00.00,"290,916.90","290,916.90"
17-Jul-2025,Commission,00.00,"29,091.69","261,825.21"
17-Jul-2025,Miscellaneous,00.00,"261,825.21",00.00
17-Jul-2025,Purchase,03.50,00.00,03.50
17-Jul-2025,Tax,06.00,00.00,09.50
17-Jul-2025,Transfer,"8,199.00",00.00,"8,208.50"
17-Jul-2025,RTGS,00.00,820.85,"7,387.65"
17-Jul-2025,Miscellaneous,"2,096.00",00.00,"9,483.65"
17-Jul-2025,Transfer,00.00,"4,741.83","4,741.82"
17-Jul-2025,Cash,04.06,00.00,"4,745.88"
18-Jul-2025,Interest,"20,301.30",00.00,"25,047.18"
18-Jul-2025,Debit Card,00.00,"4,174.53","20,872.65"
18-Jul-2025,Transfer,"487,048.00",00.00,"507,920.65"
18-Jul-2025,Cash,56.00,00.00,"507,976.65"
18-Jul-2025,Interest,00.00,"253,988.33","253,988.32"
18-Jul-2025,Miscellaneous,00.00,"84,662.77","169,325.55"
18-Jul-2025,Interest,06.40,00.00,"169,331.95"
18-Jul-2025,Tax,00.00,"84,665.98","84,665.98"
18-Jul-2025,Reversal,00.00,"21,166.50","63,499.48"
18-Jul-2025,RTGS,00.00,"6,349.95","57,149.53"
18-Jul-2025,ATM,00.00,"5,714.95","51,434.58"
18-Jul-2025,Miscellaneous,00.00,"10,286.92","41,147.66"
18-Jul-2025,IMPS,"2,014,067.25",00.00,"2,055,214.91"
18-Jul-2025,Cash,00.00,"293,602.13","1,761,612.78"
18-Jul-2025,Debit Card,"2,054.00",00.00,"1,763,666.78"
18-Jul-2025,IMPS,00.00,"440,916.70","1,322,750.08"
18-Jul-2025,Tax,00.00,"132,275.01","1,190,475.07"
18-Jul-2025,Commission,"67,413.00",00.00,"1,257,888.07"
18-Jul-2025,NEFT,"204,386.47",00.00,"1,462,274.54"
18-Jul-2025,Cheque,00.00,"162,474.95","1,299,799.59"
18-Jul-2025,Debit Card,"4,410.00",00.00,"1,304,209.59"
18-Jul-2025,ATM,00.00,"652,104.80","652,104.80"
19-Jul-2025,Miscellaneous,"26,831.11",00.00,"678,935.91"
19-Jul-2025,Interest,"19,414.57",00.00,"698,350.48"
19-Jul-2025,RTGS,"387,100.25",00.00,"1,085,450.73"
19-Jul-2025,Bill,00.00,"217,090.15","868,360.58"
19-Jul-2025,RTGS,00.00,"868,360.58",00.00
19-Jul-2025,Interest,"13,211.99",00.00,"13,211.99"
19-Jul-2025,ATM,43.22,00.00,"13,255.21"
19-Jul-2025,RTGS,00.00,"4,418.40","8,836.81"
19-Jul-2025,Reversal,00.00,"1,472.80","7,364.01"
19-Jul-2025,ATM,"1,708,026.50",00.00,"1,715,390.51"
19-Jul-2025,Cheque,00.00,"190,598.95","1,524,791.56"
19-Jul-2025,Bill,00.00,"190,598.95","1,334,192.62"
19-Jul-2025,ATM,00.00,"1,334,192.62",00.00
19-Jul-2025,Miscellaneous,"148,370.69",00.00,"148,370.69"
19-Jul-2025,Commission,00.00,"16,485.63","131,885.06"
19-Jul-2025,RTGS,00.00,"18,840.72","113,044.34"
19-Jul-2025,ATM,00.00,"12,560.48","100,483.86"
19-Jul-2025,Cash,00.80,00.00,"100,484.66"
19-Jul-2025,Cash,"2,664.20",00.00,"103,148.86"
19-Jul-2025,Interest,00.00,"17,191.48","85,957.38"
19-Jul-2025,Cash,00.00,"12,279.63","73,677.75"
19-Jul-2025,Reversal,00.52,00.00,"73,678.27"
19-Jul-2025,Bill,00.00,"36,839.14","36,839.14"
19-Jul-2025,Reversal,03.00,00.00,"36,842.14"
19-Jul-2025,ATM,"31,348.00",00.00,"68,190.14"
19-Jul-2025,NEFT,00.00,"7,576.68","60,613.46"
19-Jul-2025,Bill,55.16,00.00,"60,668.62"
20-Jul-2025,IMPS,00.00,"12,133.72","48,534.90"
20-Jul-2025,Transfer,"2,765.00",00.00,"51,299.90"
20-Jul-2025,ATM,00.00,"5,699.99","45,599.91"
20-Jul-2025,IMPS,00.00,"11,399.98","34,199.93"
21-Jul-2025,RTGS,00.00,"3,419.99","30,779.94"
21-Jul-2025,Tax,245.00,00.00,"31,024.94"
21-Jul-2025,Miscellaneous,00.00,"5,170.82","25,854.12"
21-Jul-2025,Debit Card,00.00,"2,872.68","22,981.44"
21-Jul-2025,Commission,00.00,"4,596.29","18,385.15"
21-Jul-2025,ATM,00.00,"4,596.29","13,788.86"
21-Jul-2025,Tax,00.00,"4,596.29","9,192.57"
21-Jul-2025,Debit Card,"1,998.00",00.00,"11,190.57"
21-Jul-2025,RTGS,00.00,"1,598.65","9,591.92"
21-Jul-2025,IMPS,"7,765.00",00.00,"17,356.92"
21-Jul-2025,Miscellaneous,613.16,00.00,"17,970.08"
21-Jul-2025,Interest,89.73,00.00,"18,059.81"
21-Jul-2025,Reversal,00.00,"2,579.97","15,479.84"
21-Jul-2025,Bill,00.00,"5,159.95","10,319.89"
21-Jul-2025,IMPS,05.04,00.00,"10,324.93"
21-Jul-2025,NEFT,00.00,"1,290.62","9,034.31"
21-Jul-2025,Debit Card,00.00,"1,806.86","7,227.45"
21-Jul-2025,Cash,"10,035.70",00.00,"17,263.15"
21-Jul-2025,Commission,"1,568,040.00",00.00,"1,585,303.15"
21-Jul-2025,IMPS,410.00,00.00,"1,585,713.15"
21-Jul-2025,Purchase,"2,000.00",00.00,"1,587,713.15"
21-Jul-2025,Miscellaneous,00.00,"176,412.57","1,411,300.58"
21-Jul-2025,Cash,00.00,"176,412.57","1,234,888.01"
21-Jul-2025,IMPS,49.50,00.00,"1,234,937.51"
21-Jul-2025,Debit Card,00.00,"411,645.84","823,291.67"
21-Jul-2025,NEFT,"22,320.75",00.00,"845,612.42"
21-Jul-2025,Purchase,00.00,"120,801.77","724,810.65"
21-Jul-2025,Debit Card,00.00,"80,534.52","644,276.13"
21-Jul-2025,Cheque,00.00,"92,039.45","552,236.68"
21-Jul-2025,NEFT,135.00,00.00,"552,371.68"
21-Jul-2025,Purchase,"1,384,089.50",00.00,"1,936,461.18"
21-Jul-2025,ATM,00.00,"645,487.06","1,290,974.12"
21-Jul-2025,NEFT,00.00,"258,194.82","1,032,779.30"
21-Jul-2025,Purchase,473.00,00.00,"1,033,252.30"
21-Jul-2025,NEFT,00.00,"172,208.72","861,043.58"
21-Jul-2025,Purchase,00.00,"123,006.23","738,037.35"
21-Jul-2025,Reversal,00.00,"738,037.35",00.00
21-Jul-2025,Interest,"167,017.20",00.00,"167,017.20"
21-Jul-2025,RTGS,"16,806.74",00.00,"183,823.94"
21-Jul-2025,Miscellaneous,00.00,"91,911.97","91,911.97"
21-Jul-2025,Tax,298.53,00.00,"92,210.50"
21-Jul-2025,Debit Card,00.00,"10,245.61","81,964.89"
21-Jul-2025,RTGS,"1,078.33",00.00,"83,043.22"
21-Jul-2025,IMPS,00.00,"8,304.32","74,738.90"
21-Jul-2025,Tax,00.00,"8,304.32","66,434.58"
21-Jul-2025,Miscellaneous,03.40,00.00,"66,437.98"
21-Jul-2025,NEFT,07.00,00.00,"66,444.98"
21-Jul-2025,Commission,46.00,00.00,"66,490.98"
21-Jul-2025,Tax,"835,759.00",00.00,"902,249.98"
21-Jul-2025,Debit Card,"1,942,786.75",00.00,"2,845,036.73"
21-Jul-2025,Tax,"28,198.01",00.00,"2,873,234.74"
21-Jul-2025,RTGS,00.00,"478,872.46","2,394,362.28"
21-Jul-2025,Purchase,"111,335.00",00.00,"2,505,697.28"
21-Jul-2025,Bill,02.62,00.00,"2,505,699.90"
21-Jul-2025,NEFT,"9,709.00",00.00,"2,515,408.90"
21-Jul-2025,Cash,"1,193,531.00",00.00,"3,708,939.90"
21-Jul-2025,Miscellaneous,00.00,"370,893.99","3,338,045.91"
21-Jul-2025,Transfer,03.31,00.00,"3,338,049.22"
21-Jul-2025,Transfer,369.00,00.00,"3,338,418.22"
21-Jul-2025,Cheque,"19,126.00",00.00,"3,357,544.22"
21-Jul-2025,Tax,00.00,"559,590.70","2,797,953.52"
21-Jul-2025,Commission,02.34,00.00,"2,797,955.86"
21-Jul-2025,Reversal,00.00,"279,795.59","2,518,160.27"
21-Jul-2025,Bill,"108,780.20",00.00,"2,626,940.47"
21-Jul-2025,NEFT,00.00,"437,823.41","2,189,117.06"
21-Jul-2025,IMPS,07.00,00.00,"2,189,124.06"
21-Jul-2025,Cash,03.60,00.00,"2,189,127.66"
21-Jul-2025,Bill,00.00,"437,825.53","1,751,302.13"
21-Jul-2025,Purchase,04.00,00.00,"1,751,306.13"
21-Jul-2025,Interest,33.28,00.00,"1,751,339.41"
21-Jul-2025,Transfer,08.00,00.00,"1,751,347.41"
21-Jul-2025,Cash,"70,240.90",00.00,"1,821,588.31"
21-Jul-2025,Commission,00.00,"227,698.54","1,593,889.77"
21-Jul-2025,Transfer,00.00,"531,296.59","1,062,593.18"
21-Jul-2025,RTGS,"29,660.00",00.00,"1,092,253.18"
21-Jul-2025,Interest,"3,502.00",00.00,"1,095,755.18"
21-Jul-2025,Reversal,00.00,"1,095,755.18",00.00
21-Jul-2025,Miscellaneous,"15,020.00",00.00,"15,020.00"
21-Jul-2025,Tax,00.00,"1,668.89","13,351.11"
21-Jul-2025,ATM,24.90,00.00,"13,376.01"
21-Jul-2025,Miscellaneous,00.00,"4,458.67","8,917.34"
21-Jul-2025,Debit Card,03.66,00.00,"8,921.00"
21-Jul-2025,Commission,00.00,"4,460.50","4,460.50"
21-Jul-2025,Purchase,307.00,00.00,"4,767.50"
21-Jul-2025,Bill,00.00,"2,383.75","2,383.75"
21-Jul-2025,ATM,"211,581.72",00.00,"213,965.47"
21-Jul-2025,Debit Card,"98,710.44",00.00,"312,675.91"
21-Jul-2025,RTGS,00.00,"104,225.30","208,450.61"
22-Jul-2025,Debit Card,00.00,"69,483.54","138,967.07"
22-Jul-2025,ATM,00.00,"13,896.71","125,070.36"
22-Jul-2025,NEFT,00.00,"17,867.19","107,203.17"
22-Jul-2025,Cheque,00.00,"11,911.46","95,291.71"
22-Jul-2025,Transfer,00.00,"10,587.97","84,703.74"
22-Jul-2025,Cash,264.00,00.00,"84,967.74"
22-Jul-2025,Miscellaneous,00.00,"16,993.55","67,974.19"
22-Jul-2025,ATM,"24,147.90",00.00,"92,122.09"
22-Jul-2025,Cash,"1,968,755.00",00.00,"2,060,877.09"
22-Jul-2025,Interest,00.00,"1,030,438.55","1,030,438.54"
22-Jul-2025,Debit Card,"1,926,916.50",00.00,"2,957,355.04"
22-Jul-2025,Miscellaneous,"2,081,404.20",00.00,"5,038,759.24"
22-Jul-2025,Bill,486.20,00.00,"5,039,245.44"
22-Jul-2025,Transfer,00.00,"629,905.68","4,409,339.76"
22-Jul-2025,Miscellaneous,23.10,00.00,"4,409,362.86"
22-Jul-2025,NEFT,00.00,"551,170.36","3,858,192.50"
22-Jul-2025,Interest,00.00,"428,688.06","3,429,504.44"
22-Jul-2025,Tax,251.70,00.00,"3,429,756.14"
22-Jul-2025,Interest,00.00,"381,084.02","3,048,672.12"
22-Jul-2025,Tax,"21,733.54",00.00,"3,070,405.66"
22-Jul-2025,Cheque,00.00,"1,535,202.83","1,535,202.83"
22-Jul-2025,Cash,00.00,"1,535,202.83",00.00
22-Jul-2025,Cheque,04.40,00.00,04.40
22-Jul-2025,Debit Card,04.00,00.00,08.40
22-Jul-2025,Purchase,"27,825.50",00.00,"27,833.90"
22-Jul-2025,ATM,"2,663.00",00.00,"30,496.90"
22-Jul-2025,Commission,00.00,"6,099.38","24,397.52"
22-Jul-2025,NEFT,00.00,"3,049.69","21,347.83"
22-Jul-2025,IMPS,172.00,00.00,"21,519.83"
22-Jul-2025,IMPS,00.00,"21,519.83",00.00
22-Jul-2025,Commission,"3,139.02",00.00,"3,139.02"
22-Jul-2025,Cash,05.50,00.00,"3,144.52"
22-Jul-2025,Cash,"30,012.33",00.00,"33,156.85"
22-Jul-2025,Bill,02.00,00.00,"33,158.85"
22-Jul-2025,NEFT,00.00,"11,052.95","22,105.90"
22-Jul-2025,Transfer,"812,718.00",00.00,"834,823.90"
22-Jul-2025,Commission,00.00,"208,705.98","626,117.93"
22-Jul-2025,Reversal,"1,427,083.80",00.00,"2,053,201.73"
22-Jul-2025,RTGS,00.00,"205,320.17","1,847,881.56"
22-Jul-2025,Interest,472.70,00.00,"1,848,354.26"
22-Jul-2025,ATM,"1,492.15",00.00,"1,849,846.41"
22-Jul-2025,Purchase,00.00,"369,969.28","1,479,877.13"
23-Jul-2025,ATM,"1,525,596.50",00.00,"3,005,473.63"
23-Jul-2025,NEFT,08.00,00.00,"3,005,481.63"
23-Jul-2025,Interest,07.56,00.00,"3,005,489.19"
23-Jul-2025,ATM,719.30,00.00,"3,006,208.49"
23-Jul-2025,Transfer,"915,896.00",00.00,"3,922,104.49"
23-Jul-2025,IMPS,00.00,"1,307,368.16","2,614,736.33"
23-Jul-2025,Cheque,00.00,"326,842.04","2,287,894.29"
23-Jul-2025,Transfer,07.50,00.00,"2,287,901.79"
23-Jul-2025,Cheque,"3,170.00",00.00,"2,291,071.79"
23-Jul-2025,Commission,00.94,00.00,"2,291,072.73"
23-Jul-2025,Cheque,"26,137.19",00.00,"2,317,209.92"
23-Jul-2025,Transfer,"255,778.97",00.00,"2,572,988.89"
23-Jul-2025,Cash,309.08,00.00,"2,573,297.97"
23-Jul-2025,RTGS,00.00,"257,329.80","2,315,968.17"
23-Jul-2025,IMPS,"1,736,247.00",00.00,"4,052,215.17"
23-Jul-2025,Transfer,00.00,"1,350,738.39","2,701,476.78"
23-Jul-2025,Purchase,"2,023.27",00.00,"2,703,500.05"
23-Jul-2025,Purchase,00.00,"337,937.51","2,365,562.54"
23-Jul-2025,Bill,00.00,"262,840.28","2,102,722.26"
23-Jul-2025,Commission,00.00,"262,840.28","1,839,881.98"
23-Jul-2025,Transfer,00.00,"613,293.99","1,226,587.99"
23-Jul-2025,Commission,00.00,"204,431.33","1,022,156.66"
23-Jul-2025,Purchase,347.68,00.00,"1,022,504.34"
23-Jul-2025,Miscellaneous,871.78,00.00,"1,023,376.12"
23-Jul-2025,Bill,00.00,"341,125.37","682,250.75"
23-Jul-2025,Bill,00.00,"68,225.08","614,025.68"
23-Jul-2025,Interest,"215,799.00",00.00,"829,824.68"
23-Jul-2025,Commission,00.00,"138,304.11","691,520.57"
23-Jul-2025,NEFT,00.00,"230,506.86","461,013.71"
23-Jul-2025,Transfer,370.51,00.00,"461,384.22"
23-Jul-2025,Bill,00.00,"76,897.37","384,486.85"
23-Jul-2025,Purchase,"18,641.36",00.00,"403,128.21"
23-Jul-2025,NEFT,00.00,"57,589.74","345,538.47"
23-Jul-2025,Purchase,01.00,00.00,"345,539.47"
23-Jul-2025,Commission,"3,093.00",00.00,"348,632.47"
23-Jul-2025,ATM,"939,945.80",00.00,"1,288,578.27"
23-Jul-2025,Transfer,"248,290.00",00.00,"1,536,868.27"
23-Jul-2025,NEFT,00.00,"256,144.71","1,280,723.56"
23-Jul-2025,Tax,"2,783.00",00.00,"1,283,506.56"
23-Jul-2025,Bill,01.17,00.00,"1,283,507.73"
23-Jul-2025,Debit Card,"2,051.02",00.00,"1,285,558.75"
23-Jul-2025,Miscellaneous,61.83,00.00,"1,285,620.58"
23-Jul-2025,Bill,"3,169.60",00.00,"1,288,790.18"
23-Jul-2025,RTGS,08.00,00.00,"1,288,798.18"
23-Jul-2025,IMPS,00.00,"161,099.77","1,127,698.41"
23-Jul-2025,Miscellaneous,00.00,"281,924.60","845,773.81"
23-Jul-2025,Transfer,"255,745.88",00.00,"1,101,519.69"
23-Jul-2025,NEFT,00.00,"1,101,519.69",00.00
23-Jul-2025,Interest,08.00,00.00,08.00
23-Jul-2025,Miscellaneous,"77,823.00",00.00,"77,831.00"
23-Jul-2025,Debit Card,00.00,"25,943.67","51,887.33"
24-Jul-2025,RTGS,00.00,"6,485.92","45,401.41"
24-Jul-2025,RTGS,"1,944.00",00.00,"47,345.41"
24-Jul-2025,RTGS,00.00,"7,890.90","39,454.51"
24-Jul-2025,NEFT,00.00,"13,151.50","26,303.01"
24-Jul-2025,Transfer,"16,710.64",00.00,"43,013.65"
24-Jul-2025,Cheque,"12,793.00",00.00,"55,806.65"
24-Jul-2025,Purchase,00.00,"18,602.22","37,204.43"
24-Jul-2025,Bill,"260,370.00",00.00,"297,574.43"
24-Jul-2025,Cheque,429.00,00.00,"298,003.43"
24-Jul-2025,Transfer,00.00,"298,003.43",00.00
24-Jul-2025,Commission,"232,888.20",00.00,"232,888.20"
24-Jul-2025,NEFT,00.00,"58,222.05","174,666.15"
24-Jul-2025,Cash,12.50,00.00,"174,678.65"
24-Jul-2025,NEFT,00.00,"43,669.66","131,008.99"
24-Jul-2025,NEFT,"74,057.00",00.00,"205,065.99"
24-Jul-2025,RTGS,00.00,"25,633.25","179,432.74"
24-Jul-2025,Tax,02.81,00.00,"179,435.55"
24-Jul-2025,Tax,00.00,"25,633.65","153,801.90"
24-Jul-2025,Miscellaneous,00.00,"30,760.38","123,041.52"
24-Jul-2025,ATM,00.00,"17,577.36","105,464.16"
24-Jul-2025,NEFT,00.00,"11,718.24","93,745.92"
24-Jul-2025,Interest,00.00,"11,718.24","82,027.68"
24-Jul-2025,Reversal,07.70,00.00,"82,035.38"
24-Jul-2025,Purchase,06.60,00.00,"82,041.98"
24-Jul-2025,Interest,"1,599,303.80",00.00,"1,681,345.78"
24-Jul-2025,Bill,00.00,"186,816.20","1,494,529.58"
24-Jul-2025,ATM,00.00,"298,905.92","1,195,623.66"
24-Jul-2025,IMPS,00.00,"1,195,623.66",00.00
24-Jul-2025,Reversal,44.40,00.00,44.40
24-Jul-2025,Debit Card,00.00,06.34,38.06
24-Jul-2025,NEFT,"51,154.03",00.00,"51,192.09"
24-Jul-2025,Tax,"17,925.80",00.00,"69,117.89"
24-Jul-2025,Miscellaneous,00.00,"8,639.74","60,478.15"
24-Jul-2025,Transfer,00.00,"20,159.38","40,318.77"
24-Jul-2025,ATM,"14,816.80",00.00,"55,135.57"
24-Jul-2025,NEFT,"137,556.00",00.00,"192,691.57"
24-Jul-2025,Purchase,00.00,"19,269.16","173,422.41"
24-Jul-2025,Cash,00.00,"34,684.48","138,737.93"
24-Jul-2025,Bill,00.00,"69,368.97","69,368.96"
24-Jul-2025,ATM,00.00,"9,909.85","59,459.11"
24-Jul-2025,Cash,00.00,"14,864.78","44,594.33"
24-Jul-2025,RTGS,00.00,"44,594.33",00.00
24-Jul-2025,Commission,01.00,00.00,01.00
24-Jul-2025,Miscellaneous,"106,042.00",00.00,"106,043.00"
24-Jul-2025,Reversal,55.00,00.00,"106,098.00"
24-Jul-2025,Interest,"183,053.00",00.00,"289,151.00"
24-Jul-2025,Cash,"269,532.00",00.00,"558,683.00"
24-Jul-2025,Purchase,00.00,"55,868.30","502,814.70"
24-Jul-2025,Cash,"20,743.00",00.00,"523,557.70"
24-Jul-2025,Commission,"569,792.00",00.00,"1,093,349.70"
24-Jul-2025,Miscellaneous,00.00,"156,192.81","937,156.89"
24-Jul-2025,Cash,00.00,"312,385.63","624,771.26"
24-Jul-2025,Reversal,"4,095.20",00.00,"628,866.46"
24-Jul-2025,Purchase,00.00,"209,622.15","419,244.31"
24-Jul-2025,NEFT,00.00,"46,582.70","372,661.61"
25-Jul-2025,RTGS,00.00,"46,582.70","326,078.91"
25-Jul-2025,IMPS,00.00,"163,039.46","163,039.45"
25-Jul-2025,Transfer,00.00,"32,607.89","130,431.56"
25-Jul-2025,Cheque,"2,756.60",00.00,"133,188.16"
25-Jul-2025,Cheque,00.00,"16,648.52","116,539.64"
25-Jul-2025,RTGS,"64,914.75",00.00,"181,454.39"
25-Jul-2025,RTGS,"83,826.00",00.00,"265,280.39"
25-Jul-2025,NEFT,00.00,"132,640.20","132,640.20"
25-Jul-2025,Miscellaneous,"10,145.16",00.00,"142,785.36"
25-Jul-2025,Cheque,"1,103,205.75",00.00,"1,245,991.11"
25-Jul-2025,IMPS,"110,445.00",00.00,"1,356,436.11"
25-Jul-2025,Interest,"15,481.41",00.00,"1,371,917.52"
25-Jul-2025,RTGS,"224,885.00",00.00,"1,596,802.52"
25-Jul-2025,NEFT,"39,355.00",00.00,"1,636,157.52"
25-Jul-2025,Cash,74.18,00.00,"1,636,231.70"
25-Jul-2025,Purchase,00.00,"545,410.57","1,090,821.13"
25-Jul-2025,ATM,00.00,"218,164.23","872,656.90"
25-Jul-2025,Purchase,06.10,00.00,"872,663.00"
25-Jul-2025,RTGS,"11,200.20",00.00,"883,863.20"
25-Jul-2025,Interest,00.00,"220,965.80","662,897.40"
25-Jul-2025,Cash,"1,060,779.00",00.00,"1,723,676.40"
25-Jul-2025,Commission,"14,868.00",00.00,"1,738,544.40"
25-Jul-2025,Bill,00.00,"434,636.10","1,303,908.30"
25-Jul-2025,Purchase,00.00,"260,781.66","1,043,126.64"
25-Jul-2025,Tax,00.00,"104,312.66","938,813.98"
25-Jul-2025,Cheque,"1,483.78",00.00,"940,297.76"
25-Jul-2025,Cheque,"153,570.90",00.00,"1,093,868.66"
25-Jul-2025,Debit Card,00.00,"121,540.96","972,327.70"
25-Jul-2025,Debit Card,00.00,"162,054.62","810,273.08"
25-Jul-2025,Miscellaneous,05.00,00.00,"810,278.08"
25-Jul-2025,Cash,"1,785,106.00",00.00,"2,595,384.08"
25-Jul-2025,Transfer,"12,673.40",00.00,"2,608,057.48"
25-Jul-2025,ATM,01.20,00.00,"2,608,058.68"
25-Jul-2025,Debit Card,00.00,"289,784.30","2,318,274.38"
25-Jul-2025,ATM,00.00,"386,379.06","1,931,895.32"
25-Jul-2025,IMPS,00.00,"193,189.53","1,738,705.79"
25-Jul-2025,Miscellaneous,"30,550.00",00.00,"1,769,255.79"
25-Jul-2025,Reversal,00.00,"221,156.97","1,548,098.82"
25-Jul-2025,Purchase,00.00,"221,156.97","1,326,941.85"
25-Jul-2025,Interest,507.20,00.00,"1,327,449.05"
25-Jul-2025,Tax,00.00,"331,862.26","995,586.79"
25-Jul-2025,Purchase,402.00,00.00,"995,988.79"
25-Jul-2025,ATM,00.00,"142,284.11","853,704.68"
25-Jul-2025,Commission,47.46,00.00,"853,752.14"
25-Jul-2025,Cash,00.00,"106,719.02","747,033.12"
25-Jul-2025,Transfer,07.95,00.00,"747,041.07"
25-Jul-2025,Commission,16.13,00.00,"747,057.20"
25-Jul-2025,Debit Card,"799,142.25",00.00,"1,546,199.45"
25-Jul-2025,IMPS,00.00,"515,399.82","1,030,799.63"
25-Jul-2025,ATM,"29,192.00",00.00,"1,059,991.63"
25-Jul-2025,Tax,"209,707.19",00.00,"1,269,698.82"
25-Jul-2025,Cash,00.00,"1,269,698.82",00.00
25-Jul-2025,Cash,"13,142.00",00.00,"13,142.00"
26-Jul-2025,Reversal,50.70,00.00,"13,192.70"
26-Jul-2025,Purchase,544.50,00.00,"13,737.20"
26-Jul-2025,Purchase,483.60,00.00,"14,220.80"
26-Jul-2025,Interest,00.00,"2,031.54","12,189.26"
26-Jul-2025,Purchase,00.00,"3,047.32","9,141.94"
26-Jul-2025,NEFT,"701,552.00",00.00,"710,693.94"
26-Jul-2025,NEFT,00.00,"78,965.99","631,727.95"
26-Jul-2025,Cheque,00.00,"210,575.98","421,151.97"
26-Jul-2025,Cash,00.00,"42,115.20","379,036.77"
26-Jul-2025,Transfer,00.00,"189,518.39","189,518.38"
27-Jul-2025,Tax,00.00,"47,379.60","142,138.78"
27-Jul-2025,Purchase,00.00,"14,213.88","127,924.90"
27-Jul-2025,Reversal,00.00,"21,320.82","106,604.08"
27-Jul-2025,Cheque,"181,696.69",00.00,"288,300.77"
28-Jul-2025,Bill,"3,222.00",00.00,"291,522.77"
28-Jul-2025,Interest,130.96,00.00,"291,653.73"
28-Jul-2025,Commission,"1,443,267.00",00.00,"1,734,920.73"
28-Jul-2025,Transfer,00.00,"289,153.46","1,445,767.28"
28-Jul-2025,RTGS,"1,589.20",00.00,"1,447,356.48"
28-Jul-2025,Tax,00.00,"361,839.12","1,085,517.36"
28-Jul-2025,Debit Card,"78,066.70",00.00,"1,163,584.06"
28-Jul-2025,Cash,310.40,00.00,"1,163,894.46"
28-Jul-2025,Debit Card,00.00,"290,973.62","872,920.84"
28-Jul-2025,Transfer,"716,325.00",00.00,"1,589,245.84"
28-Jul-2025,Cash,94.63,00.00,"1,589,340.47"
28-Jul-2025,IMPS,262.47,00.00,"1,589,602.94"
28-Jul-2025,Cheque,02.00,00.00,"1,589,604.94"
28-Jul-2025,RTGS,"2,766.00",00.00,"1,592,370.94"
28-Jul-2025,ATM,29.45,00.00,"1,592,400.39"
28-Jul-2025,Commission,03.47,00.00,"1,592,403.86"
28-Jul-2025,Purchase,00.00,"796,201.93","796,201.93"
28-Jul-2025,Interest,"1,762,139.00",00.00,"2,558,340.93"
28-Jul-2025,Commission,256.00,00.00,"2,558,596.93"
28-Jul-2025,NEFT,"24,134.00",00.00,"2,582,730.93"
28-Jul-2025,Cheque,212.30,00.00,"2,582,943.23"
29-Jul-2025,Cash,"198,156.75",00.00,"2,781,099.98"
29-Jul-2025,Cash,"1,063.00",00.00,"2,782,162.98"
29-Jul-2025,Cheque,"561,607.50",00.00,"3,343,770.48"
29-Jul-2025,Transfer,03.70,00.00,"3,343,774.18"
29-Jul-2025,Transfer,"77,282.12",00.00,"3,421,056.30"
29-Jul-2025,Miscellaneous,597.04,00.00,"3,421,653.34"
29-Jul-2025,Debit Card,00.00,"3,421,653.34",00.00
29-Jul-2025,Cheque,"12,934.20",00.00,"12,934.20"
29-Jul-2025,Debit Card,00.00,"1,616.78","11,317.42"
29-Jul-2025,NEFT,00.00,"5,658.71","5,658.71"
29-Jul-2025,NEFT,06.00,00.00,"5,664.71"
29-Jul-2025,Commission,00.00,"1,416.18","4,248.53"
29-Jul-2025,ATM,00.00,849.71,"3,398.82"
29-Jul-2025,Miscellaneous,00.00,566.47,"2,832.35"
29-Jul-2025,Tax,04.70,00.00,"2,837.05"
30-Jul-2025,Cheque,01.00,00.00,"2,838.05"
30-Jul-2025,Tax,00.00,"1,419.03","1,419.02"
30-Jul-2025,Purchase,"1,711,277.75",00.00,"1,712,696.77"
31-Jul-2025,Bill,00.00,"856,348.39","856,348.38"
31-Jul-2025,Purchase,28.18,00.00,"856,376.56"
31-Jul-2025,Miscellaneous,32.00,00.00,"856,408.56"
31-Jul-2025,ATM,00.00,"171,281.71","685,126.85"
31-Jul-2025,Interest,00.00,"97,875.26","587,251.59"
01-Aug-2025,ATM,"2,957.40",00.00,"590,208.99"
01-Aug-2025,NEFT,00.00,"98,368.17","491,840.82"
01-Aug-2025,ATM,14.19,00.00,"491,855.01"
01-Aug-2025,Interest,00.00,"81,975.84","409,879.18"
01-Aug-2025,Miscellaneous,"111,671.16",00.00,"521,550.34"
01-Aug-2025,Transfer,00.00,"86,925.06","434,625.28"
01-Aug-2025,Cash,00.00,"62,089.33","372,535.95"
01-Aug-2025,Bill,59.60,00.00,"372,595.55"
01-Aug-2025,Miscellaneous,00.00,"62,099.26","310,496.29"
01-Aug-2025,Cash,00.00,"31,049.63","279,446.66"
01-Aug-2025,Bill,"147,143.22",00.00,"426,589.88"
01-Aug-2025,IMPS,"4,444.50",00.00,"431,034.38"
01-Aug-2025,ATM,00.00,"107,758.60","323,275.79"
01-Aug-2025,Bill,"1,151.50",00.00,"324,427.29"
01-Aug-2025,IMPS,00.00,"40,553.41","283,873.88"
01-Aug-2025,Purchase,00.00,"94,624.63","189,249.25"
01-Aug-2025,Transfer,00.00,"47,312.31","141,936.94"
01-Aug-2025,Commission,"15,073.00",00.00,"157,009.94"
01-Aug-2025,Debit Card,00.00,"52,336.65","104,673.29"
01-Aug-2025,Purchase,"12,562.80",00.00,"117,236.09"
01-Aug-2025,Bill,00.00,"23,447.22","93,788.87"
01-Aug-2025,Transfer,00.00,"18,757.77","75,031.10"
01-Aug-2025,Debit Card,"32,439.80",00.00,"107,470.90"
01-Aug-2025,IMPS,00.00,"15,352.99","92,117.91"
01-Aug-2025,IMPS,07.45,00.00,"92,125.36"
01-Aug-2025,RTGS,03.89,00.00,"92,129.25"
01-Aug-2025,Bill,00.00,"92,129.25",00.00
01-Aug-2025,Tax,01.90,00.00,01.90
01-Aug-2025,Tax,"533,035.20",00.00,"533,037.10"
01-Aug-2025,Miscellaneous,00.00,"533,037.10",00.00
01-Aug-2025,NEFT,"2,515.00",00.00,"2,515.00"
01-Aug-2025,Commission,252.80,00.00,"2,767.80"
01-Aug-2025,Debit Card,216.71,00.00,"2,984.51"
01-Aug-2025,Purchase,"1,504,672.00",00.00,"1,507,656.51"
01-Aug-2025,Cheque,"242,665.47",00.00,"1,750,321.98"
01-Aug-2025,Debit Card,"14,188.20",00.00,"1,764,510.18"
01-Aug-2025,NEFT,04.21,00.00,"1,764,514.39"
01-Aug-2025,Cheque,"734,987.00",00.00,"2,499,501.39"
01-Aug-2025,Cash,"6,980.00",00.00,"2,506,481.39"
01-Aug-2025,ATM,"977,436.00",00.00,"3,483,917.39"
01-Aug-2025,Reversal,14.64,00.00,"3,483,932.03"
01-Aug-2025,Bill,01.00,00.00,"3,483,933.03"
01-Aug-2025,Interest,00.00,"348,393.30","3,135,539.73"
01-Aug-2025,Commission,"180,367.00",00.00,"3,315,906.73"
02-Aug-2025,Purchase,00.00,"1,105,302.24","2,210,604.49"
02-Aug-2025,Tax,00.00,"221,060.45","1,989,544.04"
02-Aug-2025,NEFT,00.00,"284,220.58","1,705,323.46"
02-Aug-2025,Miscellaneous,00.00,"426,330.87","1,278,992.60"
02-Aug-2025,ATM,00.00,"127,899.26","1,151,093.34"
02-Aug-2025,IMPS,"186,786.00",00.00,"1,337,879.34"
02-Aug-2025,Debit Card,"194,107.00",00.00,"1,531,986.34"
02-Aug-2025,Interest,00.00,"306,397.27","1,225,589.07"
02-Aug-2025,Interest,00.00,"153,198.63","1,072,390.44"
02-Aug-2025,Cheque,00.00,"134,048.81","938,341.64"
02-Aug-2025,Debit Card,"231,361.00",00.00,"1,169,702.64"
02-Aug-2025,Tax,02.80,00.00,"1,169,705.44"
02-Aug-2025,Debit Card,00.00,"194,950.91","974,754.53"
02-Aug-2025,Tax,257.25,00.00,"975,011.78"
02-Aug-2025,Cheque,06.90,00.00,"975,018.68"
03-Aug-2025,ATM,"250,436.40",00.00,"1,225,455.08"
03-Aug-2025,Cash,04.00,00.00,"1,225,459.08"
03-Aug-2025,Interest,00.00,"175,065.58","1,050,393.50"
03-Aug-2025,IMPS,"737,360.75",00.00,"1,787,754.25"
03-Aug-2025,NEFT,00.00,"223,469.28","1,564,284.97"
03-Aug-2025,Interest,00.00,"782,142.49","782,142.48"
03-Aug-2025,Miscellaneous,50.49,00.00,"782,192.97"
03-Aug-2025,RTGS,21.00,00.00,"782,213.97"
03-Aug-2025,Interest,00.00,"260,737.99","521,475.98"
03-Aug-2025,Cash,00.00,"173,825.33","347,650.65"
03-Aug-2025,Interest,59.00,00.00,"347,709.65"
03-Aug-2025,RTGS,00.00,"57,951.61","289,758.04"
03-Aug-2025,Miscellaneous,"3,017.80",00.00,"292,775.84"
03-Aug-2025,Bill,"2,385.69",00.00,"295,161.53"
03-Aug-2025,Bill,00.00,"32,795.73","262,365.80"
03-Aug-2025,Bill,02.40,00.00,"262,368.20"
03-Aug-2025,Debit Card,05.40,00.00,"262,373.60"
03-Aug-2025,Commission,00.00,"262,373.60",00.00
03-Aug-2025,Transfer,13.00,00.00,13.00
03-Aug-2025,Purchase,00.00,02.60,10.40
03-Aug-2025,Debit Card,00.00,02.60,07.80
03-Aug-2025,Cash,00.00,00.78,07.02
03-Aug-2025,IMPS,00.00,02.34,04.68
03-Aug-2025,Cheque,00.00,01.56,03.12
04-Aug-2025,RTGS,04.50,00.00,07.62
04-Aug-2025,Miscellaneous,04.02,00.00,11.64
04-Aug-2025,Miscellaneous,"62,682.00",00.00,"62,693.64"
04-Aug-2025,Bill,00.00,"6,269.36","56,424.28"
04-Aug-2025,RTGS,00.00,"9,404.05","47,020.23"
04-Aug-2025,Cheque,00.00,"5,224.47","41,795.76"
04-Aug-2025,ATM,00.00,"5,970.82","35,824.94"
04-Aug-2025,Bill,"235,902.70",00.00,"271,727.64"
04-Aug-2025,Cheque,354.00,00.00,"272,081.64"
04-Aug-2025,IMPS,00.00,"27,208.16","244,873.48"
04-Aug-2025,ATM,00.00,"244,873.48",00.00
04-Aug-2025,Cheque,28.02,00.00,28.02
04-Aug-2025,Reversal,00.00,28.02,00.00
04-Aug-2025,Interest,"2,610.00",00.00,"2,610.00"
04-Aug-2025,IMPS,287.00,00.00,"2,897.00"
04-Aug-2025,Debit Card,"5,269.93",00.00,"8,166.93"
04-Aug-2025,IMPS,02.70,00.00,"8,169.63"
04-Aug-2025,Miscellaneous,00.00,"2,042.41","6,127.22"
04-Aug-2025,Bill,"76,475.00",00.00,"82,602.22"
04-Aug-2025,Purchase,00.00,"13,767.04","68,835.18"
04-Aug-2025,RTGS,00.00,"11,472.53","57,362.65"
04-Aug-2025,Miscellaneous,00.00,"6,373.63","50,989.02"
04-Aug-2025,NEFT,"1,960,902.00",00.00,"2,011,891.02"
04-Aug-2025,Transfer,"1,009.00",00.00,"2,012,900.02"
04-Aug-2025,ATM,00.00,"223,655.56","1,789,244.46"
04-Aug-2025,Tax,00.00,"596,414.82","1,192,829.64"
04-Aug-2025,NEFT,"20,601.77",00.00,"1,213,431.41"
05-Aug-2025,Miscellaneous,"3,977.20",00.00,"1,217,408.61"
05-Aug-2025,Commission,00.00,"135,267.62","1,082,140.99"
05-Aug-2025,IMPS,01.00,00.00,"1,082,141.99"
05-Aug-2025,Interest,482.90,00.00,"1,082,624.89"
05-Aug-2025,Tax,"2,480.00",00.00,"1,085,104.89"
05-Aug-2025,Bill,"2,393.40",00.00,"1,087,498.29"
05-Aug-2025,Transfer,"27,529.70",00.00,"1,115,027.99"
05-Aug-2025,Purchase,00.00,"159,289.71","955,738.28"
05-Aug-2025,IMPS,00.00,"95,573.83","860,164.45"
05-Aug-2025,Cash,495.00,00.00,"860,659.45"
05-Aug-2025,Miscellaneous,00.00,"215,164.86","645,494.59"
05-Aug-2025,Tax,00.00,"645,494.59",00.00
05-Aug-2025,Transfer,"1,966,349.80",00.00,"1,966,349.80"
05-Aug-2025,Miscellaneous,00.00,"196,634.98","1,769,714.82"
05-Aug-2025,Cash,02.05,00.00,"1,769,716.87"
05-Aug-2025,Transfer,00.00,"884,858.44","884,858.44"
05-Aug-2025,NEFT,00.00,"126,408.35","758,450.09"
05-Aug-2025,IMPS,187.00,00.00,"758,637.09"
05-Aug-2025,Reversal,00.00,"108,376.73","650,260.36"
05-Aug-2025,IMPS,06.00,00.00,"650,266.36"
06-Aug-2025,Reversal,00.00,"325,133.18","325,133.18"
06-Aug-2025,Tax,00.00,"325,133.18",00.00
06-Aug-2025,Interest,"1,075,225.25",00.00,"1,075,225.25"
06-Aug-2025,Purchase,"934,035.00",00.00,"2,009,260.25"
06-Aug-2025,ATM,"23,253.10",00.00,"2,032,513.35"
06-Aug-2025,Bill,04.93,00.00,"2,032,518.28"
06-Aug-2025,Bill,"1,576.80",00.00,"2,034,095.08"
06-Aug-2025,NEFT,02.00,00.00,"2,034,097.08"
06-Aug-2025,Bill,"2,325.30",00.00,"2,036,422.38"
06-Aug-2025,Tax,00.00,"203,642.24","1,832,780.14"
06-Aug-2025,Transfer,00.00,"203,642.24","1,629,137.90"
06-Aug-2025,ATM,"1,337.10",00.00,"1,630,475.00"
06-Aug-2025,Debit Card,"32,322.20",00.00,"1,662,797.20"
06-Aug-2025,Interest,36.92,00.00,"1,662,834.12"
06-Aug-2025,Commission,00.00,"554,278.04","1,108,556.08"
06-Aug-2025,Debit Card,00.00,"221,711.22","886,844.86"
06-Aug-2025,Interest,"16,844.00",00.00,"903,688.86"
06-Aug-2025,Reversal,"479,766.00",00.00,"1,383,454.86"
06-Aug-2025,Tax,41.00,00.00,"1,383,495.86"
06-Aug-2025,RTGS,06.00,00.00,"1,383,501.86"
06-Aug-2025,Debit Card,270.00,00.00,"1,383,771.86"
06-Aug-2025,Cash,00.00,"345,942.97","1,037,828.90"
06-Aug-2025,Purchase,00.00,"1,037,828.90",00.00
07-Aug-2025,Miscellaneous,"227,297.20",00.00,"227,297.20"
07-Aug-2025,Transfer,"23,928.59",00.00,"251,225.79"
07-Aug-2025,Bill,00.00,"41,870.97","209,354.82"
07-Aug-2025,ATM,142.00,00.00,"209,496.82"
07-Aug-2025,Reversal,00.00,"34,916.14","174,580.68"
07-Aug-2025,Tax,335.91,00.00,"174,916.59"
07-Aug-2025,Cash,00.00,"58,305.53","116,611.06"
07-Aug-2025,Reversal,00.00,"11,661.11","104,949.95"
08-Aug-2025,Reversal,00.00,"34,983.32","69,966.63"
08-Aug-2025,Cash,00.00,"34,983.32","34,983.32"
09-Aug-2025,RTGS,00.00,"34,983.32",00.00
09-Aug-2025,RTGS,"18,678.80",00.00,"18,678.80"
09-Aug-2025,ATM,"235,469.38",00.00,"254,148.18"
09-Aug-2025,NEFT,00.00,"25,414.82","228,733.36"
09-Aug-2025,Cheque,00.00,"228,733.36",00.00
09-Aug-2025,NEFT,22.60,00.00,22.60
09-Aug-2025,Cash,"91,951.00",00.00,"91,973.60"
09-Aug-2025,ATM,00.00,"91,973.60",00.00
09-Aug-2025,NEFT,"24,359.40",00.00,"24,359.40"
09-Aug-2025,Purchase,"137,898.91",00.00,"162,258.31"
09-Aug-2025,Tax,00.00,"81,129.16","81,129.16"
09-Aug-2025,Miscellaneous,00.00,"27,043.05","54,086.11"
09-Aug-2025,Tax,00.00,"13,521.53","40,564.58"
09-Aug-2025,Purchase,00.00,"4,056.46","36,508.12"
09-Aug-2025,IMPS,00.00,"7,301.62","29,206.50"
09-Aug-2025,Transfer,47.36,00.00,"29,253.86"
09-Aug-2025,Miscellaneous,00.00,"9,751.29","19,502.57"
09-Aug-2025,Tax,03.00,00.00,"19,505.57"
09-Aug-2025,Bill,16.03,00.00,"19,521.60"
09-Aug-2025,Tax,00.00,"3,253.60","16,268.00"
09-Aug-2025,Transfer,03.61,00.00,"16,271.61"
09-Aug-2025,Purchase,00.00,"3,254.32","13,017.29"
09-Aug-2025,Tax,00.00,"1,301.73","11,715.56"
09-Aug-2025,Cash,00.00,"11,715.56",00.00
09-Aug-2025,Reversal,"534,403.50",00.00,"534,403.50"
09-Aug-2025,Purchase,00.00,"66,800.44","467,603.06"
09-Aug-2025,Purchase,"4,580.20",00.00,"472,183.26"
09-Aug-2025,Transfer,"75,542.10",00.00,"547,725.36"
09-Aug-2025,Miscellaneous,"1,319,934.50",00.00,"1,867,659.86"
09-Aug-2025,RTGS,00.00,"622,553.29","1,245,106.57"
09-Aug-2025,Purchase,00.00,"207,517.76","1,037,588.81"
09-Aug-2025,Purchase,00.00,"115,287.65","922,301.16"
09-Aug-2025,Purchase,00.00,"115,287.65","807,013.52"
09-Aug-2025,Miscellaneous,00.00,"269,004.51","538,009.01"
09-Aug-2025,Cash,594.10,00.00,"538,603.11"
09-Aug-2025,RTGS,00.00,"53,860.31","484,742.80"
09-Aug-2025,Bill,258.00,00.00,"485,000.80"
09-Aug-2025,Commission,"1,109,708.20",00.00,"1,594,709.00"
09-Aug-2025,Cash,00.00,"797,354.50","797,354.50"
09-Aug-2025,Bill,00.00,"199,338.63","598,015.88"
10-Aug-2025,Commission,00.00,"59,801.59","538,214.29"
10-Aug-2025,Reversal,"31,731.70",00.00,"569,945.99"
10-Aug-2025,IMPS,00.00,"63,327.33","506,618.66"
10-Aug-2025,Transfer,224.30,00.00,"506,842.96"
10-Aug-2025,Cash,00.00,"50,684.30","456,158.66"
10-Aug-2025,NEFT,24.85,00.00,"456,183.51"
10-Aug-2025,Debit Card,00.00,"50,687.06","405,496.45"
10-Aug-2025,Debit Card,"1,093.25",00.00,"406,589.70"
11-Aug-2025,Tax,00.00,"101,647.43","304,942.28"
11-Aug-2025,Commission,85.57,00.00,"305,027.85"
11-Aug-2025,Bill,"1,941,039.00",00.00,"2,246,066.85"
11-Aug-2025,Interest,390.40,00.00,"2,246,457.25"
11-Aug-2025,Cheque,00.00,"2,246,457.25",00.00
11-Aug-2025,Interest,283.94,00.00,283.94
11-Aug-2025,Bill,00.00,141.97,141.97
12-Aug-2025,Reversal,00.00,23.66,118.31
12-Aug-2025,Cash,00.00,14.79,103.52
12-Aug-2025,ATM,22.37,00.00,125.89
12-Aug-2025,Reversal,00.00,20.98,104.91
12-Aug-2025,Cheque,02.20,00.00,107.11
12-Aug-2025,Purchase,59.60,00.00,166.71
12-Aug-2025,RTGS,00.00,41.68,125.03
12-Aug-2025,Debit Card,"2,657.00",00.00,"2,782.03"
12-Aug-2025,Reversal,"246,331.50",00.00,"249,113.53"
12-Aug-2025,Bill,62.90,00.00,"249,176.43"
13-Aug-2025,Reversal,00.00,"83,058.81","166,117.62"
13-Aug-2025,Miscellaneous,"30,664.40",00.00,"196,782.02"
13-Aug-2025,Bill,00.00,"32,797.00","163,985.02"
13-Aug-2025,Miscellaneous,53.41,00.00,"164,038.43"
13-Aug-2025,Reversal,42.40,00.00,"164,080.83"
13-Aug-2025,Cheque,162.45,00.00,"164,243.28"
13-Aug-2025,Cash,19.90,00.00,"164,263.18"
13-Aug-2025,Transfer,00.00,"41,065.80","123,197.38"
13-Aug-2025,Miscellaneous,"252,305.00",00.00,"375,502.38"
13-Aug-2025,Miscellaneous,00.00,"53,643.20","321,859.18"
13-Aug-2025,ATM,"1,533.42",00.00,"323,392.60"
13-Aug-2025,Tax,00.00,"323,392.60",00.00
13-Aug-2025,Interest,126.39,00.00,126.39
13-Aug-2025,NEFT,"1,257.05",00.00,"1,383.44"
13-Aug-2025,Miscellaneous,00.00,691.72,691.72
14-Aug-2025,Tax,"103,428.00",00.00,"104,119.72"
14-Aug-2025,Interest,00.00,"14,874.25","89,245.47"
14-Aug-2025,NEFT,00.00,"14,874.25","74,371.23"
14-Aug-2025,Cheque,"3,571.30",00.00,"77,942.53"
14-Aug-2025,Cash,51.15,00.00,"77,993.68"
14-Aug-2025,Reversal,"3,887.00",00.00,"81,880.68"
14-Aug-2025,Bill,00.00,"81,880.68",00.00
14-Aug-2025,NEFT,"4,501.70",00.00,"4,501.70"
14-Aug-2025,Miscellaneous,390.10,00.00,"4,891.80"
14-Aug-2025,Reversal,00.00,489.18,"4,402.62"
14-Aug-2025,RTGS,35.00,00.00,"4,437.62"
15-Aug-2025,Bill,00.00,"1,109.41","3,328.22"
15-Aug-2025,Cheque,"132,886.00",00.00,"136,214.22"
15-Aug-2025,Bill,00.00,"13,621.42","122,592.80"
15-Aug-2025,Cash,"44,913.00",00.00,"167,505.80"
15-Aug-2025,IMPS,00.00,"55,835.27","111,670.53"
15-Aug-2025,IMPS,"967,369.50",00.00,"1,079,040.03"
15-Aug-2025,Cheque,00.00,"215,808.01","863,232.02"
15-Aug-2025,RTGS,00.00,00.00,"863,232.02"
15-Aug-2025,IMPS,"791,974.80",00.00,"1,655,206.82"
15-Aug-2025,Reversal,00.00,"206,900.85","1,448,305.97"
15-Aug-2025,IMPS,04.00,00.00,"1,448,309.97"
15-Aug-2025,Cheque,"165,695.75",00.00,"1,614,005.72"
15-Aug-2025,RTGS,"1,367,801.80",00.00,"2,981,807.52"
15-Aug-2025,Bill,00.00,"372,725.94","2,609,081.58"
15-Aug-2025,Cash,00.00,"869,693.86","1,739,387.72"
15-Aug-2025,NEFT,00.00,"289,897.95","1,449,489.77"
15-Aug-2025,NEFT,00.00,"181,186.22","1,268,303.55"
15-Aug-2025,Debit Card,03.20,00.00,"1,268,306.75"
15-Aug-2025,Interest,196.00,00.00,"1,268,502.75"
15-Aug-2025,Cash,"19,195.80",00.00,"1,287,698.55"
15-Aug-2025,ATM,00.00,"143,077.62","1,144,620.93"
15-Aug-2025,Reversal,00.00,"1,144,620.93",00.00
15-Aug-2025,IMPS,"1,373,253.00",00.00,"1,373,253.00"
15-Aug-2025,IMPS,00.00,"171,656.63","1,201,596.38"
15-Aug-2025,RTGS,41.10,00.00,"1,201,637.48"
15-Aug-2025,Bill,"2,239.80",00.00,"1,203,877.28"
15-Aug-2025,Interest,00.00,"240,775.46","963,101.82"
15-Aug-2025,IMPS,"118,093.25",00.00,"1,081,195.07"
15-Aug-2025,ATM,"1,841.30",00.00,"1,083,036.37"
15-Aug-2025,IMPS,00.84,00.00,"1,083,037.21"
15-Aug-2025,NEFT,00.00,"541,518.61","541,518.60"
15-Aug-2025,ATM,00.00,"60,168.73","481,349.87"
15-Aug-2025,IMPS,141.40,00.00,"481,491.27"
15-Aug-2025,ATM,00.00,"80,248.55","401,242.72"
15-Aug-2025,Bill,00.00,"50,155.34","351,087.38"
15-Aug-2025,Debit Card,57.22,00.00,"351,144.60"
15-Aug-2025,Bill,00.00,"70,228.92","280,915.68"
15-Aug-2025,Bill,"30,680.50",00.00,"311,596.18"
15-Aug-2025,ATM,"1,810.00",00.00,"313,406.18"
15-Aug-2025,Commission,610.90,00.00,"314,017.08"
15-Aug-2025,RTGS,"68,151.84",00.00,"382,168.92"
15-Aug-2025,Cheque,"36,060.50",00.00,"418,229.42"
15-Aug-2025,Commission,06.40,00.00,"418,235.82"
15-Aug-2025,ATM,"218,778.75",00.00,"637,014.57"
15-Aug-2025,Purchase,"258,066.00",00.00,"895,080.57"
15-Aug-2025,Cash,00.00,"111,885.07","783,195.50"
15-Aug-2025,Cheque,00.00,"111,885.07","671,310.43"
15-Aug-2025,Debit Card,05.00,00.00,"671,315.43"
15-Aug-2025,Reversal,00.00,"134,263.09","537,052.34"
16-Aug-2025,Tax,51.00,00.00,"537,103.34"
16-Aug-2025,Miscellaneous,"5,405.91",00.00,"542,509.25"
16-Aug-2025,IMPS,"922,572.00",00.00,"1,465,081.25"
16-Aug-2025,Bill,00.00,"162,786.81","1,302,294.44"
16-Aug-2025,Reversal,00.00,"1,302,294.44",00.00
16-Aug-2025,ATM,"231,356.00",00.00,"231,356.00"
16-Aug-2025,Bill,30.00,00.00,"231,386.00"
16-Aug-2025,Bill,00.00,"25,709.56","205,676.44"
16-Aug-2025,Purchase,00.00,"205,676.44",00.00
16-Aug-2025,Transfer,377.20,00.00,377.20
16-Aug-2025,Purchase,"268,610.00",00.00,"268,987.20"
16-Aug-2025,Purchase,00.00,"89,662.40","179,324.80"
16-Aug-2025,ATM,00.00,"29,887.47","149,437.33"
16-Aug-2025,NEFT,"25,674.05",00.00,"175,111.38"
16-Aug-2025,Commission,"768,109.00",00.00,"943,220.38"
16-Aug-2025,Transfer,"1,683,729.00",00.00,"2,626,949.38"
16-Aug-2025,Interest,00.00,"262,694.94","2,364,254.44"
16-Aug-2025,NEFT,00.00,"337,750.63","2,026,503.81"
16-Aug-2025,Transfer,00.00,"337,750.64","1,688,753.18"
16-Aug-2025,Cash,214.45,00.00,"1,688,967.63"
16-Aug-2025,Cheque,10.00,00.00,"1,688,977.63"
16-Aug-2025,Cheque,"147,881.25",00.00,"1,836,858.88"
16-Aug-2025,Bill,293.80,00.00,"1,837,152.68"
17-Aug-2025,Commission,00.00,"183,715.27","1,653,437.41"
17-Aug-2025,Cash,"1,514.60",00.00,"1,654,952.01"
17-Aug-2025,Cheque,00.00,"413,738.00","1,241,214.01"
17-Aug-2025,ATM,00.00,"177,316.29","1,063,897.72"
17-Aug-2025,IMPS,"124,197.20",00.00,"1,188,094.92"
17-Aug-2025,Debit Card,882.00,00.00,"1,188,976.92"
17-Aug-2025,Bill,00.00,"148,622.12","1,040,354.80"
17-Aug-2025,Debit Card,01.00,00.00,"1,040,355.80"
17-Aug-2025,Commission,00.00,"1,040,355.80",00.00
17-Aug-2025,Miscellaneous,"2,059,146.50",00.00,"2,059,146.50"
17-Aug-2025,ATM,00.00,"514,786.63","1,544,359.88"
17-Aug-2025,Reversal,05.00,00.00,"1,544,364.88"
17-Aug-2025,Transfer,07.00,00.00,"1,544,371.88"
17-Aug-2025,RTGS,00.00,"772,185.94","772,185.94"
17-Aug-2025,ATM,00.00,"772,185.94",00.00
17-Aug-2025,Interest,"82,610.00",00.00,"82,610.00"
17-Aug-2025,ATM,"43,740.30",00.00,"126,350.30"
17-Aug-2025,Miscellaneous,"1,970,272.00",00.00,"2,096,622.30"
17-Aug-2025,Purchase,00.00,"299,517.47","1,797,104.83"
17-Aug-2025,Transfer,00.00,"199,678.31","1,597,426.52"
17-Aug-2025,Transfer,173.29,00.00,"1,597,599.81"
17-Aug-2025,Cash,46.00,00.00,"1,597,645.81"
17-Aug-2025,Purchase,00.00,"228,235.12","1,369,410.69"
17-Aug-2025,Miscellaneous,"2,822.13",00.00,"1,372,232.82"
17-Aug-2025,Cash,43.00,00.00,"1,372,275.82"
17-Aug-2025,RTGS,00.00,"228,712.64","1,143,563.18"
17-Aug-2025,NEFT,00.00,"285,890.80","857,672.38"
17-Aug-2025,Reversal,08.00,00.00,"857,680.38"
17-Aug-2025,RTGS,"26,104.90",00.00,"883,785.28"
17-Aug-2025,Purchase,56.16,00.00,"883,841.44"
17-Aug-2025,Cash,00.00,"883,841.44",00.00
17-Aug-2025,Interest,34.00,00.00,34.00
17-Aug-2025,Transfer,00.00,17.00,17.00
17-Aug-2025,Purchase,00.00,02.83,14.17
17-Aug-2025,Miscellaneous,"3,193.88",00.00,"3,208.05"
17-Aug-2025,Reversal,07.00,00.00,"3,215.05"
17-Aug-2025,Tax,"14,889.00",00.00,"18,104.05"
17-Aug-2025,RTGS,55.30,00.00,"18,159.35"
17-Aug-2025,Commission,"119,645.00",00.00,"137,804.35"
17-Aug-2025,Debit Card,"106,406.10",00.00,"244,210.45"
18-Aug-2025,Reversal,"93,287.00",00.00,"337,497.45"
18-Aug-2025,Tax,00.00,"48,213.92","289,283.53"
19-Aug-2025,Debit Card,00.00,"41,326.22","247,957.31"
19-Aug-2025,Interest,"229,039.50",00.00,"476,996.81"
19-Aug-2025,Transfer,"24,931.00",00.00,"501,927.81"
19-Aug-2025,RTGS,00.00,"250,963.91","250,963.90"
19-Aug-2025,Cheque,00.45,00.00,"250,964.35"
19-Aug-2025,RTGS,00.00,"250,964.35",00.00
19-Aug-2025,Debit Card,26.90,00.00,26.90
19-Aug-2025,Purchase,"2,771.00",00.00,"2,797.90"
19-Aug-2025,Miscellaneous,"3,508.03",00.00,"6,305.93"
19-Aug-2025,RTGS,"71,134.25",00.00,"77,440.18"
19-Aug-2025,IMPS,00.00,"15,488.04","61,952.14"
19-Aug-2025,Tax,00.00,"12,390.43","49,561.71"
19-Aug-2025,Reversal,02.99,00.00,"49,564.70"
19-Aug-2025,RTGS,"1,296,413.00",00.00,"1,345,977.70"
19-Aug-2025,NEFT,41.70,00.00,"1,346,019.40"
19-Aug-2025,Transfer,00.00,"673,009.70","673,009.70"
19-Aug-2025,Cash,31.00,00.00,"673,040.70"
19-Aug-2025,IMPS,00.00,"84,130.09","588,910.61"
19-Aug-2025,Tax,"1,502.70",00.00,"590,413.31"
19-Aug-2025,Tax,00.00,"65,601.48","524,811.83"
19-Aug-2025,Miscellaneous,00.00,"262,405.92","262,405.91"
19-Aug-2025,Reversal,02.00,00.00,"262,407.91"
19-Aug-2025,Commission,00.00,"37,486.84","224,921.07"
19-Aug-2025,NEFT,00.00,"56,230.27","168,690.80"
19-Aug-2025,Debit Card,"3,907.20",00.00,"172,598.00"
19-Aug-2025,Commission,00.00,"57,532.67","115,065.33"
19-Aug-2025,ATM,00.00,"12,785.04","102,280.29"
19-Aug-2025,NEFT,"14,620.99",00.00,"116,901.28"
19-Aug-2025,Cash,"963,199.25",00.00,"1,080,100.53"
19-Aug-2025,Commission,42.85,00.00,"1,080,143.38"
19-Aug-2025,Interest,00.00,"540,071.69","540,071.69"
19-Aug-2025,Interest,00.00,"77,153.10","462,918.59"
19-Aug-2025,Tax,00.00,"51,435.40","411,483.19"
19-Aug-2025,Bill,07.63,00.00,"411,490.82"
20-Aug-2025,RTGS,"6,831.00",00.00,"418,321.82"
20-Aug-2025,Purchase,00.00,"52,290.23","366,031.59"
20-Aug-2025,Purchase,32.10,00.00,"366,063.69"
20-Aug-2025,Tax,"1,098,047.00",00.00,"1,464,110.69"
20-Aug-2025,Cheque,21.00,00.00,"1,464,131.69"
20-Aug-2025,Cheque,"6,404.26",00.00,"1,470,535.95"
20-Aug-2025,Cheque,00.00,"735,267.98","735,267.98"
20-Aug-2025,Interest,00.00,"245,089.33","490,178.65"
20-Aug-2025,NEFT,00.00,"163,392.88","326,785.77"
20-Aug-2025,Interest,00.00,"54,464.30","272,321.48"
20-Aug-2025,Miscellaneous,00.00,"30,257.94","242,063.54"
20-Aug-2025,Cheque,00.00,"24,206.35","217,857.19"
20-Aug-2025,IMPS,"15,549.40",00.00,"233,406.59"
20-Aug-2025,ATM,00.00,"77,802.20","155,604.39"
20-Aug-2025,RTGS,"3,841.00",00.00,"159,445.39"
20-Aug-2025,IMPS,"206,328.00",00.00,"365,773.39"
20-Aug-2025,Bill,00.00,"40,641.49","325,131.90"
20-Aug-2025,IMPS,"26,446.00",00.00,"351,577.90"
20-Aug-2025,RTGS,00.00,"175,788.95","175,788.95"
20-Aug-2025,Commission,"27,045.00",00.00,"202,833.95"
20-Aug-2025,Cheque,01.20,00.00,"202,835.15"
20-Aug-2025,IMPS,30.24,00.00,"202,865.39"
20-Aug-2025,IMPS,00.00,"33,810.90","169,054.49"
20-Aug-2025,Miscellaneous,00.00,"28,175.75","140,878.74"
20-Aug-2025,Interest,"1,250.00",00.00,"142,128.74"
20-Aug-2025,NEFT,"23,378.40",00.00,"165,507.14"
20-Aug-2025,ATM,"134,723.00",00.00,"300,230.14"
20-Aug-2025,Transfer,00.00,"42,890.02","257,340.12"
20-Aug-2025,Debit Card,771.70,00.00,"258,111.82"
20-Aug-2025,Commission,00.00,"36,873.12","221,238.70"
20-Aug-2025,Cash,00.00,"27,654.84","193,583.86"
21-Aug-2025,IMPS,00.00,"27,654.84","165,929.02"
21-Aug-2025,Debit Card,00.00,"16,592.90","149,336.12"
21-Aug-2025,RTGS,00.00,"18,667.02","130,669.10"
21-Aug-2025,IMPS,"48,775.70",00.00,"179,444.80"
21-Aug-2025,Transfer,00.00,"44,861.20","134,583.60"
21-Aug-2025,Commission,338.90,00.00,"134,922.50"
21-Aug-2025,IMPS,00.00,"134,922.50",00.00
21-Aug-2025,Bill,"646,464.25",00.00,"646,464.25"
22-Aug-2025,Cash,03.72,00.00,"646,467.97"
22-Aug-2025,Bill,04.70,00.00,"646,472.67"
22-Aug-2025,NEFT,365.10,00.00,"646,837.77"
22-Aug-2025,Bill,"2,744.44",00.00,"649,582.21"
22-Aug-2025,RTGS,02.37,00.00,"649,584.58"
22-Aug-2025,IMPS,07.00,00.00,"649,591.58"
22-Aug-2025,Commission,00.00,"72,176.84","577,414.74"
22-Aug-2025,Debit Card,"13,292.60",00.00,"590,707.34"
22-Aug-2025,RTGS,00.00,"73,838.42","516,868.92"
22-Aug-2025,Debit Card,00.00,"516,868.92",00.00
22-Aug-2025,NEFT,"16,955.00",00.00,"16,955.00"
22-Aug-2025,Interest,00.00,"2,119.38","14,835.62"
22-Aug-2025,NEFT,359.19,00.00,"15,194.81"
22-Aug-2025,Cash,00.00,"3,038.96","12,155.85"
22-Aug-2025,RTGS,44.05,00.00,"12,199.90"
22-Aug-2025,Cash,00.00,"2,439.98","9,759.92"
22-Aug-2025,Miscellaneous,"865,038.00",00.00,"874,797.92"
22-Aug-2025,Miscellaneous,00.00,"124,971.13","749,826.79"
22-Aug-2025,Debit Card,"13,607.70",00.00,"763,434.49"
22-Aug-2025,Reversal,00.00,"190,858.62","572,575.87"
22-Aug-2025,Cash,00.00,"286,287.94","286,287.94"
22-Aug-2025,Miscellaneous,"398,716.80",00.00,"685,004.74"
22-Aug-2025,Bill,00.00,"137,000.95","548,003.79"
22-Aug-2025,Debit Card,"13,938.20",00.00,"561,941.99"
22-Aug-2025,Bill,"19,280.10",00.00,"581,222.09"
22-Aug-2025,Tax,52.00,00.00,"581,274.09"
22-Aug-2025,Transfer,00.00,"64,586.01","516,688.08"
22-Aug-2025,NEFT,00.00,"57,409.79","459,278.29"
22-Aug-2025,NEFT,"1,670.50",00.00,"460,948.79"
22-Aug-2025,Transfer,00.00,"230,474.40","230,474.40"
22-Aug-2025,Transfer,"659,904.50",00.00,"890,378.90"
22-Aug-2025,IMPS,00.00,"890,378.90",00.00
22-Aug-2025,Cash,45.20,00.00,45.20
22-Aug-2025,Transfer,00.00,22.60,22.60
22-Aug-2025,ATM,00.00,03.23,19.37
22-Aug-2025,Purchase,00.00,02.42,16.95
22-Aug-2025,Purchase,279.00,00.00,295.95
22-Aug-2025,Cheque,"2,726.00",00.00,"3,021.95"
22-Aug-2025,Purchase,"2,182.50",00.00,"5,204.45"
22-Aug-2025,Debit Card,"2,637.90",00.00,"7,842.35"
22-Aug-2025,Purchase,00.00,"1,568.47","6,273.88"
22-Aug-2025,Miscellaneous,06.00,00.00,"6,279.88"
22-Aug-2025,Debit Card,00.00,784.99,"5,494.90"
22-Aug-2025,RTGS,"22,198.52",00.00,"27,693.42"
22-Aug-2025,Transfer,"3,456.43",00.00,"31,149.85"
22-Aug-2025,Tax,00.00,"7,787.46","23,362.39"
22-Aug-2025,Cash,"195,294.00",00.00,"218,656.39"
22-Aug-2025,Transfer,"58,821.00",00.00,"277,477.39"
22-Aug-2025,Purchase,00.00,"39,639.63","237,837.76"
22-Aug-2025,Interest,00.00,"33,976.82","203,860.94"
22-Aug-2025,Interest,"9,885.10",00.00,"213,746.04"
22-Aug-2025,ATM,00.00,"26,718.26","187,027.78"
22-Aug-2025,Interest,06.80,00.00,"187,034.58"
22-Aug-2025,Commission,00.00,"18,703.46","168,331.12"
22-Aug-2025,Miscellaneous,00.00,"18,703.46","149,627.66"
22-Aug-2025,Tax,"1,685.52",00.00,"151,313.18"
22-Aug-2025,Debit Card,"2,636.43",00.00,"153,949.61"
22-Aug-2025,Miscellaneous,04.00,00.00,"153,953.61"
22-Aug-2025,Miscellaneous,"3,581.00",00.00,"157,534.61"
22-Aug-2025,Transfer,"573,293.00",00.00,"730,827.61"
22-Aug-2025,ATM,00.00,"182,706.90","548,120.71"
22-Aug-2025,Purchase,35.06,00.00,"548,155.77"
22-Aug-2025,Miscellaneous,"3,371.00",00.00,"551,526.77"
22-Aug-2025,Cheque,377.22,00.00,"551,903.99"
22-Aug-2025,IMPS,"2,909.16",00.00,"554,813.15"
22-Aug-2025,NEFT,"1,617,453.75",00.00,"2,172,266.90"
22-Aug-2025,Cheque,"363,763.50",00.00,"2,536,030.40"
22-Aug-2025,RTGS,05.40,00.00,"2,536,035.80"
22-Aug-2025,Reversal,00.00,"634,008.95","1,902,026.85"
22-Aug-2025,NEFT,"2,187.00",00.00,"1,904,213.85"
22-Aug-2025,ATM,01.00,00.00,"1,904,214.85"
22-Aug-2025,IMPS,00.00,"380,842.97","1,523,371.88"
22-Aug-2025,NEFT,00.00,"253,895.31","1,269,476.57"
22-Aug-2025,Commission,00.00,"211,579.43","1,057,897.14"
22-Aug-2025,Interest,"376,201.50",00.00,"1,434,098.64"
22-Aug-2025,RTGS,"24,301.00",00.00,"1,458,399.64"
22-Aug-2025,Interest,00.00,"486,133.21","972,266.43"
22-Aug-2025,Bill,04.00,00.00,"972,270.43"
22-Aug-2025,Miscellaneous,00.00,"243,067.61","729,202.82"
22-Aug-2025,Transfer,00.00,"91,150.35","638,052.47"
22-Aug-2025,Purchase,00.00,"319,026.24","319,026.24"
22-Aug-2025,Interest,00.00,"319,026.24",00.00
22-Aug-2025,Tax,63.00,00.00,63.00
22-Aug-2025,Miscellaneous,00.00,12.60,50.40
22-Aug-2025,Commission,"17,650.00",00.00,"17,700.40"
22-Aug-2025,Purchase,"240,045.00",00.00,"257,745.40"
22-Aug-2025,Purchase,26.01,00.00,"257,771.41"
22-Aug-2025,Tax,00.00,"32,221.43","225,549.98"
22-Aug-2025,Commission,"17,174.81",00.00,"242,724.79"
22-Aug-2025,Bill,00.00,"34,674.97","208,049.82"
22-Aug-2025,Miscellaneous,00.00,"41,609.96","166,439.86"
23-Aug-2025,IMPS,00.00,"83,219.93","83,219.93"
23-Aug-2025,RTGS,00.00,"8,321.99","74,897.94"
23-Aug-2025,Cheque,00.00,"10,699.71","64,198.23"
23-Aug-2025,Interest,"1,217.20",00.00,"65,415.43"
23-Aug-2025,Cash,119.60,00.00,"65,535.03"
23-Aug-2025,Transfer,"7,429.00",00.00,"72,964.03"
23-Aug-2025,Debit Card,01.00,00.00,"72,965.03"
23-Aug-2025,Commission,08.00,00.00,"72,973.03"
23-Aug-2025,ATM,00.00,"18,243.26","54,729.77"
23-Aug-2025,IMPS,00.00,"7,818.54","46,911.23"
23-Aug-2025,Tax,"526,265.00",00.00,"573,176.23"
23-Aug-2025,Cash,"1,720.89",00.00,"574,897.12"
23-Aug-2025,Cash,00.00,"114,979.42","459,917.70"
23-Aug-2025,RTGS,"28,940.00",00.00,"488,857.70"
23-Aug-2025,Cash,00.00,"122,214.43","366,643.28"
23-Aug-2025,Reversal,00.00,"52,377.61","314,265.67"
23-Aug-2025,IMPS,343.10,00.00,"314,608.77"
23-Aug-2025,NEFT,00.00,"39,326.10","275,282.67"
23-Aug-2025,Miscellaneous,00.00,"39,326.10","235,956.57"
23-Aug-2025,Interest,03.05,00.00,"235,959.62"
23-Aug-2025,Transfer,355.71,00.00,"236,315.33"
23-Aug-2025,Tax,00.00,"47,263.07","189,052.26"
23-Aug-2025,Tax,"1,186,001.75",00.00,"1,375,054.01"
23-Aug-2025,Commission,"2,573.00",00.00,"1,377,627.01"
23-Aug-2025,Reversal,00.00,"459,209.00","918,418.01"
23-Aug-2025,IMPS,00.00,"91,841.80","826,576.21"
23-Aug-2025,Commission,"1,126,341.00",00.00,"1,952,917.21"
23-Aug-2025,Debit Card,00.00,"1,952,917.21",00.00
23-Aug-2025,Miscellaneous,"172,423.30",00.00,"172,423.30"
23-Aug-2025,NEFT,08.00,00.00,"172,431.30"
23-Aug-2025,Cash,13.00,00.00,"172,444.30"
23-Aug-2025,Commission,"1,905.00",00.00,"174,349.30"
23-Aug-2025,Cheque,00.00,"43,587.33","130,761.98"
23-Aug-2025,Miscellaneous,00.00,"130,761.98",00.00
23-Aug-2025,IMPS,"20,465.00",00.00,"20,465.00"
23-Aug-2025,NEFT,"1,995.00",00.00,"22,460.00"
23-Aug-2025,NEFT,13.31,00.00,"22,473.31"
23-Aug-2025,ATM,03.00,00.00,"22,476.31"
23-Aug-2025,Cash,501.00,00.00,"22,977.31"
23-Aug-2025,Cheque,00.00,"2,553.03","20,424.28"
23-Aug-2025,RTGS,"100,840.00",00.00,"121,264.28"
23-Aug-2025,Tax,00.00,"12,126.43","109,137.85"
23-Aug-2025,Transfer,"2,320.91",00.00,"111,458.76"
23-Aug-2025,Cheque,384.06,00.00,"111,842.82"
23-Aug-2025,Cheque,00.00,"22,368.56","89,474.26"
23-Aug-2025,Reversal,80.75,00.00,"89,555.01"
23-Aug-2025,Tax,00.00,"9,950.56","79,604.45"
23-Aug-2025,ATM,53.00,00.00,"79,657.45"
23-Aug-2025,Transfer,00.00,"26,552.48","53,104.97"
23-Aug-2025,IMPS,"72,291.00",00.00,"125,395.97"
23-Aug-2025,Cash,"151,251.00",00.00,"276,646.97"
23-Aug-2025,Tax,00.00,"55,329.39","221,317.58"
23-Aug-2025,Commission,00.00,"24,590.84","196,726.74"
23-Aug-2025,Bill,"740,974.00",00.00,"937,700.74"
23-Aug-2025,Cash,61.10,00.00,"937,761.84"
23-Aug-2025,Reversal,00.00,"156,293.64","781,468.20"
23-Aug-2025,Tax,"26,656.20",00.00,"808,124.40"
23-Aug-2025,Cheque,"1,807,385.00",00.00,"2,615,509.40"
23-Aug-2025,Cash,"1,957,341.00",00.00,"4,572,850.40"
23-Aug-2025,Purchase,"14,457.00",00.00,"4,587,307.40"
23-Aug-2025,NEFT,"2,095,314.20",00.00,"6,682,621.60"
23-Aug-2025,NEFT,00.00,"835,327.70","5,847,293.90"
23-Aug-2025,ATM,"1,697,391.75",00.00,"7,544,685.65"
23-Aug-2025,NEFT,00.00,"1,257,447.61","6,287,238.04"
23-Aug-2025,Reversal,00.00,"1,257,447.61","5,029,790.43"
23-Aug-2025,NEFT,"427,087.00",00.00,"5,456,877.43"
23-Aug-2025,Debit Card,06.00,00.00,"5,456,883.43"
23-Aug-2025,NEFT,00.00,"2,728,441.72","2,728,441.72"
23-Aug-2025,NEFT,"1,605,176.00",00.00,"4,333,617.72"
23-Aug-2025,Tax,00.00,"541,702.22","3,791,915.50"
23-Aug-2025,Commission,00.00,"3,791,915.50",00.00
23-Aug-2025,Bill,35.90,00.00,35.90
23-Aug-2025,Cheque,00.00,05.13,30.77
23-Aug-2025,Purchase,"26,976.62",00.00,"27,007.39"
23-Aug-2025,Cheque,"484,328.75",00.00,"511,336.14"
23-Aug-2025,Reversal,00.00,"51,133.61","460,202.53"
23-Aug-2025,Debit Card,00.00,"115,050.63","345,151.90"
23-Aug-2025,ATM,"4,339.00",00.00,"349,490.90"
23-Aug-2025,Debit Card,05.96,00.00,"349,496.86"
23-Aug-2025,RTGS,00.00,"58,249.48","291,247.38"
23-Aug-2025,Debit Card,"250,881.00",00.00,"542,128.38"
23-Aug-2025,Tax,00.00,"60,236.49","481,891.89"
23-Aug-2025,Interest,01.00,00.00,"481,892.89"
23-Aug-2025,Cash,194.50,00.00,"482,087.39"
23-Aug-2025,ATM,"261,392.53",00.00,"743,479.92"
23-Aug-2025,ATM,00.00,"106,211.42","637,268.50"
23-Aug-2025,Bill,00.00,"63,726.85","573,541.65"
23-Aug-2025,Bill,00.00,"81,934.52","491,607.13"
23-Aug-2025,ATM,00.00,"49,160.71","442,446.42"
23-Aug-2025,Commission,"2,087,921.00",00.00,"2,530,367.42"
23-Aug-2025,Cheque,00.00,"2,530,367.42",00.00
23-Aug-2025,Cash,"12,322.50",00.00,"12,322.50"
23-Aug-2025,NEFT,00.00,"2,464.50","9,858.00"
23-Aug-2025,Purchase,00.00,"1,408.29","8,449.71"
23-Aug-2025,Tax,00.00,"2,816.57","5,633.14"
23-Aug-2025,Debit Card,"1,140,797.50",00.00,"1,146,430.64"
23-Aug-2025,Purchase,00.00,"286,607.66","859,822.98"
23-Aug-2025,IMPS,"85,188.88",00.00,"945,011.86"
23-Aug-2025,NEFT,16.19,00.00,"945,028.05"
23-Aug-2025,RTGS,00.00,"945,028.05",00.00
23-Aug-2025,NEFT,41.98,00.00,41.98
23-Aug-2025,Debit Card,"1,442.80",00.00,"1,484.78"
23-Aug-2025,Transfer,00.00,494.93,989.85
23-Aug-2025,ATM,"26,505.30",00.00,"27,495.15"
23-Aug-2025,Tax,00.00,"3,055.02","24,440.13"
23-Aug-2025,Interest,"28,955.00",00.00,"53,395.13"
24-Aug-2025,Bill,"2,084,352.75",00.00,"2,137,747.88"
24-Aug-2025,Purchase,05.20,00.00,"2,137,753.08"
24-Aug-2025,IMPS,"2,635.40",00.00,"2,140,388.48"
24-Aug-2025,ATM,"18,262.60",00.00,"2,158,651.08"
24-Aug-2025,Interest,"223,938.47",00.00,"2,382,589.55"
24-Aug-2025,Purchase,00.00,"476,517.91","1,906,071.64"
24-Aug-2025,Purchase,00.00,"953,035.82","953,035.82"
24-Aug-2025,Cheque,61.70,00.00,"953,097.52"
25-Aug-2025,Interest,00.00,"105,899.72","847,197.80"
26-Aug-2025,Interest,"233,493.00",00.00,"1,080,690.80"
26-Aug-2025,Miscellaneous,53.50,00.00,"1,080,744.30"
26-Aug-2025,ATM,614.00,00.00,"1,081,358.30"
26-Aug-2025,Cheque,"785,433.75",00.00,"1,866,792.05"
26-Aug-2025,Commission,48.14,00.00,"1,866,840.19"
26-Aug-2025,Cheque,00.00,"466,710.05","1,400,130.14"
26-Aug-2025,NEFT,00.00,"700,065.07","700,065.07"
26-Aug-2025,Bill,05.00,00.00,"700,070.07"
27-Aug-2025,Purchase,00.00,"116,678.35","583,391.72"
27-Aug-2025,Commission,00.00,"64,821.30","518,570.42"
27-Aug-2025,Miscellaneous,"9,764.30",00.00,"528,334.72"
27-Aug-2025,Purchase,01.72,00.00,"528,336.44"
28-Aug-2025,Cheque,579.80,00.00,"528,916.24"
28-Aug-2025,Interest,"177,900.66",00.00,"706,816.90"
28-Aug-2025,Interest,"30,208.00",00.00,"737,024.90"
28-Aug-2025,IMPS,00.00,"147,404.98","589,619.92"
28-Aug-2025,Bill,00.00,"65,513.32","524,106.60"
28-Aug-2025,Reversal,00.00,"74,872.37","449,234.23"
28-Aug-2025,IMPS,00.00,"89,846.85","359,387.38"
28-Aug-2025,Reversal,00.00,"359,387.38",00.00
28-Aug-2025,Bill,"12,015.00",00.00,"12,015.00"
28-Aug-2025,Cheque,00.00,"1,716.43","10,298.57"
28-Aug-2025,Cheque,00.00,"10,298.57",00.00
28-Aug-2025,IMPS,310.01,00.00,310.01
28-Aug-2025,Reversal,02.20,00.00,312.21
28-Aug-2025,Cash,"8,349.22",00.00,"8,661.43"
28-Aug-2025,Bill,"47,824.00",00.00,"56,485.43"
28-Aug-2025,Cheque,"237,477.47",00.00,"293,962.90"
28-Aug-2025,Transfer,00.00,"58,792.58","235,170.32"
28-Aug-2025,Commission,13.45,00.00,"235,183.77"
28-Aug-2025,ATM,00.00,"117,591.89","117,591.88"
28-Aug-2025,Debit Card,"1,397,470.75",00.00,"1,515,062.63"
29-Aug-2025,Cash,00.00,"189,382.83","1,325,679.80"
30-Aug-2025,Interest,"275,892.20",00.00,"1,601,572.00"
30-Aug-2025,NEFT,"2,067.00",00.00,"1,603,639.00"
31-Aug-2025,RTGS,"236,966.22",00.00,"1,840,605.22"
31-Aug-2025,Cheque,00.00,"368,121.04","1,472,484.18"
31-Aug-2025,Debit Card,00.00,"163,609.35","1,308,874.83"
31-Aug-2025,Debit Card,07.66,00.00,"1,308,882.49"
31-Aug-2025,Interest,"1,900.10",00.00,"1,310,782.59"
31-Aug-2025,Interest,53.17,00.00,"1,310,835.76"
31-Aug-2025,Bill,00.00,"145,648.42","1,165,187.34"
31-Aug-2025,Cheque,04.40,00.00,"1,165,191.74"
31-Aug-2025,Purchase,00.00,"194,198.62","970,993.12"
31-Aug-2025,Commission,00.00,"485,496.56","485,496.56"
31-Aug-2025,IMPS,00.00,"161,832.19","323,664.37"
31-Aug-2025,NEFT,00.00,"80,916.09","242,748.28"
31-Aug-2025,ATM,37.00,00.00,"242,785.28"
31-Aug-2025,RTGS,00.00,"48,557.06","194,228.22"
31-Aug-2025,Transfer,"1,785.00",00.00,"196,013.22"
31-Aug-2025,Transfer,"1,571,682.00",00.00,"1,767,695.22"
31-Aug-2025,Cheque,00.00,"353,539.04","1,414,156.18"
31-Aug-2025,Purchase,00.00,"141,415.62","1,272,740.56"
31-Aug-2025,Transfer,00.00,"127,274.06","1,145,466.50"
31-Aug-2025,NEFT,00.00,"381,822.17","763,644.33"
31-Aug-2025,Transfer,"1,710,640.80",00.00,"2,474,285.13"
31-Aug-2025,Purchase,00.00,"274,920.57","2,199,364.56"
31-Aug-2025,Cheque,"232,444.80",00.00,"2,431,809.36"
31-Aug-2025,ATM,"1,589,080.00",00.00,"4,020,889.36"
31-Aug-2025,Transfer,"1,363,011.75",00.00,"5,383,901.11"
31-Aug-2025,Commission,00.00,"5,383,901.11",00.00
31-Aug-2025,Reversal,"1,103,049.25",00.00,"1,103,049.25"
31-Aug-2025,Reversal,36.00,00.00,"1,103,085.25"
31-Aug-2025,Tax,17.20,00.00,"1,103,102.45"
31-Aug-2025,Debit Card,05.48,00.00,"1,103,107.93"
31-Aug-2025,IMPS,00.00,"157,586.85","945,521.08"
31-Aug-2025,NEFT,00.00,"189,104.22","756,416.86"
31-Aug-2025,Tax,00.00,"189,104.22","567,312.64"
31-Aug-2025,IMPS,00.00,"81,044.66","486,267.98"
31-Aug-2025,Debit Card,00.00,"486,267.98",00.00
31-Aug-2025,NEFT,146.22,00.00,146.22
31-Aug-2025,ATM,00.00,48.74,97.48
31-Aug-2025,Tax,00.00,10.83,86.65
31-Aug-2025,Cash,"83,814.00",00.00,"83,900.65"
31-Aug-2025,Reversal,00.00,"41,950.33","41,950.32"
31-Aug-2025,Purchase,00.00,"4,661.15","37,289.17"
31-Aug-2025,ATM,00.00,"12,429.72","24,859.45"
01-Sep-2025,Transfer,00.00,"2,762.16","22,097.29"
01-Sep-2025,Interest,00.00,"2,762.16","19,335.13"
01-Sep-2025,Bill,"1,779,715.00",00.00,"1,799,050.13"
02-Sep-2025,Interest,217.00,00.00,"1,799,267.13"
02-Sep-2025,NEFT,"1,730,712.20",00.00,"3,529,979.33"
02-Sep-2025,Miscellaneous,"24,135.20",00.00,"3,554,114.53"
02-Sep-2025,Cash,00.00,"3,554,114.53",00.00
02-Sep-2025,Commission,26.30,00.00,26.30
02-Sep-2025,ATM,"796,987.25",00.00,"797,013.55"
02-Sep-2025,Transfer,00.00,"199,253.39","597,760.16"
02-Sep-2025,Cash,192.00,00.00,"597,952.16"
02-Sep-2025,Cash,"24,959.35",00.00,"622,911.51"
02-Sep-2025,Debit Card,"9,473.97",00.00,"632,385.48"
02-Sep-2025,Commission,00.00,"632,385.48",00.00
02-Sep-2025,ATM,"219,243.50",00.00,"219,243.50"
02-Sep-2025,Purchase,17.85,00.00,"219,261.35"
02-Sep-2025,Cash,"12,777.50",00.00,"232,038.85"
02-Sep-2025,Commission,36.10,00.00,"232,074.95"
02-Sep-2025,Debit Card,26.00,00.00,"232,100.95"
02-Sep-2025,Tax,00.00,"46,420.19","185,680.76"
02-Sep-2025,RTGS,00.00,"185,680.76",00.00
02-Sep-2025,Reversal,"28,754.59",00.00,"28,754.59"
02-Sep-2025,IMPS,00.00,"7,188.65","21,565.94"
02-Sep-2025,NEFT,00.00,"21,565.94",00.00
02-Sep-2025,Interest,58.00,00.00,58.00
02-Sep-2025,IMPS,00.00,06.44,51.56
02-Sep-2025,Interest,394.00,00.00,445.56
02-Sep-2025,Cheque,00.00,111.39,334.17
02-Sep-2025,Miscellaneous,455.00,00.00,789.17
02-Sep-2025,Reversal,00.00,98.65,690.52
02-Sep-2025,ATM,01.00,00.00,691.52
02-Sep-2025,Transfer,85.40,00.00,776.92
02-Sep-2025,Bill,"6,320.71",00.00,"7,097.63"
02-Sep-2025,Reversal,"2,096,519.00",00.00,"2,103,616.63"
02-Sep-2025,NEFT,275.00,00.00,"2,103,891.63"
02-Sep-2025,NEFT,00.00,"300,555.95","1,803,335.68"
02-Sep-2025,Purchase,00.00,"300,555.95","1,502,779.73"
02-Sep-2025,Reversal,"51,746.20",00.00,"1,554,525.93"
02-Sep-2025,Bill,00.00,"194,315.74","1,360,210.19"
02-Sep-2025,Cheque,00.00,"340,052.55","1,020,157.64"
02-Sep-2025,Cash,388.80,00.00,"1,020,546.44"
02-Sep-2025,Cheque,291.10,00.00,"1,020,837.54"
02-Sep-2025,NEFT,131.20,00.00,"1,020,968.74"
02-Sep-2025,Cheque,00.00,"145,852.68","875,116.06"
02-Sep-2025,IMPS,01.70,00.00,"875,117.76"
02-Sep-2025,Transfer,388.60,00.00,"875,506.36"
02-Sep-2025,Purchase,00.00,"291,835.45","583,670.91"
02-Sep-2025,Transfer,05.70,00.00,"583,676.61"
02-Sep-2025,Debit Card,00.00,"145,919.15","437,757.46"
02-Sep-2025,Commission,"1,442.72",00.00,"439,200.18"
02-Sep-2025,ATM,00.00,"48,800.02","390,400.16"
02-Sep-2025,Commission,00.00,"43,377.80","347,022.36"
02-Sep-2025,Miscellaneous,"1,098.74",00.00,"348,121.10"
03-Sep-2025,Commission,00.00,"87,030.28","261,090.82"
03-Sep-2025,ATM,"202,255.00",00.00,"463,345.82"
03-Sep-2025,Purchase,00.00,"115,836.46","347,509.36"
03-Sep-2025,Commission,00.00,"347,509.36",00.00
03-Sep-2025,Debit Card,"101,221.00",00.00,"101,221.00"
03-Sep-2025,Cheque,00.00,"12,652.63","88,568.38"
03-Sep-2025,Commission,922.18,00.00,"89,490.56"
03-Sep-2025,Transfer,180.80,00.00,"89,671.36"
03-Sep-2025,Transfer,"576,628.00",00.00,"666,299.36"
03-Sep-2025,NEFT,00.00,"74,033.26","592,266.10"
03-Sep-2025,Reversal,00.00,"74,033.26","518,232.84"
03-Sep-2025,Interest,00.61,00.00,"518,233.45"
03-Sep-2025,Cash,"2,025,311.00",00.00,"2,543,544.45"
03-Sep-2025,Transfer,00.00,"282,616.05","2,260,928.40"
03-Sep-2025,Tax,00.00,"251,214.27","2,009,714.13"
03-Sep-2025,Cash,00.00,"502,428.53","1,507,285.60"
03-Sep-2025,Purchase,"3,340.00",00.00,"1,510,625.60"
03-Sep-2025,Cash,00.00,"755,312.80","755,312.80"
03-Sep-2025,Debit Card,00.00,"107,901.83","647,410.97"
03-Sep-2025,RTGS,"26,722.00",00.00,"674,132.97"
03-Sep-2025,NEFT,549.00,00.00,"674,681.97"
03-Sep-2025,NEFT,"1,128,568.80",00.00,"1,803,250.77"
03-Sep-2025,RTGS,00.00,"901,625.39","901,625.38"
03-Sep-2025,RTGS,"13,286.72",00.00,"914,912.10"
03-Sep-2025,Tax,05.48,00.00,"914,917.58"
03-Sep-2025,Bill,274.60,00.00,"915,192.18"
03-Sep-2025,Miscellaneous,00.00,"457,596.09","457,596.09"
03-Sep-2025,Reversal,"55,218.00",00.00,"512,814.09"
03-Sep-2025,Purchase,00.00,"256,407.05","256,407.04"
03-Sep-2025,Tax,00.00,"85,469.01","170,938.03"
03-Sep-2025,NEFT,36.00,00.00,"170,974.03"
03-Sep-2025,Purchase,459.00,00.00,"171,433.03"
03-Sep-2025,Reversal,"26,249.34",00.00,"197,682.37"
03-Sep-2025,Debit Card,00.00,"49,420.59","148,261.78"
03-Sep-2025,Cheque,00.00,"37,065.45","111,196.34"
03-Sep-2025,Transfer,00.00,"37,065.45","74,130.89"
03-Sep-2025,Cash,42.10,00.00,"74,172.99"
03-Sep-2025,Transfer,00.00,"7,417.30","66,755.69"
03-Sep-2025,RTGS,40.90,00.00,"66,796.59"
03-Sep-2025,IMPS,"1,896.49",00.00,"68,693.08"
04-Sep-2025,Miscellaneous,170.10,00.00,"68,863.18"
04-Sep-2025,Purchase,"238,467.00",00.00,"307,330.18"
04-Sep-2025,Purchase,363.77,00.00,"307,693.95"
04-Sep-2025,ATM,00.00,"307,693.95",00.00
04-Sep-2025,Cheque,"11,492.86",00.00,"11,492.86"
04-Sep-2025,Cash,00.00,"1,641.84","9,851.02"
04-Sep-2025,Commission,00.00,"1,231.38","8,619.64"
04-Sep-2025,Commission,"32,498.00",00.00,"41,117.64"
04-Sep-2025,Interest,00.00,"5,873.95","35,243.69"
04-Sep-2025,Purchase,00.00,"35,243.69",00.00
04-Sep-2025,Interest,00.00,00.00,00.00
04-Sep-2025,Transfer,"1,222.00",00.00,"1,222.00"
04-Sep-2025,IMPS,"79,549.60",00.00,"80,771.60"
04-Sep-2025,IMPS,"21,066.26",00.00,"101,837.86"
04-Sep-2025,ATM,09.43,00.00,"101,847.29"
05-Sep-2025,ATM,39.64,00.00,"101,886.93"
05-Sep-2025,Purchase,00.00,"16,981.16","84,905.78"
05-Sep-2025,ATM,282.00,00.00,"85,187.78"
05-Sep-2025,Debit Card,00.00,"21,296.95","63,890.84"
05-Sep-2025,IMPS,00.00,"9,127.26","54,763.58"
05-Sep-2025,Reversal,"3,316.57",00.00,"58,080.15"
05-Sep-2025,IMPS,"17,629.36",00.00,"75,709.51"
05-Sep-2025,Commission,00.00,"18,927.38","56,782.13"
05-Sep-2025,Reversal,06.00,00.00,"56,788.13"
05-Sep-2025,Reversal,00.00,"6,309.79","50,478.34"
05-Sep-2025,Interest,06.00,00.00,"50,484.34"
05-Sep-2025,RTGS,"3,005.00",00.00,"53,489.34"
05-Sep-2025,Debit Card,00.00,"26,744.67","26,744.67"
05-Sep-2025,Reversal,00.00,"5,348.93","21,395.74"
05-Sep-2025,NEFT,00.00,"10,697.87","10,697.87"
05-Sep-2025,Miscellaneous,"2,921.00",00.00,"13,618.87"
05-Sep-2025,Bill,00.00,"1,361.89","12,256.98"
06-Sep-2025,Cash,"187,332.00",00.00,"199,588.98"
06-Sep-2025,Interest,25.95,00.00,"199,614.93"
06-Sep-2025,Reversal,405.00,00.00,"200,019.93"
06-Sep-2025,Commission,"231,669.00",00.00,"431,688.93"
06-Sep-2025,Tax,00.00,"43,168.89","388,520.04"
06-Sep-2025,Cash,00.00,"64,753.34","323,766.70"
06-Sep-2025,Cash,00.00,"161,883.35","161,883.35"
06-Sep-2025,IMPS,"55,903.00",00.00,"217,786.35"
06-Sep-2025,Debit Card,"2,414.80",00.00,"220,201.15"
06-Sep-2025,Reversal,00.00,"110,100.58","110,100.58"
06-Sep-2025,Tax,13.70,00.00,"110,114.28"
06-Sep-2025,Reversal,"3,923.80",00.00,"114,038.08"
06-Sep-2025,Miscellaneous,21.00,00.00,"114,059.08"
06-Sep-2025,Cheque,00.00,"114,059.08",00.00
06-Sep-2025,Cheque,"117,046.00",00.00,"117,046.00"
06-Sep-2025,NEFT,00.00,"16,720.86","100,325.14"
06-Sep-2025,IMPS,00.00,"50,162.57","50,162.57"
06-Sep-2025,Debit Card,00.00,00.00,"50,162.57"
06-Sep-2025,NEFT,00.00,"5,016.26","45,146.31"
06-Sep-2025,ATM,"128,024.00",00.00,"173,170.31"
06-Sep-2025,Cash,"256,735.40",00.00,"429,905.71"
06-Sep-2025,Commission,"1,313.70",00.00,"431,219.41"
06-Sep-2025,Debit Card,00.00,"431,219.41",00.00
06-Sep-2025,Commission,"17,269.07",00.00,"17,269.07"
07-Sep-2025,RTGS,"1,128.00",00.00,"18,397.07"
07-Sep-2025,Reversal,00.00,"2,044.12","16,352.95"
07-Sep-2025,Purchase,00.00,"4,088.24","12,264.71"
07-Sep-2025,Miscellaneous,"187,020.91",00.00,"199,285.62"
07-Sep-2025,IMPS,00.00,"49,821.41","149,464.22"
07-Sep-2025,Tax,04.00,00.00,"149,468.22"
07-Sep-2025,Miscellaneous,00.00,"16,607.58","132,860.64"
07-Sep-2025,Tax,39.60,00.00,"132,900.24"
07-Sep-2025,ATM,00.00,"66,450.12","66,450.12"
08-Sep-2025,Bill,00.00,"66,450.12",00.00
08-Sep-2025,Bill,"194,655.69",00.00,"194,655.69"
08-Sep-2025,ATM,"3,665.28",00.00,"198,320.97"
08-Sep-2025,Miscellaneous,"791,783.00",00.00,"990,103.97"
08-Sep-2025,Tax,00.00,"247,525.99","742,577.98"
08-Sep-2025,ATM,00.00,"92,822.25","649,755.73"
08-Sep-2025,Reversal,00.00,"81,219.47","568,536.26"
08-Sep-2025,Purchase,00.00,"189,512.09","379,024.17"
08-Sep-2025,Transfer,00.00,"94,756.04","284,268.13"
08-Sep-2025,Bill,00.00,"28,426.81","255,841.32"
08-Sep-2025,Commission,00.00,"42,640.22","213,201.10"
08-Sep-2025,Reversal,00.00,"21,320.11","191,880.99"
08-Sep-2025,ATM,41.49,00.00,"191,922.48"
08-Sep-2025,Reversal,00.00,"191,922.48",00.00
08-Sep-2025,RTGS,55.72,00.00,55.72
08-Sep-2025,Commission,670.00,00.00,725.72
08-Sep-2025,Debit Card,"21,435.31",00.00,"22,161.03"
08-Sep-2025,Debit Card,"3,707.00",00.00,"25,868.03"
08-Sep-2025,Cash,00.00,"5,173.61","20,694.42"
08-Sep-2025,Transfer,"1,814.40",00.00,"22,508.82"
08-Sep-2025,Transfer,"102,128.84",00.00,"124,637.66"
08-Sep-2025,Cheque,00.00,"41,545.89","83,091.77"
08-Sep-2025,Cheque,120.00,00.00,"83,211.77"
08-Sep-2025,Cash,00.00,"9,245.75","73,966.02"
08-Sep-2025,NEFT,00.00,"24,655.34","49,310.68"
08-Sep-2025,Cheque,00.00,"5,478.96","43,831.72"
08-Sep-2025,Cheque,00.00,"7,305.29","36,526.43"
08-Sep-2025,RTGS,"1,493.30",00.00,"38,019.73"
08-Sep-2025,Reversal,"1,825.40",00.00,"39,845.13"
08-Sep-2025,ATM,"658,874.50",00.00,"698,719.63"
08-Sep-2025,NEFT,00.00,"349,359.82","349,359.82"
08-Sep-2025,Transfer,00.00,"69,871.96","279,487.86"
08-Sep-2025,Reversal,34.20,00.00,"279,522.06"
08-Sep-2025,IMPS,00.00,"69,880.52","209,641.54"
08-Sep-2025,NEFT,"353,317.25",00.00,"562,958.79"
08-Sep-2025,Purchase,"136,151.88",00.00,"699,110.67"
08-Sep-2025,Miscellaneous,"29,186.30",00.00,"728,296.97"
08-Sep-2025,Miscellaneous,"84,178.10",00.00,"812,475.07"
08-Sep-2025,Cheque,"1,660.08",00.00,"814,135.15"
08-Sep-2025,Interest,"869,194.00",00.00,"1,683,329.15"
08-Sep-2025,Interest,111.52,00.00,"1,683,440.67"
08-Sep-2025,IMPS,00.00,"168,344.07","1,515,096.60"
08-Sep-2025,RTGS,"3,307.00",00.00,"1,518,403.60"
08-Sep-2025,Miscellaneous,"1,993,077.00",00.00,"3,511,480.60"
08-Sep-2025,Bill,"12,827.09",00.00,"3,524,307.69"
08-Sep-2025,NEFT,"163,261.00",00.00,"3,687,568.69"
08-Sep-2025,Bill,"3,622.00",00.00,"3,691,190.69"
08-Sep-2025,Interest,00.00,"922,797.67","2,768,393.02"
08-Sep-2025,Reversal,00.00,"922,797.67","1,845,595.35"
08-Sep-2025,Purchase,00.00,"205,066.15","1,640,529.20"
08-Sep-2025,RTGS,"7,312.00",00.00,"1,647,841.20"
08-Sep-2025,Cash,00.00,"164,784.12","1,483,057.08"
08-Sep-2025,Purchase,"2,025.81",00.00,"1,485,082.89"
08-Sep-2025,NEFT,"27,022.90",00.00,"1,512,105.79"
08-Sep-2025,Cash,00.00,"151,210.58","1,360,895.21"
08-Sep-2025,RTGS,00.00,"340,223.80","1,020,671.41"
08-Sep-2025,Bill,00.00,"113,407.93","907,263.48"
08-Sep-2025,Interest,"2,984.40",00.00,"910,247.88"
08-Sep-2025,RTGS,218.70,00.00,"910,466.58"
08-Sep-2025,Cheque,00.50,00.00,"910,467.08"
08-Sep-2025,Bill,00.00,"910,467.08",00.00
08-Sep-2025,RTGS,"1,640,466.00",00.00,"1,640,466.00"
08-Sep-2025,Cheque,23.00,00.00,"1,640,489.00"
08-Sep-2025,Tax,"656,556.00",00.00,"2,297,045.00"
08-Sep-2025,IMPS,03.00,00.00,"2,297,048.00"
08-Sep-2025,Transfer,00.00,"765,682.67","1,531,365.33"
08-Sep-2025,Tax,"1,428,925.00",00.00,"2,960,290.33"
08-Sep-2025,IMPS,328.30,00.00,"2,960,618.63"
08-Sep-2025,Miscellaneous,"1,667,242.75",00.00,"4,627,861.38"
08-Sep-2025,Cash,"2,461.00",00.00,"4,630,322.38"
08-Sep-2025,Tax,00.00,"514,480.26","4,115,842.12"
08-Sep-2025,Cash,06.80,00.00,"4,115,848.92"
08-Sep-2025,Reversal,00.00,"587,978.42","3,527,870.50"
08-Sep-2025,Bill,00.00,"3,527,870.50",00.00
08-Sep-2025,Tax,"1,043,043.20",00.00,"1,043,043.20"
08-Sep-2025,Commission,00.00,"1,043,043.20",00.00
08-Sep-2025,Miscellaneous,24.70,00.00,24.70
08-Sep-2025,Cheque,00.00,03.53,21.17
08-Sep-2025,IMPS,00.00,03.02,18.15
08-Sep-2025,Commission,00.00,03.03,15.12
08-Sep-2025,NEFT,00.00,02.52,12.60
08-Sep-2025,Debit Card,"127,115.19",00.00,"127,127.79"
08-Sep-2025,IMPS,"1,335,689.20",00.00,"1,462,816.99"
08-Sep-2025,NEFT,129.00,00.00,"1,462,945.99"
08-Sep-2025,NEFT,00.00,"365,736.50","1,097,209.49"
08-Sep-2025,Bill,04.00,00.00,"1,097,213.49"
08-Sep-2025,Purchase,00.00,"548,606.75","548,606.74"
08-Sep-2025,Cash,03.16,00.00,"548,609.90"
08-Sep-2025,Tax,00.00,"182,869.97","365,739.93"
08-Sep-2025,IMPS,"24,445.74",00.00,"390,185.67"
08-Sep-2025,Interest,00.00,"195,092.84","195,092.84"
08-Sep-2025,Miscellaneous,00.00,"65,030.95","130,061.89"
08-Sep-2025,Interest,"165,599.60",00.00,"295,661.49"
08-Sep-2025,RTGS,00.00,"295,661.49",00.00
08-Sep-2025,Miscellaneous,60.50,00.00,60.50
08-Sep-2025,Miscellaneous,"2,033.00",00.00,"2,093.50"
08-Sep-2025,Interest,00.00,697.83,"1,395.67"
09-Sep-2025,NEFT,00.00,348.92,"1,046.75"
09-Sep-2025,Debit Card,94.00,00.00,"1,140.75"
09-Sep-2025,Cheque,"212,301.90",00.00,"213,442.65"
09-Sep-2025,Purchase,06.88,00.00,"213,449.53"
09-Sep-2025,NEFT,02.77,00.00,"213,452.30"
09-Sep-2025,Purchase,"3,807.00",00.00,"217,259.30"
09-Sep-2025,IMPS,"1,188.50",00.00,"218,447.80"
09-Sep-2025,Debit Card,"79,186.70",00.00,"297,634.50"
09-Sep-2025,ATM,62.10,00.00,"297,696.60"
09-Sep-2025,Debit Card,"1,491.00",00.00,"299,187.60"
09-Sep-2025,NEFT,00.00,"29,918.76","269,268.84"
09-Sep-2025,Transfer,00.00,"67,317.21","201,951.63"
09-Sep-2025,Transfer,00.00,"22,439.07","179,512.56"
09-Sep-2025,RTGS,00.00,"59,837.52","119,675.04"
09-Sep-2025,Reversal,00.00,"23,935.01","95,740.03"
09-Sep-2025,Reversal,00.00,"31,913.34","63,826.69"
09-Sep-2025,Interest,00.00,"9,118.10","54,708.59"
09-Sep-2025,Tax,212.00,00.00,"54,920.59"
09-Sep-2025,RTGS,06.20,00.00,"54,926.79"
09-Sep-2025,Reversal,"1,704,910.80",00.00,"1,759,837.59"
09-Sep-2025,Interest,00.00,"1,759,837.59",00.00
10-Sep-2025,ATM,145.48,00.00,145.48
10-Sep-2025,Transfer,00.00,16.16,129.32
10-Sep-2025,NEFT,02.70,00.00,132.02
10-Sep-2025,Bill,"153,497.00",00.00,"153,629.02"
10-Sep-2025,Bill,00.00,"38,407.26","115,221.76"
10-Sep-2025,Interest,"2,677.00",00.00,"117,898.76"
10-Sep-2025,Miscellaneous,59.90,00.00,"117,958.66"
10-Sep-2025,Transfer,"26,323.04",00.00,"144,281.70"
10-Sep-2025,Purchase,00.00,"20,611.67","123,670.03"
10-Sep-2025,RTGS,"3,091.00",00.00,"126,761.03"
10-Sep-2025,Commission,00.00,"126,761.03",00.00
10-Sep-2025,Reversal,17.40,00.00,17.40
10-Sep-2025,RTGS,"111,390.00",00.00,"111,407.40"
10-Sep-2025,Cash,00.00,"22,281.48","89,125.92"
10-Sep-2025,IMPS,00.00,"9,902.88","79,223.04"
10-Sep-2025,Cash,02.50,00.00,"79,225.54"
10-Sep-2025,NEFT,00.00,"19,806.39","59,419.16"
10-Sep-2025,ATM,03.98,00.00,"59,423.14"
10-Sep-2025,ATM,00.00,"5,942.31","53,480.83"
10-Sep-2025,Commission,00.00,"10,696.17","42,784.66"
10-Sep-2025,Tax,00.00,"21,392.33","21,392.33"
10-Sep-2025,Debit Card,00.00,"3,565.39","17,826.94"
11-Sep-2025,Purchase,06.70,00.00,"17,833.64"
11-Sep-2025,Commission,06.99,00.00,"17,840.63"
11-Sep-2025,Interest,"10,935.35",00.00,"28,775.98"
11-Sep-2025,Purchase,00.00,"3,597.00","25,178.98"
11-Sep-2025,Purchase,"5,612.80",00.00,"30,791.78"
11-Sep-2025,Transfer,00.42,00.00,"30,792.20"
11-Sep-2025,ATM,"80,535.16",00.00,"111,327.36"
11-Sep-2025,Tax,15.16,00.00,"111,342.52"
11-Sep-2025,Debit Card,04.20,00.00,"111,346.72"
11-Sep-2025,RTGS,00.00,"55,673.36","55,673.36"
11-Sep-2025,NEFT,485.00,00.00,"56,158.36"
11-Sep-2025,Miscellaneous,00.00,"11,231.67","44,926.69"
11-Sep-2025,Cheque,00.00,"5,615.84","39,310.85"
11-Sep-2025,NEFT,00.00,"9,827.71","29,483.14"
11-Sep-2025,Miscellaneous,00.00,"3,275.90","26,207.24"
11-Sep-2025,NEFT,00.00,"26,207.24",00.00
11-Sep-2025,Miscellaneous,06.00,00.00,06.00
11-Sep-2025,Commission,"1,795,866.00",00.00,"1,795,872.00"
11-Sep-2025,Bill,"80,420.30",00.00,"1,876,292.30"
11-Sep-2025,Transfer,06.71,00.00,"1,876,299.01"
11-Sep-2025,NEFT,00.00,"469,074.75","1,407,224.26"
11-Sep-2025,Purchase,00.00,"156,358.25","1,250,866.01"
11-Sep-2025,Cash,00.00,"625,433.01","625,433.00"
11-Sep-2025,Debit Card,00.00,"78,179.13","547,253.88"
11-Sep-2025,ATM,243.10,00.00,"547,496.98"
11-Sep-2025,Cash,00.00,"182,498.99","364,997.99"
11-Sep-2025,Interest,"205,905.00",00.00,"570,902.99"
11-Sep-2025,Reversal,887.30,00.00,"571,790.29"
11-Sep-2025,Miscellaneous,"851,142.00",00.00,"1,422,932.29"
11-Sep-2025,NEFT,00.00,"474,310.76","948,621.53"
11-Sep-2025,Transfer,"164,517.40",00.00,"1,113,138.93"
11-Sep-2025,Transfer,00.00,"222,627.79","890,511.14"
11-Sep-2025,NEFT,00.00,"445,255.57","445,255.57"
11-Sep-2025,NEFT,"1,251,142.50",00.00,"1,696,398.07"
11-Sep-2025,Reversal,00.00,"242,342.58","1,454,055.49"
11-Sep-2025,Tax,"9,794.50",00.00,"1,463,849.99"
11-Sep-2025,Cheque,00.00,"1,463,849.99",00.00
11-Sep-2025,Commission,"960,097.50",00.00,"960,097.50"
11-Sep-2025,Tax,"133,713.00",00.00,"1,093,810.50"
11-Sep-2025,Tax,26.90,00.00,"1,093,837.40"
11-Sep-2025,Interest,00.00,"364,612.47","729,224.93"
11-Sep-2025,Purchase,00.00,"121,537.49","607,687.44"
11-Sep-2025,IMPS,"107,674.53",00.00,"715,361.97"
11-Sep-2025,Miscellaneous,00.00,"715,361.97",00.00
11-Sep-2025,Reversal,"12,713.30",00.00,"12,713.30"
11-Sep-2025,Debit Card,00.00,"1,412.59","11,300.71"
12-Sep-2025,RTGS,"1,948.98",00.00,"13,249.69"
12-Sep-2025,NEFT,00.00,"6,624.85","6,624.84"
12-Sep-2025,Purchase,46.00,00.00,"6,670.84"
12-Sep-2025,Bill,"1,966,450.50",00.00,"1,973,121.34"
12-Sep-2025,Transfer,00.00,"328,853.56","1,644,267.78"
12-Sep-2025,Cash,"130,305.50",00.00,"1,774,573.28"
12-Sep-2025,Miscellaneous,"1,938,647.75",00.00,"3,713,221.03"
12-Sep-2025,Debit Card,49.18,00.00,"3,713,270.21"
12-Sep-2025,Tax,"263,197.20",00.00,"3,976,467.41"
12-Sep-2025,Cheque,04.10,00.00,"3,976,471.51"
13-Sep-2025,Commission,00.00,"662,745.25","3,313,726.26"
13-Sep-2025,ATM,56.00,00.00,"3,313,782.26"
13-Sep-2025,Tax,"2,884.50",00.00,"3,316,666.76"
13-Sep-2025,Transfer,00.00,"1,658,333.38","1,658,333.38"
13-Sep-2025,Transfer,00.00,"414,583.35","1,243,750.03"
13-Sep-2025,ATM,00.00,"1,243,750.03",00.00
13-Sep-2025,Reversal,"137,496.40",00.00,"137,496.40"
13-Sep-2025,Commission,00.00,"27,499.28","109,997.12"
13-Sep-2025,Miscellaneous,00.00,"109,997.12",00.00
13-Sep-2025,Debit Card,"2,963.00",00.00,"2,963.00"
13-Sep-2025,Bill,00.00,"2,963.00",00.00
13-Sep-2025,Transfer,"3,181.00",00.00,"3,181.00"
13-Sep-2025,Cheque,00.00,530.17,"2,650.83"
13-Sep-2025,Reversal,00.00,378.69,"2,272.14"
13-Sep-2025,Miscellaneous,"1,779.96",00.00,"4,052.10"
13-Sep-2025,ATM,03.18,00.00,"4,055.28"
13-Sep-2025,Purchase,00.00,450.59,"3,604.69"
13-Sep-2025,Tax,39.80,00.00,"3,644.49"
13-Sep-2025,NEFT,00.00,364.45,"3,280.04"
13-Sep-2025,Reversal,01.18,00.00,"3,281.22"
13-Sep-2025,Cash,"3,505.70",00.00,"6,786.92"
13-Sep-2025,Reversal,05.69,00.00,"6,792.61"
13-Sep-2025,Reversal,00.00,754.73,"6,037.88"
13-Sep-2025,RTGS,00.00,754.74,"5,283.14"
13-Sep-2025,RTGS,351.96,00.00,"5,635.10"
13-Sep-2025,ATM,00.00,704.39,"4,930.71"
13-Sep-2025,IMPS,"65,610.00",00.00,"70,540.71"
13-Sep-2025,Cash,246.31,00.00,"70,787.02"
13-Sep-2025,Purchase,00.00,"10,112.43","60,674.59"
13-Sep-2025,IMPS,52.80,00.00,"60,727.39"
13-Sep-2025,Cheque,05.42,00.00,"60,732.81"
13-Sep-2025,Reversal,00.00,"12,146.56","48,586.25"
13-Sep-2025,Miscellaneous,375.60,00.00,"48,961.85"
13-Sep-2025,Cash,"32,354.50",00.00,"81,316.35"
13-Sep-2025,Interest,00.00,"8,131.64","73,184.72"
14-Sep-2025,Cash,"50,827.00",00.00,"124,011.72"
15-Sep-2025,ATM,00.00,"20,668.62","103,343.10"
15-Sep-2025,RTGS,348.41,00.00,"103,691.51"
15-Sep-2025,Transfer,"1,254,491.00",00.00,"1,358,182.51"
15-Sep-2025,Debit Card,"1,508.00",00.00,"1,359,690.51"
15-Sep-2025,IMPS,00.00,"453,230.17","906,460.34"
15-Sep-2025,Debit Card,00.00,"906,460.34",00.00
15-Sep-2025,Interest,"456,606.25",00.00,"456,606.25"
15-Sep-2025,NEFT,00.00,"45,660.63","410,945.62"
15-Sep-2025,Cash,00.00,"68,490.94","342,454.68"
15-Sep-2025,Reversal,"1,058.53",00.00,"343,513.21"
15-Sep-2025,Bill,00.00,"171,756.61","171,756.60"
15-Sep-2025,Transfer,00.00,"17,175.66","154,580.94"
15-Sep-2025,ATM,"3,618.10",00.00,"158,199.04"
15-Sep-2025,Bill,00.00,"31,639.81","126,559.23"
15-Sep-2025,Interest,00.00,"31,639.81","94,919.42"
15-Sep-2025,RTGS,00.00,"13,559.92","81,359.50"
15-Sep-2025,RTGS,61.00,00.00,"81,420.50"
15-Sep-2025,IMPS,00.00,"10,177.56","71,242.94"
15-Sep-2025,Miscellaneous,00.00,"7,915.88","63,327.06"
15-Sep-2025,Bill,"20,069.77",00.00,"83,396.83"
15-Sep-2025,Purchase,00.00,"20,849.21","62,547.62"
15-Sep-2025,NEFT,00.00,"31,273.81","31,273.81"
15-Sep-2025,Cash,00.00,"31,273.81",00.00
15-Sep-2025,Tax,"2,212.90",00.00,"2,212.90"
15-Sep-2025,Commission,52.19,00.00,"2,265.09"
15-Sep-2025,Reversal,00.00,283.14,"1,981.95"
15-Sep-2025,NEFT,00.00,247.74,"1,734.21"
15-Sep-2025,IMPS,00.00,578.07,"1,156.14"
15-Sep-2025,Cash,00.00,128.46,"1,027.68"
15-Sep-2025,Interest,"10,227.88",00.00,"11,255.56"
15-Sep-2025,Commission,00.00,"5,627.78","5,627.78"
15-Sep-2025,Commission,00.00,562.78,"5,065.00"
15-Sep-2025,NEFT,370.25,00.00,"5,435.25"
15-Sep-2025,Interest,"231,162.40",00.00,"236,597.65"
15-Sep-2025,ATM,38.31,00.00,"236,635.96"
15-Sep-2025,Commission,00.00,"26,292.88","210,343.08"
15-Sep-2025,ATM,00.00,"30,049.01","180,294.07"
15-Sep-2025,Transfer,00.00,"90,147.04","90,147.04"
15-Sep-2025,Transfer,"232,454.78",00.00,"322,601.82"
15-Sep-2025,NEFT,00.00,"53,766.97","268,834.85"
16-Sep-2025,Commission,06.10,00.00,"268,840.95"
16-Sep-2025,Bill,"40,461.00",00.00,"309,301.95"
16-Sep-2025,Purchase,00.00,"309,301.95",00.00
16-Sep-2025,Commission,"192,370.40",00.00,"192,370.40"
16-Sep-2025,Purchase,00.00,"64,123.47","128,246.93"
17-Sep-2025,Debit Card,00.00,"25,649.39","102,597.54"
17-Sep-2025,Purchase,00.00,"17,099.59","85,497.95"
17-Sep-2025,Cash,00.00,"21,374.49","64,123.46"
17-Sep-2025,Interest,"1,766.80",00.00,"65,890.26"
17-Sep-2025,Debit Card,00.00,"7,321.14","58,569.12"
17-Sep-2025,Cash,"14,616.00",00.00,"73,185.12"
17-Sep-2025,Purchase,00.00,"14,637.02","58,548.10"
17-Sep-2025,Cash,00.00,"9,758.02","48,790.08"
17-Sep-2025,Bill,436.00,00.00,"49,226.08"
17-Sep-2025,Cheque,49.65,00.00,"49,275.73"
17-Sep-2025,Miscellaneous,00.00,"9,855.15","39,420.58"
17-Sep-2025,Purchase,"43,715.97",00.00,"83,136.55"
17-Sep-2025,RTGS,00.00,"20,784.14","62,352.41"
17-Sep-2025,Cheque,"31,811.58",00.00,"94,163.99"
17-Sep-2025,ATM,"192,943.88",00.00,"287,107.87"
17-Sep-2025,Commission,00.00,"41,015.41","246,092.46"
17-Sep-2025,Debit Card,00.00,"35,156.07","210,936.39"
17-Sep-2025,Purchase,"1,035,496.20",00.00,"1,246,432.59"
17-Sep-2025,Miscellaneous,113.63,00.00,"1,246,546.22"
17-Sep-2025,Miscellaneous,00.00,"178,078.03","1,068,468.19"
17-Sep-2025,Reversal,"12,869.00",00.00,"1,081,337.19"
18-Sep-2025,Debit Card,00.00,"360,445.73","720,891.46"
18-Sep-2025,Bill,00.00,"102,984.49","617,906.97"
18-Sep-2025,ATM,00.00,"68,656.33","549,250.64"
18-Sep-2025,Purchase,00.00,"549,250.64",00.00
18-Sep-2025,Debit Card,"216,601.80",00.00,"216,601.80"
18-Sep-2025,Bill,00.00,"43,320.36","173,281.44"
18-Sep-2025,Transfer,00.00,"19,253.49","154,027.95"
18-Sep-2025,Commission,00.40,00.00,"154,028.35"
18-Sep-2025,RTGS,00.00,"19,253.54","134,774.81"
18-Sep-2025,Cash,00.00,"22,462.47","112,312.34"
19-Sep-2025,NEFT,"20,817.48",00.00,"133,129.82"
19-Sep-2025,Transfer,"1,508,988.50",00.00,"1,642,118.32"
19-Sep-2025,Cash,"335,668.20",00.00,"1,977,786.52"
19-Sep-2025,Cash,00.00,"197,778.65","1,780,007.87"
19-Sep-2025,Transfer,00.00,"1,780,007.87",00.00
19-Sep-2025,ATM,"16,339.40",00.00,"16,339.40"
19-Sep-2025,Cheque,02.80,00.00,"16,342.20"
19-Sep-2025,Reversal,00.00,"1,634.22","14,707.98"
19-Sep-2025,Commission,488.00,00.00,"15,195.98"
19-Sep-2025,Transfer,"2,237.41",00.00,"17,433.39"
19-Sep-2025,Miscellaneous,68.00,00.00,"17,501.39"
19-Sep-2025,Cheque,00.00,"1,944.60","15,556.79"
19-Sep-2025,Cash,"2,248.60",00.00,"17,805.39"
19-Sep-2025,Transfer,"7,441.70",00.00,"25,247.09"
19-Sep-2025,NEFT,204.00,00.00,"25,451.09"
19-Sep-2025,NEFT,00.00,"3,635.87","21,815.22"
19-Sep-2025,Transfer,06.60,00.00,"21,821.82"
19-Sep-2025,Debit Card,311.85,00.00,"22,133.67"
19-Sep-2025,Tax,00.00,"3,161.95","18,971.72"
19-Sep-2025,Bill,48.30,00.00,"19,020.02"
19-Sep-2025,Transfer,64.40,00.00,"19,084.42"
19-Sep-2025,RTGS,00.00,"1,908.44","17,175.98"
19-Sep-2025,Tax,00.00,"4,294.00","12,881.98"
19-Sep-2025,ATM,00.00,"1,840.28","11,041.70"
19-Sep-2025,NEFT,00.00,"1,840.28","9,201.42"
19-Sep-2025,Cash,"69,087.80",00.00,"78,289.22"
20-Sep-2025,Miscellaneous,00.00,"9,786.15","68,503.07"
20-Sep-2025,ATM,97.00,00.00,"68,600.07"
20-Sep-2025,Commission,"2,942.90",00.00,"71,542.97"
20-Sep-2025,NEFT,05.00,00.00,"71,547.97"
20-Sep-2025,Cheque,00.00,"71,547.97",00.00
20-Sep-2025,Purchase,126.00,00.00,126.00
20-Sep-2025,Debit Card,"1,710,198.80",00.00,"1,710,324.80"
20-Sep-2025,Miscellaneous,00.00,"855,162.40","855,162.40"
20-Sep-2025,Cheque,00.00,"85,516.24","769,646.16"
20-Sep-2025,IMPS,53.00,00.00,"769,699.16"
20-Sep-2025,Transfer,00.00,"128,283.19","641,415.97"
20-Sep-2025,Debit Card,322.64,00.00,"641,738.61"
20-Sep-2025,Bill,00.00,"128,347.72","513,390.89"
20-Sep-2025,Cash,00.00,"513,390.89",00.00
20-Sep-2025,Bill,02.60,00.00,02.60
20-Sep-2025,Debit Card,00.20,00.00,02.80
20-Sep-2025,Commission,56.50,00.00,59.30
20-Sep-2025,Commission,"2,740.13",00.00,"2,799.43"
20-Sep-2025,ATM,63.90,00.00,"2,863.33"
20-Sep-2025,Cheque,00.00,954.44,"1,908.89"
20-Sep-2025,Purchase,"3,334.00",00.00,"5,242.89"
20-Sep-2025,ATM,00.00,655.36,"4,587.53"
20-Sep-2025,Interest,00.00,"2,293.77","2,293.76"
20-Sep-2025,Tax,"2,664.00",00.00,"4,957.76"
20-Sep-2025,Cheque,"90,691.00",00.00,"95,648.76"
20-Sep-2025,RTGS,19.00,00.00,"95,667.76"
20-Sep-2025,Debit Card,"3,418.00",00.00,"99,085.76"
20-Sep-2025,Cash,00.00,"24,771.44","74,314.32"
20-Sep-2025,RTGS,00.00,"10,616.33","63,697.99"
20-Sep-2025,Cash,"927,717.00",00.00,"991,414.99"
20-Sep-2025,Miscellaneous,00.00,"123,926.87","867,488.12"
20-Sep-2025,RTGS,00.00,"123,926.87","743,561.25"
20-Sep-2025,Cheque,"2,117.00",00.00,"745,678.25"
20-Sep-2025,Interest,00.00,"106,525.46","639,152.79"
20-Sep-2025,Commission,00.00,"63,915.28","575,237.51"
20-Sep-2025,Interest,"3,377.20",00.00,"578,614.71"
20-Sep-2025,ATM,00.00,"72,326.84","506,287.87"
20-Sep-2025,Miscellaneous,00.00,"101,257.57","405,030.30"
20-Sep-2025,Miscellaneous,04.00,00.00,"405,034.30"
20-Sep-2025,Tax,00.00,"101,258.58","303,775.72"
20-Sep-2025,IMPS,"3,206.20",00.00,"306,981.92"
20-Sep-2025,Reversal,44.00,00.00,"307,025.92"
20-Sep-2025,RTGS,00.00,"43,860.85","263,165.07"
20-Sep-2025,Interest,"1,984,391.50",00.00,"2,247,556.57"
20-Sep-2025,Commission,00.00,"1,123,778.29","1,123,778.28"
20-Sep-2025,Miscellaneous,140.60,00.00,"1,123,918.88"
20-Sep-2025,RTGS,"1,694.92",00.00,"1,125,613.80"
21-Sep-2025,Interest,00.00,"1,125,613.80",00.00
21-Sep-2025,Cash,"204,585.28",00.00,"204,585.28"
21-Sep-2025,Commission,00.00,"34,097.55","170,487.73"
21-Sep-2025,Tax,"8,701.60",00.00,"179,189.33"
22-Sep-2025,Purchase,12.10,00.00,"179,201.43"
22-Sep-2025,Tax,"31,767.00",00.00,"210,968.43"
22-Sep-2025,Interest,47.00,00.00,"211,015.43"
22-Sep-2025,Interest,00.00,"42,203.09","168,812.34"
22-Sep-2025,IMPS,00.00,"21,101.54","147,710.80"
22-Sep-2025,Cash,"12,995.00",00.00,"160,705.80"
22-Sep-2025,Cash,00.00,"22,957.97","137,747.83"
22-Sep-2025,Debit Card,35.10,00.00,"137,782.93"
22-Sep-2025,Cash,"1,159.00",00.00,"138,941.93"
22-Sep-2025,NEFT,00.00,"15,437.99","123,503.94"
22-Sep-2025,Miscellaneous,07.00,00.00,"123,510.94"
22-Sep-2025,Debit Card,00.00,"12,351.09","111,159.85"
22-Sep-2025,Cash,00.00,"11,115.99","100,043.86"
22-Sep-2025,Cash,00.00,"12,505.48","87,538.38"
22-Sep-2025,Reversal,38.00,00.00,"87,576.38"
22-Sep-2025,Miscellaneous,225.00,00.00,"87,801.38"
23-Sep-2025,Reversal,106.90,00.00,"87,908.28"
23-Sep-2025,Purchase,00.00,"14,651.38","73,256.90"
23-Sep-2025,Cash,07.00,00.00,"73,263.90"
23-Sep-2025,IMPS,00.00,"12,210.65","61,053.25"
23-Sep-2025,Transfer,00.00,"30,526.63","30,526.62"
23-Sep-2025,Reversal,00.00,"10,175.54","20,351.08"
23-Sep-2025,Commission,00.00,"4,070.22","16,280.86"
23-Sep-2025,ATM,00.00,"8,140.43","8,140.43"
23-Sep-2025,Interest,00.00,"4,070.22","4,070.22"
23-Sep-2025,RTGS,00.00,"4,070.22",00.00
23-Sep-2025,ATM,33.19,00.00,33.19
23-Sep-2025,Debit Card,00.00,03.32,29.87
24-Sep-2025,Tax,153.62,00.00,183.49
24-Sep-2025,Purchase,"18,775.50",00.00,"18,958.99"
24-Sep-2025,Reversal,110.00,00.00,"19,068.99"
24-Sep-2025,Bill,00.00,"19,068.99",00.00
24-Sep-2025,Cheque,"190,798.69",00.00,"190,798.69"
24-Sep-2025,IMPS,"20,125.10",00.00,"210,923.79"
24-Sep-2025,Interest,00.00,"52,730.95","158,192.84"
24-Sep-2025,Interest,00.00,"39,548.21","118,644.63"
24-Sep-2025,Transfer,00.00,"23,728.93","94,915.70"
24-Sep-2025,Cash,00.00,"15,819.28","79,096.42"
24-Sep-2025,Transfer,00.00,"15,819.28","63,277.14"
24-Sep-2025,Commission,00.00,"63,277.14",00.00
24-Sep-2025,ATM,34.00,00.00,34.00
25-Sep-2025,Reversal,385.12,00.00,419.12
25-Sep-2025,Bill,00.00,59.87,359.25
25-Sep-2025,Purchase,00.00,359.25,00.00
25-Sep-2025,Miscellaneous,"236,865.00",00.00,"236,865.00"
25-Sep-2025,Purchase,148.20,00.00,"237,013.20"
25-Sep-2025,Purchase,00.00,"29,626.65","207,386.55"
25-Sep-2025,Commission,00.00,"23,042.95","184,343.60"
25-Sep-2025,Purchase,00.00,"30,723.93","153,619.67"
25-Sep-2025,Commission,00.00,"51,206.56","102,413.11"
25-Sep-2025,Bill,"983,243.00",00.00,"1,085,656.11"
25-Sep-2025,Debit Card,00.00,"180,942.69","904,713.42"
25-Sep-2025,Tax,00.00,"226,178.36","678,535.06"
25-Sep-2025,RTGS,"62,258.53",00.00,"740,793.59"
25-Sep-2025,Reversal,00.00,"740,793.59",00.00
25-Sep-2025,Miscellaneous,49.10,00.00,49.10
25-Sep-2025,Miscellaneous,00.00,24.55,24.55
25-Sep-2025,ATM,00.00,00.00,24.55
25-Sep-2025,Miscellaneous,253.00,00.00,277.55
25-Sep-2025,Cash,00.00,34.69,242.86
25-Sep-2025,Purchase,00.00,34.69,208.17
25-Sep-2025,Miscellaneous,361.90,00.00,570.07
25-Sep-2025,Interest,30.40,00.00,600.47
25-Sep-2025,Tax,00.00,200.16,400.31
25-Sep-2025,Purchase,41.00,00.00,441.31
25-Sep-2025,Cash,31.88,00.00,473.19
25-Sep-2025,Reversal,00.00,94.64,378.55
25-Sep-2025,Purchase,366.11,00.00,744.66
25-Sep-2025,IMPS,06.30,00.00,750.96
25-Sep-2025,Commission,04.00,00.00,754.96
25-Sep-2025,Debit Card,04.11,00.00,759.07
25-Sep-2025,Commission,"4,053.30",00.00,"4,812.37"
25-Sep-2025,RTGS,430.49,00.00,"5,242.86"
25-Sep-2025,Transfer,259.00,00.00,"5,501.86"
26-Sep-2025,Cheque,00.00,"1,100.37","4,401.49"
26-Sep-2025,Reversal,"3,002.03",00.00,"7,403.52"
26-Sep-2025,Reversal,00.00,"2,467.84","4,935.68"
26-Sep-2025,IMPS,00.00,548.41,"4,387.27"
26-Sep-2025,IMPS,412.01,00.00,"4,799.28"
26-Sep-2025,NEFT,"3,813.07",00.00,"8,612.35"
26-Sep-2025,Cash,"23,538.00",00.00,"32,150.35"
26-Sep-2025,Commission,"134,805.20",00.00,"166,955.55"
26-Sep-2025,IMPS,00.00,"20,869.44","146,086.11"
26-Sep-2025,Cheque,03.20,00.00,"146,089.31"
26-Sep-2025,Cash,00.00,"20,869.90","125,219.41"
26-Sep-2025,Miscellaneous,"1,646.09",00.00,"126,865.50"
26-Sep-2025,Interest,00.00,"42,288.50","84,577.00"
26-Sep-2025,Cash,"1,126.08",00.00,"85,703.08"
26-Sep-2025,Cheque,00.00,"14,283.85","71,419.23"
26-Sep-2025,Miscellaneous,"1,809,999.20",00.00,"1,881,418.43"
26-Sep-2025,Reversal,00.00,"188,141.84","1,693,276.59"
26-Sep-2025,Transfer,00.00,"282,212.77","1,411,063.83"
26-Sep-2025,NEFT,44.40,00.00,"1,411,108.23"
26-Sep-2025,IMPS,00.00,"156,789.80","1,254,318.43"
26-Sep-2025,Debit Card,00.00,"1,254,318.43",00.00
26-Sep-2025,Tax,"123,414.00",00.00,"123,414.00"
26-Sep-2025,Purchase,43.00,00.00,"123,457.00"
26-Sep-2025,Bill,03.00,00.00,"123,460.00"
26-Sep-2025,Miscellaneous,00.00,"15,432.50","108,027.50"
26-Sep-2025,Reversal,00.00,"36,009.17","72,018.33"
26-Sep-2025,Debit Card,40.20,00.00,"72,058.53"
26-Sep-2025,RTGS,03.00,00.00,"72,061.53"
26-Sep-2025,Purchase,00.00,"10,294.50","61,767.03"
26-Sep-2025,Miscellaneous,00.00,"20,589.01","41,178.02"
26-Sep-2025,Cheque,00.00,"4,117.80","37,060.22"
26-Sep-2025,RTGS,00.00,"6,176.70","30,883.52"
26-Sep-2025,Debit Card,02.00,00.00,"30,885.52"
26-Sep-2025,Miscellaneous,48.92,00.00,"30,934.44"
26-Sep-2025,Transfer,"3,127.36",00.00,"34,061.80"
26-Sep-2025,Purchase,"302,174.00",00.00,"336,235.80"
26-Sep-2025,Cheque,04.67,00.00,"336,240.47"
26-Sep-2025,Cheque,00.00,"67,248.09","268,992.38"
26-Sep-2025,NEFT,"11,263.30",00.00,"280,255.68"
26-Sep-2025,IMPS,10.46,00.00,"280,266.14"
26-Sep-2025,Cash,"175,759.38",00.00,"456,025.52"
26-Sep-2025,Miscellaneous,"1,590,511.00",00.00,"2,046,536.52"
26-Sep-2025,Miscellaneous,00.00,"255,817.07","1,790,719.46"
26-Sep-2025,Miscellaneous,00.00,"298,453.24","1,492,266.22"
26-Sep-2025,NEFT,07.00,00.00,"1,492,273.22"
26-Sep-2025,IMPS,00.00,"298,454.64","1,193,818.58"
26-Sep-2025,Reversal,230.50,00.00,"1,194,049.08"
26-Sep-2025,NEFT,"462,311.00",00.00,"1,656,360.08"
27-Sep-2025,Interest,00.00,"236,622.87","1,419,737.21"
27-Sep-2025,Interest,"42,548.75",00.00,"1,462,285.96"
27-Sep-2025,Cash,00.00,"365,571.49","1,096,714.47"
27-Sep-2025,RTGS,00.00,"121,857.16","974,857.31"
27-Sep-2025,Reversal,46.13,00.00,"974,903.44"
27-Sep-2025,Cash,00.00,"162,483.91","812,419.53"
27-Sep-2025,Miscellaneous,00.00,"135,403.26","677,016.28"
27-Sep-2025,Bill,08.00,00.00,"677,024.28"
27-Sep-2025,Bill,00.00,"67,702.43","609,321.85"
27-Sep-2025,Cash,00.00,"87,045.98","522,275.87"
27-Sep-2025,Debit Card,00.00,"74,610.84","447,665.03"
27-Sep-2025,Cheque,"243,554.00",00.00,"691,219.03"
28-Sep-2025,Reversal,00.00,"138,243.81","552,975.22"
28-Sep-2025,Reversal,"14,771.20",00.00,"567,746.42"
28-Sep-2025,Interest,00.00,"81,106.63","486,639.79"
28-Sep-2025,Miscellaneous,00.00,"48,663.98","437,975.81"
28-Sep-2025,Purchase,"1,164,061.00",00.00,"1,602,036.81"
29-Sep-2025,RTGS,00.00,"178,004.09","1,424,032.72"
29-Sep-2025,Miscellaneous,"5,684.23",00.00,"1,429,716.95"
29-Sep-2025,Commission,00.00,"142,971.70","1,286,745.25"
29-Sep-2025,RTGS,00.00,"142,971.69","1,143,773.56"
29-Sep-2025,Reversal,02.00,00.00,"1,143,775.56"
29-Sep-2025,Reversal,00.00,"381,258.52","762,517.04"
29-Sep-2025,Cheque,00.00,"76,251.70","686,265.34"
29-Sep-2025,Cash,00.00,"76,251.70","610,013.64"
29-Sep-2025,Cash,"1,660.50",00.00,"611,674.14"
29-Sep-2025,Cheque,00.00,"152,918.54","458,755.60"
29-Sep-2025,NEFT,00.00,"114,688.90","344,066.70"
29-Sep-2025,ATM,00.00,"49,152.39","294,914.31"
29-Sep-2025,Purchase,59.40,00.00,"294,973.71"
29-Sep-2025,Cheque,"1,143,359.50",00.00,"1,438,333.21"
29-Sep-2025,Cheque,00.00,"159,814.80","1,278,518.41"
29-Sep-2025,IMPS,"649,225.00",00.00,"1,927,743.41"
29-Sep-2025,ATM,502.27,00.00,"1,928,245.68"
29-Sep-2025,Reversal,00.00,"642,748.56","1,285,497.12"
29-Sep-2025,Debit Card,00.00,"183,642.45","1,101,854.67"
29-Sep-2025,Tax,"433,492.00",00.00,"1,535,346.67"
29-Sep-2025,Purchase,00.00,"767,673.34","767,673.34"
29-Sep-2025,Cash,06.69,00.00,"767,680.03"
29-Sep-2025,ATM,00.00,"767,680.03",00.00
29-Sep-2025,Tax,"200,583.88",00.00,"200,583.88"
29-Sep-2025,Transfer,356.00,00.00,"200,939.88"
29-Sep-2025,Cheque,45.00,00.00,"200,984.88"
29-Sep-2025,IMPS,"234,549.03",00.00,"435,533.91"
29-Sep-2025,Transfer,"1,765,578.00",00.00,"2,201,111.91"
30-Sep-2025,RTGS,"920,038.00",00.00,"3,121,149.91"
30-Sep-2025,ATM,00.00,"445,878.56","2,675,271.35"
30-Sep-2025,ATM,"14,857.40",00.00,"2,690,128.75"
30-Sep-2025,Cheque,126.40,00.00,"2,690,255.15"
30-Sep-2025,Debit Card,00.00,"298,917.24","2,391,337.91"
30-Sep-2025,Purchase,969.70,00.00,"2,392,307.61"
30-Sep-2025,Transfer,"2,646.22",00.00,"2,394,953.83"
01-Oct-2025,IMPS,"510,656.00",00.00,"2,905,609.83"
01-Oct-2025,RTGS,"28,190.00",00.00,"2,933,799.83"
01-Oct-2025,Miscellaneous,05.50,00.00,"2,933,805.33"
01-Oct-2025,Interest,00.00,"488,967.56","2,444,837.78"
01-Oct-2025,NEFT,196.08,00.00,"2,445,033.86"
01-Oct-2025,IMPS,45.30,00.00,"2,445,079.16"
01-Oct-2025,Purchase,27.30,00.00,"2,445,106.46"
01-Oct-2025,Tax,"168,574.50",00.00,"2,613,680.96"
01-Oct-2025,ATM,21.00,00.00,"2,613,701.96"
01-Oct-2025,Interest,00.00,"435,616.99","2,178,084.97"
01-Oct-2025,RTGS,00.00,"272,260.62","1,905,824.35"
01-Oct-2025,Miscellaneous,302.00,00.00,"1,906,126.35"
01-Oct-2025,RTGS,00.00,"238,265.79","1,667,860.56"
01-Oct-2025,IMPS,00.00,"833,930.28","833,930.28"
01-Oct-2025,IMPS,00.00,"416,965.14","416,965.14"
01-Oct-2025,Cheque,"457,946.20",00.00,"874,911.34"
01-Oct-2025,IMPS,"70,214.00",00.00,"945,125.34"
01-Oct-2025,Commission,133.00,00.00,"945,258.34"
01-Oct-2025,Interest,124.70,00.00,"945,383.04"
01-Oct-2025,ATM,00.00,"189,076.61","756,306.43"
01-Oct-2025,Miscellaneous,14.88,00.00,"756,321.31"
01-Oct-2025,Cash,"46,661.00",00.00,"802,982.31"
01-Oct-2025,Interest,220.03,00.00,"803,202.34"
01-Oct-2025,Transfer,"22,721.00",00.00,"825,923.34"
01-Oct-2025,Bill,244.00,00.00,"826,167.34"
01-Oct-2025,Cash,476.94,00.00,"826,644.28"
01-Oct-2025,ATM,00.00,"118,092.04","708,552.24"
01-Oct-2025,Transfer,"2,354.00",00.00,"710,906.24"
02-Oct-2025,Cash,00.00,"710,906.24",00.00
02-Oct-2025,Reversal,"945,265.00",00.00,"945,265.00"
02-Oct-2025,Purchase,00.00,"118,158.13","827,106.88"
02-Oct-2025,Commission,00.00,"275,702.29","551,404.59"
02-Oct-2025,Cash,"2,554.00",00.00,"553,958.59"
02-Oct-2025,Bill,00.00,"184,652.86","369,305.73"
02-Oct-2025,NEFT,00.00,"46,163.22","323,142.51"
02-Oct-2025,Debit Card,00.00,"40,392.81","282,749.70"
02-Oct-2025,Bill,00.00,"282,749.70",00.00
02-Oct-2025,IMPS,35.70,00.00,35.70
02-Oct-2025,Cheque,00.00,05.95,29.75
02-Oct-2025,Miscellaneous,00.00,14.88,14.88
02-Oct-2025,Debit Card,00.00,02.13,12.75
02-Oct-2025,Tax,00.81,00.00,13.56
02-Oct-2025,Interest,00.00,03.39,10.17
02-Oct-2025,Commission,06.60,00.00,16.77
03-Oct-2025,Interest,00.00,02.80,13.98
03-Oct-2025,Interest,"678,012.80",00.00,"678,026.78"
03-Oct-2025,Bill,06.60,00.00,"678,033.38"
03-Oct-2025,Miscellaneous,"35,118.30",00.00,"713,151.68"
03-Oct-2025,RTGS,"2,680.00",00.00,"715,831.68"
03-Oct-2025,Transfer,00.00,"715,831.68",00.00
04-Oct-2025,Interest,"6,608.70",00.00,"6,608.70"
04-Oct-2025,NEFT,00.00,826.09,"5,782.61"
04-Oct-2025,Cheque,"1,891.97",00.00,"7,674.58"
04-Oct-2025,NEFT,07.00,00.00,"7,681.58"
04-Oct-2025,Commission,321.80,00.00,"8,003.38"
04-Oct-2025,Miscellaneous,307.40,00.00,"8,310.78"
04-Oct-2025,RTGS,01.00,00.00,"8,311.78"
04-Oct-2025,RTGS,00.00,"1,187.40","7,124.38"
04-Oct-2025,RTGS,"2,163.30",00.00,"9,287.68"
04-Oct-2025,Cheque,00.00,"3,095.89","6,191.79"
04-Oct-2025,IMPS,"1,468,069.00",00.00,"1,474,260.79"
04-Oct-2025,ATM,"1,543.00",00.00,"1,475,803.79"
04-Oct-2025,Interest,"1,324.00",00.00,"1,477,127.79"
04-Oct-2025,Transfer,51.00,00.00,"1,477,178.79"
04-Oct-2025,Cash,00.00,"184,647.35","1,292,531.44"
04-Oct-2025,Cheque,822.00,00.00,"1,293,353.44"
04-Oct-2025,Purchase,"213,926.19",00.00,"1,507,279.63"
04-Oct-2025,Cheque,00.00,"301,455.93","1,205,823.70"
04-Oct-2025,NEFT,00.00,"172,260.53","1,033,563.17"
04-Oct-2025,NEFT,"1,181,006.75",00.00,"2,214,569.92"
05-Oct-2025,Cash,00.00,"369,094.99","1,845,474.93"
05-Oct-2025,Tax,00.00,"307,579.16","1,537,895.78"
05-Oct-2025,Bill,00.00,"384,473.95","1,153,421.84"
05-Oct-2025,Cheque,"67,636.20",00.00,"1,221,058.04"
05-Oct-2025,Tax,01.00,00.00,"1,221,059.04"
05-Oct-2025,IMPS,00.00,"610,529.52","610,529.52"
05-Oct-2025,Transfer,362.50,00.00,"610,892.02"
05-Oct-2025,NEFT,00.00,"203,630.67","407,261.35"
05-Oct-2025,IMPS,"105,026.00",00.00,"512,287.35"
05-Oct-2025,Bill,00.00,"256,143.68","256,143.68"
05-Oct-2025,Miscellaneous,"242,652.00",00.00,"498,795.68"
06-Oct-2025,Miscellaneous,00.00,"55,421.74","443,373.94"
06-Oct-2025,Transfer,58.80,00.00,"443,432.74"
06-Oct-2025,Debit Card,"1,733,229.00",00.00,"2,176,661.74"
06-Oct-2025,Reversal,00.00,"241,851.30","1,934,810.44"
06-Oct-2025,Cash,00.00,"483,702.61","1,451,107.83"
06-Oct-2025,Debit Card,00.00,"1,451,107.83",00.00
06-Oct-2025,Commission,"207,022.00",00.00,"207,022.00"
06-Oct-2025,IMPS,00.00,"34,503.67","172,518.33"
06-Oct-2025,Cash,"14,149.00",00.00,"186,667.33"
06-Oct-2025,Commission,60.40,00.00,"186,727.73"
07-Oct-2025,Debit Card,00.00,"20,747.53","165,980.20"
07-Oct-2025,Bill,"3,937.24",00.00,"169,917.44"
07-Oct-2025,Cheque,"105,236.00",00.00,"275,153.44"
07-Oct-2025,Interest,54.18,00.00,"275,207.62"
07-Oct-2025,IMPS,"2,107.70",00.00,"277,315.32"
07-Oct-2025,Cheque,00.00,"92,438.44","184,876.88"
07-Oct-2025,Bill,00.00,"184,876.88",00.00
07-Oct-2025,Purchase,"5,794.10",00.00,"5,794.10"
07-Oct-2025,Debit Card,01.00,00.00,"5,795.10"
07-Oct-2025,Miscellaneous,"930,227.00",00.00,"936,022.10"
07-Oct-2025,Reversal,55.00,00.00,"936,077.10"
07-Oct-2025,IMPS,00.00,"936,077.10",00.00
08-Oct-2025,Commission,48.40,00.00,48.40
08-Oct-2025,Purchase,"4,399.00",00.00,"4,447.40"
08-Oct-2025,Tax,"1,665,721.80",00.00,"1,670,169.20"
08-Oct-2025,Cheque,00.00,"185,574.36","1,484,594.84"
08-Oct-2025,ATM,273.00,00.00,"1,484,867.84"
08-Oct-2025,Miscellaneous,"3,291.70",00.00,"1,488,159.54"
08-Oct-2025,Tax,287.00,00.00,"1,488,446.54"
08-Oct-2025,IMPS,00.00,"248,074.42","1,240,372.12"
08-Oct-2025,Commission,00.00,"620,186.06","620,186.06"
08-Oct-2025,RTGS,"13,187.00",00.00,"633,373.06"
08-Oct-2025,ATM,00.00,"211,124.35","422,248.71"
08-Oct-2025,RTGS,00.00,"84,449.74","337,798.97"
08-Oct-2025,Tax,"12,624.10",00.00,"350,423.07"
08-Oct-2025,Debit Card,"3,418.00",00.00,"353,841.07"
08-Oct-2025,Bill,"19,402.00",00.00,"373,243.07"
08-Oct-2025,IMPS,00.00,"74,648.61","298,594.46"
08-Oct-2025,IMPS,00.00,"49,765.74","248,828.72"
08-Oct-2025,Miscellaneous,00.00,"49,765.74","199,062.98"
08-Oct-2025,Miscellaneous,08.00,00.00,"199,070.98"
08-Oct-2025,Miscellaneous,"2,744.65",00.00,"201,815.63"
08-Oct-2025,Cheque,775.33,00.00,"202,590.96"
08-Oct-2025,Miscellaneous,00.00,"33,765.16","168,825.80"
08-Oct-2025,Debit Card,"1,125.00",00.00,"169,950.80"
08-Oct-2025,Cash,00.00,"169,950.80",00.00
08-Oct-2025,Purchase,"419,822.25",00.00,"419,822.25"
08-Oct-2025,Debit Card,00.00,"41,982.23","377,840.02"
08-Oct-2025,Miscellaneous,"2,012,108.00",00.00,"2,389,948.02"
08-Oct-2025,Cheque,273.70,00.00,"2,390,221.72"
08-Oct-2025,NEFT,00.00,"298,777.72","2,091,444.00"
08-Oct-2025,IMPS,00.00,"522,861.00","1,568,583.00"
08-Oct-2025,Commission,00.00,"784,291.50","784,291.50"
08-Oct-2025,Bill,61.46,00.00,"784,352.96"
08-Oct-2025,Miscellaneous,00.00,"196,088.24","588,264.72"
08-Oct-2025,Purchase,00.00,"65,362.75","522,901.97"
08-Oct-2025,IMPS,"1,885.90",00.00,"524,787.87"
08-Oct-2025,Bill,"541,943.50",00.00,"1,066,731.37"
08-Oct-2025,NEFT,00.00,"106,673.14","960,058.23"
08-Oct-2025,Cash,00.00,"137,151.18","822,907.05"
08-Oct-2025,Bill,"4,555.00",00.00,"827,462.05"
08-Oct-2025,IMPS,00.00,"827,462.05",00.00
08-Oct-2025,ATM,06.00,00.00,06.00
08-Oct-2025,Reversal,00.00,02.00,04.00
08-Oct-2025,Interest,00.00,00.44,03.56
08-Oct-2025,Interest,00.00,00.89,02.67
08-Oct-2025,Purchase,00.00,01.34,01.34
08-Oct-2025,RTGS,00.00,00.45,00.89
08-Oct-2025,Purchase,00.00,00.30,00.59
08-Oct-2025,IMPS,04.00,00.00,04.59
08-Oct-2025,NEFT,00.00,01.53,03.06
08-Oct-2025,Cheque,"168,288.25",00.00,"168,291.31"
08-Oct-2025,Reversal,"31,181.50",00.00,"199,472.81"
08-Oct-2025,Bill,03.64,00.00,"199,476.45"
08-Oct-2025,RTGS,00.00,"19,947.65","179,528.81"
08-Oct-2025,Debit Card,02.00,00.00,"179,530.81"
08-Oct-2025,Debit Card,382.30,00.00,"179,913.11"
08-Oct-2025,RTGS,"19,756.48",00.00,"199,669.59"
08-Oct-2025,Cash,464.00,00.00,"200,133.59"
08-Oct-2025,RTGS,00.00,"28,590.51","171,543.08"
08-Oct-2025,Commission,00.00,"28,590.51","142,952.57"
08-Oct-2025,Commission,00.00,"20,421.80","122,530.77"
08-Oct-2025,Cheque,"29,702.00",00.00,"152,232.77"
08-Oct-2025,IMPS,00.00,"152,232.77",00.00
08-Oct-2025,Miscellaneous,"1,212.79",00.00,"1,212.79"
08-Oct-2025,Miscellaneous,"3,873.50",00.00,"5,086.29"
08-Oct-2025,Miscellaneous,00.00,"1,695.43","3,390.86"
09-Oct-2025,Cash,789.00,00.00,"4,179.86"
09-Oct-2025,Interest,00.05,00.00,"4,179.91"
09-Oct-2025,Cheque,53.60,00.00,"4,233.51"
09-Oct-2025,NEFT,00.00,"2,116.76","2,116.76"
09-Oct-2025,Cheque,00.00,211.68,"1,905.08"
09-Oct-2025,Reversal,"1,450,205.00",00.00,"1,452,110.08"
09-Oct-2025,Debit Card,00.00,"290,422.02","1,161,688.06"
09-Oct-2025,Tax,"1,575,890.25",00.00,"2,737,578.31"
09-Oct-2025,Interest,00.00,"547,515.66","2,190,062.65"
09-Oct-2025,Debit Card,00.00,"312,866.09","1,877,196.56"
09-Oct-2025,Bill,21.20,00.00,"1,877,217.76"
09-Oct-2025,RTGS,"3,975.60",00.00,"1,881,193.36"
09-Oct-2025,Interest,"1,851,215.00",00.00,"3,732,408.36"
09-Oct-2025,Transfer,"15,010.75",00.00,"3,747,419.11"
09-Oct-2025,Interest,00.00,"3,747,419.11",00.00
09-Oct-2025,RTGS,"14,148.88",00.00,"14,148.88"
09-Oct-2025,Cash,00.00,"1,572.10","12,576.78"
09-Oct-2025,Miscellaneous,00.00,"4,192.26","8,384.52"
09-Oct-2025,Purchase,00.00,"8,384.52",00.00
09-Oct-2025,ATM,"3,342.93",00.00,"3,342.93"
09-Oct-2025,Miscellaneous,"3,619.00",00.00,"6,961.93"
09-Oct-2025,Reversal,04.50,00.00,"6,966.43"
09-Oct-2025,Tax,00.00,"1,741.61","5,224.82"
09-Oct-2025,Bill,00.00,"1,306.21","3,918.62"
09-Oct-2025,Tax,00.00,00.00,"3,918.62"
09-Oct-2025,Miscellaneous,"173,887.47",00.00,"177,806.09"
09-Oct-2025,RTGS,00.00,"59,268.70","118,537.39"
09-Oct-2025,IMPS,00.00,"23,707.48","94,829.91"
09-Oct-2025,Purchase,00.00,"31,609.97","63,219.94"
09-Oct-2025,Miscellaneous,07.57,00.00,"63,227.51"
09-Oct-2025,Cheque,00.00,"7,903.44","55,324.07"
09-Oct-2025,RTGS,00.00,"5,532.41","49,791.66"
09-Oct-2025,Miscellaneous,"3,802.14",00.00,"53,593.80"
09-Oct-2025,Bill,747.00,00.00,"54,340.80"
09-Oct-2025,NEFT,00.00,"27,170.40","27,170.40"
09-Oct-2025,Miscellaneous,00.00,"2,717.04","24,453.36"
09-Oct-2025,Tax,00.00,"4,890.67","19,562.69"
09-Oct-2025,ATM,00.00,"1,956.27","17,606.42"
09-Oct-2025,Cash,125.00,00.00,"17,731.42"
09-Oct-2025,Reversal,458.00,00.00,"18,189.42"
09-Oct-2025,Transfer,00.00,"2,273.68","15,915.74"
09-Oct-2025,NEFT,922.27,00.00,"16,838.01"
10-Oct-2025,Commission,"6,988.96",00.00,"23,826.97"
10-Oct-2025,NEFT,00.00,"4,765.39","19,061.58"
10-Oct-2025,Tax,00.00,"3,812.32","15,249.26"
10-Oct-2025,Interest,00.00,"1,906.16","13,343.10"
10-Oct-2025,IMPS,00.00,"1,482.57","11,860.53"
10-Oct-2025,Bill,"256,506.03",00.00,"268,366.56"
10-Oct-2025,Commission,00.00,"29,818.51","238,548.05"
10-Oct-2025,Commission,00.00,"47,709.61","190,838.44"
10-Oct-2025,Purchase,00.00,"63,612.81","127,225.63"
10-Oct-2025,Transfer,41.26,00.00,"127,266.89"
10-Oct-2025,Cheque,00.00,"127,266.89",00.00
10-Oct-2025,Transfer,249.10,00.00,249.10
10-Oct-2025,Interest,62.25,00.00,311.35
10-Oct-2025,Miscellaneous,00.00,77.84,233.51
10-Oct-2025,Purchase,00.00,25.95,207.56
10-Oct-2025,ATM,"30,436.30",00.00,"30,643.86"
10-Oct-2025,Miscellaneous,00.00,"30,643.86",00.00
10-Oct-2025,Reversal,"308,377.25",00.00,"308,377.25"
10-Oct-2025,Reversal,"3,084.50",00.00,"311,461.75"
10-Oct-2025,Bill,00.00,"34,606.86","276,854.89"
10-Oct-2025,Commission,00.00,"138,427.45","138,427.44"
10-Oct-2025,IMPS,"15,928.00",00.00,"154,355.44"
10-Oct-2025,Commission,00.00,"17,150.60","137,204.84"
10-Oct-2025,Tax,00.00,"17,150.61","120,054.24"
10-Oct-2025,Commission,00.00,"60,027.12","60,027.12"
10-Oct-2025,Transfer,00.00,"60,027.12",00.00
10-Oct-2025,Transfer,217.10,00.00,217.10
10-Oct-2025,Cash,"23,508.20",00.00,"23,725.30"
10-Oct-2025,Miscellaneous,00.00,"5,931.33","17,793.97"
10-Oct-2025,Purchase,00.00,"1,779.40","16,014.57"
10-Oct-2025,NEFT,"210,050.00",00.00,"226,064.57"
10-Oct-2025,Commission,00.00,"56,516.14","169,548.43"
10-Oct-2025,Debit Card,45.90,00.00,"169,594.33"
10-Oct-2025,Tax,00.00,"28,265.72","141,328.61"
10-Oct-2025,Transfer,00.00,"20,189.80","121,138.81"
10-Oct-2025,Purchase,00.00,"121,138.81",00.00
10-Oct-2025,Reversal,309.00,00.00,309.00
10-Oct-2025,Cash,00.00,44.14,264.86
10-Oct-2025,Reversal,"1,123.77",00.00,"1,388.63"
10-Oct-2025,NEFT,00.00,231.44,"1,157.19"
10-Oct-2025,IMPS,00.00,165.31,991.88
10-Oct-2025,Purchase,00.00,495.94,495.94
11-Oct-2025,IMPS,"20,118.83",00.00,"20,614.77"
11-Oct-2025,Cash,02.00,00.00,"20,616.77"
11-Oct-2025,Cash,00.00,"6,872.26","13,744.51"
11-Oct-2025,ATM,41.46,00.00,"13,785.97"
11-Oct-2025,Reversal,00.00,"1,531.77","12,254.20"
11-Oct-2025,ATM,"286,763.80",00.00,"299,018.00"
11-Oct-2025,Reversal,00.00,"29,901.80","269,116.20"
11-Oct-2025,IMPS,"180,550.00",00.00,"449,666.20"
11-Oct-2025,Reversal,"82,653.38",00.00,"532,319.58"
11-Oct-2025,Tax,"3,498.94",00.00,"535,818.52"
11-Oct-2025,Reversal,00.00,"53,581.85","482,236.67"
11-Oct-2025,IMPS,00.00,"96,447.33","385,789.34"
11-Oct-2025,Commission,"147,518.80",00.00,"533,308.14"
11-Oct-2025,Interest,00.00,"106,661.63","426,646.51"
11-Oct-2025,Purchase,06.00,00.00,"426,652.51"
11-Oct-2025,ATM,00.00,"213,326.26","213,326.26"
11-Oct-2025,Commission,"1,039.31",00.00,"214,365.57"
12-Oct-2025,Debit Card,00.00,"30,623.65","183,741.92"
12-Oct-2025,Purchase,04.10,00.00,"183,746.02"
12-Oct-2025,RTGS,00.00,"26,249.43","157,496.59"
12-Oct-2025,IMPS,00.00,"31,499.32","125,997.27"
12-Oct-2025,RTGS,07.00,00.00,"126,004.27"
12-Oct-2025,IMPS,00.00,"21,000.71","105,003.56"
12-Oct-2025,Cash,00.00,"13,125.45","91,878.12"
12-Oct-2025,RTGS,00.00,"30,626.04","61,252.08"
12-Oct-2025,Cheque,06.71,00.00,"61,258.79"
12-Oct-2025,Cheque,32.00,00.00,"61,290.79"
12-Oct-2025,Tax,00.00,"61,290.79",00.00
12-Oct-2025,RTGS,43.00,00.00,43.00
12-Oct-2025,Debit Card,00.00,43.00,00.00
12-Oct-2025,Tax,98.50,00.00,98.50
12-Oct-2025,Bill,"2,691.00",00.00,"2,789.50"
12-Oct-2025,Cash,00.00,929.83,"1,859.67"
12-Oct-2025,Interest,00.00,265.67,"1,594.00"
12-Oct-2025,Purchase,"2,004,094.50",00.00,"2,005,688.50"
12-Oct-2025,Transfer,00.00,"200,568.85","1,805,119.65"
12-Oct-2025,Cash,"1,825,368.00",00.00,"3,630,487.65"
12-Oct-2025,Commission,19.00,00.00,"3,630,506.65"
12-Oct-2025,Transfer,00.00,"605,084.44","3,025,422.21"
12-Oct-2025,Purchase,06.76,00.00,"3,025,428.97"
12-Oct-2025,RTGS,00.00,"432,204.14","2,593,224.83"
12-Oct-2025,Reversal,04.90,00.00,"2,593,229.73"
13-Oct-2025,Transfer,407.00,00.00,"2,593,636.73"
13-Oct-2025,Cheque,00.00,"432,272.79","2,161,363.94"
13-Oct-2025,Tax,"252,058.00",00.00,"2,413,421.94"
13-Oct-2025,Bill,"2,074,953.80",00.00,"4,488,375.74"
13-Oct-2025,Debit Card,00.00,"498,708.42","3,989,667.32"
13-Oct-2025,IMPS,00.00,"3,989,667.32",00.00
13-Oct-2025,Reversal,"4,047.00",00.00,"4,047.00"
13-Oct-2025,NEFT,40.80,00.00,"4,087.80"
13-Oct-2025,Reversal,00.00,817.56,"3,270.24"
13-Oct-2025,Cash,"1,461,810.00",00.00,"1,465,080.24"
13-Oct-2025,Transfer,"14,807.10",00.00,"1,479,887.34"
13-Oct-2025,Debit Card,00.00,"369,971.84","1,109,915.51"
13-Oct-2025,ATM,"154,920.70",00.00,"1,264,836.21"
13-Oct-2025,NEFT,06.35,00.00,"1,264,842.56"
13-Oct-2025,Commission,00.00,"1,264,842.56",00.00
13-Oct-2025,Debit Card,"1,616,643.00",00.00,"1,616,643.00"
13-Oct-2025,Commission,00.00,"161,664.30","1,454,978.70"
13-Oct-2025,Cheque,"30,579.00",00.00,"1,485,557.70"
13-Oct-2025,IMPS,00.00,"185,694.71","1,299,862.99"
13-Oct-2025,Debit Card,00.00,"144,429.22","1,155,433.77"
13-Oct-2025,IMPS,00.00,"192,572.30","962,861.48"
13-Oct-2025,Miscellaneous,"400,443.25",00.00,"1,363,304.73"
13-Oct-2025,Cheque,"1,615,205.00",00.00,"2,978,509.73"
13-Oct-2025,Commission,00.00,"744,627.43","2,233,882.30"
13-Oct-2025,Commission,"1,682,134.00",00.00,"3,916,016.30"
13-Oct-2025,NEFT,"32,589.97",00.00,"3,948,606.27"
13-Oct-2025,Reversal,00.00,"658,101.05","3,290,505.22"
13-Oct-2025,Tax,00.00,"822,626.31","2,467,878.92"
13-Oct-2025,Debit Card,00.00,"352,554.13","2,115,324.79"
13-Oct-2025,ATM,"11,957.50",00.00,"2,127,282.29"
14-Oct-2025,IMPS,36.58,00.00,"2,127,318.87"
14-Oct-2025,Miscellaneous,464.40,00.00,"2,127,783.27"
14-Oct-2025,Miscellaneous,"15,890.70",00.00,"2,143,673.97"
14-Oct-2025,Cash,"2,938.90",00.00,"2,146,612.87"
14-Oct-2025,ATM,00.00,"268,326.61","1,878,286.26"
14-Oct-2025,Miscellaneous,00.00,"939,143.13","939,143.13"
14-Oct-2025,RTGS,54.00,00.00,"939,197.13"
14-Oct-2025,Debit Card,"17,892.10",00.00,"957,089.23"
14-Oct-2025,Commission,488.00,00.00,"957,577.23"
14-Oct-2025,RTGS,"80,874.60",00.00,"1,038,451.83"
14-Oct-2025,Tax,57.10,00.00,"1,038,508.93"
14-Oct-2025,Debit Card,00.00,"103,850.89","934,658.04"
15-Oct-2025,Miscellaneous,33.00,00.00,"934,691.04"
15-Oct-2025,RTGS,"2,872.00",00.00,"937,563.04"
15-Oct-2025,IMPS,00.00,"187,512.61","750,050.43"
15-Oct-2025,Transfer,00.00,"75,005.04","675,045.39"
15-Oct-2025,Reversal,00.00,"84,380.67","590,664.72"
15-Oct-2025,Cash,00.00,"84,380.67","506,284.05"
15-Oct-2025,Tax,00.00,"253,142.03","253,142.02"
15-Oct-2025,RTGS,00.00,"50,628.40","202,513.62"
15-Oct-2025,Debit Card,138.75,00.00,"202,652.37"
15-Oct-2025,Transfer,00.00,"28,950.34","173,702.03"
15-Oct-2025,Transfer,"877,235.50",00.00,"1,050,937.53"
15-Oct-2025,Cash,00.00,"350,312.51","700,625.02"
15-Oct-2025,Cheque,00.00,"77,847.22","622,777.80"
15-Oct-2025,NEFT,01.20,00.00,"622,779.00"
15-Oct-2025,Reversal,00.00,"103,796.50","518,982.50"
15-Oct-2025,Bill,"150,402.80",00.00,"669,385.30"
15-Oct-2025,Transfer,00.00,"95,626.47","573,758.83"
15-Oct-2025,Bill,00.00,"57,375.88","516,382.95"
15-Oct-2025,Transfer,"2,007,881.50",00.00,"2,524,264.45"
16-Oct-2025,Debit Card,64.00,00.00,"2,524,328.45"
16-Oct-2025,ATM,"1,605,747.00",00.00,"4,130,075.45"
16-Oct-2025,Tax,00.00,"826,015.09","3,304,060.36"
16-Oct-2025,RTGS,00.00,"413,007.55","2,891,052.82"
16-Oct-2025,Transfer,00.00,"481,842.14","2,409,210.68"
16-Oct-2025,Cheque,00.00,"344,172.95","2,065,037.73"
16-Oct-2025,RTGS,"3,113.74",00.00,"2,068,151.47"
16-Oct-2025,ATM,00.00,"517,037.87","1,551,113.60"
16-Oct-2025,IMPS,"85,523.90",00.00,"1,636,637.50"
16-Oct-2025,Purchase,"1,889,833.00",00.00,"3,526,470.50"
16-Oct-2025,RTGS,00.00,"705,294.10","2,821,176.40"
16-Oct-2025,Commission,319.96,00.00,"2,821,496.36"
16-Oct-2025,IMPS,00.00,"2,821,496.36",00.00
16-Oct-2025,Miscellaneous,03.00,00.00,03.00
16-Oct-2025,ATM,04.90,00.00,07.90
16-Oct-2025,Bill,00.00,00.79,07.11
16-Oct-2025,NEFT,00.00,01.42,05.69
16-Oct-2025,NEFT,00.00,05.69,00.00
16-Oct-2025,Commission,"3,917.00",00.00,"3,917.00"
16-Oct-2025,Purchase,00.00,"1,305.67","2,611.33"
16-Oct-2025,Bill,00.00,261.13,"2,350.20"
16-Oct-2025,Interest,"9,675.66",00.00,"12,025.86"
16-Oct-2025,RTGS,716.00,00.00,"12,741.86"
16-Oct-2025,RTGS,00.00,"1,820.27","10,921.59"
16-Oct-2025,Purchase,00.00,"1,092.16","9,829.43"
16-Oct-2025,Debit Card,00.00,"2,457.36","7,372.07"
16-Oct-2025,Transfer,00.00,819.12,"6,552.95"
16-Oct-2025,Tax,"31,294.10",00.00,"37,847.05"
16-Oct-2025,Reversal,27.00,00.00,"37,874.05"
16-Oct-2025,Bill,531.50,00.00,"38,405.55"
16-Oct-2025,IMPS,"12,850.00",00.00,"51,255.55"
16-Oct-2025,Cash,00.00,"17,085.18","34,170.37"
16-Oct-2025,Transfer,255.00,00.00,"34,425.37"
16-Oct-2025,Miscellaneous,00.00,"34,425.37",00.00
16-Oct-2025,Commission,53.00,00.00,53.00
16-Oct-2025,IMPS,"12,661.40",00.00,"12,714.40"
16-Oct-2025,Interest,00.00,"1,412.71","11,301.69"
16-Oct-2025,Cheque,03.87,00.00,"11,305.56"
16-Oct-2025,Transfer,238.00,00.00,"11,543.56"
16-Oct-2025,Debit Card,00.00,"5,771.78","5,771.78"
16-Oct-2025,Tax,"5,185.00",00.00,"10,956.78"
16-Oct-2025,Tax,00.00,"1,826.13","9,130.65"
16-Oct-2025,Cheque,00.00,"1,014.52","8,116.13"
16-Oct-2025,Reversal,25.00,00.00,"8,141.13"
16-Oct-2025,Commission,00.00,904.57,"7,236.56"
16-Oct-2025,Commission,00.00,804.06,"6,432.50"
16-Oct-2025,Cheque,00.00,714.72,"5,717.78"
16-Oct-2025,Interest,52.31,00.00,"5,770.09"
16-Oct-2025,Miscellaneous,12.00,00.00,"5,782.09"
16-Oct-2025,Reversal,"3,578.11",00.00,"9,360.20"
16-Oct-2025,Reversal,00.00,"9,360.20",00.00
16-Oct-2025,Cheque,04.00,00.00,04.00
16-Oct-2025,Cheque,00.00,01.33,02.67
16-Oct-2025,Commission,00.00,00.45,02.22
16-Oct-2025,NEFT,926.06,00.00,928.28
16-Oct-2025,RTGS,00.00,103.14,825.14
16-Oct-2025,NEFT,00.00,825.14,00.00
16-Oct-2025,Cheque,59.00,00.00,59.00
16-Oct-2025,Tax,00.00,59.00,00.00
16-Oct-2025,Commission,"199,612.00",00.00,"199,612.00"
16-Oct-2025,Interest,00.00,"66,537.33","133,074.67"
16-Oct-2025,IMPS,00.00,"44,358.22","88,716.45"
16-Oct-2025,Bill,"1,178,531.80",00.00,"1,267,248.25"
16-Oct-2025,Miscellaneous,24.00,00.00,"1,267,272.25"
16-Oct-2025,Bill,04.90,00.00,"1,267,277.15"
16-Oct-2025,Cheque,00.30,00.00,"1,267,277.45"
16-Oct-2025,Cheque,"16,617.40",00.00,"1,283,894.85"
16-Oct-2025,NEFT,00.00,"1,283,894.85",00.00
16-Oct-2025,NEFT,20.50,00.00,20.50
16-Oct-2025,Miscellaneous,00.00,02.05,18.45
16-Oct-2025,IMPS,00.00,18.45,00.00
16-Oct-2025,Miscellaneous,04.00,00.00,04.00
16-Oct-2025,Miscellaneous,"1,660,879.25",00.00,"1,660,883.25"
16-Oct-2025,Cheque,00.00,"207,610.41","1,453,272.84"
16-Oct-2025,Transfer,00.00,"726,636.42","726,636.42"
16-Oct-2025,Commission,474.00,00.00,"727,110.42"
16-Oct-2025,NEFT,"254,482.00",00.00,"981,592.42"
16-Oct-2025,ATM,05.24,00.00,"981,597.66"
16-Oct-2025,Miscellaneous,00.00,"490,798.83","490,798.83"
16-Oct-2025,RTGS,411.00,00.00,"491,209.83"
17-Oct-2025,Tax,"28,911.80",00.00,"520,121.63"
17-Oct-2025,Cash,00.00,"57,791.29","462,330.34"
17-Oct-2025,Purchase,00.00,"231,165.17","231,165.17"
17-Oct-2025,Cheque,00.00,"57,791.29","173,373.88"
17-Oct-2025,Commission,00.00,"86,686.94","86,686.94"
17-Oct-2025,Debit Card,00.00,"9,631.88","77,055.06"
17-Oct-2025,ATM,00.00,"12,842.51","64,212.55"
17-Oct-2025,Commission,"2,000,571.50",00.00,"2,064,784.05"
17-Oct-2025,NEFT,"12,906.43",00.00,"2,077,690.48"
17-Oct-2025,Bill,03.00,00.00,"2,077,693.48"
17-Oct-2025,Cheque,00.00,"296,813.35","1,780,880.13"
17-Oct-2025,Debit Card,00.00,"222,610.02","1,558,270.11"
17-Oct-2025,Transfer,"244,923.80",00.00,"1,803,193.91"
17-Oct-2025,Cheque,00.00,"601,064.64","1,202,129.27"
17-Oct-2025,ATM,00.00,"601,064.64","601,064.64"
17-Oct-2025,Purchase,60.92,00.00,"601,125.56"
17-Oct-2025,Tax,00.00,"601,125.56",00.00
17-Oct-2025,Bill,"1,282,555.00",00.00,"1,282,555.00"
17-Oct-2025,NEFT,"116,942.00",00.00,"1,399,497.00"
17-Oct-2025,Transfer,333.00,00.00,"1,399,830.00"
17-Oct-2025,IMPS,00.00,"174,978.75","1,224,851.25"
17-Oct-2025,Cash,00.00,"153,106.41","1,071,744.84"
17-Oct-2025,Cheque,00.00,"357,248.28","714,496.56"
17-Oct-2025,Cash,"57,959.50",00.00,"772,456.06"
17-Oct-2025,Reversal,00.00,"77,245.61","695,210.45"
17-Oct-2025,Cash,00.00,"347,605.23","347,605.22"
17-Oct-2025,Transfer,00.00,"115,868.41","231,736.81"
17-Oct-2025,Debit Card,"32,537.54",00.00,"264,274.35"
17-Oct-2025,Purchase,17.80,00.00,"264,292.15"
17-Oct-2025,Reversal,00.00,"44,048.69","220,243.46"
17-Oct-2025,RTGS,00.00,"73,414.49","146,828.97"
17-Oct-2025,Purchase,00.00,"20,975.57","125,853.40"
17-Oct-2025,NEFT,00.00,"31,463.35","94,390.05"
17-Oct-2025,Purchase,00.00,"11,798.76","82,591.29"
17-Oct-2025,Cash,"211,834.75",00.00,"294,426.04"
17-Oct-2025,NEFT,00.00,"32,714.00","261,712.04"
17-Oct-2025,RTGS,174.00,00.00,"261,886.04"
17-Oct-2025,RTGS,08.00,00.00,"261,894.04"
17-Oct-2025,Transfer,"221,129.72",00.00,"483,023.76"
17-Oct-2025,Debit Card,"1,226,771.50",00.00,"1,709,795.26"
17-Oct-2025,IMPS,00.00,"244,256.47","1,465,538.79"
17-Oct-2025,RTGS,"104,467.62",00.00,"1,570,006.41"
17-Oct-2025,Miscellaneous,00.00,"392,501.60","1,177,504.81"
17-Oct-2025,NEFT,00.00,"196,250.80","981,254.01"
17-Oct-2025,Cash,48.90,00.00,"981,302.91"
17-Oct-2025,RTGS,00.00,"122,662.86","858,640.05"
17-Oct-2025,Commission,00.00,"85,864.01","772,776.04"
17-Oct-2025,Commission,00.00,"96,597.01","676,179.04"
17-Oct-2025,Transfer,"178,219.20",00.00,"854,398.24"
17-Oct-2025,Cheque,00.00,"170,879.65","683,518.59"
17-Oct-2025,Cheque,343.70,00.00,"683,862.29"
17-Oct-2025,IMPS,"26,041.57",00.00,"709,903.86"
17-Oct-2025,Interest,00.00,"70,990.39","638,913.47"
17-Oct-2025,NEFT,381.90,00.00,"639,295.37"
17-Oct-2025,Debit Card,00.00,"71,032.82","568,262.55"
17-Oct-2025,IMPS,"1,923.90",00.00,"570,186.45"
17-Oct-2025,ATM,"1,903.00",00.00,"572,089.45"
17-Oct-2025,RTGS,"16,534.14",00.00,"588,623.59"
17-Oct-2025,Reversal,00.00,"73,577.95","515,045.64"
17-Oct-2025,Commission,00.00,"128,761.41","386,284.23"
17-Oct-2025,NEFT,"1,008,066.25",00.00,"1,394,350.48"
17-Oct-2025,Bill,"54,618.50",00.00,"1,448,968.98"
17-Oct-2025,Cash,"1,966,176.00",00.00,"3,415,144.98"
17-Oct-2025,Interest,72.80,00.00,"3,415,217.78"
17-Oct-2025,RTGS,16.00,00.00,"3,415,233.78"
17-Oct-2025,Cheque,02.00,00.00,"3,415,235.78"
17-Oct-2025,IMPS,384.22,00.00,"3,415,620.00"
17-Oct-2025,RTGS,"84,530.10",00.00,"3,500,150.10"
17-Oct-2025,Commission,05.10,00.00,"3,500,155.20"
17-Oct-2025,Purchase,04.15,00.00,"3,500,159.35"
17-Oct-2025,RTGS,00.00,"350,015.94","3,150,143.42"
17-Oct-2025,IMPS,269.00,00.00,"3,150,412.42"
17-Oct-2025,ATM,00.00,"525,068.74","2,625,343.68"
17-Oct-2025,Cash,00.00,"328,167.96","2,297,175.72"
17-Oct-2025,Miscellaneous,00.00,"229,717.57","2,067,458.15"
17-Oct-2025,Debit Card,51.60,00.00,"2,067,509.75"
17-Oct-2025,Tax,33.70,00.00,"2,067,543.45"
17-Oct-2025,NEFT,178.00,00.00,"2,067,721.45"
17-Oct-2025,NEFT,"1,521,899.80",00.00,"3,589,621.25"
17-Oct-2025,Bill,00.00,"512,803.04","3,076,818.21"
17-Oct-2025,NEFT,69.40,00.00,"3,076,887.61"
17-Oct-2025,IMPS,25.29,00.00,"3,076,912.90"
17-Oct-2025,IMPS,477.00,00.00,"3,077,389.90"
17-Oct-2025,Transfer,00.00,"1,025,796.63","2,051,593.27"
17-Oct-2025,ATM,00.00,"341,932.21","1,709,661.06"
17-Oct-2025,ATM,00.00,"244,237.29","1,465,423.77"
17-Oct-2025,Debit Card,00.00,"244,237.30","1,221,186.48"
17-Oct-2025,Cash,00.00,"203,531.08","1,017,655.40"
17-Oct-2025,Interest,00.00,"1,017,655.40",00.00
17-Oct-2025,Transfer,"159,660.10",00.00,"159,660.10"
17-Oct-2025,NEFT,270.74,00.00,"159,930.84"
17-Oct-2025,RTGS,00.00,"19,991.36","139,939.48"
17-Oct-2025,ATM,"689,754.00",00.00,"829,693.48"
17-Oct-2025,ATM,"123,893.50",00.00,"953,586.98"
17-Oct-2025,Purchase,59.96,00.00,"953,646.94"
17-Oct-2025,Commission,00.00,"95,364.69","858,282.25"
17-Oct-2025,Transfer,00.00,"171,656.45","686,625.80"
17-Oct-2025,Commission,117.00,00.00,"686,742.80"
17-Oct-2025,Cheque,"1,700,779.00",00.00,"2,387,521.80"
17-Oct-2025,NEFT,"2,082.95",00.00,"2,389,604.75"
18-Oct-2025,Bill,00.00,"298,700.59","2,090,904.16"
18-Oct-2025,Debit Card,"93,604.25",00.00,"2,184,508.41"
18-Oct-2025,ATM,00.00,"436,901.68","1,747,606.73"
18-Oct-2025,Transfer,33.60,00.00,"1,747,640.33"
18-Oct-2025,Purchase,00.00,"174,764.03","1,572,876.30"
18-Oct-2025,ATM,"1,208.15",00.00,"1,574,084.45"
18-Oct-2025,Miscellaneous,00.00,"787,042.23","787,042.22"
18-Oct-2025,IMPS,01.30,00.00,"787,043.52"
18-Oct-2025,Purchase,00.00,"78,704.35","708,339.17"
18-Oct-2025,NEFT,00.00,"70,833.92","637,505.25"
18-Oct-2025,NEFT,11.00,00.00,"637,516.25"
18-Oct-2025,Bill,"356,185.50",00.00,"993,701.75"
18-Oct-2025,NEFT,00.00,"331,233.92","662,467.83"
18-Oct-2025,ATM,00.00,"331,233.92","331,233.91"
18-Oct-2025,Tax,00.00,"33,123.39","298,110.52"
18-Oct-2025,Interest,"3,499.54",00.00,"301,610.06"
18-Oct-2025,Purchase,"778,252.00",00.00,"1,079,862.06"
18-Oct-2025,Cheque,00.00,"539,931.03","539,931.03"
18-Oct-2025,Reversal,00.00,"269,965.52","269,965.52"
18-Oct-2025,Cash,645.00,00.00,"270,610.52"
18-Oct-2025,Debit Card,00.00,"67,652.63","202,957.89"
18-Oct-2025,Commission,12.50,00.00,"202,970.39"
18-Oct-2025,Cheque,00.00,"67,656.80","135,313.59"
18-Oct-2025,Miscellaneous,00.00,"15,034.84","120,278.75"
18-Oct-2025,ATM,00.00,"20,046.46","100,232.29"
18-Oct-2025,IMPS,"130,180.00",00.00,"230,412.29"
18-Oct-2025,Purchase,01.91,00.00,"230,414.20"
18-Oct-2025,Cash,00.00,"23,041.42","207,372.78"
18-Oct-2025,Bill,00.00,"34,562.13","172,810.65"
19-Oct-2025,Cash,00.00,"43,202.66","129,607.99"
19-Oct-2025,NEFT,00.00,"129,607.99",00.00
19-Oct-2025,Bill,01.30,00.00,01.30
19-Oct-2025,Bill,"15,425.40",00.00,"15,426.70"
19-Oct-2025,Miscellaneous,00.00,"5,142.23","10,284.47"
19-Oct-2025,Debit Card,00.00,"2,571.12","7,713.35"
19-Oct-2025,Transfer,03.00,00.00,"7,716.35"
19-Oct-2025,ATM,"111,391.00",00.00,"119,107.35"
19-Oct-2025,Bill,05.20,00.00,"119,112.55"
19-Oct-2025,Tax,"2,488.00",00.00,"121,600.55"
19-Oct-2025,Tax,47.85,00.00,"121,648.40"
19-Oct-2025,Commission,00.00,"40,549.47","81,098.93"
19-Oct-2025,ATM,00.00,"27,032.98","54,065.95"
19-Oct-2025,Purchase,03.00,00.00,"54,068.95"
19-Oct-2025,Bill,00.00,"18,022.98","36,045.97"
19-Oct-2025,Interest,"2,621.10",00.00,"38,667.07"
19-Oct-2025,NEFT,182.00,00.00,"38,849.07"
19-Oct-2025,Miscellaneous,36.05,00.00,"38,885.12"
19-Oct-2025,NEFT,00.00,"12,961.71","25,923.41"
19-Oct-2025,Cash,00.00,"12,961.71","12,961.70"
19-Oct-2025,Purchase,00.00,"1,296.17","11,665.53"
19-Oct-2025,Cheque,"13,900.53",00.00,"25,566.06"
20-Oct-2025,Cheque,"29,599.00",00.00,"55,165.06"
20-Oct-2025,NEFT,121.36,00.00,"55,286.42"
20-Oct-2025,RTGS,06.32,00.00,"55,292.74"
20-Oct-2025,Miscellaneous,00.00,"6,911.59","48,381.15"
20-Oct-2025,Reversal,"17,919.00",00.00,"66,300.15"
20-Oct-2025,Miscellaneous,00.00,"6,630.02","59,670.13"
20-Oct-2025,Interest,00.00,"7,458.77","52,211.36"
20-Oct-2025,NEFT,00.00,"5,801.26","46,410.10"
20-Oct-2025,RTGS,00.00,"5,156.68","41,253.42"
20-Oct-2025,Debit Card,00.00,"8,250.68","33,002.74"
20-Oct-2025,Tax,"1,716.00",00.00,"34,718.74"
20-Oct-2025,Interest,677.90,00.00,"35,396.64"
20-Oct-2025,Cheque,00.00,"35,396.64",00.00
20-Oct-2025,Purchase,"1,076,976.25",00.00,"1,076,976.25"
20-Oct-2025,Interest,"1,721,042.00",00.00,"2,798,018.25"
20-Oct-2025,Reversal,70.00,00.00,"2,798,088.25"
20-Oct-2025,Transfer,"184,750.40",00.00,"2,982,838.65"
20-Oct-2025,Reversal,00.00,"331,426.52","2,651,412.13"
20-Oct-2025,IMPS,00.00,"378,773.16","2,272,638.97"
20-Oct-2025,Reversal,00.00,"757,546.32","1,515,092.65"
20-Oct-2025,Reversal,"2,288.00",00.00,"1,517,380.65"
20-Oct-2025,ATM,00.00,"151,738.07","1,365,642.58"
20-Oct-2025,Commission,08.00,00.00,"1,365,650.58"
20-Oct-2025,Reversal,00.00,"682,825.29","682,825.29"
20-Oct-2025,IMPS,00.00,"113,804.22","569,021.08"
20-Oct-2025,Cash,00.00,"284,510.54","284,510.54"
20-Oct-2025,Cash,00.00,"28,451.05","256,059.49"
20-Oct-2025,Commission,"14,187.61",00.00,"270,247.10"
21-Oct-2025,Cash,142.00,00.00,"270,389.10"
21-Oct-2025,Purchase,00.00,"38,627.01","231,762.09"
21-Oct-2025,Cash,"5,928.00",00.00,"237,690.09"
21-Oct-2025,Purchase,00.00,"237,690.09",00.00
21-Oct-2025,Debit Card,299.00,00.00,299.00
21-Oct-2025,Interest,00.00,59.80,239.20
21-Oct-2025,Miscellaneous,00.00,26.58,212.62
21-Oct-2025,Bill,00.00,30.37,182.25
21-Oct-2025,Cheque,00.00,30.38,151.88
21-Oct-2025,ATM,00.00,50.63,101.25
21-Oct-2025,ATM,00.00,33.75,67.50
21-Oct-2025,RTGS,00.00,16.88,50.62
21-Oct-2025,Purchase,"596,662.00",00.00,"596,712.62"
21-Oct-2025,ATM,00.00,"66,301.40","530,411.22"
21-Oct-2025,IMPS,00.00,"265,205.61","265,205.61"
21-Oct-2025,NEFT,00.00,"26,520.56","238,685.05"
21-Oct-2025,Purchase,00.00,"26,520.56","212,164.49"
21-Oct-2025,Debit Card,"2,618.80",00.00,"214,783.29"
21-Oct-2025,IMPS,"1,984,938.00",00.00,"2,199,721.29"
21-Oct-2025,NEFT,00.00,"274,965.16","1,924,756.13"
21-Oct-2025,Reversal,03.07,00.00,"1,924,759.20"
22-Oct-2025,IMPS,00.00,"1,924,759.20",00.00
22-Oct-2025,Debit Card,480.24,00.00,480.24
22-Oct-2025,ATM,00.00,68.61,411.63
22-Oct-2025,Interest,"22,921.00",00.00,"23,332.63"
22-Oct-2025,Purchase,07.70,00.00,"23,340.33"
22-Oct-2025,Reversal,"3,606.00",00.00,"26,946.33"
22-Oct-2025,Transfer,"288,076.00",00.00,"315,022.33"
22-Oct-2025,Purchase,00.00,"35,002.48","280,019.85"
23-Oct-2025,Cheque,00.00,"40,002.84","240,017.01"
23-Oct-2025,NEFT,00.00,"48,003.40","192,013.61"
24-Oct-2025,Debit Card,00.00,"48,003.40","144,010.21"
24-Oct-2025,Reversal,05.00,00.00,"144,015.21"
24-Oct-2025,Commission,303.49,00.00,"144,318.70"
24-Oct-2025,IMPS,00.00,"14,431.87","129,886.83"
24-Oct-2025,Transfer,00.00,"16,235.85","113,650.98"
24-Oct-2025,Cash,"3,885.00",00.00,"117,535.98"
24-Oct-2025,Cash,00.00,"16,790.85","100,745.13"
24-Oct-2025,Commission,"11,187.00",00.00,"111,932.13"
24-Oct-2025,Reversal,00.00,"12,436.90","99,495.23"
24-Oct-2025,NEFT,00.00,"19,899.05","79,596.18"
25-Oct-2025,Interest,00.00,"39,798.09","39,798.09"
25-Oct-2025,Purchase,00.00,"13,266.03","26,532.06"
25-Oct-2025,Interest,00.00,"13,266.03","13,266.03"
25-Oct-2025,Purchase,64.00,00.00,"13,330.03"
25-Oct-2025,Bill,00.00,"2,666.01","10,664.02"
25-Oct-2025,Debit Card,02.28,00.00,"10,666.30"
25-Oct-2025,Purchase,00.00,"5,333.15","5,333.15"
25-Oct-2025,Tax,00.00,"1,066.63","4,266.52"
25-Oct-2025,ATM,05.00,00.00,"4,271.52"
25-Oct-2025,Cash,00.00,"1,067.88","3,203.64"
25-Oct-2025,Transfer,"213,147.70",00.00,"216,351.34"
25-Oct-2025,ATM,"4,001.00",00.00,"220,352.34"
25-Oct-2025,Cash,283.74,00.00,"220,636.08"
25-Oct-2025,Commission,"1,495.84",00.00,"222,131.92"
25-Oct-2025,Purchase,"23,321.00",00.00,"245,452.92"
25-Oct-2025,Transfer,05.86,00.00,"245,458.78"
25-Oct-2025,Cash,509.00,00.00,"245,967.78"
25-Oct-2025,Cheque,"200,335.00",00.00,"446,302.78"
25-Oct-2025,Interest,07.00,00.00,"446,309.78"
25-Oct-2025,Miscellaneous,00.00,"44,630.98","401,678.80"
25-Oct-2025,RTGS,05.00,00.00,"401,683.80"
25-Oct-2025,Tax,"228,956.38",00.00,"630,640.18"
26-Oct-2025,Bill,16.00,00.00,"630,656.18"
26-Oct-2025,Cash,00.00,"630,656.18",00.00
26-Oct-2025,Reversal,383.70,00.00,383.70
26-Oct-2025,ATM,00.00,76.74,306.96
26-Oct-2025,ATM,"853,609.80",00.00,"853,916.76"
26-Oct-2025,Bill,00.00,"106,739.60","747,177.16"
26-Oct-2025,Miscellaneous,46.00,00.00,"747,223.16"
26-Oct-2025,Miscellaneous,00.00,"186,805.79","560,417.37"
26-Oct-2025,RTGS,00.00,"56,041.74","504,375.63"
26-Oct-2025,NEFT,00.00,"168,125.21","336,250.42"
26-Oct-2025,ATM,00.00,"56,041.74","280,208.68"
26-Oct-2025,Cash,00.00,"40,029.81","240,178.87"
26-Oct-2025,Transfer,00.00,"24,017.89","216,160.98"
26-Oct-2025,Debit Card,361.00,00.00,"216,521.98"
26-Oct-2025,Debit Card,06.80,00.00,"216,528.78"
26-Oct-2025,Reversal,"1,252,559.00",00.00,"1,469,087.78"
26-Oct-2025,IMPS,"139,140.30",00.00,"1,608,228.08"
26-Oct-2025,NEFT,00.00,"321,645.62","1,286,582.46"
26-Oct-2025,RTGS,573.40,00.00,"1,287,155.86"
26-Oct-2025,Tax,00.00,"160,894.48","1,126,261.38"
26-Oct-2025,Reversal,"332,277.80",00.00,"1,458,539.18"
26-Oct-2025,Reversal,43.00,00.00,"1,458,582.18"
26-Oct-2025,Tax,00.00,"486,194.06","972,388.12"
27-Oct-2025,Cheque,00.00,"138,912.59","833,475.53"
27-Oct-2025,Bill,452.00,00.00,"833,927.53"
27-Oct-2025,Cash,"1,926,902.50",00.00,"2,760,830.03"
27-Oct-2025,Interest,00.00,"345,103.75","2,415,726.28"
27-Oct-2025,NEFT,02.80,00.00,"2,415,729.08"
27-Oct-2025,Interest,"2,091,899.75",00.00,"4,507,628.83"
27-Oct-2025,Cash,00.00,"901,525.77","3,606,103.06"
27-Oct-2025,IMPS,642.00,00.00,"3,606,745.06"
27-Oct-2025,Cash,00.00,"400,749.45","3,205,995.61"
27-Oct-2025,Miscellaneous,00.00,"1,068,665.20","2,137,330.41"
27-Oct-2025,Interest,00.00,"534,332.60","1,602,997.81"
27-Oct-2025,Purchase,00.00,"178,110.87","1,424,886.94"
27-Oct-2025,Tax,00.00,"284,977.39","1,139,909.55"
27-Oct-2025,Miscellaneous,"1,386,369.75",00.00,"2,526,279.30"
27-Oct-2025,Cash,00.00,"315,784.91","2,210,494.39"
27-Oct-2025,Debit Card,"85,124.90",00.00,"2,295,619.29"
27-Oct-2025,Transfer,00.00,"382,603.22","1,913,016.08"
27-Oct-2025,Debit Card,06.40,00.00,"1,913,022.48"
27-Oct-2025,Interest,00.00,"318,837.08","1,594,185.40"
27-Oct-2025,RTGS,00.00,"159,418.54","1,434,766.86"
27-Oct-2025,Purchase,00.00,"717,383.43","717,383.43"
27-Oct-2025,Miscellaneous,04.79,00.00,"717,388.22"
27-Oct-2025,Cheque,"1,935,549.50",00.00,"2,652,937.72"
27-Oct-2025,Purchase,29.52,00.00,"2,652,967.24"
27-Oct-2025,ATM,00.00,"294,774.14","2,358,193.10"
27-Oct-2025,Cash,51.72,00.00,"2,358,244.82"
27-Oct-2025,Cheque,00.00,"336,892.12","2,021,352.70"
27-Oct-2025,Tax,08.00,00.00,"2,021,360.70"
28-Oct-2025,Transfer,00.00,"202,136.07","1,819,224.63"
28-Oct-2025,Purchase,00.00,"303,204.11","1,516,020.52"
28-Oct-2025,Bill,"203,866.40",00.00,"1,719,886.92"
28-Oct-2025,Transfer,"3,853.00",00.00,"1,723,739.92"
28-Oct-2025,Bill,00.00,"287,289.99","1,436,449.93"
28-Oct-2025,Debit Card,05.00,00.00,"1,436,454.93"
28-Oct-2025,Tax,"2,217.80",00.00,"1,438,672.73"
28-Oct-2025,Debit Card,"258,870.25",00.00,"1,697,542.98"
28-Oct-2025,Debit Card,00.00,"424,385.75","1,273,157.23"
28-Oct-2025,Commission,00.00,"318,289.31","954,867.92"
28-Oct-2025,Purchase,00.00,"318,289.31","636,578.61"
28-Oct-2025,Cash,00.00,"106,096.44","530,482.18"
28-Oct-2025,Debit Card,730.00,00.00,"531,212.18"
28-Oct-2025,Reversal,49.00,00.00,"531,261.18"
28-Oct-2025,Tax,00.00,"177,087.06","354,174.12"
28-Oct-2025,RTGS,43.93,00.00,"354,218.05"
28-Oct-2025,RTGS,00.00,"59,036.34","295,181.71"
28-Oct-2025,Reversal,00.00,"98,393.90","196,787.81"
28-Oct-2025,Tax,00.00,"28,112.54","168,675.27"
28-Oct-2025,Commission,115.70,00.00,"168,790.97"
28-Oct-2025,Commission,"26,897.00",00.00,"195,687.97"
28-Oct-2025,Tax,00.00,"97,843.99","97,843.98"
28-Oct-2025,Purchase,00.00,"48,921.99","48,921.99"
28-Oct-2025,NEFT,00.00,"12,230.50","36,691.49"
28-Oct-2025,Commission,00.00,"7,338.30","29,353.19"
28-Oct-2025,IMPS,"1,718,559.75",00.00,"1,747,912.94"
28-Oct-2025,Debit Card,"1,556.04",00.00,"1,749,468.98"
28-Oct-2025,Purchase,19.50,00.00,"1,749,488.48"
28-Oct-2025,Transfer,373.00,00.00,"1,749,861.48"
28-Oct-2025,RTGS,00.00,"218,732.69","1,531,128.80"
28-Oct-2025,Reversal,55.00,00.00,"1,531,183.80"
28-Oct-2025,Purchase,00.00,"153,118.38","1,378,065.42"
28-Oct-2025,Transfer,00.00,"229,677.57","1,148,387.85"
28-Oct-2025,Reversal,"1,287,206.00",00.00,"2,435,593.85"
28-Oct-2025,Cheque,"51,077.00",00.00,"2,486,670.85"
29-Oct-2025,Debit Card,140.40,00.00,"2,486,811.25"
29-Oct-2025,IMPS,402.20,00.00,"2,487,213.45"
29-Oct-2025,Commission,"2,000,024.75",00.00,"4,487,238.20"
29-Oct-2025,Bill,384.73,00.00,"4,487,622.93"
29-Oct-2025,RTGS,00.00,"560,952.87","3,926,670.06"
29-Oct-2025,Cash,00.00,"560,952.87","3,365,717.19"
29-Oct-2025,Bill,"2,569.00",00.00,"3,368,286.19"
29-Oct-2025,Debit Card,05.00,00.00,"3,368,291.19"
29-Oct-2025,RTGS,458.00,00.00,"3,368,749.19"
29-Oct-2025,Bill,00.00,"1,122,916.40","2,245,832.79"
29-Oct-2025,NEFT,"10,589.50",00.00,"2,256,422.29"
29-Oct-2025,Miscellaneous,"13,894.00",00.00,"2,270,316.29"
30-Oct-2025,RTGS,00.00,"227,031.63","2,043,284.66"
30-Oct-2025,RTGS,238.97,00.00,"2,043,523.63"
30-Oct-2025,Commission,00.00,"2,043,523.63",00.00
30-Oct-2025,Debit Card,"66,554.90",00.00,"66,554.90"
30-Oct-2025,Bill,00.00,"33,277.45","33,277.45"
30-Oct-2025,Cheque,49.70,00.00,"33,327.15"
30-Oct-2025,Interest,00.00,"4,761.02","28,566.13"
30-Oct-2025,NEFT,00.00,"3,570.77","24,995.36"
30-Oct-2025,NEFT,23.00,00.00,"25,018.36"
30-Oct-2025,Reversal,"616,044.00",00.00,"641,062.36"
30-Oct-2025,Reversal,"750,648.00",00.00,"1,391,710.36"
30-Oct-2025,Transfer,"438,125.50",00.00,"1,829,835.86"
30-Oct-2025,Reversal,00.00,"457,458.97","1,372,376.90"
30-Oct-2025,Miscellaneous,00.00,"1,372,376.90",00.00
30-Oct-2025,IMPS,06.00,00.00,06.00
30-Oct-2025,NEFT,"25,122.63",00.00,"25,128.63"
30-Oct-2025,Reversal,"1,601,152.00",00.00,"1,626,280.63"
30-Oct-2025,Bill,00.00,"271,046.77","1,355,233.86"
30-Oct-2025,Bill,00.00,"451,744.62","903,489.24"
30-Oct-2025,Debit Card,05.40,00.00,"903,494.64"
30-Oct-2025,Commission,00.00,"903,494.64",00.00
30-Oct-2025,Commission,08.90,00.00,08.90
30-Oct-2025,RTGS,"1,883,824.80",00.00,"1,883,833.70"
30-Oct-2025,Miscellaneous,00.00,"209,314.86","1,674,518.84"
30-Oct-2025,Cash,00.00,"418,629.71","1,255,889.13"
30-Oct-2025,Reversal,00.00,"139,543.24","1,116,345.89"
30-Oct-2025,Transfer,00.00,"159,477.98","956,867.91"
30-Oct-2025,Transfer,318.60,00.00,"957,186.51"
31-Oct-2025,NEFT,07.03,00.00,"957,193.54"
01-Nov-2025,Tax,178.00,00.00,"957,371.54"
01-Nov-2025,Commission,338.00,00.00,"957,709.54"
01-Nov-2025,NEFT,"190,266.56",00.00,"1,147,976.10"
01-Nov-2025,IMPS,"119,449.50",00.00,"1,267,425.60"
01-Nov-2025,NEFT,00.00,"1,267,425.60",00.00
01-Nov-2025,Cash,45.00,00.00,45.00
01-Nov-2025,RTGS,00.00,15.00,30.00
01-Nov-2025,IMPS,00.00,03.00,27.00
01-Nov-2025,Purchase,"449,529.00",00.00,"449,556.00"
01-Nov-2025,Debit Card,"6,698.90",00.00,"456,254.90"
01-Nov-2025,Commission,54.50,00.00,"456,309.40"
01-Nov-2025,IMPS,00.00,"57,038.68","399,270.72"
01-Nov-2025,RTGS,00.00,"79,854.14","319,416.58"
01-Nov-2025,IMPS,"252,650.00",00.00,"572,066.58"
01-Nov-2025,Purchase,00.00,"286,033.29","286,033.29"
01-Nov-2025,NEFT,00.00,"57,206.66","228,826.63"
01-Nov-2025,Interest,00.00,"38,137.77","190,688.86"
01-Nov-2025,Interest,310.78,00.00,"190,999.64"
01-Nov-2025,ATM,"304,384.50",00.00,"495,384.14"
01-Nov-2025,Cash,00.00,"247,692.07","247,692.07"
01-Nov-2025,Cash,"122,711.25",00.00,"370,403.32"
01-Nov-2025,Cash,"2,905.00",00.00,"373,308.32"
01-Nov-2025,RTGS,"3,923.40",00.00,"377,231.72"
01-Nov-2025,Interest,497.40,00.00,"377,729.12"
01-Nov-2025,Miscellaneous,22.27,00.00,"377,751.39"
01-Nov-2025,Reversal,00.00,"188,875.70","188,875.70"
01-Nov-2025,IMPS,"413,782.00",00.00,"602,657.70"
01-Nov-2025,Tax,00.00,"75,332.21","527,325.49"
01-Nov-2025,IMPS,"2,812.00",00.00,"530,137.49"
01-Nov-2025,Interest,00.00,"530,137.49",00.00
01-Nov-2025,Reversal,"1,396,081.50",00.00,"1,396,081.50"
01-Nov-2025,Purchase,02.00,00.00,"1,396,083.50"
01-Nov-2025,Transfer,00.00,"139,608.35","1,256,475.15"
01-Nov-2025,ATM,00.00,"209,412.53","1,047,062.62"
01-Nov-2025,Cash,00.00,"116,340.29","930,722.33"
01-Nov-2025,Interest,"236,525.00",00.00,"1,167,247.33"
01-Nov-2025,Interest,00.00,"1,167,247.33",00.00
02-Nov-2025,Bill,"2,046,945.80",00.00,"2,046,945.80"
02-Nov-2025,RTGS,"1,077,895.50",00.00,"3,124,841.30"
02-Nov-2025,Tax,00.00,"1,041,613.77","2,083,227.53"
02-Nov-2025,Miscellaneous,00.00,"231,469.73","1,851,757.80"
02-Nov-2025,Tax,00.00,"370,351.56","1,481,406.24"
02-Nov-2025,Reversal,00.00,"1,481,406.24",00.00
02-Nov-2025,Debit Card,20.10,00.00,20.10
03-Nov-2025,IMPS,00.00,02.51,17.59
03-Nov-2025,RTGS,"1,585.20",00.00,"1,602.79"
04-Nov-2025,Cash,"4,027.06",00.00,"5,629.85"
04-Nov-2025,Purchase,"1,116.00",00.00,"6,745.85"
04-Nov-2025,ATM,481.40,00.00,"7,227.25"
04-Nov-2025,Cash,00.20,00.00,"7,227.45"
04-Nov-2025,NEFT,"193,835.10",00.00,"201,062.55"
04-Nov-2025,Reversal,"221,302.00",00.00,"422,364.55"
04-Nov-2025,Debit Card,00.00,"211,182.28","211,182.28"
04-Nov-2025,Cheque,00.00,"21,118.23","190,064.05"
04-Nov-2025,Reversal,"26,336.80",00.00,"216,400.85"
04-Nov-2025,Interest,00.00,"24,044.54","192,356.31"
04-Nov-2025,Cash,"343,741.00",00.00,"536,097.31"
04-Nov-2025,Tax,37.00,00.00,"536,134.31"
04-Nov-2025,Tax,205.00,00.00,"536,339.31"
04-Nov-2025,Debit Card,00.00,"76,619.90","459,719.41"
04-Nov-2025,Cash,"5,681.00",00.00,"465,400.41"
04-Nov-2025,RTGS,"1,341,172.00",00.00,"1,806,572.41"
04-Nov-2025,Cash,00.00,"180,657.24","1,625,915.17"
04-Nov-2025,Transfer,00.00,"232,273.60","1,393,641.57"
04-Nov-2025,IMPS,00.00,"154,849.06","1,238,792.51"
04-Nov-2025,NEFT,00.00,"176,970.36","1,061,822.15"
04-Nov-2025,Debit Card,05.00,00.00,"1,061,827.15"
04-Nov-2025,Cash,00.00,"1,061,827.15",00.00
04-Nov-2025,Purchase,760.00,00.00,760.00
04-Nov-2025,Transfer,00.00,108.57,651.43
04-Nov-2025,Miscellaneous,00.00,93.06,558.37
04-Nov-2025,RTGS,54.30,00.00,612.67
04-Nov-2025,Debit Card,"139,893.10",00.00,"140,505.77"
04-Nov-2025,Transfer,"5,756.00",00.00,"146,261.77"
04-Nov-2025,Debit Card,"6,547.00",00.00,"152,808.77"
05-Nov-2025,Cash,00.00,"19,101.10","133,707.67"
05-Nov-2025,IMPS,07.00,00.00,"133,714.67"
05-Nov-2025,Transfer,00.00,"33,428.67","100,286.00"
05-Nov-2025,IMPS,03.43,00.00,"100,289.43"
05-Nov-2025,Cash,00.00,"16,714.91","83,574.52"
05-Nov-2025,Debit Card,00.00,"83,574.52",00.00
05-Nov-2025,Cheque,07.20,00.00,07.20
05-Nov-2025,IMPS,00.00,02.40,04.80
05-Nov-2025,Transfer,"166,217.03",00.00,"166,221.83"
05-Nov-2025,Tax,00.00,"33,244.37","132,977.46"
05-Nov-2025,IMPS,05.00,00.00,"132,982.46"
05-Nov-2025,Transfer,00.00,"13,298.25","119,684.21"
05-Nov-2025,RTGS,00.00,"29,921.05","89,763.16"
05-Nov-2025,Miscellaneous,21.52,00.00,"89,784.68"
05-Nov-2025,Interest,00.00,"9,976.08","79,808.60"
05-Nov-2025,Tax,"8,404.00",00.00,"88,212.60"
05-Nov-2025,RTGS,00.00,"9,801.40","78,411.20"
05-Nov-2025,Miscellaneous,00.00,"13,068.53","65,342.67"
05-Nov-2025,Cheque,"6,392.18",00.00,"71,734.85"
05-Nov-2025,RTGS,998.00,00.00,"72,732.85"
05-Nov-2025,RTGS,00.00,"72,732.85",00.00
05-Nov-2025,RTGS,"3,230.00",00.00,"3,230.00"
05-Nov-2025,Interest,07.10,00.00,"3,237.10"
05-Nov-2025,ATM,"22,155.40",00.00,"25,392.50"
05-Nov-2025,ATM,00.00,"3,627.50","21,765.00"
05-Nov-2025,RTGS,"6,571.34",00.00,"28,336.34"
05-Nov-2025,IMPS,00.00,"5,667.27","22,669.07"
05-Nov-2025,Purchase,"1,074,488.00",00.00,"1,097,157.07"
05-Nov-2025,Cash,"2,084.90",00.00,"1,099,241.97"
05-Nov-2025,Interest,"3,750.00",00.00,"1,102,991.97"
05-Nov-2025,Miscellaneous,07.79,00.00,"1,102,999.76"
05-Nov-2025,RTGS,"868,146.00",00.00,"1,971,145.76"
05-Nov-2025,Miscellaneous,00.00,"219,016.20","1,752,129.56"
05-Nov-2025,Cheque,00.00,"292,021.59","1,460,107.97"
05-Nov-2025,Interest,44.00,00.00,"1,460,151.97"
05-Nov-2025,ATM,00.00,"486,717.32","973,434.65"
06-Nov-2025,Tax,"3,727.50",00.00,"977,162.15"
06-Nov-2025,Debit Card,"133,686.88",00.00,"1,110,849.03"
06-Nov-2025,RTGS,"19,859.20",00.00,"1,130,708.23"
06-Nov-2025,Debit Card,"2,357.00",00.00,"1,133,065.23"
06-Nov-2025,Bill,"67,356.00",00.00,"1,200,421.23"
06-Nov-2025,Interest,00.00,"120,042.12","1,080,379.11"
06-Nov-2025,Transfer,"23,350.00",00.00,"1,103,729.11"
06-Nov-2025,Interest,00.00,"551,864.56","551,864.56"
06-Nov-2025,Commission,00.00,"137,966.14","413,898.42"
06-Nov-2025,IMPS,"161,229.60",00.00,"575,128.02"
06-Nov-2025,Interest,00.00,"82,161.15","492,966.87"
06-Nov-2025,Transfer,00.00,"82,161.15","410,805.72"
06-Nov-2025,Cash,187.10,00.00,"410,992.82"
06-Nov-2025,Tax,00.00,"410,992.82",00.00
06-Nov-2025,ATM,"14,516.60",00.00,"14,516.60"
06-Nov-2025,Interest,00.00,"4,838.87","9,677.73"
06-Nov-2025,Bill,"3,923.80",00.00,"13,601.53"
06-Nov-2025,Cheque,00.00,"2,266.92","11,334.61"
06-Nov-2025,IMPS,00.00,"1,259.40","10,075.21"
06-Nov-2025,IMPS,53.80,00.00,"10,129.01"
06-Nov-2025,Commission,31.40,00.00,"10,160.41"
06-Nov-2025,NEFT,55.00,00.00,"10,215.41"
07-Nov-2025,RTGS,00.00,"10,215.41",00.00
07-Nov-2025,Cheque,"206,673.94",00.00,"206,673.94"
07-Nov-2025,NEFT,00.00,"20,667.39","186,006.55"
07-Nov-2025,Bill,00.00,"23,250.82","162,755.73"
07-Nov-2025,ATM,"1,356.40",00.00,"164,112.13"
07-Nov-2025,Purchase,"13,318.00",00.00,"177,430.13"
07-Nov-2025,RTGS,00.00,"44,357.53","133,072.60"
07-Nov-2025,Cash,"16,410.56",00.00,"149,483.16"
08-Nov-2025,Cash,249.84,00.00,"149,733.00"
08-Nov-2025,Bill,"6,065.00",00.00,"155,798.00"
08-Nov-2025,Miscellaneous,329.00,00.00,"156,127.00"
08-Nov-2025,Debit Card,710.00,00.00,"156,837.00"
08-Nov-2025,RTGS,02.09,00.00,"156,839.09"
08-Nov-2025,IMPS,"10,393.51",00.00,"167,232.60"
08-Nov-2025,Cash,00.00,"33,446.52","133,786.08"
09-Nov-2025,Transfer,00.00,"26,757.22","107,028.86"
09-Nov-2025,Commission,01.00,00.00,"107,029.86"
09-Nov-2025,Interest,"6,513.00",00.00,"113,542.86"
09-Nov-2025,Cash,"15,952.40",00.00,"129,495.26"
09-Nov-2025,IMPS,00.00,"16,186.91","113,308.35"
09-Nov-2025,RTGS,00.00,"12,589.82","100,718.53"
09-Nov-2025,RTGS,"3,804.90",00.00,"104,523.43"
09-Nov-2025,Interest,"31,933.00",00.00,"136,456.43"
09-Nov-2025,NEFT,00.00,"45,485.48","90,970.95"
09-Nov-2025,Bill,00.00,"45,485.48","45,485.48"
09-Nov-2025,Transfer,06.00,00.00,"45,491.48"
09-Nov-2025,NEFT,00.00,"15,163.83","30,327.65"
09-Nov-2025,Transfer,00.00,"3,369.74","26,957.91"
09-Nov-2025,Reversal,00.00,"6,739.48","20,218.43"
09-Nov-2025,IMPS,"3,469.77",00.00,"23,688.20"
09-Nov-2025,Transfer,00.00,"7,896.07","15,792.13"
09-Nov-2025,Interest,07.15,00.00,"15,799.28"
09-Nov-2025,Cheque,00.00,"3,949.82","11,849.46"
09-Nov-2025,ATM,00.00,"3,949.82","7,899.64"
09-Nov-2025,Interest,"2,064,615.00",00.00,"2,072,514.64"
09-Nov-2025,Cash,56.00,00.00,"2,072,570.64"
09-Nov-2025,Purchase,"1,435,957.00",00.00,"3,508,527.64"
09-Nov-2025,Debit Card,00.00,"350,852.76","3,157,674.88"
09-Nov-2025,Commission,"32,187.00",00.00,"3,189,861.88"
09-Nov-2025,Cheque,00.00,"531,643.65","2,658,218.23"
09-Nov-2025,Interest,00.00,"886,072.74","1,772,145.49"
09-Nov-2025,Cash,00.00,"177,214.55","1,594,930.94"
09-Nov-2025,Debit Card,07.30,00.00,"1,594,938.24"
09-Nov-2025,Interest,00.00,"199,367.28","1,395,570.96"
09-Nov-2025,Tax,06.62,00.00,"1,395,577.58"
09-Nov-2025,Interest,"1,125.00",00.00,"1,396,702.58"
09-Nov-2025,Debit Card,00.00,"1,396,702.58",00.00
09-Nov-2025,NEFT,42.80,00.00,42.80
09-Nov-2025,Cash,31.00,00.00,73.80
09-Nov-2025,Commission,"25,654.30",00.00,"25,728.10"
09-Nov-2025,Transfer,00.00,"4,288.02","21,440.08"
09-Nov-2025,Bill,"1,031,709.00",00.00,"1,053,149.08"
09-Nov-2025,Bill,00.00,"526,574.54","526,574.54"
09-Nov-2025,Reversal,00.00,"175,524.85","351,049.69"
09-Nov-2025,ATM,00.00,"70,209.94","280,839.75"
09-Nov-2025,Bill,00.00,"31,204.42","249,635.33"
09-Nov-2025,Cheque,"4,202.47",00.00,"253,837.80"
09-Nov-2025,Transfer,00.00,"42,306.30","211,531.50"
09-Nov-2025,Debit Card,00.00,"30,218.79","181,312.71"
09-Nov-2025,Transfer,00.00,"45,328.18","135,984.53"
09-Nov-2025,Transfer,00.00,"67,992.27","67,992.26"
09-Nov-2025,Reversal,00.00,"13,598.45","54,393.81"
09-Nov-2025,RTGS,00.00,"6,799.23","47,594.58"
09-Nov-2025,Purchase,"18,795.75",00.00,"66,390.33"
09-Nov-2025,Miscellaneous,172.70,00.00,"66,563.03"
09-Nov-2025,Reversal,41.00,00.00,"66,604.03"
09-Nov-2025,Tax,"9,825.99",00.00,"76,430.02"
10-Nov-2025,Reversal,00.00,"7,643.00","68,787.02"
10-Nov-2025,Interest,"26,269.00",00.00,"95,056.02"
10-Nov-2025,Transfer,00.00,"11,882.00","83,174.02"
10-Nov-2025,Bill,00.00,"13,862.34","69,311.68"
10-Nov-2025,Commission,"120,586.50",00.00,"189,898.18"
10-Nov-2025,Purchase,00.00,"189,898.18",00.00
10-Nov-2025,NEFT,"112,730.70",00.00,"112,730.70"
10-Nov-2025,Miscellaneous,00.00,"16,104.39","96,626.31"
10-Nov-2025,Interest,220.98,00.00,"96,847.29"
10-Nov-2025,Miscellaneous,00.00,"96,847.29",00.00
10-Nov-2025,Cheque,"6,492.26",00.00,"6,492.26"
10-Nov-2025,Bill,"163,477.00",00.00,"169,969.26"
10-Nov-2025,IMPS,"14,639.16",00.00,"184,608.42"
10-Nov-2025,Tax,"165,276.70",00.00,"349,885.12"
10-Nov-2025,Tax,00.00,"49,983.59","299,901.53"
10-Nov-2025,Cash,"639,819.00",00.00,"939,720.53"
10-Nov-2025,Transfer,00.00,"156,620.09","783,100.44"
10-Nov-2025,Transfer,00.00,"261,033.48","522,066.96"
11-Nov-2025,Miscellaneous,00.00,"174,022.32","348,044.64"
11-Nov-2025,Purchase,00.00,"116,014.88","232,029.76"
11-Nov-2025,Cash,00.00,"33,147.11","198,882.65"
11-Nov-2025,IMPS,"3,445.21",00.00,"202,327.86"
11-Nov-2025,Purchase,00.00,"50,581.97","151,745.89"
11-Nov-2025,Transfer,08.00,00.00,"151,753.89"
11-Nov-2025,Interest,07.94,00.00,"151,761.83"
11-Nov-2025,Purchase,00.00,"151,761.83",00.00
11-Nov-2025,Interest,24.41,00.00,24.41
11-Nov-2025,Transfer,"22,939.80",00.00,"22,964.21"
11-Nov-2025,RTGS,00.00,"11,482.11","11,482.10"
11-Nov-2025,Interest,"27,690.00",00.00,"39,172.10"
11-Nov-2025,Bill,00.00,"4,896.51","34,275.59"
11-Nov-2025,Interest,"1,398,807.25",00.00,"1,433,082.84"
11-Nov-2025,Reversal,00.00,"179,135.36","1,253,947.49"
11-Nov-2025,RTGS,00.00,"626,973.75","626,973.74"
11-Nov-2025,Reversal,"18,146.29",00.00,"645,120.03"
11-Nov-2025,Tax,00.00,"92,160.00","552,960.03"
11-Nov-2025,NEFT,59.35,00.00,"553,019.38"
11-Nov-2025,RTGS,00.70,00.00,"553,020.08"
11-Nov-2025,Cheque,00.00,"184,340.03","368,680.05"
11-Nov-2025,Transfer,00.00,"52,668.58","316,011.47"
11-Nov-2025,Reversal,00.00,"45,144.50","270,866.97"
11-Nov-2025,Miscellaneous,00.00,"38,695.28","232,171.69"
11-Nov-2025,Debit Card,"219,501.00",00.00,"451,672.69"
11-Nov-2025,RTGS,321.63,00.00,"451,994.32"
11-Nov-2025,Reversal,00.00,"90,398.86","361,595.46"
11-Nov-2025,NEFT,00.00,"120,531.82","241,063.64"
11-Nov-2025,Cheque,00.00,"34,437.66","206,625.98"
11-Nov-2025,IMPS,00.00,"41,325.20","165,300.78"
11-Nov-2025,NEFT,06.40,00.00,"165,307.18"
11-Nov-2025,IMPS,189.80,00.00,"165,496.98"
12-Nov-2025,IMPS,"154,007.80",00.00,"319,504.78"
12-Nov-2025,Purchase,00.00,"319,504.78",00.00
12-Nov-2025,IMPS,31.00,00.00,31.00
12-Nov-2025,Debit Card,00.00,07.75,23.25
12-Nov-2025,ATM,00.00,02.58,20.67
12-Nov-2025,Bill,443.00,00.00,463.67
12-Nov-2025,Transfer,"105,760.38",00.00,"106,224.05"
12-Nov-2025,NEFT,"170,886.80",00.00,"277,110.85"
12-Nov-2025,Tax,26.00,00.00,"277,136.85"
12-Nov-2025,Cash,00.00,"30,792.98","246,343.87"
12-Nov-2025,NEFT,00.00,"27,371.54","218,972.33"
12-Nov-2025,IMPS,"138,353.20",00.00,"357,325.53"
12-Nov-2025,IMPS,122.00,00.00,"357,447.53"
12-Nov-2025,Interest,00.00,"39,716.39","317,731.14"
12-Nov-2025,Cheque,"1,514.89",00.00,"319,246.03"
12-Nov-2025,Bill,"119,663.59",00.00,"438,909.62"
12-Nov-2025,Purchase,00.00,"219,454.81","219,454.81"
12-Nov-2025,Interest,"8,562.00",00.00,"228,016.81"
12-Nov-2025,Cash,00.00,"28,502.10","199,514.71"
12-Nov-2025,IMPS,"495,631.75",00.00,"695,146.46"
12-Nov-2025,Cash,00.00,"347,573.23","347,573.23"
13-Nov-2025,NEFT,"2,677.92",00.00,"350,251.15"
13-Nov-2025,Miscellaneous,00.00,"58,375.19","291,875.96"
13-Nov-2025,Purchase,"129,448.00",00.00,"421,323.96"
13-Nov-2025,Bill,"1,976,256.50",00.00,"2,397,580.46"
13-Nov-2025,RTGS,00.00,"1,198,790.23","1,198,790.23"
13-Nov-2025,Bill,"1,134,970.00",00.00,"2,333,760.23"
13-Nov-2025,Transfer,01.47,00.00,"2,333,761.70"
13-Nov-2025,Interest,00.00,"583,440.43","1,750,321.28"
13-Nov-2025,Bill,425.20,00.00,"1,750,746.48"
14-Nov-2025,Debit Card,"3,505.00",00.00,"1,754,251.48"
14-Nov-2025,Cash,"2,886.00",00.00,"1,757,137.48"
14-Nov-2025,Reversal,465.50,00.00,"1,757,602.98"
14-Nov-2025,Reversal,35.50,00.00,"1,757,638.48"
15-Nov-2025,NEFT,07.80,00.00,"1,757,646.28"
15-Nov-2025,NEFT,02.50,00.00,"1,757,648.78"
15-Nov-2025,Miscellaneous,465.00,00.00,"1,758,113.78"
15-Nov-2025,Bill,00.00,"879,056.89","879,056.89"
16-Nov-2025,Purchase,"93,915.40",00.00,"972,972.29"
16-Nov-2025,Commission,00.00,"108,108.03","864,864.26"
16-Nov-2025,Cash,"73,117.60",00.00,"937,981.86"
16-Nov-2025,IMPS,"252,548.50",00.00,"1,190,530.36"
16-Nov-2025,Interest,00.00,"119,053.04","1,071,477.32"
16-Nov-2025,Cash,"220,308.00",00.00,"1,291,785.32"
16-Nov-2025,Tax,00.00,"129,178.53","1,162,606.79"
16-Nov-2025,Cash,00.00,"193,767.80","968,838.99"
16-Nov-2025,NEFT,00.00,"161,473.17","807,365.82"
16-Nov-2025,Interest,00.00,"161,473.16","645,892.66"
16-Nov-2025,Tax,00.00,"215,297.55","430,595.11"
16-Nov-2025,Purchase,"2,052,362.00",00.00,"2,482,957.11"
16-Nov-2025,Interest,300.93,00.00,"2,483,258.04"
16-Nov-2025,Miscellaneous,00.00,"1,241,629.02","1,241,629.02"
16-Nov-2025,Debit Card,"252,443.70",00.00,"1,494,072.72"
16-Nov-2025,IMPS,03.00,00.00,"1,494,075.72"
16-Nov-2025,Bill,140.30,00.00,"1,494,216.02"
16-Nov-2025,IMPS,00.00,"498,072.01","996,144.01"
16-Nov-2025,IMPS,00.00,"332,048.00","664,096.01"
16-Nov-2025,Purchase,00.00,"132,819.20","531,276.81"
16-Nov-2025,Cash,00.00,"132,819.20","398,457.61"
16-Nov-2025,Bill,47.30,00.00,"398,504.91"
16-Nov-2025,RTGS,00.00,"49,813.11","348,691.80"
16-Nov-2025,Reversal,07.00,00.00,"348,698.80"
16-Nov-2025,NEFT,"17,141.95",00.00,"365,840.75"
16-Nov-2025,Reversal,00.00,"121,946.92","243,893.83"
16-Nov-2025,NEFT,00.00,"40,648.97","203,244.86"
16-Nov-2025,IMPS,00.00,"29,034.98","174,209.88"
16-Nov-2025,Commission,00.00,"17,420.99","156,788.89"
16-Nov-2025,Cash,240.98,00.00,"157,029.87"
16-Nov-2025,IMPS,11.20,00.00,"157,041.07"
16-Nov-2025,Reversal,00.00,"26,173.51","130,867.56"
16-Nov-2025,Cheque,39.00,00.00,"130,906.56"
16-Nov-2025,Cheque,00.00,"43,635.52","87,271.04"
16-Nov-2025,Interest,"1,549,636.50",00.00,"1,636,907.54"
16-Nov-2025,Bill,00.00,"204,613.44","1,432,294.10"
16-Nov-2025,Purchase,00.00,"716,147.05","716,147.05"
16-Nov-2025,Tax,00.00,"119,357.84","596,789.21"
16-Nov-2025,RTGS,36.52,00.00,"596,825.73"
16-Nov-2025,RTGS,00.00,"99,470.96","497,354.78"
16-Nov-2025,Debit Card,35.20,00.00,"497,389.98"
16-Nov-2025,Commission,"12,205.00",00.00,"509,594.98"
16-Nov-2025,Cheque,00.00,"63,699.37","445,895.61"
16-Nov-2025,Reversal,00.00,"74,315.94","371,579.68"
16-Nov-2025,ATM,00.00,"123,859.89","247,719.79"
16-Nov-2025,Reversal,"2,983.00",00.00,"250,702.79"
16-Nov-2025,Miscellaneous,00.00,"62,675.70","188,027.09"
16-Nov-2025,Miscellaneous,00.00,"31,337.85","156,689.24"
16-Nov-2025,Interest,00.00,"19,586.16","137,103.08"
16-Nov-2025,Debit Card,"1,209,714.75",00.00,"1,346,817.83"
16-Nov-2025,Transfer,"18,018.00",00.00,"1,364,835.83"
16-Nov-2025,ATM,"30,844.13",00.00,"1,395,679.96"
16-Nov-2025,Miscellaneous,"2,811.60",00.00,"1,398,491.56"
17-Nov-2025,Commission,06.00,00.00,"1,398,497.56"
17-Nov-2025,Transfer,"728,139.50",00.00,"2,126,637.06"
17-Nov-2025,Miscellaneous,"16,437.00",00.00,"2,143,074.06"
17-Nov-2025,Purchase,35.00,00.00,"2,143,109.06"
18-Nov-2025,Bill,19.11,00.00,"2,143,128.17"
18-Nov-2025,IMPS,"164,088.80",00.00,"2,307,216.97"
18-Nov-2025,Interest,00.00,"230,721.70","2,076,495.27"
18-Nov-2025,Commission,00.00,"2,076,495.27",00.00
18-Nov-2025,Cash,05.00,00.00,05.00
18-Nov-2025,NEFT,04.00,00.00,09.00
18-Nov-2025,Debit Card,00.00,01.13,07.88
18-Nov-2025,RTGS,00.00,00.88,07.00
18-Nov-2025,Tax,381.50,00.00,388.50
18-Nov-2025,Cash,276.00,00.00,664.50
18-Nov-2025,Miscellaneous,240.66,00.00,905.16
18-Nov-2025,Cash,02.00,00.00,907.16
18-Nov-2025,Transfer,00.00,226.79,680.37
18-Nov-2025,RTGS,00.00,75.60,604.77
18-Nov-2025,Interest,00.00,86.40,518.37
18-Nov-2025,RTGS,00.00,129.59,388.78
18-Nov-2025,Cash,"3,035.00",00.00,"3,423.78"
18-Nov-2025,RTGS,00.00,"1,711.89","1,711.89"
18-Nov-2025,RTGS,00.00,190.21,"1,521.68"
18-Nov-2025,RTGS,35.13,00.00,"1,556.81"
18-Nov-2025,Cheque,"18,853.00",00.00,"20,409.81"
18-Nov-2025,Bill,00.00,"10,204.91","10,204.91"
18-Nov-2025,Transfer,00.00,"10,204.91",00.00
18-Nov-2025,Transfer,"2,240.20",00.00,"2,240.20"
18-Nov-2025,Interest,"755,083.00",00.00,"757,323.20"
18-Nov-2025,IMPS,00.00,"126,220.53","631,102.67"
18-Nov-2025,IMPS,00.00,"210,367.56","420,735.11"
18-Nov-2025,Miscellaneous,00.00,"140,245.04","280,490.07"
18-Nov-2025,IMPS,07.40,00.00,"280,497.47"
18-Nov-2025,Cheque,159.00,00.00,"280,656.47"
18-Nov-2025,RTGS,00.00,"56,131.29","224,525.18"
18-Nov-2025,Tax,43.40,00.00,"224,568.58"
18-Nov-2025,NEFT,59.30,00.00,"224,627.88"
18-Nov-2025,Commission,00.00,"112,313.94","112,313.94"
18-Nov-2025,Interest,00.00,"28,078.49","84,235.46"
18-Nov-2025,Transfer,"279,032.00",00.00,"363,267.46"
18-Nov-2025,Miscellaneous,00.00,"90,816.87","272,450.60"
18-Nov-2025,Cash,"14,728.90",00.00,"287,179.50"
18-Nov-2025,Cheque,"19,666.00",00.00,"306,845.50"
18-Nov-2025,IMPS,00.00,"30,684.55","276,160.95"
18-Nov-2025,RTGS,00.00,"276,160.95",00.00
18-Nov-2025,Debit Card,"14,135.80",00.00,"14,135.80"
18-Nov-2025,Cheque,00.00,"2,355.97","11,779.83"
18-Nov-2025,ATM,02.00,00.00,"11,781.83"
18-Nov-2025,Transfer,00.00,"11,781.83",00.00
18-Nov-2025,IMPS,"168,106.00",00.00,"168,106.00"
18-Nov-2025,Reversal,00.00,"28,017.67","140,088.33"
18-Nov-2025,Transfer,"4,419.00",00.00,"144,507.33"
18-Nov-2025,NEFT,03.60,00.00,"144,510.93"
18-Nov-2025,Tax,"767,050.00",00.00,"911,560.93"
18-Nov-2025,Cheque,00.00,"151,926.82","759,634.11"
18-Nov-2025,NEFT,00.00,"379,817.06","379,817.06"
18-Nov-2025,Debit Card,"1,027,183.80",00.00,"1,407,000.86"
18-Nov-2025,Miscellaneous,00.00,"1,407,000.86",00.00
18-Nov-2025,Cheque,03.94,00.00,03.94
19-Nov-2025,ATM,04.49,00.00,08.43
19-Nov-2025,Reversal,00.00,02.11,06.32
19-Nov-2025,Debit Card,00.00,06.32,00.00
19-Nov-2025,Tax,402.00,00.00,402.00
19-Nov-2025,ATM,451.80,00.00,853.80
20-Nov-2025,Cheque,00.00,213.45,640.35
20-Nov-2025,RTGS,04.00,00.00,644.35
20-Nov-2025,Cash,00.00,644.35,00.00
20-Nov-2025,Cash,42.51,00.00,42.51
20-Nov-2025,Bill,00.00,04.25,38.26
20-Nov-2025,Cash,00.00,04.78,33.48
20-Nov-2025,Cheque,00.00,06.70,26.78
20-Nov-2025,Debit Card,471.00,00.00,497.78
20-Nov-2025,Interest,"2,382.49",00.00,"2,880.27"
20-Nov-2025,Purchase,"31,382.30",00.00,"34,262.57"
20-Nov-2025,Purchase,00.00,"3,806.95","30,455.62"
20-Nov-2025,RTGS,04.90,00.00,"30,460.52"
20-Nov-2025,Debit Card,07.00,00.00,"30,467.52"
20-Nov-2025,Tax,"5,369.00",00.00,"35,836.52"
20-Nov-2025,Commission,07.90,00.00,"35,844.42"
20-Nov-2025,Bill,"5,693.09",00.00,"41,537.51"
20-Nov-2025,Purchase,00.00,"10,384.38","31,153.13"
20-Nov-2025,Reversal,37.00,00.00,"31,190.13"
21-Nov-2025,Tax,"31,350.61",00.00,"62,540.74"
21-Nov-2025,Purchase,00.00,"6,254.07","56,286.67"
21-Nov-2025,IMPS,00.00,"6,254.07","50,032.60"
21-Nov-2025,Cash,00.00,"25,016.30","25,016.30"
21-Nov-2025,Cash,19.00,00.00,"25,035.30"
21-Nov-2025,Cash,00.00,"2,781.70","22,253.60"
21-Nov-2025,Reversal,00.00,"7,417.87","14,835.73"
21-Nov-2025,Purchase,00.00,"1,648.41","13,187.32"
21-Nov-2025,Cheque,00.00,"1,883.90","11,303.42"
21-Nov-2025,Transfer,00.00,"2,260.68","9,042.74"
21-Nov-2025,NEFT,00.00,"4,521.37","4,521.37"
21-Nov-2025,Debit Card,45.11,00.00,"4,566.48"
22-Nov-2025,Miscellaneous,00.00,"1,141.62","3,424.86"
22-Nov-2025,Cash,"1,021.85",00.00,"4,446.71"
22-Nov-2025,Bill,00.00,555.84,"3,890.87"
22-Nov-2025,Reversal,"19,681.30",00.00,"23,572.17"
22-Nov-2025,NEFT,"1,021,043.20",00.00,"1,044,615.37"
22-Nov-2025,Cash,00.00,"348,205.12","696,410.25"
22-Nov-2025,RTGS,"2,053,121.00",00.00,"2,749,531.25"
22-Nov-2025,Reversal,"1,205.00",00.00,"2,750,736.25"
22-Nov-2025,Bill,"244,918.25",00.00,"2,995,654.50"
22-Nov-2025,Miscellaneous,00.00,"1,497,827.25","1,497,827.25"
22-Nov-2025,Bill,112.30,00.00,"1,497,939.55"
22-Nov-2025,IMPS,"1,495,273.50",00.00,"2,993,213.05"
22-Nov-2025,ATM,627.80,00.00,"2,993,840.85"
22-Nov-2025,Tax,"1,135,635.00",00.00,"4,129,475.85"
22-Nov-2025,RTGS,00.00,"412,947.59","3,716,528.26"
22-Nov-2025,Commission,31.00,00.00,"3,716,559.26"
23-Nov-2025,Commission,01.09,00.00,"3,716,560.35"
23-Nov-2025,Cash,03.63,00.00,"3,716,563.98"
23-Nov-2025,NEFT,"213,530.00",00.00,"3,930,093.98"
23-Nov-2025,Commission,00.00,"786,018.80","3,144,075.18"
23-Nov-2025,Reversal,"2,811.00",00.00,"3,146,886.18"
23-Nov-2025,Commission,00.00,"349,654.02","2,797,232.16"
23-Nov-2025,Debit Card,50.00,00.00,"2,797,282.16"
23-Nov-2025,IMPS,01.10,00.00,"2,797,283.26"
23-Nov-2025,NEFT,"261,632.00",00.00,"3,058,915.26"
23-Nov-2025,Bill,00.00,"764,728.82","2,294,186.44"
23-Nov-2025,Cheque,33.30,00.00,"2,294,219.74"
23-Nov-2025,NEFT,02.30,00.00,"2,294,222.04"
23-Nov-2025,Bill,"91,053.00",00.00,"2,385,275.04"
23-Nov-2025,NEFT,00.80,00.00,"2,385,275.84"
23-Nov-2025,Tax,00.00,"340,753.69","2,044,522.15"
23-Nov-2025,Cheque,03.00,00.00,"2,044,525.15"
23-Nov-2025,Miscellaneous,00.00,"340,754.19","1,703,770.96"
23-Nov-2025,Cash,00.00,"851,885.48","851,885.48"
23-Nov-2025,Interest,00.00,"85,188.55","766,696.93"
23-Nov-2025,Cheque,00.00,"76,669.69","690,027.24"
23-Nov-2025,Transfer,00.00,"98,575.32","591,451.92"
23-Nov-2025,Purchase,106.04,00.00,"591,557.96"
23-Nov-2025,RTGS,"1,893,912.75",00.00,"2,485,470.71"
23-Nov-2025,Transfer,"16,068.60",00.00,"2,501,539.31"
23-Nov-2025,Transfer,"1,333.22",00.00,"2,502,872.53"
23-Nov-2025,ATM,"2,438.20",00.00,"2,505,310.73"
23-Nov-2025,IMPS,24.00,00.00,"2,505,334.73"
23-Nov-2025,Tax,238.27,00.00,"2,505,573.00"
23-Nov-2025,Reversal,22.50,00.00,"2,505,595.50"
23-Nov-2025,Bill,"16,711.67",00.00,"2,522,307.17"
23-Nov-2025,Debit Card,00.00,00.00,"2,522,307.17"
23-Nov-2025,NEFT,00.00,"1,261,153.59","1,261,153.58"
23-Nov-2025,Reversal,381.70,00.00,"1,261,535.28"
23-Nov-2025,IMPS,04.97,00.00,"1,261,540.25"
23-Nov-2025,Cheque,483.00,00.00,"1,262,023.25"
23-Nov-2025,Miscellaneous,213.00,00.00,"1,262,236.25"
23-Nov-2025,NEFT,"980,183.25",00.00,"2,242,419.50"
23-Nov-2025,Purchase,00.00,"373,736.58","1,868,682.92"
23-Nov-2025,Bill,00.00,"186,868.29","1,681,814.63"
23-Nov-2025,IMPS,"50,538.30",00.00,"1,732,352.93"
23-Nov-2025,IMPS,"1,386.30",00.00,"1,733,739.23"
23-Nov-2025,Bill,"1,530.00",00.00,"1,735,269.23"
23-Nov-2025,Cash,00.00,"867,634.62","867,634.62"
23-Nov-2025,Reversal,306.00,00.00,"867,940.62"
23-Nov-2025,Purchase,00.00,"289,313.54","578,627.08"
23-Nov-2025,Bill,"251,863.00",00.00,"830,490.08"
23-Nov-2025,Reversal,00.00,"118,641.44","711,848.64"
23-Nov-2025,Interest,00.00,"88,981.08","622,867.56"
23-Nov-2025,IMPS,"23,136.00",00.00,"646,003.56"
23-Nov-2025,Miscellaneous,02.17,00.00,"646,005.73"
23-Nov-2025,NEFT,41.50,00.00,"646,047.23"
23-Nov-2025,Commission,00.00,"129,209.45","516,837.78"
23-Nov-2025,ATM,00.00,"172,279.26","344,558.52"
23-Nov-2025,Purchase,00.00,"114,852.84","229,705.68"
23-Nov-2025,RTGS,00.00,"45,941.14","183,764.54"
23-Nov-2025,Purchase,00.00,"183,764.54",00.00
23-Nov-2025,Transfer,504.40,00.00,504.40
23-Nov-2025,Bill,"257,707.00",00.00,"258,211.40"
23-Nov-2025,Purchase,"889,411.75",00.00,"1,147,623.15"
23-Nov-2025,NEFT,494.00,00.00,"1,148,117.15"
23-Nov-2025,ATM,00.00,"574,058.58","574,058.57"
23-Nov-2025,Debit Card,00.00,"191,352.86","382,705.71"
23-Nov-2025,Transfer,00.00,"38,270.57","344,435.14"
23-Nov-2025,Commission,"3,711.70",00.00,"348,146.84"
23-Nov-2025,Commission,"2,303.15",00.00,"350,449.99"
23-Nov-2025,Debit Card,"13,951.22",00.00,"364,401.21"
23-Nov-2025,Purchase,00.00,"52,057.32","312,343.89"
24-Nov-2025,Transfer,00.00,"31,234.39","281,109.50"
24-Nov-2025,Purchase,"105,583.20",00.00,"386,692.70"
24-Nov-2025,RTGS,00.00,"55,241.81","331,450.89"
24-Nov-2025,IMPS,10.76,00.00,"331,461.65"
24-Nov-2025,Cheque,00.00,"331,461.65",00.00
24-Nov-2025,RTGS,01.00,00.00,01.00
24-Nov-2025,Debit Card,"201,240.50",00.00,"201,241.50"
24-Nov-2025,Interest,"3,364.41",00.00,"204,605.91"
24-Nov-2025,Debit Card,00.00,"20,460.59","184,145.32"
24-Nov-2025,Purchase,"333,973.25",00.00,"518,118.57"
24-Nov-2025,Miscellaneous,00.00,"129,529.64","388,588.93"
24-Nov-2025,Bill,00.00,"55,512.70","333,076.23"
24-Nov-2025,Reversal,00.00,"55,512.71","277,563.52"
24-Nov-2025,Miscellaneous,"13,370.38",00.00,"290,933.90"
24-Nov-2025,Tax,00.00,"58,186.78","232,747.12"
24-Nov-2025,Miscellaneous,00.00,"38,791.19","193,955.93"
24-Nov-2025,Reversal,00.00,"27,707.99","166,247.94"
24-Nov-2025,Interest,"3,899.20",00.00,"170,147.14"
24-Nov-2025,Cheque,"46,092.62",00.00,"216,239.76"
24-Nov-2025,ATM,00.00,"72,079.92","144,159.84"
24-Nov-2025,ATM,00.00,"16,017.76","128,142.08"
24-Nov-2025,Cash,"183,503.80",00.00,"311,645.88"
24-Nov-2025,Transfer,"18,630.00",00.00,"330,275.88"
24-Nov-2025,Cheque,00.00,"33,027.59","297,248.29"
24-Nov-2025,Commission,"2,015,985.50",00.00,"2,313,233.79"
24-Nov-2025,Cheque,00.00,"578,308.45","1,734,925.34"
24-Nov-2025,Reversal,00.00,"289,154.22","1,445,771.12"
24-Nov-2025,Interest,"1,668.50",00.00,"1,447,439.62"
24-Nov-2025,ATM,"1,052,588.50",00.00,"2,500,028.12"
24-Nov-2025,NEFT,00.00,"625,007.03","1,875,021.09"
24-Nov-2025,Purchase,317.00,00.00,"1,875,338.09"
25-Nov-2025,RTGS,01.10,00.00,"1,875,339.19"
26-Nov-2025,Interest,"362,503.50",00.00,"2,237,842.69"
26-Nov-2025,RTGS,"388,103.20",00.00,"2,625,945.89"
26-Nov-2025,IMPS,"131,409.00",00.00,"2,757,354.89"
26-Nov-2025,Debit Card,54.27,00.00,"2,757,409.16"
26-Nov-2025,NEFT,03.09,00.00,"2,757,412.25"
26-Nov-2025,IMPS,00.00,"275,741.23","2,481,671.02"
26-Nov-2025,Transfer,"497,052.00",00.00,"2,978,723.02"
26-Nov-2025,Tax,00.00,"744,680.76","2,234,042.26"
26-Nov-2025,Tax,00.00,"279,255.28","1,954,786.98"
26-Nov-2025,Cash,00.00,"244,348.37","1,710,438.61"
26-Nov-2025,Reversal,215.22,00.00,"1,710,653.83"
26-Nov-2025,Bill,00.00,"244,379.12","1,466,274.71"
26-Nov-2025,Debit Card,00.00,"244,379.12","1,221,895.59"
26-Nov-2025,RTGS,28.35,00.00,"1,221,923.94"
26-Nov-2025,Cash,00.00,"305,480.99","916,442.96"
26-Nov-2025,Cash,00.00,"152,740.49","763,702.47"
26-Nov-2025,Miscellaneous,00.00,"152,740.49","610,961.98"
26-Nov-2025,IMPS,05.55,00.00,"610,967.53"
26-Nov-2025,Transfer,44.00,00.00,"611,011.53"
27-Nov-2025,IMPS,00.00,"203,670.51","407,341.02"
27-Nov-2025,Interest,00.00,"81,468.20","325,872.82"
27-Nov-2025,Miscellaneous,00.00,"32,587.28","293,285.54"
27-Nov-2025,Transfer,312.00,00.00,"293,597.54"
27-Nov-2025,Tax,00.00,"41,942.51","251,655.03"
27-Nov-2025,Cheque,00.00,"83,885.01","167,770.02"
27-Nov-2025,Debit Card,00.00,"23,967.15","143,802.87"
27-Nov-2025,Tax,92.00,00.00,"143,894.87"
27-Nov-2025,Debit Card,00.00,"71,947.44","71,947.44"
27-Nov-2025,Debit Card,"1,443,844.50",00.00,"1,515,791.94"
27-Nov-2025,Cheque,00.00,"168,421.33","1,347,370.61"
27-Nov-2025,NEFT,08.00,00.00,"1,347,378.61"
27-Nov-2025,Interest,00.00,"168,422.33","1,178,956.28"
27-Nov-2025,Reversal,18.00,00.00,"1,178,974.28"
27-Nov-2025,Commission,"1,303,455.25",00.00,"2,482,429.53"
27-Nov-2025,Miscellaneous,"872,745.00",00.00,"3,355,174.53"
27-Nov-2025,Reversal,"4,866.00",00.00,"3,360,040.53"
27-Nov-2025,Commission,00.00,"3,360,040.53",00.00
27-Nov-2025,Tax,"1,536,610.20",00.00,"1,536,610.20"
27-Nov-2025,Miscellaneous,272.20,00.00,"1,536,882.40"
27-Nov-2025,Cheque,00.00,"384,220.60","1,152,661.80"
27-Nov-2025,IMPS,00.00,"576,330.90","576,330.90"
27-Nov-2025,Commission,00.00,"57,633.09","518,697.81"
27-Nov-2025,ATM,101.80,00.00,"518,799.61"
27-Nov-2025,Bill,00.00,"129,699.90","389,099.71"
27-Nov-2025,Cash,39.00,00.00,"389,138.71"
27-Nov-2025,Interest,00.00,"64,856.45","324,282.26"
27-Nov-2025,Miscellaneous,00.00,"40,535.28","283,746.98"
27-Nov-2025,Purchase,"63,296.70",00.00,"347,043.68"
27-Nov-2025,Commission,280.40,00.00,"347,324.08"
27-Nov-2025,Tax,00.00,"347,324.08",00.00
27-Nov-2025,Transfer,292.00,00.00,292.00
27-Nov-2025,Interest,00.00,292.00,00.00
27-Nov-2025,Reversal,"1,694,342.00",00.00,"1,694,342.00"
27-Nov-2025,IMPS,"115,701.78",00.00,"1,810,043.78"
27-Nov-2025,Purchase,00.00,"452,510.95","1,357,532.84"
27-Nov-2025,Cheque,00.00,"452,510.95","905,021.89"
27-Nov-2025,Commission,00.00,"181,004.38","724,017.51"
27-Nov-2025,Debit Card,"1,647,505.00",00.00,"2,371,522.51"
27-Nov-2025,NEFT,"26,981.00",00.00,"2,398,503.51"
27-Nov-2025,Miscellaneous,00.00,"239,850.35","2,158,653.16"
27-Nov-2025,Cash,00.00,"719,551.05","1,439,102.11"
27-Nov-2025,Miscellaneous,00.00,"179,887.76","1,259,214.35"
27-Nov-2025,ATM,00.00,"629,607.18","629,607.18"
27-Nov-2025,Miscellaneous,39.06,00.00,"629,646.24"
27-Nov-2025,ATM,"162,487.50",00.00,"792,133.74"
27-Nov-2025,IMPS,00.00,"396,066.87","396,066.87"
27-Nov-2025,Transfer,"2,052.50",00.00,"398,119.37"
27-Nov-2025,Cheque,344.00,00.00,"398,463.37"
27-Nov-2025,IMPS,00.00,"56,923.34","341,540.03"
27-Nov-2025,IMPS,00.00,"170,770.02","170,770.02"
27-Nov-2025,Tax,00.00,"34,154.00","136,616.02"
27-Nov-2025,Tax,00.00,"17,077.00","119,539.02"
27-Nov-2025,Reversal,59.00,00.00,"119,598.02"
27-Nov-2025,Bill,19.00,00.00,"119,617.02"
27-Nov-2025,Tax,25.40,00.00,"119,642.42"
27-Nov-2025,IMPS,00.00,"23,928.48","95,713.94"
27-Nov-2025,IMPS,02.70,00.00,"95,716.64"
27-Nov-2025,Cash,04.00,00.00,"95,720.64"
27-Nov-2025,Miscellaneous,00.00,"19,144.13","76,576.51"
27-Nov-2025,Transfer,"941,853.75",00.00,"1,018,430.26"
27-Nov-2025,NEFT,"2,932.20",00.00,"1,021,362.46"
27-Nov-2025,Purchase,54.90,00.00,"1,021,417.36"
27-Nov-2025,Reversal,00.00,"170,236.23","851,181.13"
27-Nov-2025,Cheque,"1,054,865.00",00.00,"1,906,046.13"
27-Nov-2025,RTGS,33.30,00.00,"1,906,079.43"
27-Nov-2025,IMPS,"2,029,638.25",00.00,"3,935,717.68"
27-Nov-2025,ATM,00.00,"3,935,717.68",00.00
27-Nov-2025,Transfer,"2,351.32",00.00,"2,351.32"
27-Nov-2025,Commission,27.70,00.00,"2,379.02"
27-Nov-2025,Reversal,00.00,396.50,"1,982.52"
27-Nov-2025,IMPS,00.00,660.84,"1,321.68"
27-Nov-2025,Reversal,"15,605.40",00.00,"16,927.08"
27-Nov-2025,Interest,00.00,"1,880.79","15,046.29"
27-Nov-2025,Bill,00.00,"1,504.63","13,541.66"
27-Nov-2025,Miscellaneous,11.70,00.00,"13,553.36"
27-Nov-2025,Reversal,"1,440.30",00.00,"14,993.66"
27-Nov-2025,Cash,"80,385.94",00.00,"95,379.60"
27-Nov-2025,Commission,"13,099.00",00.00,"108,478.60"
27-Nov-2025,IMPS,00.50,00.00,"108,479.10"
27-Nov-2025,Tax,"357,532.75",00.00,"466,011.85"
27-Nov-2025,Bill,00.00,"233,005.93","233,005.92"
27-Nov-2025,Miscellaneous,00.00,"23,300.59","209,705.33"
27-Nov-2025,Miscellaneous,"2,442.10",00.00,"212,147.43"
27-Nov-2025,Debit Card,"60,582.00",00.00,"272,729.43"
27-Nov-2025,Transfer,00.00,"30,303.27","242,426.16"
27-Nov-2025,Purchase,00.00,"34,632.31","207,793.85"
27-Nov-2025,Cheque,"199,969.88",00.00,"407,763.73"
27-Nov-2025,Bill,00.00,"58,251.96","349,511.77"
27-Nov-2025,Commission,"140,668.06",00.00,"490,179.83"
27-Nov-2025,NEFT,00.00,"490,179.83",00.00
27-Nov-2025,Debit Card,"365,466.00",00.00,"365,466.00"
27-Nov-2025,Bill,07.30,00.00,"365,473.30"
27-Nov-2025,Miscellaneous,"22,726.93",00.00,"388,200.23"
27-Nov-2025,Tax,"217,523.00",00.00,"605,723.23"
27-Nov-2025,NEFT,00.00,"151,430.81","454,292.42"
27-Nov-2025,Cheque,"563,880.75",00.00,"1,018,173.17"
27-Nov-2025,Debit Card,00.00,"254,543.29","763,629.88"
27-Nov-2025,Interest,"555,230.25",00.00,"1,318,860.13"
28-Nov-2025,Commission,"13,926.25",00.00,"1,332,786.38"
28-Nov-2025,ATM,00.00,"333,196.60","999,589.78"
28-Nov-2025,Commission,00.00,"99,958.98","899,630.80"
28-Nov-2025,Debit Card,00.00,"128,518.69","771,112.11"
28-Nov-2025,Interest,"511,227.00",00.00,"1,282,339.11"
28-Nov-2025,Interest,"1,198,446.75",00.00,"2,480,785.86"
28-Nov-2025,Reversal,"76,833.56",00.00,"2,557,619.42"
28-Nov-2025,Reversal,08.20,00.00,"2,557,627.62"
28-Nov-2025,IMPS,136.00,00.00,"2,557,763.62"
28-Nov-2025,NEFT,"2,960.90",00.00,"2,560,724.52"
28-Nov-2025,NEFT,"23,606.00",00.00,"2,584,330.52"
28-Nov-2025,Reversal,00.00,"861,443.51","1,722,887.01"
28-Nov-2025,Purchase,00.00,"191,431.89","1,531,455.12"
28-Nov-2025,IMPS,00.00,"382,863.78","1,148,591.34"
28-Nov-2025,Cash,00.00,"574,295.67","574,295.67"
28-Nov-2025,IMPS,00.00,"57,429.57","516,866.10"
28-Nov-2025,Purchase,"28,388.00",00.00,"545,254.10"
28-Nov-2025,IMPS,"16,449.10",00.00,"561,703.20"
28-Nov-2025,Purchase,"152,351.69",00.00,"714,054.89"
28-Nov-2025,NEFT,00.00,"89,256.86","624,798.03"
28-Nov-2025,Debit Card,197.45,00.00,"624,995.48"
28-Nov-2025,ATM,411.90,00.00,"625,407.38"
28-Nov-2025,Cash,07.58,00.00,"625,414.96"
28-Nov-2025,Cheque,00.00,"62,541.50","562,873.46"
28-Nov-2025,Cash,"168,526.00",00.00,"731,399.46"
28-Nov-2025,Cheque,"794,957.75",00.00,"1,526,357.21"
28-Nov-2025,Interest,00.00,"508,785.74","1,017,571.47"
28-Nov-2025,Reversal,"2,984.60",00.00,"1,020,556.07"
28-Nov-2025,Transfer,00.00,"113,395.12","907,160.95"
28-Nov-2025,Bill,00.00,"453,580.48","453,580.48"
28-Nov-2025,Interest,00.00,"226,790.24","226,790.24"
28-Nov-2025,NEFT,00.00,"226,790.24",00.00
28-Nov-2025,Cheque,"8,649.62",00.00,"8,649.62"
28-Nov-2025,Purchase,00.00,"2,162.41","6,487.22"
28-Nov-2025,RTGS,"21,294.60",00.00,"27,781.82"
28-Nov-2025,Bill,00.00,"2,778.18","25,003.64"
28-Nov-2025,Debit Card,00.00,"4,167.27","20,836.37"
28-Nov-2025,ATM,00.00,"2,083.64","18,752.73"
28-Nov-2025,Bill,00.00,"4,688.18","14,064.55"
28-Nov-2025,RTGS,"217,787.53",00.00,"231,852.08"
28-Nov-2025,Cheque,331.55,00.00,"232,183.63"
28-Nov-2025,Transfer,"994,009.75",00.00,"1,226,193.38"
29-Nov-2025,Bill,00.00,"1,226,193.38",00.00
29-Nov-2025,Cash,"807,423.00",00.00,"807,423.00"
29-Nov-2025,Purchase,00.00,"115,346.14","692,076.86"
29-Nov-2025,Reversal,06.00,00.00,"692,082.86"
29-Nov-2025,RTGS,00.00,"173,020.72","519,062.14"
29-Nov-2025,ATM,00.00,"64,882.77","454,179.37"
29-Nov-2025,ATM,00.00,"45,417.94","408,761.43"
29-Nov-2025,Miscellaneous,00.00,"102,190.36","306,571.07"
29-Nov-2025,Debit Card,495.50,00.00,"307,066.57"
29-Nov-2025,Bill,00.00,"76,766.64","230,299.93"
29-Nov-2025,Bill,10.40,00.00,"230,310.33"
29-Nov-2025,Commission,04.90,00.00,"230,315.23"
29-Nov-2025,Miscellaneous,00.00,"57,578.81","172,736.42"
29-Nov-2025,Bill,"28,280.63",00.00,"201,017.05"
29-Nov-2025,IMPS,319.58,00.00,"201,336.63"
29-Nov-2025,Debit Card,00.00,"28,762.38","172,574.25"
29-Nov-2025,NEFT,04.97,00.00,"172,579.22"
29-Nov-2025,Reversal,00.00,"43,144.81","129,434.42"
30-Nov-2025,Reversal,00.00,"18,490.63","110,943.79"
30-Nov-2025,NEFT,"27,739.40",00.00,"138,683.19"
30-Nov-2025,Miscellaneous,"151,676.81",00.00,"290,360.00"
30-Nov-2025,Interest,00.00,"145,180.00","145,180.00"
30-Nov-2025,Commission,02.43,00.00,"145,182.43"
30-Nov-2025,Bill,105.70,00.00,"145,288.13"
30-Nov-2025,Tax,00.00,"36,322.03","108,966.10"
30-Nov-2025,Transfer,"100,849.00",00.00,"209,815.10"
30-Nov-2025,IMPS,00.00,"23,312.79","186,502.31"
30-Nov-2025,Cheque,23.70,00.00,"186,526.01"
30-Nov-2025,Tax,00.00,"23,315.75","163,210.26"
30-Nov-2025,Cheque,00.00,"81,605.13","81,605.13"
30-Nov-2025,Transfer,00.00,"8,160.51","73,444.62"
30-Nov-2025,Bill,00.00,"18,361.16","55,083.46"
30-Nov-2025,Cheque,07.00,00.00,"55,090.46"
30-Nov-2025,Cheque,"19,014.00",00.00,"74,104.46"
30-Nov-2025,Transfer,"5,089.52",00.00,"79,193.98"
30-Nov-2025,Miscellaneous,00.00,"79,193.98",00.00
30-Nov-2025,Purchase,"168,898.30",00.00,"168,898.30"
30-Nov-2025,IMPS,"1,229.00",00.00,"170,127.30"
30-Nov-2025,Tax,"165,718.00",00.00,"335,845.30"
30-Nov-2025,Tax,00.00,"67,169.06","268,676.24"
30-Nov-2025,Purchase,00.00,"33,584.53","235,091.71"
30-Nov-2025,IMPS,01.30,00.00,"235,093.01"
30-Nov-2025,ATM,00.00,"58,773.25","176,319.76"
30-Nov-2025,Debit Card,"216,789.30",00.00,"393,109.06"
30-Nov-2025,ATM,00.00,"78,621.81","314,487.25"
30-Nov-2025,Purchase,330.80,00.00,"314,818.05"
30-Nov-2025,Commission,"28,448.53",00.00,"343,266.58"
30-Nov-2025,Bill,"1,345.75",00.00,"344,612.33"
30-Nov-2025,Cash,07.90,00.00,"344,620.23"
30-Nov-2025,Cash,00.00,"86,155.06","258,465.17"
30-Nov-2025,Bill,04.00,00.00,"258,469.17"
30-Nov-2025,Miscellaneous,"332,016.75",00.00,"590,485.92"
30-Nov-2025,Purchase,"13,257.00",00.00,"603,742.92"
30-Nov-2025,Interest,"1,141.32",00.00,"604,884.24"
01-Dec-2025,Tax,00.00,"201,628.08","403,256.16"
01-Dec-2025,NEFT,"1,682,179.75",00.00,"2,085,435.91"
01-Dec-2025,Cheque,"1,792,602.00",00.00,"3,878,037.91"
01-Dec-2025,Debit Card,00.00,"484,754.74","3,393,283.17"
01-Dec-2025,Cheque,00.00,"339,328.32","3,053,954.85"
01-Dec-2025,Cheque,00.00,"508,992.48","2,544,962.38"
01-Dec-2025,Commission,01.70,00.00,"2,544,964.08"
01-Dec-2025,Purchase,00.00,"424,160.68","2,120,803.40"
01-Dec-2025,Interest,52.70,00.00,"2,120,856.10"
01-Dec-2025,Cheque,00.00,"1,060,428.05","1,060,428.05"
01-Dec-2025,RTGS,291.34,00.00,"1,060,719.39"
01-Dec-2025,Bill,00.00,"176,786.57","883,932.82"
01-Dec-2025,Bill,604.11,00.00,"884,536.93"
01-Dec-2025,Cash,"29,427.95",00.00,"913,964.88"
02-Dec-2025,IMPS,00.00,"114,245.61","799,719.27"
02-Dec-2025,Purchase,02.00,00.00,"799,721.27"
02-Dec-2025,Tax,00.00,"114,245.90","685,475.37"
02-Dec-2025,Cash,"188,466.00",00.00,"873,941.37"
02-Dec-2025,Bill,00.00,"124,848.77","749,092.60"
02-Dec-2025,Debit Card,00.00,"74,909.26","674,183.34"
02-Dec-2025,Interest,"240,653.88",00.00,"914,837.22"
02-Dec-2025,Transfer,00.00,"304,945.74","609,891.48"
02-Dec-2025,Reversal,07.79,00.00,"609,899.27"
02-Dec-2025,Tax,00.00,"609,899.27",00.00
02-Dec-2025,Purchase,08.00,00.00,08.00
02-Dec-2025,Debit Card,"81,426.72",00.00,"81,434.72"
02-Dec-2025,Commission,"1,468,188.00",00.00,"1,549,622.72"
02-Dec-2025,ATM,00.00,"309,924.54","1,239,698.18"
02-Dec-2025,Reversal,00.00,"309,924.55","929,773.64"
02-Dec-2025,IMPS,00.00,"103,308.18","826,465.46"
02-Dec-2025,IMPS,00.00,"206,616.37","619,849.10"
02-Dec-2025,ATM,"330,558.00",00.00,"950,407.10"
02-Dec-2025,Purchase,"32,180.00",00.00,"982,587.10"
02-Dec-2025,ATM,54.00,00.00,"982,641.10"
02-Dec-2025,RTGS,"3,391.00",00.00,"986,032.10"
02-Dec-2025,Commission,"226,724.16",00.00,"1,212,756.26"
02-Dec-2025,Transfer,"20,049.42",00.00,"1,232,805.68"
02-Dec-2025,Transfer,00.00,"308,201.42","924,604.26"
02-Dec-2025,Commission,00.00,"154,100.71","770,503.55"
02-Dec-2025,Purchase,00.00,"770,503.55",00.00
02-Dec-2025,Debit Card,"3,845.60",00.00,"3,845.60"
02-Dec-2025,Miscellaneous,00.00,640.93,"3,204.67"
02-Dec-2025,Purchase,00.00,"1,068.22","2,136.45"
02-Dec-2025,Reversal,00.00,"1,068.23","1,068.22"
02-Dec-2025,NEFT,23.80,00.00,"1,092.02"
02-Dec-2025,Reversal,"2,105.50",00.00,"3,197.52"
02-Dec-2025,Interest,"9,515.00",00.00,"12,712.52"
02-Dec-2025,Cash,15.71,00.00,"12,728.23"
02-Dec-2025,Cheque,"2,862.00",00.00,"15,590.23"
02-Dec-2025,Commission,"1,592,488.00",00.00,"1,608,078.23"
02-Dec-2025,Cheque,"1,475.20",00.00,"1,609,553.43"
02-Dec-2025,Interest,04.00,00.00,"1,609,557.43"
02-Dec-2025,Reversal,"1,553.14",00.00,"1,611,110.57"
02-Dec-2025,Debit Card,04.00,00.00,"1,611,114.57"
02-Dec-2025,Commission,00.00,"201,389.32","1,409,725.25"
02-Dec-2025,Interest,"186,430.00",00.00,"1,596,155.25"
02-Dec-2025,NEFT,00.00,"798,077.63","798,077.62"
02-Dec-2025,Purchase,00.00,"266,025.87","532,051.75"
02-Dec-2025,ATM,"31,970.00",00.00,"564,021.75"
03-Dec-2025,Cheque,00.00,"94,003.63","470,018.12"
03-Dec-2025,Purchase,05.43,00.00,"470,023.55"
03-Dec-2025,Debit Card,"151,460.10",00.00,"621,483.65"
03-Dec-2025,Miscellaneous,17.10,00.00,"621,500.75"
03-Dec-2025,Interest,00.00,"103,583.46","517,917.29"
03-Dec-2025,Cheque,00.00,"258,958.65","258,958.64"
03-Dec-2025,ATM,04.51,00.00,"258,963.15"
03-Dec-2025,Bill,24.56,00.00,"258,987.71"
03-Dec-2025,Bill,00.00,"258,987.71",00.00
04-Dec-2025,Cheque,"18,472.80",00.00,"18,472.80"
05-Dec-2025,Purchase,174.00,00.00,"18,646.80"
05-Dec-2025,IMPS,"118,104.60",00.00,"136,751.40"
05-Dec-2025,Reversal,01.00,00.00,"136,752.40"
05-Dec-2025,Reversal,"1,152,062.00",00.00,"1,288,814.40"
05-Dec-2025,Cheque,00.00,"429,604.80","859,209.60"
05-Dec-2025,Cheque,51.69,00.00,"859,261.29"
05-Dec-2025,RTGS,00.00,"85,926.13","773,335.16"
05-Dec-2025,Bill,"18,879.60",00.00,"792,214.76"
05-Dec-2025,ATM,05.00,00.00,"792,219.76"
05-Dec-2025,IMPS,00.00,"396,109.88","396,109.88"
05-Dec-2025,Commission,"6,108.54",00.00,"402,218.42"
05-Dec-2025,RTGS,00.00,"67,036.40","335,182.02"
05-Dec-2025,Bill,"1,504.00",00.00,"336,686.02"
05-Dec-2025,Purchase,00.00,"42,085.75","294,600.27"
05-Dec-2025,Transfer,00.00,"49,100.05","245,500.22"
05-Dec-2025,RTGS,00.00,"40,916.70","204,583.52"
05-Dec-2025,IMPS,00.00,"40,916.70","163,666.82"
05-Dec-2025,Tax,00.00,"32,733.36","130,933.46"
05-Dec-2025,Purchase,00.00,"26,186.69","104,746.77"
05-Dec-2025,Interest,43.29,00.00,"104,790.06"
05-Dec-2025,Bill,00.30,00.00,"104,790.36"
06-Dec-2025,RTGS,00.00,"17,465.06","87,325.30"
06-Dec-2025,Interest,192.00,00.00,"87,517.30"
06-Dec-2025,NEFT,00.00,"17,503.46","70,013.84"
06-Dec-2025,ATM,"48,615.00",00.00,"118,628.84"
06-Dec-2025,ATM,51.00,00.00,"118,679.84"
06-Dec-2025,ATM,"476,270.00",00.00,"594,949.84"
06-Dec-2025,Transfer,00.00,"118,989.97","475,959.87"
06-Dec-2025,Transfer,00.00,"158,653.29","317,306.58"
06-Dec-2025,ATM,00.00,"105,768.86","211,537.72"
06-Dec-2025,RTGS,00.00,"105,768.86","105,768.86"
06-Dec-2025,Reversal,"146,689.40",00.00,"252,458.26"
06-Dec-2025,Purchase,205.60,00.00,"252,663.86"
06-Dec-2025,ATM,00.00,"31,582.98","221,080.88"
06-Dec-2025,NEFT,"1,624,788.25",00.00,"1,845,869.13"
06-Dec-2025,Interest,"1,822,486.00",00.00,"3,668,355.13"
06-Dec-2025,ATM,00.00,"1,834,177.57","1,834,177.56"
06-Dec-2025,Interest,00.00,"1,834,177.56",00.00
06-Dec-2025,IMPS,"1,843,191.25",00.00,"1,843,191.25"
06-Dec-2025,Cash,00.00,"307,198.54","1,535,992.71"
06-Dec-2025,Debit Card,"30,045.07",00.00,"1,566,037.78"
06-Dec-2025,Miscellaneous,00.00,"1,566,037.78",00.00
06-Dec-2025,RTGS,395.70,00.00,395.70
06-Dec-2025,Tax,00.00,395.70,00.00
06-Dec-2025,Bill,"1,197.42",00.00,"1,197.42"
06-Dec-2025,Miscellaneous,"1,974.53",00.00,"3,171.95"
06-Dec-2025,Bill,438.60,00.00,"3,610.55"
06-Dec-2025,Debit Card,00.00,"3,610.55",00.00
06-Dec-2025,NEFT,06.40,00.00,06.40
06-Dec-2025,ATM,00.00,00.64,05.76
07-Dec-2025,Interest,00.00,02.88,02.88
07-Dec-2025,Interest,30.20,00.00,33.08
07-Dec-2025,Miscellaneous,00.00,11.03,22.05
07-Dec-2025,ATM,00.00,07.35,14.70
07-Dec-2025,Reversal,"1,224,387.25",00.00,"1,224,401.95"
07-Dec-2025,Commission,00.00,"408,133.98","816,267.97"
07-Dec-2025,ATM,00.00,"204,066.99","612,200.98"
07-Dec-2025,Reversal,"194,419.80",00.00,"806,620.78"
07-Dec-2025,NEFT,07.30,00.00,"806,628.08"
07-Dec-2025,Debit Card,00.00,"100,828.51","705,799.57"
07-Dec-2025,IMPS,00.00,"352,899.79","352,899.78"
07-Dec-2025,Cheque,00.00,"117,633.26","235,266.52"
07-Dec-2025,Transfer,00.00,"26,140.72","209,125.80"
08-Dec-2025,ATM,"11,448.00",00.00,"220,573.80"
08-Dec-2025,Bill,"1,023.00",00.00,"221,596.80"
08-Dec-2025,Debit Card,00.00,"221,596.80",00.00
08-Dec-2025,RTGS,"154,029.53",00.00,"154,029.53"
08-Dec-2025,RTGS,"3,385.00",00.00,"157,414.53"
08-Dec-2025,Cheque,490.60,00.00,"157,905.13"
09-Dec-2025,NEFT,00.00,"19,738.14","138,166.99"
09-Dec-2025,Transfer,37.31,00.00,"138,204.30"
09-Dec-2025,Cash,00.00,"13,820.43","124,383.87"
09-Dec-2025,Cash,104.30,00.00,"124,488.17"
09-Dec-2025,IMPS,"23,655.16",00.00,"148,143.33"
09-Dec-2025,Debit Card,00.00,"18,517.92","129,625.41"
09-Dec-2025,Cash,00.00,"14,402.82","115,222.59"
09-Dec-2025,RTGS,00.00,"38,407.53","76,815.06"
09-Dec-2025,Miscellaneous,"11,506.00",00.00,"88,321.06"
09-Dec-2025,NEFT,01.00,00.00,"88,322.06"
09-Dec-2025,Commission,00.00,"11,040.26","77,281.80"
09-Dec-2025,Tax,00.00,"19,320.45","57,961.35"
09-Dec-2025,ATM,"1,814,176.50",00.00,"1,872,137.85"
09-Dec-2025,Debit Card,"10,038.90",00.00,"1,882,176.75"
09-Dec-2025,Miscellaneous,"9,129.00",00.00,"1,891,305.75"
09-Dec-2025,RTGS,00.00,"236,413.22","1,654,892.53"
09-Dec-2025,NEFT,42.22,00.00,"1,654,934.75"
09-Dec-2025,IMPS,"254,283.40",00.00,"1,909,218.15"
09-Dec-2025,Miscellaneous,00.00,"190,921.82","1,718,296.34"
09-Dec-2025,Reversal,00.00,"171,829.63","1,546,466.71"
09-Dec-2025,Tax,00.00,"171,829.63","1,374,637.08"
09-Dec-2025,Interest,"99,252.00",00.00,"1,473,889.08"
09-Dec-2025,NEFT,00.00,"184,236.14","1,289,652.94"
09-Dec-2025,Transfer,03.00,00.00,"1,289,655.94"
09-Dec-2025,Reversal,00.00,"184,236.56","1,105,419.38"
09-Dec-2025,Transfer,"1,823,617.00",00.00,"2,929,036.38"
09-Dec-2025,Commission,00.00,"418,433.77","2,510,602.61"
09-Dec-2025,Bill,00.00,"358,657.52","2,151,945.09"
09-Dec-2025,Reversal,00.00,"717,315.03","1,434,630.06"
09-Dec-2025,NEFT,00.00,"358,657.52","1,075,972.54"
09-Dec-2025,Reversal,01.37,00.00,"1,075,973.91"
09-Dec-2025,Cash,"12,074.03",00.00,"1,088,047.94"
09-Dec-2025,Purchase,00.00,"155,435.42","932,612.52"
09-Dec-2025,Cash,"27,484.60",00.00,"960,097.12"
09-Dec-2025,Cash,00.00,"160,016.19","800,080.93"
09-Dec-2025,Interest,00.00,"266,693.64","533,387.29"
09-Dec-2025,NEFT,00.00,"53,338.73","480,048.56"
09-Dec-2025,Purchase,00.00,"53,338.73","426,709.83"
09-Dec-2025,RTGS,"24,062.94",00.00,"450,772.77"
09-Dec-2025,Cheque,"198,919.80",00.00,"649,692.57"
09-Dec-2025,NEFT,05.90,00.00,"649,698.47"
09-Dec-2025,Commission,00.00,"324,849.24","324,849.24"
09-Dec-2025,Cheque,26.00,00.00,"324,875.24"
09-Dec-2025,Cash,00.00,"40,609.41","284,265.83"
09-Dec-2025,Cash,"4,856.00",00.00,"289,121.83"
09-Dec-2025,RTGS,428.77,00.00,"289,550.60"
09-Dec-2025,Debit Card,00.00,"32,172.29","257,378.31"
09-Dec-2025,Reversal,02.40,00.00,"257,380.71"
09-Dec-2025,Cash,"22,071.30",00.00,"279,452.01"
09-Dec-2025,Commission,"9,272.00",00.00,"288,724.01"
09-Dec-2025,RTGS,00.00,"96,241.34","192,482.67"
09-Dec-2025,Cheque,00.00,"27,497.52","164,985.15"
09-Dec-2025,IMPS,425.00,00.00,"165,410.15"
09-Dec-2025,NEFT,23.05,00.00,"165,433.20"
09-Dec-2025,Transfer,01.00,00.00,"165,434.20"
09-Dec-2025,Interest,"1,920,404.00",00.00,"2,085,838.20"
09-Dec-2025,RTGS,00.00,"521,459.55","1,564,378.65"
09-Dec-2025,NEFT,02.00,00.00,"1,564,380.65"
09-Dec-2025,Cash,00.00,"391,095.16","1,173,285.49"
09-Dec-2025,NEFT,"638,534.75",00.00,"1,811,820.24"
09-Dec-2025,ATM,00.00,"1,811,820.24",00.00
09-Dec-2025,Cash,53.58,00.00,53.58
09-Dec-2025,Bill,00.00,07.65,45.93
09-Dec-2025,Transfer,00.00,22.97,22.96
09-Dec-2025,ATM,256.00,00.00,278.96
10-Dec-2025,ATM,00.00,69.74,209.22
11-Dec-2025,Cheque,00.00,69.74,139.48
11-Dec-2025,Reversal,"1,464,716.75",00.00,"1,464,856.23"
11-Dec-2025,Cash,00.00,"292,971.25","1,171,884.98"
11-Dec-2025,RTGS,00.00,"117,188.50","1,054,696.48"
11-Dec-2025,Bill,221.00,00.00,"1,054,917.48"
11-Dec-2025,Cheque,00.00,"210,983.50","843,933.98"
11-Dec-2025,Interest,00.00,"168,786.80","675,147.18"
11-Dec-2025,Miscellaneous,00.00,"96,449.60","578,697.58"
11-Dec-2025,Interest,00.00,"72,337.20","506,360.38"
11-Dec-2025,Debit Card,06.90,00.00,"506,367.28"
12-Dec-2025,Bill,54.00,00.00,"506,421.28"
12-Dec-2025,Purchase,00.00,"101,284.26","405,137.02"
12-Dec-2025,Cheque,00.00,"40,513.70","364,623.32"
12-Dec-2025,Reversal,00.00,"60,770.55","303,852.77"
12-Dec-2025,IMPS,00.00,"30,385.28","273,467.49"
12-Dec-2025,Cheque,00.00,"91,155.83","182,311.66"
12-Dec-2025,Cheque,"28,793.00",00.00,"211,104.66"
12-Dec-2025,Cash,00.00,"105,552.33","105,552.33"
12-Dec-2025,Tax,03.80,00.00,"105,556.13"
12-Dec-2025,Interest,"160,473.80",00.00,"266,029.93"
12-Dec-2025,ATM,00.00,"29,558.88","236,471.05"
12-Dec-2025,NEFT,00.00,"59,117.76","177,353.29"
12-Dec-2025,RTGS,00.00,"88,676.65","88,676.64"
12-Dec-2025,RTGS,29.42,00.00,"88,706.06"
12-Dec-2025,Reversal,07.86,00.00,"88,713.92"
12-Dec-2025,NEFT,00.00,"88,713.92",00.00
12-Dec-2025,Reversal,66.00,00.00,66.00
12-Dec-2025,Purchase,00.00,08.25,57.75
12-Dec-2025,RTGS,00.20,00.00,57.95
12-Dec-2025,Purchase,00.00,57.95,00.00
12-Dec-2025,Cheque,"2,394.94",00.00,"2,394.94"
12-Dec-2025,Debit Card,00.00,"2,394.94",00.00
12-Dec-2025,ATM,37.00,00.00,37.00
12-Dec-2025,Tax,00.00,07.40,29.60
12-Dec-2025,Bill,"1,904,850.50",00.00,"1,904,880.10"
12-Dec-2025,Tax,00.00,"317,480.02","1,587,400.08"
12-Dec-2025,Bill,06.00,00.00,"1,587,406.08"
12-Dec-2025,NEFT,10.68,00.00,"1,587,416.76"
12-Dec-2025,Cheque,00.00,"793,708.38","793,708.38"
12-Dec-2025,Cash,"794,749.00",00.00,"1,588,457.38"
12-Dec-2025,Bill,"14,549.00",00.00,"1,603,006.38"
12-Dec-2025,Tax,00.00,"400,751.60","1,202,254.78"
12-Dec-2025,RTGS,"1,938,344.50",00.00,"3,140,599.28"
13-Dec-2025,Transfer,"3,680.80",00.00,"3,144,280.08"
13-Dec-2025,Purchase,18.00,00.00,"3,144,298.08"
13-Dec-2025,ATM,20.60,00.00,"3,144,318.68"
13-Dec-2025,Interest,00.00,"786,079.67","2,358,239.01"
13-Dec-2025,Miscellaneous,00.00,"336,891.29","2,021,347.72"
13-Dec-2025,RTGS,05.00,00.00,"2,021,352.72"
14-Dec-2025,Interest,104.10,00.00,"2,021,456.82"
14-Dec-2025,Cash,00.00,"336,909.47","1,684,547.35"
14-Dec-2025,Reversal,00.00,"187,171.93","1,497,375.42"
14-Dec-2025,Bill,00.00,"299,475.08","1,197,900.34"
14-Dec-2025,NEFT,"2,017.90",00.00,"1,199,918.24"
14-Dec-2025,Interest,"18,260.40",00.00,"1,218,178.64"
14-Dec-2025,Cash,"182,921.00",00.00,"1,401,099.64"
14-Dec-2025,Commission,28.67,00.00,"1,401,128.31"
14-Dec-2025,RTGS,00.00,"233,521.39","1,167,606.92"
14-Dec-2025,Bill,"1,378.40",00.00,"1,168,985.32"
14-Dec-2025,Purchase,470.50,00.00,"1,169,455.82"
14-Dec-2025,ATM,00.00,"1,169,455.82",00.00
14-Dec-2025,Reversal,"230,329.22",00.00,"230,329.22"
14-Dec-2025,Commission,00.00,"23,032.92","207,296.30"
14-Dec-2025,Transfer,03.33,00.00,"207,299.63"
14-Dec-2025,Bill,"1,707.50",00.00,"209,007.13"
15-Dec-2025,Interest,44.90,00.00,"209,052.03"
16-Dec-2025,Purchase,00.00,"104,526.02","104,526.02"
16-Dec-2025,Reversal,00.00,"14,932.29","89,593.73"
16-Dec-2025,Cheque,"78,792.00",00.00,"168,385.73"
16-Dec-2025,Cash,"3,805.20",00.00,"172,190.93"
16-Dec-2025,Miscellaneous,00.00,"172,190.93",00.00
16-Dec-2025,Transfer,"3,528.00",00.00,"3,528.00"
16-Dec-2025,IMPS,"708,399.00",00.00,"711,927.00"
16-Dec-2025,Interest,00.00,"711,927.00",00.00
16-Dec-2025,Interest,13.40,00.00,13.40
16-Dec-2025,Interest,"3,804.05",00.00,"3,817.45"
16-Dec-2025,NEFT,00.00,545.35,"3,272.10"
16-Dec-2025,Tax,00.00,818.03,"2,454.07"
16-Dec-2025,RTGS,00.00,409.01,"2,045.06"
16-Dec-2025,Transfer,00.00,681.69,"1,363.37"
16-Dec-2025,RTGS,00.00,454.46,908.91
16-Dec-2025,Interest,"2,674.00",00.00,"3,582.91"
16-Dec-2025,NEFT,"24,173.35",00.00,"27,756.26"
16-Dec-2025,IMPS,"30,399.97",00.00,"58,156.23"
16-Dec-2025,Miscellaneous,00.00,"7,269.53","50,886.70"
17-Dec-2025,Tax,"2,283.40",00.00,"53,170.10"
17-Dec-2025,Transfer,32.40,00.00,"53,202.50"
17-Dec-2025,Commission,00.00,"6,650.31","46,552.19"
17-Dec-2025,Transfer,03.70,00.00,"46,555.89"
17-Dec-2025,Purchase,272.70,00.00,"46,828.59"
17-Dec-2025,ATM,00.00,"11,707.15","35,121.44"
17-Dec-2025,Debit Card,00.00,"35,121.44",00.00
17-Dec-2025,Purchase,"899,110.00",00.00,"899,110.00"
17-Dec-2025,Tax,00.00,"224,777.50","674,332.50"
17-Dec-2025,ATM,01.00,00.00,"674,333.50"
17-Dec-2025,Purchase,"12,438.11",00.00,"686,771.61"
17-Dec-2025,Miscellaneous,"16,123.27",00.00,"702,894.88"
17-Dec-2025,Miscellaneous,252.00,00.00,"703,146.88"
17-Dec-2025,Miscellaneous,00.00,"703,146.88",00.00
17-Dec-2025,Commission,"27,773.20",00.00,"27,773.20"
17-Dec-2025,Reversal,62.27,00.00,"27,835.47"
17-Dec-2025,ATM,"2,082.70",00.00,"29,918.17"
18-Dec-2025,ATM,"1,630,494.00",00.00,"1,660,412.17"
18-Dec-2025,RTGS,00.00,"276,735.36","1,383,676.81"
18-Dec-2025,Interest,"4,932.10",00.00,"1,388,608.91"
18-Dec-2025,Transfer,00.00,"198,372.70","1,190,236.21"
18-Dec-2025,NEFT,00.00,"148,779.53","1,041,456.68"
18-Dec-2025,IMPS,"612,016.20",00.00,"1,653,472.88"
18-Dec-2025,Miscellaneous,00.00,"206,684.11","1,446,788.77"
18-Dec-2025,Transfer,03.00,00.00,"1,446,791.77"
18-Dec-2025,NEFT,"85,094.44",00.00,"1,531,886.21"
18-Dec-2025,Debit Card,00.00,"170,209.58","1,361,676.63"
18-Dec-2025,Reversal,"124,727.62",00.00,"1,486,404.25"
18-Dec-2025,NEFT,102.87,00.00,"1,486,507.12"
18-Dec-2025,Transfer,00.00,"165,167.46","1,321,339.66"
18-Dec-2025,Miscellaneous,00.00,"264,267.93","1,057,071.73"
18-Dec-2025,Miscellaneous,28.60,00.00,"1,057,100.33"
18-Dec-2025,Cheque,00.00,"117,455.59","939,644.74"
18-Dec-2025,Transfer,00.00,"117,455.59","822,189.15"
18-Dec-2025,RTGS,00.00,"91,354.35","730,834.80"
18-Dec-2025,NEFT,06.10,00.00,"730,840.90"
18-Dec-2025,NEFT,"27,770.61",00.00,"758,611.51"
18-Dec-2025,IMPS,"52,612.50",00.00,"811,224.01"
19-Dec-2025,Transfer,53.30,00.00,"811,277.31"
19-Dec-2025,NEFT,"2,018,046.00",00.00,"2,829,323.31"
19-Dec-2025,Interest,00.00,"1,414,661.66","1,414,661.66"
19-Dec-2025,Cheque,74.18,00.00,"1,414,735.84"
19-Dec-2025,RTGS,00.00,"202,105.12","1,212,630.72"
19-Dec-2025,Transfer,00.00,"202,105.12","1,010,525.60"
19-Dec-2025,Miscellaneous,"778,732.75",00.00,"1,789,258.35"
19-Dec-2025,Tax,00.00,"1,789,258.35",00.00
19-Dec-2025,NEFT,08.00,00.00,08.00
19-Dec-2025,Commission,"987,124.00",00.00,"987,132.00"
19-Dec-2025,Cash,"1,374,336.00",00.00,"2,361,468.00"
19-Dec-2025,Bill,00.00,"1,180,734.00","1,180,734.00"
19-Dec-2025,RTGS,00.00,"196,789.00","983,945.00"
19-Dec-2025,RTGS,324.00,00.00,"984,269.00"
19-Dec-2025,IMPS,00.00,"109,363.22","874,905.78"
19-Dec-2025,Interest,720.30,00.00,"875,626.08"
19-Dec-2025,Tax,00.00,"109,453.26","766,172.82"
19-Dec-2025,Cash,"102,253.20",00.00,"868,426.02"
19-Dec-2025,Miscellaneous,"39,281.00",00.00,"907,707.02"
19-Dec-2025,Reversal,00.00,"226,926.76","680,780.26"
19-Dec-2025,Cheque,00.00,"68,078.03","612,702.23"
19-Dec-2025,IMPS,"1,782.33",00.00,"614,484.56"
19-Dec-2025,Miscellaneous,"2,448.00",00.00,"616,932.56"
19-Dec-2025,IMPS,"2,496.00",00.00,"619,428.56"
19-Dec-2025,Cash,"1,332.60",00.00,"620,761.16"
20-Dec-2025,IMPS,00.00,"155,190.29","465,570.87"
20-Dec-2025,NEFT,"2,256.50",00.00,"467,827.37"
20-Dec-2025,Cash,00.00,"51,980.82","415,846.55"
20-Dec-2025,Cheque,"3,294.50",00.00,"419,141.05"
20-Dec-2025,NEFT,00.00,"209,570.53","209,570.52"
20-Dec-2025,Cash,00.00,"104,785.26","104,785.26"
20-Dec-2025,Commission,22.90,00.00,"104,808.16"
20-Dec-2025,Miscellaneous,00.00,"52,404.08","52,404.08"
20-Dec-2025,Debit Card,00.00,"13,101.02","39,303.06"
20-Dec-2025,Interest,00.00,"39,303.06",00.00
20-Dec-2025,Cheque,07.14,00.00,07.14
20-Dec-2025,Purchase,"2,014,391.25",00.00,"2,014,398.39"
20-Dec-2025,Purchase,"11,034.00",00.00,"2,025,432.39"
20-Dec-2025,RTGS,"15,520.10",00.00,"2,040,952.49"
20-Dec-2025,Cash,00.00,"680,317.50","1,360,634.99"
20-Dec-2025,Miscellaneous,"23,042.00",00.00,"1,383,676.99"
20-Dec-2025,RTGS,00.00,"230,612.83","1,153,064.16"
20-Dec-2025,Commission,"3,918.40",00.00,"1,156,982.56"
20-Dec-2025,Commission,06.80,00.00,"1,156,989.36"
20-Dec-2025,Reversal,00.00,"144,623.67","1,012,365.69"
20-Dec-2025,RTGS,00.00,"168,727.62","843,638.08"
20-Dec-2025,RTGS,00.00,"168,727.62","674,910.46"
20-Dec-2025,Reversal,"93,857.06",00.00,"768,767.52"
20-Dec-2025,Cash,70.00,00.00,"768,837.52"
20-Dec-2025,IMPS,146.64,00.00,"768,984.16"
20-Dec-2025,NEFT,00.00,"153,796.83","615,187.33"
21-Dec-2025,Transfer,00.00,"102,531.22","512,656.11"
21-Dec-2025,Purchase,00.00,"73,236.59","439,419.52"
21-Dec-2025,Bill,00.00,"54,927.44","384,492.08"
21-Dec-2025,Bill,00.00,"64,082.01","320,410.07"
21-Dec-2025,Debit Card,00.00,"40,051.26","280,358.81"
21-Dec-2025,Purchase,737.00,00.00,"281,095.81"
21-Dec-2025,Miscellaneous,143.00,00.00,"281,238.81"
21-Dec-2025,Cheque,00.00,"28,123.88","253,114.93"
21-Dec-2025,Debit Card,00.00,"28,123.88","224,991.05"
21-Dec-2025,Cash,205.70,00.00,"225,196.75"
21-Dec-2025,Reversal,00.00,"75,065.58","150,131.17"
21-Dec-2025,Tax,"704,215.00",00.00,"854,346.17"
21-Dec-2025,IMPS,00.62,00.00,"854,346.79"
21-Dec-2025,Tax,00.00,"142,391.13","711,955.66"
21-Dec-2025,Reversal,"14,498.72",00.00,"726,454.38"
21-Dec-2025,Purchase,00.00,"80,717.15","645,737.23"
21-Dec-2025,Transfer,00.00,"645,737.23",00.00
21-Dec-2025,Bill,40.00,00.00,40.00
21-Dec-2025,NEFT,05.00,00.00,45.00
21-Dec-2025,Cash,"2,251.00",00.00,"2,296.00"
21-Dec-2025,Reversal,00.00,"1,148.00","1,148.00"
21-Dec-2025,Tax,00.00,127.56,"1,020.44"
21-Dec-2025,Tax,00.00,102.04,918.40
21-Dec-2025,Debit Card,00.00,131.20,787.20
21-Dec-2025,Tax,05.60,00.00,792.80
21-Dec-2025,IMPS,00.00,79.28,713.52
22-Dec-2025,NEFT,38.60,00.00,752.12
22-Dec-2025,Cheque,00.00,188.03,564.09
22-Dec-2025,RTGS,00.00,564.09,00.00
22-Dec-2025,IMPS,07.03,00.00,07.03
22-Dec-2025,Purchase,00.00,03.52,03.52
22-Dec-2025,Tax,499.86,00.00,503.38
22-Dec-2025,Cash,"919,355.50",00.00,"919,858.88"
22-Dec-2025,NEFT,00.00,"183,971.78","735,887.10"
22-Dec-2025,RTGS,00.00,"245,295.70","490,591.40"
22-Dec-2025,Transfer,00.00,"49,059.14","441,532.26"
23-Dec-2025,Transfer,00.00,"441,532.26",00.00
23-Dec-2025,Transfer,412.00,00.00,412.00
23-Dec-2025,Purchase,00.00,45.78,366.22
23-Dec-2025,Debit Card,"210,151.50",00.00,"210,517.72"
23-Dec-2025,Commission,"9,047.27",00.00,"219,564.99"
23-Dec-2025,ATM,186.00,00.00,"219,750.99"
23-Dec-2025,Tax,"1,960,571.00",00.00,"2,180,321.99"
23-Dec-2025,Commission,37.50,00.00,"2,180,359.49"
23-Dec-2025,Tax,506.00,00.00,"2,180,865.49"
23-Dec-2025,Transfer,435.07,00.00,"2,181,300.56"
23-Dec-2025,ATM,"1,864,582.00",00.00,"4,045,882.56"
23-Dec-2025,Commission,"1,337.63",00.00,"4,047,220.19"
23-Dec-2025,Bill,00.00,"809,444.04","3,237,776.15"
23-Dec-2025,NEFT,"1,569,767.20",00.00,"4,807,543.35"
23-Dec-2025,Transfer,00.00,"2,403,771.68","2,403,771.67"
23-Dec-2025,Cash,00.00,"600,942.92","1,802,828.75"
23-Dec-2025,Reversal,"1,144,546.00",00.00,"2,947,374.75"
23-Dec-2025,Debit Card,00.00,"1,473,687.38","1,473,687.38"
23-Dec-2025,NEFT,00.00,"294,737.48","1,178,949.90"
23-Dec-2025,Debit Card,57.00,00.00,"1,179,006.90"
23-Dec-2025,Reversal,00.00,"235,801.38","943,205.52"
23-Dec-2025,Tax,00.00,"104,800.61","838,404.91"
23-Dec-2025,Commission,00.00,"139,734.15","698,670.76"
23-Dec-2025,Miscellaneous,"65,531.00",00.00,"764,201.76"
23-Dec-2025,NEFT,"1,824,184.00",00.00,"2,588,385.76"
23-Dec-2025,NEFT,00.00,"2,588,385.76",00.00
23-Dec-2025,Tax,"3,551.97",00.00,"3,551.97"
23-Dec-2025,Miscellaneous,00.00,592.00,"2,959.98"
23-Dec-2025,Reversal,"1,947,795.50",00.00,"1,950,755.48"
23-Dec-2025,Cheque,00.00,"975,377.74","975,377.74"
23-Dec-2025,Tax,00.00,"195,075.55","780,302.19"
23-Dec-2025,Commission,"796,224.80",00.00,"1,576,526.99"
23-Dec-2025,Commission,"1,298.00",00.00,"1,577,824.99"
23-Dec-2025,Bill,00.00,"157,782.50","1,420,042.49"
23-Dec-2025,Interest,00.00,"142,004.25","1,278,038.24"
23-Dec-2025,NEFT,00.00,"142,004.25","1,136,033.99"
23-Dec-2025,ATM,00.00,"113,603.40","1,022,430.59"
23-Dec-2025,NEFT,"1,798.90",00.00,"1,024,229.49"
23-Dec-2025,Purchase,468.00,00.00,"1,024,697.49"
23-Dec-2025,Bill,"3,967.51",00.00,"1,028,665.00"
23-Dec-2025,Bill,00.00,"205,733.00","822,932.00"
23-Dec-2025,Tax,00.00,"411,466.00","411,466.00"
23-Dec-2025,Miscellaneous,00.00,"82,293.20","329,172.80"
23-Dec-2025,NEFT,00.00,"164,586.40","164,586.40"
23-Dec-2025,Bill,"3,044.12",00.00,"167,630.52"
23-Dec-2025,IMPS,00.00,"20,953.82","146,676.70"
23-Dec-2025,Cash,00.00,"24,446.12","122,230.58"
24-Dec-2025,NEFT,05.00,00.00,"122,235.58"
24-Dec-2025,Debit Card,00.00,"40,745.19","81,490.39"
24-Dec-2025,Cheque,"10,745.04",00.00,"92,235.43"
24-Dec-2025,Reversal,00.00,"11,529.43","80,706.00"
24-Dec-2025,Purchase,"30,035.00",00.00,"110,741.00"
24-Dec-2025,Debit Card,00.00,"13,842.63","96,898.38"
24-Dec-2025,Bill,"1,042.00",00.00,"97,940.38"
24-Dec-2025,Interest,"1,017.10",00.00,"98,957.48"
24-Dec-2025,Reversal,"108,802.00",00.00,"207,759.48"
24-Dec-2025,Cheque,05.60,00.00,"207,765.08"
24-Dec-2025,Commission,00.00,"51,941.27","155,823.81"
24-Dec-2025,Bill,00.00,"155,823.81",00.00
24-Dec-2025,Reversal,"26,944.00",00.00,"26,944.00"
24-Dec-2025,Debit Card,00.00,"3,368.00","23,576.00"
24-Dec-2025,Bill,00.00,"3,929.33","19,646.67"
24-Dec-2025,Transfer,477.81,00.00,"20,124.48"
24-Dec-2025,Reversal,00.00,"2,874.93","17,249.55"
24-Dec-2025,NEFT,00.00,"8,624.78","8,624.78"
24-Dec-2025,Debit Card,00.00,"2,156.20","6,468.59"
24-Dec-2025,Cash,10.00,00.00,"6,478.59"
24-Dec-2025,ATM,00.00,719.84,"5,758.75"
24-Dec-2025,Cheque,329.30,00.00,"6,088.05"
24-Dec-2025,NEFT,00.00,"1,522.01","4,566.04"
24-Dec-2025,ATM,"245,701.38",00.00,"250,267.42"
24-Dec-2025,Commission,"2,022,174.80",00.00,"2,272,442.22"
24-Dec-2025,Reversal,00.00,"568,110.56","1,704,331.66"
24-Dec-2025,IMPS,00.00,"213,041.46","1,491,290.20"
24-Dec-2025,Interest,60.50,00.00,"1,491,350.70"
24-Dec-2025,Commission,07.00,00.00,"1,491,357.70"
24-Dec-2025,Commission,00.00,"186,419.71","1,304,937.99"
24-Dec-2025,Purchase,"3,045.55",00.00,"1,307,983.54"
24-Dec-2025,IMPS,00.00,"145,331.50","1,162,652.04"
24-Dec-2025,Tax,00.00,"581,326.02","581,326.02"
24-Dec-2025,Cash,63.00,00.00,"581,389.02"
24-Dec-2025,NEFT,10.30,00.00,"581,399.32"
24-Dec-2025,NEFT,00.00,"96,899.89","484,499.43"
24-Dec-2025,Debit Card,00.00,"242,249.72","242,249.72"
24-Dec-2025,IMPS,"122,534.00",00.00,"364,783.72"
24-Dec-2025,Reversal,00.00,"36,478.37","328,305.35"
24-Dec-2025,Commission,00.00,"82,076.34","246,229.01"
24-Dec-2025,Purchase,"6,881.00",00.00,"253,110.01"
24-Dec-2025,Purchase,125.40,00.00,"253,235.41"
24-Dec-2025,Reversal,237.40,00.00,"253,472.81"
24-Dec-2025,Cheque,"1,045,922.00",00.00,"1,299,394.81"
24-Dec-2025,Debit Card,00.00,"185,627.83","1,113,766.98"
24-Dec-2025,Miscellaneous,301.20,00.00,"1,114,068.18"
24-Dec-2025,Interest,00.00,"278,517.05","835,551.14"
24-Dec-2025,Debit Card,35.00,00.00,"835,586.14"
24-Dec-2025,Commission,00.00,"139,264.36","696,321.78"
24-Dec-2025,Cheque,"123,639.81",00.00,"819,961.59"
24-Dec-2025,NEFT,"26,320.60",00.00,"846,282.19"
24-Dec-2025,NEFT,00.00,"211,570.55","634,711.64"
24-Dec-2025,Tax,"16,242.00",00.00,"650,953.64"
24-Dec-2025,ATM,36.99,00.00,"650,990.63"
24-Dec-2025,Transfer,478.06,00.00,"651,468.69"
24-Dec-2025,IMPS,"1,582,083.00",00.00,"2,233,551.69"
24-Dec-2025,Debit Card,00.00,"279,193.96","1,954,357.73"
24-Dec-2025,NEFT,00.00,"651,452.58","1,302,905.15"
24-Dec-2025,Reversal,00.00,"217,150.86","1,085,754.29"
24-Dec-2025,RTGS,00.00,"1,085,754.29",00.00
24-Dec-2025,Transfer,"31,258.20",00.00,"31,258.20"
24-Dec-2025,Miscellaneous,00.00,"15,629.10","15,629.10"
24-Dec-2025,Interest,00.00,"2,604.85","13,024.25"
24-Dec-2025,Cash,00.00,"2,604.85","10,419.40"
24-Dec-2025,Cash,"19,321.95",00.00,"29,741.35"
24-Dec-2025,RTGS,03.97,00.00,"29,745.32"
24-Dec-2025,Purchase,"12,734.00",00.00,"42,479.32"
24-Dec-2025,NEFT,00.00,"5,309.92","37,169.40"
24-Dec-2025,Tax,00.00,"7,433.88","29,735.52"
24-Dec-2025,Cheque,00.00,"7,433.88","22,301.64"
24-Dec-2025,ATM,00.00,"3,716.94","18,584.70"
24-Dec-2025,Interest,00.00,"3,097.45","15,487.25"
24-Dec-2025,Interest,00.00,"7,743.63","7,743.62"
24-Dec-2025,Cash,"1,049.40",00.00,"8,793.02"
24-Dec-2025,Cheque,00.00,"4,396.51","4,396.51"
24-Dec-2025,Interest,"31,409.91",00.00,"35,806.42"
25-Dec-2025,Purchase,"22,536.00",00.00,"58,342.42"
25-Dec-2025,Cheque,16.50,00.00,"58,358.92"
25-Dec-2025,Debit Card,03.00,00.00,"58,361.92"
25-Dec-2025,Miscellaneous,00.00,00.00,"58,361.92"
25-Dec-2025,Purchase,"26,194.00",00.00,"84,555.92"
25-Dec-2025,Transfer,"3,703.04",00.00,"88,258.96"
25-Dec-2025,Interest,00.00,"88,258.96",00.00
26-Dec-2025,Cheque,124.00,00.00,124.00
26-Dec-2025,Cash,00.00,17.71,106.29
27-Dec-2025,IMPS,00.00,10.63,95.66
27-Dec-2025,ATM,"223,444.20",00.00,"223,539.86"
27-Dec-2025,Commission,00.00,"111,769.93","111,769.93"
27-Dec-2025,Cash,00.00,"111,769.93",00.00
27-Dec-2025,Cash,"12,029.60",00.00,"12,029.60"
27-Dec-2025,Transfer,00.00,"3,007.40","9,022.20"
27-Dec-2025,Commission,00.00,"1,503.70","7,518.50"
27-Dec-2025,Interest,00.00,"1,503.70","6,014.80"
27-Dec-2025,Tax,"197,896.90",00.00,"203,911.70"
27-Dec-2025,Purchase,"30,985.00",00.00,"234,896.70"
27-Dec-2025,RTGS,03.40,00.00,"234,900.10"
27-Dec-2025,NEFT,"205,458.59",00.00,"440,358.69"
27-Dec-2025,Transfer,00.00,"73,393.12","366,965.58"
27-Dec-2025,Purchase,00.00,"45,870.70","321,094.88"
27-Dec-2025,Purchase,"125,404.00",00.00,"446,498.88"
27-Dec-2025,Miscellaneous,"18,681.00",00.00,"465,179.88"
27-Dec-2025,ATM,03.74,00.00,"465,183.62"
27-Dec-2025,RTGS,59.70,00.00,"465,243.32"
27-Dec-2025,IMPS,"192,505.00",00.00,"657,748.32"
27-Dec-2025,ATM,02.00,00.00,"657,750.32"
27-Dec-2025,Purchase,04.00,00.00,"657,754.32"
27-Dec-2025,NEFT,00.00,"328,877.16","328,877.16"
28-Dec-2025,Cash,"5,933.28",00.00,"334,810.44"
28-Dec-2025,Interest,48.20,00.00,"334,858.64"
28-Dec-2025,ATM,00.00,"66,971.73","267,886.91"
28-Dec-2025,Purchase,"85,282.00",00.00,"353,168.91"
28-Dec-2025,Transfer,00.00,"353,168.91",00.00
28-Dec-2025,Tax,559.00,00.00,559.00
28-Dec-2025,Reversal,122.80,00.00,681.80
28-Dec-2025,Cash,00.00,85.23,596.57
28-Dec-2025,Purchase,00.00,99.43,497.14
28-Dec-2025,NEFT,58.90,00.00,556.04
28-Dec-2025,Debit Card,"45,009.00",00.00,"45,565.04"
28-Dec-2025,Bill,00.00,"5,062.78","40,502.26"
28-Dec-2025,NEFT,00.00,"5,062.78","35,439.48"
28-Dec-2025,NEFT,"2,735.70",00.00,"38,175.18"
28-Dec-2025,Debit Card,03.30,00.00,"38,178.48"
28-Dec-2025,Cash,00.00,"4,242.05","33,936.43"
28-Dec-2025,RTGS,"393,662.00",00.00,"427,598.43"
28-Dec-2025,Tax,"71,191.22",00.00,"498,789.65"
28-Dec-2025,Reversal,"1,207.00",00.00,"499,996.65"
28-Dec-2025,Interest,40.00,00.00,"500,036.65"
28-Dec-2025,NEFT,00.00,"125,009.16","375,027.49"
28-Dec-2025,Miscellaneous,231.00,00.00,"375,258.49"
28-Dec-2025,Commission,00.00,"41,695.39","333,563.10"
28-Dec-2025,Transfer,00.00,00.00,"333,563.10"
28-Dec-2025,Miscellaneous,00.00,"166,781.55","166,781.55"
28-Dec-2025,Purchase,00.00,"55,593.85","111,187.70"
28-Dec-2025,RTGS,00.00,"27,796.93","83,390.77"
28-Dec-2025,NEFT,00.00,"9,265.64","74,125.13"
28-Dec-2025,Cash,"2,325.00",00.00,"76,450.13"
28-Dec-2025,Interest,00.00,"12,741.69","63,708.44"
28-Dec-2025,Bill,00.00,"9,101.21","54,607.23"
28-Dec-2025,Cheque,"77,377.03",00.00,"131,984.26"
28-Dec-2025,Reversal,00.00,"13,198.43","118,785.83"
28-Dec-2025,Bill,36.70,00.00,"118,822.53"
28-Dec-2025,Debit Card,02.00,00.00,"118,824.53"
28-Dec-2025,Interest,59.90,00.00,"118,884.43"
28-Dec-2025,ATM,00.00,"19,814.07","99,070.36"
28-Dec-2025,Cheque,"84,503.09",00.00,"183,573.45"
28-Dec-2025,IMPS,00.00,"61,191.15","122,382.30"
28-Dec-2025,Miscellaneous,"24,119.70",00.00,"146,502.00"
28-Dec-2025,RTGS,522.00,00.00,"147,024.00"
28-Dec-2025,Reversal,11.00,00.00,"147,035.00"
29-Dec-2025,RTGS,00.00,"36,758.75","110,276.25"
29-Dec-2025,Transfer,50.10,00.00,"110,326.35"
29-Dec-2025,Purchase,00.00,"22,065.27","88,261.08"
29-Dec-2025,Purchase,"80,751.84",00.00,"169,012.92"
29-Dec-2025,ATM,61.00,00.00,"169,073.92"
29-Dec-2025,Reversal,00.00,"21,134.24","147,939.68"
29-Dec-2025,IMPS,45.47,00.00,"147,985.15"
29-Dec-2025,Bill,"65,594.20",00.00,"213,579.35"
29-Dec-2025,NEFT,00.00,"35,596.56","177,982.79"
29-Dec-2025,Debit Card,"1,453.00",00.00,"179,435.79"
29-Dec-2025,Purchase,"2,041,153.00",00.00,"2,220,588.79"
29-Dec-2025,Debit Card,21.94,00.00,"2,220,610.73"
29-Dec-2025,Tax,00.00,"740,203.58","1,480,407.15"
29-Dec-2025,Interest,"30,996.90",00.00,"1,511,404.05"
29-Dec-2025,Cheque,00.00,"167,933.78","1,343,470.27"
29-Dec-2025,IMPS,00.00,"447,823.42","895,646.85"
30-Dec-2025,Purchase,145.28,00.00,"895,792.13"
30-Dec-2025,RTGS,00.00,"89,579.21","806,212.92"
30-Dec-2025,Purchase,07.00,00.00,"806,219.92"
30-Dec-2025,Miscellaneous,"2,052.27",00.00,"808,272.19"
30-Dec-2025,IMPS,299.49,00.00,"808,571.68"
30-Dec-2025,Cash,01.90,00.00,"808,573.58"
30-Dec-2025,Interest,00.00,"80,857.36","727,716.22"
31-Dec-2025,Commission,459.59,00.00,"728,175.81"
31-Dec-2025,Bill,"1,304,739.50",00.00,"2,032,915.31"
31-Dec-2025,RTGS,07.80,00.00,"2,032,923.11"
31-Dec-2025,ATM,26.51,00.00,"2,032,949.62"
31-Dec-2025,IMPS,07.00,00.00,"2,032,956.62"
31-Dec-2025,ATM,00.00,"290,422.37","1,742,534.25"
31-Dec-2025,Cheque,"24,730.10",00.00,"1,767,264.35"
31-Dec-2025,Bill,"20,339.90",00.00,"1,787,604.25"
31-Dec-2025,Cheque,00.00,"893,802.13","893,802.12"
31-Dec-2025,Transfer,00.00,"297,934.04","595,868.08"
31-Dec-2025,Debit Card,00.00,"198,622.69","397,245.39"
31-Dec-2025,IMPS,"2,018,147.00",00.00,"2,415,392.39"
31-Dec-2025,Transfer,"1,539,990.75",00.00,"3,955,383.14"
31-Dec-2025,IMPS,00.00,"395,538.31","3,559,844.83"
31-Dec-2025,ATM,451.43,00.00,"3,560,296.26"
31-Dec-2025,Transfer,"1,826,670.00",00.00,"5,386,966.26"
31-Dec-2025,IMPS,00.87,00.00,"5,386,967.13"
31-Dec-2025,Purchase,00.00,"2,693,483.57","2,693,483.56"
31-Dec-2025,RTGS,07.00,00.00,"2,693,490.56"
31-Dec-2025,Transfer,00.00,"2,693,490.56",00.00
01-Jan-2026,Interest,01.70,00.00,01.70
01-Jan-2026,NEFT,"1,343.65",00.00,"1,345.35"
01-Jan-2026,RTGS,00.00,448.45,896.90
01-Jan-2026,Commission,"27,297.56",00.00,"28,194.46"
01-Jan-2026,Cheque,00.00,"7,048.62","21,145.84"
01-Jan-2026,ATM,"28,103.60",00.00,"49,249.44"
01-Jan-2026,Interest,59.00,00.00,"49,308.44"
01-Jan-2026,Bill,01.90,00.00,"49,310.34"
01-Jan-2026,Interest,00.00,"7,044.33","42,266.01"
01-Jan-2026,Purchase,491.30,00.00,"42,757.31"
01-Jan-2026,Reversal,48.93,00.00,"42,806.24"
01-Jan-2026,Miscellaneous,59.19,00.00,"42,865.43"
01-Jan-2026,Debit Card,00.00,"8,573.09","34,292.34"
01-Jan-2026,IMPS,00.00,"34,292.34",00.00
01-Jan-2026,Purchase,96.00,00.00,96.00
01-Jan-2026,Commission,00.00,19.20,76.80
01-Jan-2026,Cash,00.00,25.60,51.20
01-Jan-2026,ATM,00.00,25.60,25.60
01-Jan-2026,Bill,00.00,04.27,21.33
01-Jan-2026,Bill,"26,679.00",00.00,"26,700.33"
01-Jan-2026,Purchase,04.00,00.00,"26,704.33"
01-Jan-2026,Purchase,00.00,"3,814.90","22,889.43"
01-Jan-2026,Interest,694.50,00.00,"23,583.93"
01-Jan-2026,IMPS,00.00,"2,358.39","21,225.54"
01-Jan-2026,IMPS,00.00,"3,032.22","18,193.32"
01-Jan-2026,IMPS,00.00,"3,032.22","15,161.10"
01-Jan-2026,Cheque,00.00,"1,516.11","13,644.99"
01-Jan-2026,IMPS,00.00,"2,729.00","10,915.99"
01-Jan-2026,RTGS,"1,252,353.80",00.00,"1,263,269.79"
01-Jan-2026,RTGS,00.00,"1,263,269.79",00.00
01-Jan-2026,Cash,"2,035,879.00",00.00,"2,035,879.00"
01-Jan-2026,RTGS,228.80,00.00,"2,036,107.80"
01-Jan-2026,Cash,"26,099.82",00.00,"2,062,207.62"
02-Jan-2026,IMPS,"32,167.00",00.00,"2,094,374.62"
02-Jan-2026,Transfer,00.00,"261,796.83","1,832,577.79"
02-Jan-2026,Commission,00.00,"183,257.78","1,649,320.01"
02-Jan-2026,Purchase,14.00,00.00,"1,649,334.01"
02-Jan-2026,NEFT,00.00,"274,889.00","1,374,445.01"
03-Jan-2026,Commission,00.00,"152,716.11","1,221,728.90"
03-Jan-2026,IMPS,"19,036.61",00.00,"1,240,765.51"
03-Jan-2026,Commission,00.00,"177,252.22","1,063,513.29"
04-Jan-2026,Miscellaneous,"1,153,144.00",00.00,"2,216,657.29"
04-Jan-2026,IMPS,"163,514.03",00.00,"2,380,171.32"
04-Jan-2026,Cheque,00.00,"340,024.47","2,040,146.85"
04-Jan-2026,Cash,00.00,"2,040,146.85",00.00
04-Jan-2026,ATM,08.00,00.00,08.00
04-Jan-2026,Bill,00.00,02.00,06.00
04-Jan-2026,Interest,28.00,00.00,34.00
04-Jan-2026,Reversal,241.44,00.00,275.44
04-Jan-2026,Cheque,00.00,39.35,236.09
04-Jan-2026,NEFT,00.00,26.23,209.86
04-Jan-2026,IMPS,29.30,00.00,239.16
04-Jan-2026,Cheque,"2,556.00",00.00,"2,795.16"
04-Jan-2026,Commission,"87,933.00",00.00,"90,728.16"
04-Jan-2026,Purchase,00.00,"45,364.08","45,364.08"
04-Jan-2026,RTGS,21.10,00.00,"45,385.18"
04-Jan-2026,NEFT,"30,975.00",00.00,"76,360.18"
04-Jan-2026,Reversal,402.00,00.00,"76,762.18"
04-Jan-2026,ATM,00.00,"9,595.27","67,166.91"
04-Jan-2026,Transfer,"27,555.75",00.00,"94,722.66"
04-Jan-2026,Miscellaneous,00.00,"18,944.53","75,778.13"
04-Jan-2026,Reversal,"26,187.99",00.00,"101,966.12"
04-Jan-2026,Interest,"1,460.12",00.00,"103,426.24"
04-Jan-2026,Bill,00.00,"12,928.28","90,497.96"
04-Jan-2026,Miscellaneous,"225,121.59",00.00,"315,619.55"
04-Jan-2026,Interest,"239,487.31",00.00,"555,106.86"
05-Jan-2026,Transfer,32.20,00.00,"555,139.06"
05-Jan-2026,Miscellaneous,06.46,00.00,"555,145.52"
05-Jan-2026,IMPS,00.00,"79,306.50","475,839.02"
05-Jan-2026,Cash,"227,603.00",00.00,"703,442.02"
05-Jan-2026,Purchase,00.00,"351,721.01","351,721.01"
05-Jan-2026,RTGS,00.00,"58,620.17","293,100.84"
05-Jan-2026,Reversal,"600,274.75",00.00,"893,375.59"
05-Jan-2026,IMPS,00.00,"446,687.80","446,687.80"
05-Jan-2026,Cash,"148,365.03",00.00,"595,052.83"
05-Jan-2026,Transfer,00.00,"59,505.28","535,547.55"
05-Jan-2026,ATM,205.50,00.00,"535,753.05"
05-Jan-2026,Commission,00.00,"178,584.35","357,168.70"
05-Jan-2026,RTGS,00.00,"178,584.35","178,584.35"
05-Jan-2026,Commission,00.00,"19,842.71","158,741.64"
05-Jan-2026,Bill,00.00,"26,456.94","132,284.70"
05-Jan-2026,Bill,"188,292.80",00.00,"320,577.50"
05-Jan-2026,Commission,03.47,00.00,"320,580.97"
05-Jan-2026,RTGS,00.00,"80,145.24","240,435.73"
05-Jan-2026,Cash,306.39,00.00,"240,742.12"
06-Jan-2026,Purchase,08.00,00.00,"240,750.12"
06-Jan-2026,IMPS,448.77,00.00,"241,198.89"
06-Jan-2026,IMPS,"23,092.00",00.00,"264,290.89"
06-Jan-2026,Tax,00.00,"88,096.96","176,193.93"
06-Jan-2026,Interest,00.00,"44,048.48","132,145.45"
06-Jan-2026,RTGS,215.35,00.00,"132,360.80"
06-Jan-2026,Reversal,00.00,"18,908.69","113,452.11"
06-Jan-2026,IMPS,00.00,"22,690.42","90,761.69"
06-Jan-2026,Cash,16.80,00.00,"90,778.49"
06-Jan-2026,NEFT,"208,122.91",00.00,"298,901.40"
06-Jan-2026,ATM,"27,730.52",00.00,"326,631.92"
07-Jan-2026,Transfer,00.00,"163,315.96","163,315.96"
07-Jan-2026,Cheque,"3,579.00",00.00,"166,894.96"
07-Jan-2026,NEFT,"124,826.20",00.00,"291,721.16"
07-Jan-2026,Commission,02.00,00.00,"291,723.16"
07-Jan-2026,Cash,"117,015.00",00.00,"408,738.16"
07-Jan-2026,Cash,285.00,00.00,"409,023.16"
07-Jan-2026,Bill,"3,069.00",00.00,"412,092.16"
07-Jan-2026,Commission,587.36,00.00,"412,679.52"
07-Jan-2026,Interest,00.00,"103,169.88","309,509.64"
07-Jan-2026,Cash,"99,109.10",00.00,"408,618.74"
07-Jan-2026,Transfer,00.00,"102,154.69","306,464.06"
07-Jan-2026,Cash,"17,457.53",00.00,"323,921.59"
07-Jan-2026,IMPS,"8,055.00",00.00,"331,976.59"
07-Jan-2026,Miscellaneous,00.00,"47,425.23","284,551.36"
07-Jan-2026,Reversal,25.05,00.00,"284,576.41"
07-Jan-2026,Tax,00.00,"94,858.80","189,717.61"
07-Jan-2026,ATM,00.00,"63,239.20","126,478.41"
07-Jan-2026,Purchase,917.00,00.00,"127,395.41"
07-Jan-2026,Miscellaneous,00.00,"127,395.41",00.00
08-Jan-2026,Commission,"25,099.00",00.00,"25,099.00"
08-Jan-2026,IMPS,415.30,00.00,"25,514.30"
08-Jan-2026,RTGS,00.00,"6,378.58","19,135.72"
08-Jan-2026,Reversal,"1,975.00",00.00,"21,110.72"
08-Jan-2026,Interest,"28,619.00",00.00,"49,729.72"
08-Jan-2026,Debit Card,00.00,"12,432.43","37,297.29"
08-Jan-2026,Tax,00.00,"37,297.29",00.00
08-Jan-2026,Purchase,269.10,00.00,269.10
08-Jan-2026,Purchase,"3,645.00",00.00,"3,914.10"
08-Jan-2026,RTGS,00.00,978.53,"2,935.58"
08-Jan-2026,Reversal,"333,231.50",00.00,"336,167.08"
08-Jan-2026,Interest,136.00,00.00,"336,303.08"
08-Jan-2026,Cheque,00.00,"84,075.77","252,227.31"
08-Jan-2026,Cash,"13,245.00",00.00,"265,472.31"
08-Jan-2026,NEFT,"20,066.66",00.00,"285,538.97"
08-Jan-2026,Purchase,00.00,"57,107.79","228,431.18"
08-Jan-2026,NEFT,00.67,00.00,"228,431.85"
08-Jan-2026,IMPS,00.00,"76,143.95","152,287.90"
08-Jan-2026,Cheque,"1,503.64",00.00,"153,791.54"
08-Jan-2026,Interest,00.00,"38,447.89","115,343.66"
08-Jan-2026,Transfer,"20,147.00",00.00,"135,490.66"
08-Jan-2026,Cheque,00.00,"19,355.81","116,134.85"
08-Jan-2026,Reversal,"30,384.06",00.00,"146,518.91"
08-Jan-2026,Interest,"2,864.80",00.00,"149,383.71"
08-Jan-2026,Cheque,00.80,00.00,"149,384.51"
08-Jan-2026,Tax,00.00,"37,346.13","112,038.38"
08-Jan-2026,Cash,00.00,"14,004.80","98,033.58"
08-Jan-2026,Purchase,"1,704,507.00",00.00,"1,802,540.58"
08-Jan-2026,Debit Card,00.00,"300,423.43","1,502,117.15"
08-Jan-2026,Bill,132.30,00.00,"1,502,249.45"
08-Jan-2026,Bill,00.00,"166,916.61","1,335,332.84"
08-Jan-2026,RTGS,"106,288.00",00.00,"1,441,620.84"
08-Jan-2026,Cheque,37.76,00.00,"1,441,658.60"
08-Jan-2026,RTGS,00.00,"288,331.72","1,153,326.88"
08-Jan-2026,RTGS,"79,294.20",00.00,"1,232,621.08"
08-Jan-2026,Reversal,00.00,"308,155.27","924,465.81"
08-Jan-2026,Cash,00.00,"154,077.64","770,388.18"
08-Jan-2026,Purchase,"29,744.20",00.00,"800,132.38"
08-Jan-2026,Cash,00.00,"133,355.40","666,776.98"
08-Jan-2026,ATM,00.00,"66,677.70","600,099.28"
08-Jan-2026,Commission,00.00,"120,019.86","480,079.42"
08-Jan-2026,Cheque,00.00,"53,342.16","426,737.26"
08-Jan-2026,Miscellaneous,00.00,"142,245.75","284,491.51"
08-Jan-2026,Reversal,00.00,"31,610.17","252,881.34"
08-Jan-2026,Commission,702.20,00.00,"253,583.54"
08-Jan-2026,Reversal,00.00,"63,395.89","190,187.66"
09-Jan-2026,Reversal,00.00,"21,131.96","169,055.70"
09-Jan-2026,Purchase,63.32,00.00,"169,119.02"
09-Jan-2026,Cheque,00.00,"16,911.90","152,207.12"
09-Jan-2026,Miscellaneous,483.00,00.00,"152,690.12"
09-Jan-2026,Transfer,"104,094.00",00.00,"256,784.12"
09-Jan-2026,Commission,00.00,"36,683.45","220,100.67"
09-Jan-2026,Commission,00.00,"110,050.34","110,050.34"
09-Jan-2026,Interest,00.00,"13,756.29","96,294.05"
09-Jan-2026,Bill,00.00,"96,294.05",00.00
09-Jan-2026,RTGS,"819,248.00",00.00,"819,248.00"
09-Jan-2026,Interest,"13,704.30",00.00,"832,952.30"
09-Jan-2026,Commission,"117,757.72",00.00,"950,710.02"
10-Jan-2026,Reversal,29.44,00.00,"950,739.46"
10-Jan-2026,NEFT,00.00,"475,369.73","475,369.73"
10-Jan-2026,Miscellaneous,00.00,"79,228.29","396,141.44"
10-Jan-2026,Cash,00.00,"99,035.36","297,106.08"
10-Jan-2026,Purchase,00.00,"59,421.22","237,684.86"
10-Jan-2026,ATM,"1,217.04",00.00,"238,901.90"
10-Jan-2026,Transfer,273.63,00.00,"239,175.53"
10-Jan-2026,Interest,00.00,"59,793.88","179,381.65"
10-Jan-2026,Debit Card,00.00,"35,876.33","143,505.32"
10-Jan-2026,Cheque,00.00,"47,835.11","95,670.21"
10-Jan-2026,Cheque,"1,242,739.00",00.00,"1,338,409.21"
10-Jan-2026,Bill,00.00,"148,712.13","1,189,697.08"
10-Jan-2026,Commission,00.00,"169,956.73","1,019,740.35"
10-Jan-2026,Debit Card,00.76,00.00,"1,019,741.11"
10-Jan-2026,Purchase,00.00,"339,913.70","679,827.41"
10-Jan-2026,Miscellaneous,"193,327.22",00.00,"873,154.63"
10-Jan-2026,Purchase,00.00,"291,051.54","582,103.09"
10-Jan-2026,IMPS,58.70,00.00,"582,161.79"
10-Jan-2026,IMPS,00.00,"58,216.18","523,945.61"
11-Jan-2026,ATM,432.20,00.00,"524,377.81"
11-Jan-2026,Commission,03.40,00.00,"524,381.21"
11-Jan-2026,Cheque,"13,846.00",00.00,"538,227.21"
11-Jan-2026,Reversal,00.00,"76,889.60","461,337.61"
11-Jan-2026,Transfer,00.00,"230,668.81","230,668.80"
11-Jan-2026,Cheque,00.00,"57,667.20","173,001.60"
11-Jan-2026,Cash,"12,699.00",00.00,"185,700.60"
11-Jan-2026,Cheque,"10,337.00",00.00,"196,037.60"
11-Jan-2026,Cash,00.00,"32,672.93","163,364.67"
11-Jan-2026,NEFT,"2,074,160.50",00.00,"2,237,525.17"
11-Jan-2026,Reversal,00.00,"1,118,762.59","1,118,762.58"
11-Jan-2026,Debit Card,00.00,"372,920.86","745,841.72"
11-Jan-2026,Bill,02.47,00.00,"745,844.19"
12-Jan-2026,ATM,00.00,"149,168.84","596,675.35"
12-Jan-2026,Interest,00.00,"298,337.68","298,337.68"
12-Jan-2026,Reversal,50.46,00.00,"298,388.14"
13-Jan-2026,RTGS,00.00,"74,597.04","223,791.10"
13-Jan-2026,Cheque,00.00,"31,970.16","191,820.94"
13-Jan-2026,Interest,00.00,"38,364.19","153,456.75"
13-Jan-2026,Cash,"22,251.50",00.00,"175,708.25"
13-Jan-2026,Commission,00.00,"87,854.13","87,854.12"
13-Jan-2026,NEFT,00.00,"14,642.35","73,211.77"
13-Jan-2026,NEFT,37.00,00.00,"73,248.77"
13-Jan-2026,Bill,00.00,"10,464.11","62,784.66"
13-Jan-2026,Cheque,00.00,"7,848.08","54,936.58"
13-Jan-2026,RTGS,00.00,"54,936.58",00.00
13-Jan-2026,Debit Card,44.00,00.00,44.00
13-Jan-2026,IMPS,00.00,04.89,39.11
13-Jan-2026,Commission,00.00,04.89,34.22
13-Jan-2026,ATM,"31,383.00",00.00,"31,417.22"
13-Jan-2026,Transfer,"2,008.86",00.00,"33,426.08"
13-Jan-2026,IMPS,00.00,"6,685.22","26,740.86"
13-Jan-2026,Debit Card,269.00,00.00,"27,009.86"
14-Jan-2026,Interest,00.00,"2,700.99","24,308.87"
14-Jan-2026,Commission,00.00,"4,051.48","20,257.39"
14-Jan-2026,Purchase,"245,321.50",00.00,"265,578.89"
14-Jan-2026,ATM,"186,530.97",00.00,"452,109.86"
14-Jan-2026,Transfer,00.00,00.00,"452,109.86"
14-Jan-2026,IMPS,00.00,"90,421.97","361,687.89"
14-Jan-2026,RTGS,07.40,00.00,"361,695.29"
14-Jan-2026,Commission,00.00,"40,188.37","321,506.92"
14-Jan-2026,Bill,00.00,"45,929.56","275,577.36"
14-Jan-2026,Tax,00.00,"34,447.17","241,130.19"
14-Jan-2026,Transfer,00.00,"60,282.55","180,847.64"
15-Jan-2026,Interest,00.00,"25,835.38","155,012.26"
15-Jan-2026,Transfer,35.15,00.00,"155,047.41"
16-Jan-2026,Commission,"2,610.50",00.00,"157,657.91"
16-Jan-2026,Bill,00.00,"78,828.96","78,828.96"
16-Jan-2026,Cash,07.00,00.00,"78,835.96"
17-Jan-2026,Cheque,00.00,"26,278.65","52,557.31"
17-Jan-2026,Miscellaneous,328.70,00.00,"52,886.01"
17-Jan-2026,Transfer,00.00,"6,610.75","46,275.26"
17-Jan-2026,Cash,00.00,"7,712.54","38,562.72"
17-Jan-2026,Tax,00.00,"7,712.54","30,850.18"
17-Jan-2026,ATM,"16,337.00",00.00,"47,187.18"
17-Jan-2026,Bill,03.90,00.00,"47,191.08"
17-Jan-2026,Tax,"14,593.00",00.00,"61,784.08"
17-Jan-2026,ATM,00.00,"10,297.35","51,486.73"
17-Jan-2026,Transfer,254.70,00.00,"51,741.43"
17-Jan-2026,Transfer,07.17,00.00,"51,748.60"
17-Jan-2026,Cash,"21,391.00",00.00,"73,139.60"
17-Jan-2026,Reversal,381.53,00.00,"73,521.13"
17-Jan-2026,Bill,04.00,00.00,"73,525.13"
17-Jan-2026,Purchase,202.00,00.00,"73,727.13"
17-Jan-2026,Cash,11.43,00.00,"73,738.56"
17-Jan-2026,Cash,00.00,"18,434.64","55,303.92"
17-Jan-2026,Bill,00.00,"5,530.39","49,773.53"
17-Jan-2026,Interest,"140,772.00",00.00,"190,545.53"
17-Jan-2026,IMPS,02.57,00.00,"190,548.10"
17-Jan-2026,Bill,53.10,00.00,"190,601.20"
17-Jan-2026,Cash,00.00,"38,120.24","152,480.96"
17-Jan-2026,Commission,00.00,"21,782.99","130,697.97"
17-Jan-2026,Interest,00.00,"43,565.99","87,131.98"
17-Jan-2026,RTGS,00.00,"10,891.50","76,240.48"
17-Jan-2026,Interest,00.00,"7,624.05","68,616.43"
17-Jan-2026,Debit Card,03.73,00.00,"68,620.16"
17-Jan-2026,Transfer,"610,101.75",00.00,"678,721.91"
17-Jan-2026,Debit Card,00.00,"135,744.38","542,977.53"
17-Jan-2026,Debit Card,00.00,"180,992.51","361,985.02"
17-Jan-2026,Miscellaneous,03.37,00.00,"361,988.39"
17-Jan-2026,Debit Card,437.85,00.00,"362,426.24"
17-Jan-2026,Debit Card,03.00,00.00,"362,429.24"
17-Jan-2026,RTGS,04.80,00.00,"362,434.04"
17-Jan-2026,Purchase,36.00,00.00,"362,470.04"
17-Jan-2026,NEFT,"1,071,291.75",00.00,"1,433,761.79"
17-Jan-2026,Cheque,56.59,00.00,"1,433,818.38"
17-Jan-2026,Bill,00.00,"477,939.46","955,878.92"
17-Jan-2026,Reversal,07.01,00.00,"955,885.93"
17-Jan-2026,Debit Card,44.60,00.00,"955,930.53"
17-Jan-2026,Interest,00.00,"95,593.05","860,337.48"
17-Jan-2026,Cash,17.00,00.00,"860,354.48"
17-Jan-2026,NEFT,00.00,"107,544.31","752,810.17"
17-Jan-2026,Purchase,"378,050.00",00.00,"1,130,860.17"
17-Jan-2026,Debit Card,00.00,"226,172.03","904,688.14"
17-Jan-2026,Reversal,258.84,00.00,"904,946.98"
17-Jan-2026,Tax,306.73,00.00,"905,253.71"
17-Jan-2026,Interest,"1,166,773.00",00.00,"2,072,026.71"
17-Jan-2026,Bill,00.00,"690,675.57","1,381,351.14"
17-Jan-2026,Debit Card,00.00,"230,225.19","1,151,125.95"
17-Jan-2026,ATM,00.00,"383,708.65","767,417.30"
18-Jan-2026,ATM,06.00,00.00,"767,423.30"
18-Jan-2026,RTGS,00.00,"127,903.88","639,519.42"
19-Jan-2026,NEFT,"375,693.25",00.00,"1,015,212.67"
19-Jan-2026,Interest,00.00,"253,803.17","761,409.50"
19-Jan-2026,Miscellaneous,"133,167.00",00.00,"894,576.50"
19-Jan-2026,RTGS,"88,888.50",00.00,"983,465.00"
19-Jan-2026,Tax,"127,314.00",00.00,"1,110,779.00"
19-Jan-2026,NEFT,00.00,"277,694.75","833,084.25"
19-Jan-2026,Cheque,00.00,"83,308.43","749,775.82"
19-Jan-2026,NEFT,00.00,"83,308.42","666,467.40"
19-Jan-2026,RTGS,00.00,"74,051.93","592,415.47"
19-Jan-2026,Bill,00.00,"197,471.82","394,943.65"
19-Jan-2026,NEFT,448.50,00.00,"395,392.15"
19-Jan-2026,Debit Card,"190,738.00",00.00,"586,130.15"
19-Jan-2026,ATM,04.00,00.00,"586,134.15"
19-Jan-2026,Tax,00.00,"65,126.02","521,008.13"
19-Jan-2026,ATM,40.19,00.00,"521,048.32"
19-Jan-2026,Debit Card,"17,114.60",00.00,"538,162.92"
19-Jan-2026,ATM,787.67,00.00,"538,950.59"
19-Jan-2026,ATM,36.00,00.00,"538,986.59"
19-Jan-2026,NEFT,00.00,"179,662.20","359,324.39"
19-Jan-2026,Reversal,00.00,"39,924.93","319,399.46"
19-Jan-2026,Debit Card,"2,996.43",00.00,"322,395.89"
19-Jan-2026,Miscellaneous,281.00,00.00,"322,676.89"
19-Jan-2026,Reversal,"2,871.40",00.00,"325,548.29"
19-Jan-2026,Reversal,"1,400,256.00",00.00,"1,725,804.29"
19-Jan-2026,Purchase,20.00,00.00,"1,725,824.29"
19-Jan-2026,Purchase,00.00,"215,728.04","1,510,096.25"
19-Jan-2026,Reversal,03.00,00.00,"1,510,099.25"
19-Jan-2026,Cheque,"101,847.00",00.00,"1,611,946.25"
19-Jan-2026,ATM,"3,615.04",00.00,"1,615,561.29"
19-Jan-2026,Commission,"2,928.40",00.00,"1,618,489.69"
19-Jan-2026,RTGS,00.00,"202,311.21","1,416,178.48"
19-Jan-2026,RTGS,00.00,"177,022.31","1,239,156.17"
19-Jan-2026,Commission,00.00,"247,831.23","991,324.94"
19-Jan-2026,Cheque,"1,560,511.00",00.00,"2,551,835.94"
19-Jan-2026,ATM,"15,398.00",00.00,"2,567,233.94"
19-Jan-2026,Cash,00.00,"641,808.49","1,925,425.46"
19-Jan-2026,IMPS,05.90,00.00,"1,925,431.36"
19-Jan-2026,Debit Card,"23,889.16",00.00,"1,949,320.52"
19-Jan-2026,Commission,"1,200.70",00.00,"1,950,521.22"
19-Jan-2026,NEFT,00.00,"278,645.89","1,671,875.33"
19-Jan-2026,Bill,00.00,"1,671,875.33",00.00
19-Jan-2026,Cash,03.84,00.00,03.84
19-Jan-2026,Bill,"24,423.00",00.00,"24,426.84"
19-Jan-2026,Commission,00.00,"24,426.84",00.00
19-Jan-2026,Interest,"26,644.22",00.00,"26,644.22"
19-Jan-2026,IMPS,"8,505.00",00.00,"35,149.22"
19-Jan-2026,Transfer,00.00,"5,021.32","30,127.90"
19-Jan-2026,Interest,"330,242.00",00.00,"360,369.90"
19-Jan-2026,Interest,"31,475.77",00.00,"391,845.67"
19-Jan-2026,NEFT,"1,165.80",00.00,"393,011.47"
19-Jan-2026,Commission,00.00,"43,667.94","349,343.53"
19-Jan-2026,IMPS,01.50,00.00,"349,345.03"
19-Jan-2026,Miscellaneous,"1,385,332.00",00.00,"1,734,677.03"
19-Jan-2026,Interest,"7,355.00",00.00,"1,742,032.03"
19-Jan-2026,Debit Card,"32,734.20",00.00,"1,774,766.23"
19-Jan-2026,Commission,"1,272,600.00",00.00,"3,047,366.23"
19-Jan-2026,IMPS,00.00,"1,523,683.12","1,523,683.12"
19-Jan-2026,Miscellaneous,00.00,"190,460.39","1,333,222.73"
19-Jan-2026,Bill,00.00,"266,644.55","1,066,578.18"
19-Jan-2026,Bill,"150,818.30",00.00,"1,217,396.48"
19-Jan-2026,RTGS,02.00,00.00,"1,217,398.48"
19-Jan-2026,Debit Card,00.00,"152,174.81","1,065,223.67"
19-Jan-2026,Reversal,00.00,"1,065,223.67",00.00
19-Jan-2026,IMPS,"961,198.00",00.00,"961,198.00"
19-Jan-2026,Tax,07.20,00.00,"961,205.20"
19-Jan-2026,Bill,00.00,"160,200.87","801,004.33"
19-Jan-2026,ATM,"220,981.00",00.00,"1,021,985.33"
19-Jan-2026,Cheque,"1,326.00",00.00,"1,023,311.33"
19-Jan-2026,RTGS,00.00,"170,551.89","852,759.44"
19-Jan-2026,Purchase,00.00,"213,189.86","639,569.58"
19-Jan-2026,Miscellaneous,00.00,"319,784.79","319,784.79"
19-Jan-2026,Interest,00.00,"63,956.96","255,827.83"
19-Jan-2026,NEFT,364.00,00.00,"256,191.83"
19-Jan-2026,Transfer,"26,009.20",00.00,"282,201.03"
19-Jan-2026,Miscellaneous,00.00,"94,067.01","188,134.02"
19-Jan-2026,Commission,00.00,"23,516.75","164,617.27"
19-Jan-2026,Miscellaneous,04.60,00.00,"164,621.87"
19-Jan-2026,Debit Card,00.00,"23,517.41","141,104.46"
19-Jan-2026,NEFT,00.00,"28,220.89","112,883.57"
19-Jan-2026,Bill,00.00,"18,813.93","94,069.64"
19-Jan-2026,Cheque,22.00,00.00,"94,091.64"
19-Jan-2026,Miscellaneous,412.09,00.00,"94,503.73"
19-Jan-2026,RTGS,"5,506.90",00.00,"100,010.63"
19-Jan-2026,Miscellaneous,00.00,"16,668.44","83,342.19"
19-Jan-2026,Purchase,00.00,"10,417.77","72,924.42"
19-Jan-2026,Cash,275.00,00.00,"73,199.42"
19-Jan-2026,ATM,"88,074.00",00.00,"161,273.42"
19-Jan-2026,Bill,00.00,"16,127.34","145,146.08"
19-Jan-2026,Cheque,00.00,"16,127.34","129,018.74"
19-Jan-2026,RTGS,"26,215.00",00.00,"155,233.74"
20-Jan-2026,Tax,00.00,"25,872.29","129,361.45"
20-Jan-2026,Commission,00.00,"21,560.24","107,801.21"
20-Jan-2026,Commission,00.00,"11,977.91","95,823.30"
20-Jan-2026,Cheque,00.00,"47,911.65","47,911.65"
20-Jan-2026,NEFT,03.50,00.00,"47,915.15"
20-Jan-2026,Commission,01.96,00.00,"47,917.11"
20-Jan-2026,Bill,00.00,"11,979.28","35,937.83"
20-Jan-2026,Transfer,00.00,"7,187.57","28,750.26"
20-Jan-2026,Interest,00.00,"7,187.57","21,562.70"
20-Jan-2026,ATM,00.00,"2,695.34","18,867.36"
20-Jan-2026,Interest,00.00,"3,144.56","15,722.80"
20-Jan-2026,ATM,00.00,"15,722.80",00.00
20-Jan-2026,Debit Card,"10,318.34",00.00,"10,318.34"
20-Jan-2026,Purchase,"16,963.44",00.00,"27,281.78"
20-Jan-2026,NEFT,00.00,"4,546.96","22,734.82"
20-Jan-2026,ATM,61.70,00.00,"22,796.52"
20-Jan-2026,Transfer,00.00,"22,796.52",00.00
20-Jan-2026,Miscellaneous,"2,762.00",00.00,"2,762.00"
20-Jan-2026,Purchase,00.00,"1,381.00","1,381.00"
20-Jan-2026,Reversal,00.00,172.63,"1,208.38"
20-Jan-2026,Reversal,00.00,172.63,"1,035.75"
20-Jan-2026,Cash,00.00,207.15,828.60
20-Jan-2026,Reversal,00.00,828.60,00.00
20-Jan-2026,Commission,"227,819.40",00.00,"227,819.40"
20-Jan-2026,Cheque,00.00,"227,819.40",00.00
20-Jan-2026,NEFT,"210,862.00",00.00,"210,862.00"
20-Jan-2026,Tax,00.00,"23,429.11","187,432.89"
20-Jan-2026,Tax,00.00,"62,477.63","124,955.26"
20-Jan-2026,Interest,00.00,"20,825.88","104,129.38"
20-Jan-2026,Cheque,00.00,"17,354.90","86,774.48"
20-Jan-2026,RTGS,495.10,00.00,"87,269.58"
20-Jan-2026,Transfer,00.00,"10,908.70","76,360.88"
20-Jan-2026,Reversal,00.00,"19,090.22","57,270.66"
20-Jan-2026,Bill,00.00,"57,270.66",00.00
20-Jan-2026,Reversal,270.80,00.00,270.80
21-Jan-2026,IMPS,00.00,38.69,232.11
